time,subj_course_id,sec_code,sec_id,prof,available,waitlist,total,enrolled_ct
1653297008190,AAS 10,A01,085689,Butler; Elizabeth Annette,28,0,34,6
1653297008190,AAS 10,A02,085690,Butler; Elizabeth Annette,34,0,34,0
1653297008721,AAS 170,A00,085691,Butler; Elizabeth Annette,30,0,32,2
1653297009245,AIP 197,001,085683,Staff,100,0,100,0
1653297009245,AIP 197,002,085684,Rao; Ramesh R,50,0,50,0
1653297009777,AIP 197DC,001,085696,Anderson; Patrick W.,27,0,27,0
1653297010300,AIP 197T,A00,085685,Anderson; Patrick W.,15,0,15,0
1653297010834,ANAR 100,A00,094326,Fortier; Jana,22,0,25,3
1653297011377,ANAR 104,A01,085846,Staff,13,0,15,2
1653297011905,ANAR 120,A00,085847,Staff,15,0,15,0
1653297012430,ANAR 143,A00,094288,Staff,31,0,32,1
1653297012962,ANBI 100,A00,085849,Marchetto; Maria Carolina,31,0,34,3
1653297013487,ANBI 112,A00,085850,Marchetto; Maria Carolina,21,0,28,7
1653297014012,ANBI 118,A00,085851,Fox; Patrick Keolu Ozer,32,0,32,0
1653297014538,ANBI 136,A00,085852,Semendeferi; Ekaterini,20,0,22,2
1653297015063,ANBI 141,A00,085854,Gagneux; Pascal,186,0,192,6
1653297015585,ANBI 145,A00,085855,Staff,30,0,32,2
1653297016109,ANBI 175,A00,085857,Staff,30,0,32,2
1653297016641,ANSC 104,A00,094290,Yeh; Rihan Wen Xin,40,0,46,6
1653297017164,ANSC 105,A00,085859,Olivas Hernandez; Olga Lid,36,0,37,1
1653297017688,ANSC 120,A00,085860,Jassal; Aftab,51,0,56,5
1653297018212,ANSC 121,A00,085861,Staff,29,0,32,3
1653297019263,ANSC 148,A00,085866,Staff,71,0,73,2
1653297019791,ANSC 169,A00,085869,Fortier; Jana,23,0,25,2
1653297020321,ANSC 175,A00,085871,Pedersen; David,28,0,32,4
1653297020846,ANTH 1,A00,085803,Varma; Saiba,146,0,146,0
1653297021374,ANTH 2,A01,085805,Staff,43,0,44,1
1653297021374,ANTH 2,A02,085806,Staff,42,0,44,2
1653297021374,ANTH 2,A03,085807,Staff,44,0,44,0
1653297021374,ANTH 2,A04,085808,Staff,44,0,44,0
1653297021374,ANTH 2,A05,085809,Staff,40,0,40,0
1653297021907,ANTH 4,A01,085811,Yeh; Rihan Wen Xin,32,0,32,0
1653297021907,ANTH 4,A02,095113,Yeh; Rihan Wen Xin,32,0,32,0
1653297021907,ANTH 4,A03,095114,Yeh; Rihan Wen Xin,32,0,32,0
1653297021907,ANTH 4,A04,095115,Yeh; Rihan Wen Xin,34,0,34,0
1653297022432,ANTH 10,A00,085814,Stewart; Alexander B,215,0,216,1
1653297022960,ANTH 21,A01,085816,Kang; Byung Chu,35,0,35,0
1653297022960,ANTH 21,A02,085817,Kang; Byung Chu,35,0,35,0
1653297022960,ANTH 21,A03,085818,Kang; Byung Chu,35,0,35,0
1653297022960,ANTH 21,A04,085819,Kang; Byung Chu,35,0,35,0
1653297022960,ANTH 21,A05,085820,Kang; Byung Chu,33,0,35,2
1653297022960,ANTH 21,A06,085821,Kang; Byung Chu,33,0,35,2
1653297022960,ANTH 21,A07,085822,Kang; Byung Chu,35,0,35,0
1653297022960,ANTH 21,A08,085823,Kang; Byung Chu,35,0,35,0
1653297022960,ANTH 21,A09,085824,Kang; Byung Chu,0,0,0,0
1653297022960,ANTH 21,A10,085825,Kang; Byung Chu,0,0,0,0
1653297022960,ANTH 21,A11,095111,Kang; Byung Chu,30,0,30,0
1653297022960,ANTH 21,A12,095112,Kang; Byung Chu,30,0,30,0
1653297022960,ANTH 21,B01,085827,Staff,36,0,36,0
1653297022960,ANTH 21,B02,085828,Staff,36,0,36,0
1653297022960,ANTH 21,B03,085829,Staff,36,0,36,0
1653297022960,ANTH 21,B04,085830,Staff,38,0,38,0
1653297023487,ANTH 23,A01,085832,Stewart; Alexander B,31,0,31,0
1653297023487,ANTH 23,A02,085833,Stewart; Alexander B,31,0,31,0
1653297023487,ANTH 23,A03,085834,Stewart; Alexander B,31,0,31,0
1653297023487,ANTH 23,A04,085835,Stewart; Alexander B,31,0,31,0
1653297023487,ANTH 23,A05,085836,Stewart; Alexander B,31,0,31,0
1653297023487,ANTH 23,A06,085837,Stewart; Alexander B,0,0,0,0
1653297023487,ANTH 23,A07,085838,Stewart; Alexander B,0,0,0,0
1653297024014,ANTH 87,A00,085842,Staff,20,0,20,0
1653297024014,ANTH 87,B00,085843,Staff,20,0,20,0
1653297024544,ANTH 101,A01,085873,Goldstein; Paul S,33,0,36,3
1653297024544,ANTH 101,A02,085874,Goldstein; Paul S,33,0,36,3
1653297024544,ANTH 101,A03,085875,Goldstein; Paul S,36,0,36,0
1653297024544,ANTH 101,A04,085876,Goldstein; Paul S,36,0,38,2
1653297025068,ANTH 105,A00,085877,Staff,39,0,40,1
1653297025592,ANTH 108,A00,085878,Staff,31,0,32,1
1653297026125,ANTH 192,A00,094234,Kaiser; Bronwyn Nicole & Non; Amy L,20,0,20,0
1653297026648,ANTH 196A,A00,085879,Varma; Saiba,20,0,20,0
1653297027184,AWP 3,001,085697,Staff,13,0,13,0
1653297027184,AWP 3,002,085698,Staff,13,0,13,0
1653297027184,AWP 3,003,085699,Staff,13,0,13,0
1653297027184,AWP 3,004,085700,Staff,0,0,0,0
1653297027184,AWP 3,005,085701,Staff,0,0,0,0
1653297027184,AWP 3,006,085703,Staff,0,0,0,0
1653297027184,AWP 3,007,085704,Staff,13,0,13,0
1653297027184,AWP 3,008,085707,Staff,0,0,0,0
1653297027184,AWP 3,009,085709,Staff,13,0,13,0
1653297027184,AWP 3,010,085710,Staff,13,0,13,0
1653297027184,AWP 3,011,085711,Staff,0,0,0,0
1653297027184,AWP 3,012,085712,Staff,0,0,0,0
1653297027184,AWP 3,013,085713,Staff,13,0,13,0
1653297027184,AWP 3,014,085715,Staff,13,0,13,0
1653297027184,AWP 3,015,085717,Staff,13,0,13,0
1653297027184,AWP 3,016,085719,Staff,13,0,13,0
1653297027184,AWP 3,017,085720,Staff,13,0,13,0
1653297027184,AWP 3,018,085721,Staff,13,0,13,0
1653297027184,AWP 3,019,085722,Staff,13,0,13,0
1653297027184,AWP 3,020,085723,Staff,13,0,13,0
1653297027184,AWP 3,021,085724,Staff,13,0,13,0
1653297027184,AWP 3,022,085725,Staff,13,0,13,0
1653297027184,AWP 3,023,085726,Staff,13,0,13,0
1653297027184,AWP 3,024,085727,Staff,13,0,13,0
1653297027184,AWP 3,025,085728,Staff,13,0,13,0
1653297027184,AWP 3,026,085729,Staff,13,0,13,0
1653297027184,AWP 3,027,085730,Staff,13,0,13,0
1653297027184,AWP 3,028,085731,Staff,13,0,13,0
1653297027184,AWP 3,029,085732,Staff,13,0,13,0
1653297027184,AWP 3,030,085733,Staff,13,0,13,0
1653297027184,AWP 3,031,085734,Staff,13,0,13,0
1653297027184,AWP 3,032,085735,Staff,13,0,13,0
1653297027184,AWP 3,033,085736,Staff,13,0,13,0
1653297027184,AWP 3,034,085737,Staff,13,0,13,0
1653297027184,AWP 3,035,085738,Staff,13,0,13,0
1653297027184,AWP 3,036,085739,Staff,13,0,13,0
1653297027184,AWP 3,037,085740,Staff,13,0,13,0
1653297027184,AWP 3,038,085741,Staff,13,0,13,0
1653297027184,AWP 3,039,085742,Staff,13,0,13,0
1653297027184,AWP 3,040,085743,Staff,13,0,13,0
1653297027184,AWP 3,041,085744,Staff,13,0,13,0
1653297027184,AWP 3,042,085745,Staff,13,0,13,0
1653297027184,AWP 3,043,085746,Staff,13,0,13,0
1653297027184,AWP 3,044,085747,Staff,13,0,13,0
1653297027184,AWP 3,045,085748,Staff,13,0,13,0
1653297027184,AWP 3,046,085749,Staff,13,0,13,0
1653297027184,AWP 3,047,085750,Staff,13,0,13,0
1653297027184,AWP 3,048,085751,Staff,13,0,13,0
1653297027184,AWP 3,049,085752,Staff,13,0,13,0
1653297027184,AWP 3,050,085753,Staff,13,0,13,0
1653297027184,AWP 3,051,085754,Staff,13,0,13,0
1653297027184,AWP 3,052,085755,Staff,0,0,0,0
1653297027184,AWP 3,053,085756,Staff,13,0,13,0
1653297027184,AWP 3,054,085757,Staff,0,0,0,0
1653297027184,AWP 3,055,085758,Staff,13,0,13,0
1653297027184,AWP 3,056,085759,Staff,13,0,13,0
1653297027184,AWP 3,057,085760,Staff,13,0,13,0
1653297027184,AWP 3,058,085761,Staff,13,0,13,0
1653297027184,AWP 3,059,085762,Staff,13,0,13,0
1653297027184,AWP 3,060,085763,Staff,13,0,13,0
1653297027184,AWP 3,061,085764,Staff,13,0,13,0
1653297027184,AWP 3,062,085765,Staff,13,0,13,0
1653297027184,AWP 3,063,085766,Staff,13,0,13,0
1653297027184,AWP 3,064,085767,Staff,13,0,13,0
1653297027184,AWP 3,065,085768,Staff,13,0,13,0
1653297027184,AWP 3,066,085769,Staff,0,0,0,0
1653297027712,AWP 4A,001,085770,Staff,0,0,0,0
1653297027712,AWP 4A,002,085771,Staff,13,0,13,0
1653297027712,AWP 4A,003,085772,Staff,13,0,13,0
1653297027712,AWP 4A,004,085773,Staff,13,0,13,0
1653297027712,AWP 4A,005,085774,Staff,0,0,0,0
1653297027712,AWP 4A,006,085775,Staff,13,0,13,0
1653297027712,AWP 4A,007,085776,Staff,0,0,0,0
1653297027712,AWP 4A,008,085777,Staff,0,0,0,0
1653297027712,AWP 4A,009,085778,Staff,0,0,0,0
1653297027712,AWP 4A,010,085779,Staff,13,0,13,0
1653297027712,AWP 4A,011,085780,Staff,13,0,13,0
1653297027712,AWP 4A,012,085781,Staff,0,0,0,0
1653297027712,AWP 4A,013,085782,Staff,13,0,13,0
1653297027712,AWP 4A,014,085783,Staff,13,0,13,0
1653297027712,AWP 4A,015,085784,Staff,13,0,13,0
1653297027712,AWP 4A,016,085785,Staff,13,0,13,0
1653297027712,AWP 4A,017,085786,Staff,13,0,13,0
1653297027712,AWP 4A,018,085787,Staff,0,0,0,0
1653297027712,AWP 4A,019,085788,Staff,13,0,13,0
1653297027712,AWP 4A,020,085789,Staff,13,0,13,0
1653297027712,AWP 4A,021,085790,Staff,0,0,0,0
1653297027712,AWP 4A,022,085791,Staff,13,0,13,0
1653297027712,AWP 4A,023,085792,Staff,0,0,0,0
1653297027712,AWP 4A,024,085793,Staff,0,0,0,0
1653297027712,AWP 4A,025,085794,Staff,13,0,13,0
1653297027712,AWP 4A,026,085795,Staff,13,0,13,0
1653297027712,AWP 4A,027,085796,Staff,13,0,13,0
1653297027712,AWP 4A,028,085797,Staff,13,0,13,0
1653297027712,AWP 4A,029,085798,Staff,0,0,0,0
1653297027712,AWP 4A,030,085799,Staff,0,0,0,0
1653297027712,AWP 4A,031,093835,Staff,0,0,0,0
1653297028241,AWP 4B,001,085800,Staff,0,0,0,0
1653297028241,AWP 4B,002,085801,Staff,0,0,0,0
1653297028777,BENG 2,A00,085936,Wheeler; Bruce Christopher,28,0,30,2
1653297029301,BENG 110,A01,085939,Mc Culloch; Andrew Douglas,20,0,30,10
1653297029301,BENG 110,A02,085940,Mc Culloch; Andrew Douglas,18,0,30,12
1653297029301,BENG 110,A03,085941,Mc Culloch; Andrew Douglas,27,0,30,3
1653297029826,BENG 119A,A01,085943,Wheeler; Bruce Christopher,29,0,30,1
1653297030355,BENG 122A,A01,085945,Cauwenberghs; Gert,18,0,25,7
1653297030355,BENG 122A,A02,085946,Cauwenberghs; Gert,22,0,25,3
1653297030355,BENG 122A,A03,085947,Cauwenberghs; Gert,22,0,25,3
1653297030883,BENG 126A,A01,085949,Wheeler; Bruce Christopher,30,0,30,0
1653297031406,BENG 127A,A01,085951,Wheeler; Bruce Christopher,28,0,30,2
1653297031935,BENG 128A,A01,085953,Wheeler; Bruce Christopher,29,0,30,1
1653297032463,BENG 134,A01,085955,Smarr; Benjamin,0,0,0,0
1653297032987,BENG 135,A00,085956,Wheeler; Bruce Christopher,23,0,30,7
1653297033524,BENG 141,A00,085958,Lal; Ratnesh,20,0,30,10
1653297034047,BENG 147A,A01,085963,Wheeler; Bruce Christopher,30,0,30,0
1653297034570,BENG 148A,A01,085967,Wheeler; Bruce Christopher,30,0,30,0
1653297035092,BENG 149A,A01,085969,Wheeler; Bruce Christopher,30,0,30,0
1653297035623,BENG 161A,A01,085971,Fraley; Stephanie I.,20,0,25,5
1653297035623,BENG 161A,A02,085972,Fraley; Stephanie I.,13,0,25,12
1653297035623,BENG 161A,A03,085973,Fraley; Stephanie I.,9,0,25,16
1653297036147,BENG 162,A01,085975,Mali; Prashant Gulab Ram,0,0,35,35
1653297036147,BENG 162,A02,085976,Mali; Prashant Gulab Ram,26,0,35,9
1653297036672,BENG 166A,A00,085977,Sah; Robert Lie-Yuan,0,0,0,0
1653297037201,BENG 169A,A01,085982,Wheeler; Bruce Christopher,28,0,30,2
1653297037729,BENG 179A,A01,085984,Wheeler; Bruce Christopher,30,0,30,0
1653297038253,BENG 183,A01,085986,Zhong; Sheng,13,0,30,17
1653297038253,BENG 183,A02,085987,Zhong; Sheng,15,0,30,15
1653297038253,BENG 183,A03,085988,Zhong; Sheng,20,0,30,10
1653297038776,BENG 187B,A00,085989,Wheeler; Bruce Christopher,105,0,170,65
1653297039299,BENG 196,001,094047,Engler; Adam J.,9999,0,9999,0
1653297039838,BIBC 100,A01,092918,Huffaker; Alisa,0,0,19,19
1653297039838,BIBC 100,A02,092919,Huffaker; Alisa,19,0,19,0
1653297039838,BIBC 100,A03,092920,Huffaker; Alisa,18,0,19,1
1653297039838,BIBC 100,A04,092921,Huffaker; Alisa,18,0,19,1
1653297039838,BIBC 100,A05,092922,Huffaker; Alisa,19,0,19,0
1653297039838,BIBC 100,A06,092923,Huffaker; Alisa,18,0,19,1
1653297039838,BIBC 100,A07,092924,Huffaker; Alisa,10,0,19,9
1653297039838,BIBC 100,A08,092925,Huffaker; Alisa,17,0,19,2
1653297039838,BIBC 100,A09,092926,Huffaker; Alisa,19,0,19,0
1653297039838,BIBC 100,A10,092927,Huffaker; Alisa,11,0,19,8
1653297040381,BIBC 102,A01,092997,Schmelz; Eric Alexander,16,0,19,3
1653297040381,BIBC 102,A02,092998,Schmelz; Eric Alexander,5,0,19,14
1653297040381,BIBC 102,A03,092999,Schmelz; Eric Alexander,1,0,19,18
1653297040381,BIBC 102,A04,093000,Schmelz; Eric Alexander,17,0,19,2
1653297040381,BIBC 102,A05,093001,Schmelz; Eric Alexander,9,0,19,10
1653297040381,BIBC 102,A06,093002,Schmelz; Eric Alexander,16,0,19,3
1653297040381,BIBC 102,A07,093003,Schmelz; Eric Alexander,19,0,19,0
1653297040381,BIBC 102,A08,093004,Schmelz; Eric Alexander,19,0,19,0
1653297040381,BIBC 102,A09,093005,Schmelz; Eric Alexander,14,0,19,5
1653297040381,BIBC 102,B01,093064,Coleman; Aaron B.,19,0,19,0
1653297040381,BIBC 102,B02,093065,Coleman; Aaron B.,17,0,19,2
1653297040381,BIBC 102,B03,093066,Coleman; Aaron B.,16,0,19,3
1653297040381,BIBC 102,B04,093067,Coleman; Aaron B.,11,0,19,8
1653297040381,BIBC 102,B05,093068,Coleman; Aaron B.,18,0,19,1
1653297040381,BIBC 102,B06,093069,Coleman; Aaron B.,16,0,19,3
1653297040381,BIBC 102,B07,093070,Coleman; Aaron B.,19,0,19,0
1653297040381,BIBC 102,B08,093071,Coleman; Aaron B.,15,0,19,4
1653297040381,BIBC 102,B09,093072,Coleman; Aaron B.,17,0,19,2
1653297040913,BIBC 103,A01,089887,Bozinovic; Goran,19,0,24,5
1653297040913,BIBC 103,A02,089888,Bozinovic; Goran,23,0,24,1
1653297040913,BIBC 103,B01,089890,Burg; Michael,2,0,24,22
1653297040913,BIBC 103,B02,089891,Burg; Michael,20,0,24,4
1653297040913,BIBC 103,C01,089893,Beyhan; Sinem,14,0,24,10
1653297040913,BIBC 103,C02,089894,Beyhan; Sinem,22,0,24,2
1653297040913,BIBC 103,D01,089896,Coleman; Aaron B.,10,0,24,14
1653297040913,BIBC 103,D02,089897,Coleman; Aaron B.,22,0,24,2
1653297041441,BIBC 194,A00,089898,Hui; Enfu,16,0,27,11
1653297041975,BICD 100,A01,092396,Smith; Laurie,21,0,22,1
1653297041975,BICD 100,A02,092397,Smith; Laurie,22,0,22,0
1653297041975,BICD 100,A03,092398,Smith; Laurie,21,0,22,1
1653297041975,BICD 100,A04,092399,Smith; Laurie,22,0,22,0
1653297041975,BICD 100,A05,092400,Smith; Laurie,21,0,22,1
1653297041975,BICD 100,A06,092401,Smith; Laurie,22,0,22,0
1653297041975,BICD 100,A07,092402,Smith; Laurie,22,0,22,0
1653297041975,BICD 100,A08,092403,Smith; Laurie,22,0,22,0
1653297041975,BICD 100,B01,093073,Mueller; Liam O'Connor,21,0,22,1
1653297041975,BICD 100,B02,093074,Mueller; Liam O'Connor,22,0,22,0
1653297041975,BICD 100,B03,093075,Mueller; Liam O'Connor,22,0,22,0
1653297041975,BICD 100,B04,093076,Mueller; Liam O'Connor,22,0,22,0
1653297041975,BICD 100,B05,093077,Mueller; Liam O'Connor,22,0,22,0
1653297041975,BICD 100,B06,093078,Mueller; Liam O'Connor,22,0,22,0
1653297041975,BICD 100,B07,093079,Mueller; Liam O'Connor,21,0,22,1
1653297041975,BICD 100,B08,093080,Mueller; Liam O'Connor,22,0,22,0
1653297041975,BICD 100,C01,093021,McDonnell; Lisa Marie,21,0,22,1
1653297041975,BICD 100,C02,093022,McDonnell; Lisa Marie,20,0,22,2
1653297041975,BICD 100,C03,093023,McDonnell; Lisa Marie,22,0,22,0
1653297041975,BICD 100,C04,093024,McDonnell; Lisa Marie,22,0,22,0
1653297041975,BICD 100,C05,093025,McDonnell; Lisa Marie,22,0,22,0
1653297041975,BICD 100,C06,093026,McDonnell; Lisa Marie,22,0,22,0
1653297041975,BICD 100,C07,093027,McDonnell; Lisa Marie,20,0,22,2
1653297041975,BICD 100,C08,093028,McDonnell; Lisa Marie,22,0,22,0
1653297041975,BICD 100,D01,093081,Day; Christopher D,22,0,22,0
1653297041975,BICD 100,D02,093082,Day; Christopher D,17,0,22,5
1653297041975,BICD 100,D03,093083,Day; Christopher D,21,0,22,1
1653297041975,BICD 100,D04,093084,Day; Christopher D,19,0,22,3
1653297041975,BICD 100,D05,093085,Day; Christopher D,22,0,22,0
1653297041975,BICD 100,D06,093086,Day; Christopher D,20,0,22,2
1653297041975,BICD 100,D07,093087,Day; Christopher D,19,0,22,3
1653297041975,BICD 100,D08,093088,Day; Christopher D,20,0,22,2
1653297042513,BICD 110,A01,093089,Kiger; Amy,29,0,32,3
1653297042513,BICD 110,A02,093091,Kiger; Amy,32,0,32,0
1653297042513,BICD 110,A03,093092,Kiger; Amy,31,0,32,1
1653297042513,BICD 110,A04,093093,Kiger; Amy,31,0,32,1
1653297042513,BICD 110,A05,093094,Kiger; Amy,26,0,32,6
1653297042513,BICD 110,A06,093095,Kiger; Amy,31,0,32,1
1653297042513,BICD 110,A07,093096,Kiger; Amy,31,0,32,1
1653297042513,BICD 110,B01,093029,Grossman; Emily N,21,0,32,11
1653297042513,BICD 110,B02,093030,Grossman; Emily N,28,0,32,4
1653297042513,BICD 110,B03,093031,Grossman; Emily N,32,0,32,0
1653297042513,BICD 110,B04,093032,Grossman; Emily N,28,0,32,4
1653297042513,BICD 110,B05,093033,Grossman; Emily N,26,0,32,6
1653297042513,BICD 110,B06,093034,Grossman; Emily N,19,0,32,13
1653297042513,BICD 110,B07,093035,Grossman; Emily N,20,0,32,12
1653297043045,BICD 140,A01,093097,Zuniga; Elina I,19,0,32,13
1653297043045,BICD 140,A02,093098,Zuniga; Elina I,17,0,32,15
1653297043045,BICD 140,A03,093099,Zuniga; Elina I,30,0,32,2
1653297043045,BICD 140,A04,093100,Zuniga; Elina I,32,0,32,0
1653297043045,BICD 140,A05,093101,Zuniga; Elina I,29,0,32,3
1653297043045,BICD 140,A06,093102,Zuniga; Elina I,27,0,32,5
1653297043575,BIEB 102,A01,092528,Butler; Shannon Rhey,22,0,27,5
1653297043575,BIEB 102,A02,092529,Butler; Shannon Rhey,17,0,27,10
1653297043575,BIEB 102,A03,092530,Butler; Shannon Rhey,24,0,27,3
1653297043575,BIEB 102,A04,092531,Butler; Shannon Rhey,26,0,27,1
1653297043575,BIEB 102,A05,092532,Butler; Shannon Rhey,25,0,27,2
1653297043575,BIEB 102,A06,092533,Butler; Shannon Rhey,24,0,27,3
1653297043575,BIEB 102,A07,092534,Butler; Shannon Rhey,23,0,27,4
1653297044104,BIEB 121,A00,089907,Holway; David A.,0,0,32,32
1653297044630,BIEB 126,A01,092974,Kohn; Joshua R,24,0,27,3
1653297044630,BIEB 126,A02,092975,Kohn; Joshua R,26,0,27,1
1653297044630,BIEB 126,A03,092976,Kohn; Joshua R,23,0,27,4
1653297044630,BIEB 126,A04,092977,Kohn; Joshua R,26,0,27,1
1653297044630,BIEB 126,A05,092978,Kohn; Joshua R,27,0,27,0
1653297045156,BIEB 146,A01,093054,Petrie; Katherine Lynn,1,0,27,26
1653297045156,BIEB 146,A02,093055,Petrie; Katherine Lynn,4,0,27,23
1653297045156,BIEB 146,A03,093056,Petrie; Katherine Lynn,0,0,27,27
1653297045156,BIEB 146,A04,093057,Petrie; Katherine Lynn,0,0,27,27
1653297045156,BIEB 146,A05,093058,Petrie; Katherine Lynn,20,0,27,7
1653297045156,BIEB 146,A06,093059,Petrie; Katherine Lynn,26,0,27,1
1653297045156,BIEB 146,A07,093060,Petrie; Katherine Lynn,16,0,27,11
1653297045156,BIEB 146,A08,093061,Petrie; Katherine Lynn,25,0,27,2
1653297045156,BIEB 146,A09,093062,Petrie; Katherine Lynn,17,0,27,10
1653297045685,BIEB 150,A01,093103,Rennison; Diana,16,0,27,11
1653297045685,BIEB 150,A02,093104,Rennison; Diana,21,0,27,6
1653297045685,BIEB 150,A03,093105,Rennison; Diana,26,0,27,1
1653297045685,BIEB 150,A04,093106,Rennison; Diana,24,0,27,3
1653297045685,BIEB 150,A05,093107,Rennison; Diana,25,0,27,2
1653297045685,BIEB 150,A06,093108,Rennison; Diana,27,0,27,0
1653297046212,BIEB 158,A01,094057,Reese; Aspen Taylor & Jackrel; Sara,31,0,32,1
1653297046212,BIEB 158,A02,094058,Reese; Aspen Taylor & Jackrel; Sara,28,0,32,4
1653297046212,BIEB 158,A03,094059,Reese; Aspen Taylor & Jackrel; Sara,31,0,32,1
1653297046212,BIEB 158,A04,094060,Reese; Aspen Taylor & Jackrel; Sara,32,0,32,0
1653297046750,BIEB 174,A01,092465,Cleland; Elsa Eleanor & Barton; Andrew David,27,0,27,0
1653297046750,BIEB 174,A02,092466,Cleland; Elsa Eleanor & Barton; Andrew David,27,0,27,0
1653297046750,BIEB 174,A03,092467,Cleland; Elsa Eleanor & Barton; Andrew David,23,0,27,4
1653297046750,BIEB 174,A04,092468,Cleland; Elsa Eleanor & Barton; Andrew David,20,0,27,7
1653297046750,BIEB 174,A05,092469,Cleland; Elsa Eleanor & Barton; Andrew David,25,0,27,2
1653297046750,BIEB 174,A06,092470,Cleland; Elsa Eleanor & Barton; Andrew David,27,0,27,0
1653297046750,BIEB 174,A07,092471,Cleland; Elsa Eleanor & Barton; Andrew David,25,0,27,2
1653297047282,BILD 1,A01,092884,Pickett; Brooke Elizabeth,16,0,19,3
1653297047282,BILD 1,A02,092885,Pickett; Brooke Elizabeth,19,0,19,0
1653297047282,BILD 1,A03,092886,Pickett; Brooke Elizabeth,19,0,19,0
1653297047282,BILD 1,A04,092887,Pickett; Brooke Elizabeth,18,0,19,1
1653297047282,BILD 1,A05,092888,Pickett; Brooke Elizabeth,19,0,19,0
1653297047282,BILD 1,A06,092889,Pickett; Brooke Elizabeth,19,0,19,0
1653297047282,BILD 1,A07,092890,Pickett; Brooke Elizabeth,17,0,19,2
1653297047282,BILD 1,B01,092891,Pekkurnaz Banghart; Gulcin,19,0,19,0
1653297047282,BILD 1,B02,092892,Pekkurnaz Banghart; Gulcin,16,0,19,3
1653297047282,BILD 1,B03,092893,Pekkurnaz Banghart; Gulcin,19,0,19,0
1653297047282,BILD 1,B04,092894,Pekkurnaz Banghart; Gulcin,19,0,19,0
1653297047282,BILD 1,B05,092895,Pekkurnaz Banghart; Gulcin,17,0,19,2
1653297047282,BILD 1,B06,092896,Pekkurnaz Banghart; Gulcin,19,0,19,0
1653297047282,BILD 1,B07,092897,Pekkurnaz Banghart; Gulcin,19,0,19,0
1653297047282,BILD 1,C01,092421,Meaders; Clara Leigh,18,0,19,1
1653297047282,BILD 1,C02,092422,Meaders; Clara Leigh,18,0,19,1
1653297047282,BILD 1,C03,092423,Meaders; Clara Leigh,17,0,19,2
1653297047282,BILD 1,C04,092424,Meaders; Clara Leigh,16,0,19,3
1653297047282,BILD 1,C05,092425,Meaders; Clara Leigh,19,0,19,0
1653297047282,BILD 1,C06,092426,Meaders; Clara Leigh,19,0,19,0
1653297047282,BILD 1,C07,092427,Meaders; Clara Leigh,19,0,19,0
1653297047282,BILD 1,D01,092428,Meaders; Clara Leigh,14,0,19,5
1653297047282,BILD 1,D02,092429,Meaders; Clara Leigh,19,0,19,0
1653297047282,BILD 1,D03,092430,Meaders; Clara Leigh,19,0,19,0
1653297047282,BILD 1,D04,092431,Meaders; Clara Leigh,19,0,19,0
1653297047282,BILD 1,D05,092432,Meaders; Clara Leigh,19,0,19,0
1653297047282,BILD 1,D06,092433,Meaders; Clara Leigh,19,0,19,0
1653297047282,BILD 1,D07,092434,Meaders; Clara Leigh,19,0,19,0
1653297047282,BILD 1,E01,092445,Cooper; Andrew Michael,19,0,19,0
1653297047282,BILD 1,E02,092446,Cooper; Andrew Michael,19,0,19,0
1653297047282,BILD 1,E03,092447,Cooper; Andrew Michael,19,0,19,0
1653297047282,BILD 1,E04,092448,Cooper; Andrew Michael,19,0,19,0
1653297047282,BILD 1,E05,092449,Cooper; Andrew Michael,17,0,19,2
1653297047282,BILD 1,E06,092450,Cooper; Andrew Michael,19,0,19,0
1653297047282,BILD 1,E07,092451,Cooper; Andrew Michael,19,0,19,0
1653297047822,BILD 2,A01,092822,Glasgow; Stacey Marie,25,0,25,0
1653297047822,BILD 2,A02,092823,Glasgow; Stacey Marie,24,0,25,1
1653297047822,BILD 2,A03,092824,Glasgow; Stacey Marie,24,0,25,1
1653297047822,BILD 2,A04,092825,Glasgow; Stacey Marie,25,0,25,0
1653297047822,BILD 2,A05,092826,Glasgow; Stacey Marie,25,0,25,0
1653297047822,BILD 2,A06,092827,Glasgow; Stacey Marie,25,0,25,0
1653297047822,BILD 2,A07,092828,Glasgow; Stacey Marie,25,0,25,0
1653297047822,BILD 2,B01,092830,Owens; Melinda Tsao-Ying,25,0,25,0
1653297047822,BILD 2,B02,092831,Owens; Melinda Tsao-Ying,21,0,25,4
1653297047822,BILD 2,B03,092832,Owens; Melinda Tsao-Ying,23,0,25,2
1653297047822,BILD 2,B04,092833,Owens; Melinda Tsao-Ying,25,0,25,0
1653297047822,BILD 2,B05,092834,Owens; Melinda Tsao-Ying,24,0,25,1
1653297047822,BILD 2,B06,092835,Owens; Melinda Tsao-Ying,21,0,25,4
1653297047822,BILD 2,B07,092836,Owens; Melinda Tsao-Ying,25,0,25,0
1653297047822,BILD 2,C01,092668,Owens; Melinda Tsao-Ying,24,0,25,1
1653297047822,BILD 2,C02,092669,Owens; Melinda Tsao-Ying,23,0,25,2
1653297047822,BILD 2,C03,092670,Owens; Melinda Tsao-Ying,22,0,25,3
1653297047822,BILD 2,C04,092671,Owens; Melinda Tsao-Ying,25,0,25,0
1653297047822,BILD 2,C05,092672,Owens; Melinda Tsao-Ying,25,0,25,0
1653297047822,BILD 2,C06,092673,Owens; Melinda Tsao-Ying,24,0,25,1
1653297047822,BILD 2,C07,092674,Owens; Melinda Tsao-Ying,25,0,25,0
1653297048368,BILD 3,A01,092454,Stockwell; Sarah R,17,0,19,2
1653297048368,BILD 3,A02,092455,Stockwell; Sarah R,17,0,19,2
1653297048368,BILD 3,A03,092456,Stockwell; Sarah R,18,0,19,1
1653297048368,BILD 3,A04,092457,Stockwell; Sarah R,19,0,19,0
1653297048368,BILD 3,A05,092458,Stockwell; Sarah R,19,0,19,0
1653297048368,BILD 3,A06,092459,Stockwell; Sarah R,18,0,19,1
1653297048368,BILD 3,A07,092460,Stockwell; Sarah R,18,0,19,1
1653297048368,BILD 3,A08,092461,Stockwell; Sarah R,19,0,19,0
1653297048368,BILD 3,A09,092462,Stockwell; Sarah R,19,0,19,0
1653297048368,BILD 3,B01,092479,Stockwell; Sarah R,19,0,19,0
1653297048368,BILD 3,B02,092480,Stockwell; Sarah R,18,0,19,1
1653297048368,BILD 3,B03,092481,Stockwell; Sarah R,18,0,19,1
1653297048368,BILD 3,B04,092482,Stockwell; Sarah R,19,0,19,0
1653297048368,BILD 3,B05,092483,Stockwell; Sarah R,19,0,19,0
1653297048368,BILD 3,B06,092484,Stockwell; Sarah R,19,0,19,0
1653297048368,BILD 3,B07,092485,Stockwell; Sarah R,19,0,19,0
1653297048368,BILD 3,B08,092486,Stockwell; Sarah R,18,0,19,1
1653297048368,BILD 3,B09,092487,Stockwell; Sarah R,18,0,19,1
1653297048368,BILD 3,C01,092412,Butler; Shannon Rhey,18,0,19,1
1653297048368,BILD 3,C02,092413,Butler; Shannon Rhey,15,0,19,4
1653297048368,BILD 3,C03,092414,Butler; Shannon Rhey,19,0,19,0
1653297048368,BILD 3,C04,092415,Butler; Shannon Rhey,19,0,19,0
1653297048368,BILD 3,C05,092416,Butler; Shannon Rhey,19,0,19,0
1653297048368,BILD 3,C06,092417,Butler; Shannon Rhey,19,0,19,0
1653297048368,BILD 3,C07,092418,Butler; Shannon Rhey,19,0,19,0
1653297048368,BILD 3,C08,092419,Butler; Shannon Rhey,19,0,19,0
1653297048368,BILD 3,C09,092420,Butler; Shannon Rhey,19,0,19,0
1653297048368,BILD 3,D01,092898,Reuther; Keefe,18,0,19,1
1653297048368,BILD 3,D02,092899,Reuther; Keefe,19,0,19,0
1653297048368,BILD 3,D03,092900,Reuther; Keefe,19,0,19,0
1653297048368,BILD 3,D04,092901,Reuther; Keefe,19,0,19,0
1653297048368,BILD 3,D05,092902,Reuther; Keefe,19,0,19,0
1653297048368,BILD 3,D06,092903,Reuther; Keefe,19,0,19,0
1653297048368,BILD 3,D07,092904,Reuther; Keefe,18,0,19,1
1653297048368,BILD 3,D08,092905,Reuther; Keefe,19,0,19,0
1653297048368,BILD 3,D09,092906,Reuther; Keefe,19,0,19,0
1653297048897,BILD 4,A01,089840,Mel; Stephanie,0,0,0,0
1653297048897,BILD 4,A02,089841,Mel; Stephanie,0,0,0,0
1653297048897,BILD 4,A03,089842,Mel; Stephanie,0,0,0,0
1653297048897,BILD 4,A04,089843,Mel; Stephanie,0,0,0,0
1653297048897,BILD 4,A05,089844,Mel; Stephanie,0,0,0,0
1653297048897,BILD 4,A06,089845,Mel; Stephanie,0,0,0,0
1653297048897,BILD 4,A07,089846,Mel; Stephanie,0,0,0,0
1653297048897,BILD 4,A08,089847,Mel; Stephanie,0,0,0,0
1653297048897,BILD 4,A09,089848,Mel; Stephanie,0,0,0,0
1653297048897,BILD 4,A10,089849,Mel; Stephanie,0,0,0,0
1653297048897,BILD 4,A11,089850,Mel; Stephanie,0,0,0,0
1653297048897,BILD 4,A12,089851,Mel; Stephanie,0,0,0,0
1653297048897,BILD 4,A13,089852,Mel; Stephanie,0,0,0,0
1653297048897,BILD 4,A14,089853,Mel; Stephanie,0,0,0,0
1653297048897,BILD 4,A15,089854,Mel; Stephanie,0,0,0,0
1653297048897,BILD 4,A16,089855,Mel; Stephanie,0,0,0,0
1653297048897,BILD 4,B01,089857,Lo; Stanley M.,0,0,0,0
1653297048897,BILD 4,B02,089858,Lo; Stanley M.,0,0,0,0
1653297048897,BILD 4,B03,089859,Lo; Stanley M.,0,0,0,0
1653297048897,BILD 4,B04,089860,Lo; Stanley M.,0,0,0,0
1653297048897,BILD 4,B05,089861,Lo; Stanley M.,0,0,0,0
1653297048897,BILD 4,B06,089862,Lo; Stanley M.,0,0,0,0
1653297048897,BILD 4,B07,089863,Lo; Stanley M.,0,0,0,0
1653297048897,BILD 4,B08,089864,Lo; Stanley M.,0,0,0,0
1653297048897,BILD 4,B09,089865,Lo; Stanley M.,0,0,0,0
1653297048897,BILD 4,B10,089866,Lo; Stanley M.,0,0,0,0
1653297048897,BILD 4,B11,089867,Lo; Stanley M.,0,0,0,0
1653297048897,BILD 4,B12,089868,Lo; Stanley M.,0,0,0,0
1653297048897,BILD 4,B13,089869,Lo; Stanley M.,0,0,0,0
1653297048897,BILD 4,B14,089870,Lo; Stanley M.,0,0,0,0
1653297048897,BILD 4,B15,089871,Lo; Stanley M.,0,0,0,0
1653297048897,BILD 4,B16,089872,Lo; Stanley M.,0,0,0,0
1653297049426,BILD 5,A01,092907,Reuther; Keefe,31,0,32,1
1653297049426,BILD 5,A02,092908,Reuther; Keefe,30,0,32,2
1653297049965,BILD 10,A01,092909,Gustafson-Brown; Cindy,27,0,27,0
1653297049965,BILD 10,A02,092910,Gustafson-Brown; Cindy,27,0,27,0
1653297049965,BILD 10,A03,092911,Gustafson-Brown; Cindy,27,0,27,0
1653297049965,BILD 10,A04,092912,Gustafson-Brown; Cindy,27,0,27,0
1653297049965,BILD 10,A05,092913,Gustafson-Brown; Cindy,25,0,27,2
1653297049965,BILD 10,A06,092914,Gustafson-Brown; Cindy,26,0,27,1
1653297049965,BILD 10,A07,092915,Gustafson-Brown; Cindy,27,0,27,0
1653297049965,BILD 10,A08,092916,Gustafson-Brown; Cindy,27,0,27,0
1653297049965,BILD 10,A09,092917,Gustafson-Brown; Cindy,27,0,27,0
1653297050496,BILD 20,A01,092956,Rana; Brinda Kanti,24,0,27,3
1653297050496,BILD 20,A02,092957,Rana; Brinda Kanti,24,0,27,3
1653297050496,BILD 20,A03,092958,Rana; Brinda Kanti,27,0,27,0
1653297050496,BILD 20,A04,092959,Rana; Brinda Kanti,27,0,27,0
1653297051032,BILD 32,A01,092990,Burg; Michael,27,0,27,0
1653297051032,BILD 32,A02,092991,Burg; Michael,26,0,27,1
1653297051032,BILD 32,A03,092992,Burg; Michael,27,0,27,0
1653297051032,BILD 32,A04,092993,Burg; Michael,26,0,27,1
1653297051032,BILD 32,A05,092994,Burg; Michael,27,0,27,0
1653297051032,BILD 32,A06,092995,Burg; Michael,27,0,27,0
1653297051032,BILD 32,A07,092996,Burg; Michael,27,0,27,0
1653297051559,BILD 60,A01,092392,Hammond; LaTisha Marie,24,0,24,0
1653297051559,BILD 60,A02,092393,Hammond; LaTisha Marie,24,0,24,0
1653297051559,BILD 60,B01,092394,Macagno; Eduardo R.,23,0,24,1
1653297051559,BILD 60,B02,092395,Macagno; Eduardo R.,24,0,24,0
1653297052088,BILD 62,A01,092949,Aljadeff; Johnatan,31,0,32,1
1653297052088,BILD 62,A02,092950,Aljadeff; Johnatan,32,0,32,0
1653297052088,BILD 62,A03,092951,Aljadeff; Johnatan,32,0,32,0
1653297052629,BILD 80,A00,089880,Pogliano; Joseph,27,0,30,3
1653297053158,BIMM 100,A01,092435,Pasquinelli; Amy,32,0,32,0
1653297053158,BIMM 100,A02,092436,Pasquinelli; Amy,30,0,32,2
1653297053158,BIMM 100,A03,092437,Pasquinelli; Amy,32,0,32,0
1653297053158,BIMM 100,A04,092438,Pasquinelli; Amy,31,0,32,1
1653297053158,BIMM 100,A05,092439,Pasquinelli; Amy,32,0,32,0
1653297053158,BIMM 100,A06,092440,Pasquinelli; Amy,32,0,32,0
1653297053158,BIMM 100,A07,092441,Pasquinelli; Amy,32,0,32,0
1653297053158,BIMM 100,A08,092442,Pasquinelli; Amy,32,0,32,0
1653297053158,BIMM 100,A09,092443,Pasquinelli; Amy,32,0,32,0
1653297053158,BIMM 100,A10,092444,Pasquinelli; Amy,32,0,32,0
1653297053158,BIMM 100,B01,092518,Pruneda-Paz; Jose L.,26,0,32,6
1653297053158,BIMM 100,B02,092519,Pruneda-Paz; Jose L.,19,0,32,13
1653297053158,BIMM 100,B03,092520,Pruneda-Paz; Jose L.,20,0,32,12
1653297053158,BIMM 100,B04,092521,Pruneda-Paz; Jose L.,24,0,32,8
1653297053158,BIMM 100,B05,092522,Pruneda-Paz; Jose L.,23,0,32,9
1653297053158,BIMM 100,B06,092523,Pruneda-Paz; Jose L.,24,0,32,8
1653297053158,BIMM 100,B07,092524,Pruneda-Paz; Jose L.,28,0,32,4
1653297053158,BIMM 100,B08,092525,Pruneda-Paz; Jose L.,25,0,32,7
1653297053158,BIMM 100,B09,092526,Pruneda-Paz; Jose L.,26,0,32,6
1653297053158,BIMM 100,B10,092527,Pruneda-Paz; Jose L.,24,0,32,8
1653297053687,BIMM 101,A01,089915,Rusert; Jessica Marie,22,0,24,2
1653297053687,BIMM 101,A02,089916,Rusert; Jessica Marie,21,0,24,3
1653297053687,BIMM 101,A03,089917,Rusert; Jessica Marie,21,0,24,3
1653297053687,BIMM 101,A04,089918,Rusert; Jessica Marie,20,0,24,4
1653297053687,BIMM 101,B01,089920,Grossman; Emily N,0,0,24,24
1653297053687,BIMM 101,B02,089921,Grossman; Emily N,1,0,24,23
1653297053687,BIMM 101,C01,089923,Day; Christopher D,0,0,24,24
1653297053687,BIMM 101,C02,089924,Day; Christopher D,0,0,24,24
1653297053687,BIMM 101,D01,089926,Cooper; Andrew Michael,18,0,24,6
1653297053687,BIMM 101,D02,089927,Cooper; Andrew Michael,24,0,24,0
1653297053687,BIMM 101,E01,089929,McDonnell; Lisa Marie,1,0,24,23
1653297053687,BIMM 101,E02,089930,McDonnell; Lisa Marie,12,0,24,12
1653297054215,BIMM 110,A01,092472,Tour; Ella,26,0,32,6
1653297054215,BIMM 110,A02,092473,Tour; Ella,23,0,32,9
1653297054215,BIMM 110,A03,092474,Tour; Ella,29,0,32,3
1653297054215,BIMM 110,A04,092475,Tour; Ella,27,0,32,5
1653297054215,BIMM 110,A05,092476,Tour; Ella,32,0,32,0
1653297054215,BIMM 110,A06,092477,Tour; Ella,30,0,32,2
1653297054215,BIMM 110,A07,092478,Tour; Ella,29,0,32,3
1653297054740,BIMM 120,A01,092979,Allen; Eric,28,0,32,4
1653297054740,BIMM 120,A02,092980,Allen; Eric,1,0,32,31
1653297054740,BIMM 120,A03,092981,Allen; Eric,14,0,32,18
1653297054740,BIMM 120,A04,092982,Allen; Eric,27,0,32,5
1653297054740,BIMM 120,A05,092983,Allen; Eric,30,0,32,2
1653297054740,BIMM 120,A06,092984,Allen; Eric,29,0,32,3
1653297054740,BIMM 120,A07,092985,Allen; Eric,20,0,32,12
1653297054740,BIMM 120,A08,092986,Allen; Eric,30,0,32,2
1653297054740,BIMM 120,A09,092987,Allen; Eric,30,0,32,2
1653297054740,BIMM 120,A10,092988,Allen; Eric,30,0,32,2
1653297054740,BIMM 120,A11,092989,Allen; Eric,32,0,32,0
1653297055267,BIMM 121,A01,089934,Petrie; Katherine Lynn,0,0,24,24
1653297055267,BIMM 121,A02,089935,Petrie; Katherine Lynn,0,0,24,24
1653297055267,BIMM 121,B01,089937,Pickett; Brooke Elizabeth,0,0,24,24
1653297055267,BIMM 121,B02,089938,Pickett; Brooke Elizabeth,0,0,24,24
1653297055267,BIMM 121,C01,089940,Pirino; Giorgia,0,0,24,24
1653297055267,BIMM 121,C02,089941,Pirino; Giorgia,0,0,24,24
1653297055267,BIMM 121,C03,089942,Pirino; Giorgia,0,0,24,24
1653297055267,BIMM 121,C04,089943,Pirino; Giorgia,0,0,24,24
1653297055795,BIMM 122,A01,093006,Russell; Alistair B,18,0,32,14
1653297055795,BIMM 122,A02,093007,Russell; Alistair B,16,0,32,16
1653297055795,BIMM 122,A03,093008,Russell; Alistair B,26,0,32,6
1653297055795,BIMM 122,A04,093009,Russell; Alistair B,32,0,32,0
1653297055795,BIMM 122,A05,093010,Russell; Alistair B,30,0,32,2
1653297056319,BIMM 124,A01,092404,Gustafson-Brown; Cindy,26,0,32,6
1653297056319,BIMM 124,A02,092405,Gustafson-Brown; Cindy,29,0,32,3
1653297056319,BIMM 124,A03,092406,Gustafson-Brown; Cindy,30,0,32,2
1653297056319,BIMM 124,A04,092407,Gustafson-Brown; Cindy,32,0,32,0
1653297056319,BIMM 124,A05,092408,Gustafson-Brown; Cindy,28,0,32,4
1653297056319,BIMM 124,A06,092409,Gustafson-Brown; Cindy,31,0,32,1
1653297056319,BIMM 124,A07,092410,Gustafson-Brown; Cindy,32,0,32,0
1653297056845,BIMM 140,A01,089947,Suel; Gurol Mehmet & Hao; Nan,16,0,27,11
1653297056845,BIMM 140,A02,089948,Suel; Gurol Mehmet & Hao; Nan,24,0,27,3
1653297056845,BIMM 140,A03,089949,Suel; Gurol Mehmet & Hao; Nan,21,0,27,6
1653297056845,BIMM 140,A04,089950,Suel; Gurol Mehmet & Hao; Nan,25,0,27,2
1653297056845,BIMM 140,A05,089951,Suel; Gurol Mehmet & Hao; Nan,24,0,27,3
1653297057378,BIMM 143,A01,089953,Grant; Barry J,0,0,40,40
1653297057378,BIMM 143,B01,089955,Fan; Chun Chieh,39,0,40,1
1653297057378,BIMM 143,C01,089957,Bozinovic; Goran,29,0,40,11
1653297057906,BIMM 194,A00,089958,Hasty; Jeff M,15,0,27,12
1653297057906,BIMM 194,B00,089959,Golden; James W,19,0,27,8
1653297057906,BIMM 194,C00,089960,Lykke-Andersen; Jens,2,0,27,25
1653297057906,BIMM 194,D00,094317,Golden; Susan S.,25,0,27,2
1653297058439,BIPN 100,A01,093011,Cooke; James Edward,7,0,19,12
1653297058439,BIPN 100,A02,093012,Cooke; James Edward,10,0,19,9
1653297058439,BIPN 100,A03,093013,Cooke; James Edward,8,0,19,11
1653297058439,BIPN 100,A04,093014,Cooke; James Edward,12,0,19,7
1653297058439,BIPN 100,A05,093015,Cooke; James Edward,17,0,19,2
1653297058439,BIPN 100,A06,093016,Cooke; James Edward,12,0,19,7
1653297058439,BIPN 100,A07,093017,Cooke; James Edward,12,0,19,7
1653297058439,BIPN 100,A08,093018,Cooke; James Edward,18,0,19,1
1653297058439,BIPN 100,A09,093019,Cooke; James Edward,17,0,19,2
1653297058439,BIPN 100,A10,093020,Cooke; James Edward,18,0,19,1
1653297058439,BIPN 100,B01,093036,Reyes Gonzalez; Catalina,17,0,19,2
1653297058439,BIPN 100,B02,093037,Reyes Gonzalez; Catalina,14,0,19,5
1653297058439,BIPN 100,B03,093038,Reyes Gonzalez; Catalina,16,0,19,3
1653297058439,BIPN 100,B04,093039,Reyes Gonzalez; Catalina,19,0,19,0
1653297058439,BIPN 100,B05,093040,Reyes Gonzalez; Catalina,19,0,19,0
1653297058439,BIPN 100,B06,093041,Reyes Gonzalez; Catalina,19,0,19,0
1653297058439,BIPN 100,B07,093042,Reyes Gonzalez; Catalina,14,0,19,5
1653297058439,BIPN 100,B08,093043,Reyes Gonzalez; Catalina,16,0,19,3
1653297058439,BIPN 100,B09,093044,Reyes Gonzalez; Catalina,19,0,19,0
1653297058439,BIPN 100,B10,093045,Reyes Gonzalez; Catalina,19,0,19,0
1653297059061,BIPN 102,A01,093046,Reyes Gonzalez; Catalina,28,0,32,4
1653297059061,BIPN 102,A02,093047,Reyes Gonzalez; Catalina,17,0,32,15
1653297059061,BIPN 102,A05,093050,Reyes Gonzalez; Catalina,29,0,32,3
1653297059061,BIPN 102,A06,093051,Reyes Gonzalez; Catalina,15,0,32,17
1653297059061,BIPN 102,A07,093052,Reyes Gonzalez; Catalina,29,0,32,3
1653297059061,BIPN 102,A08,093053,Reyes Gonzalez; Catalina,31,0,32,1
1653297059605,BIPN 105,A01,089966,Armour; Jon Christopher,0,0,21,21
1653297059605,BIPN 105,A02,089967,Armour; Jon Christopher,0,0,21,21
1653297059605,BIPN 105,A03,089968,Armour; Jon Christopher,3,0,21,18
1653297059605,BIPN 105,A04,089969,Armour; Jon Christopher,10,0,21,11
1653297060144,BIPN 140,A01,092514,Spitzer; Nicholas & Su; Chih-Ying,9,0,19,10
1653297060144,BIPN 140,A02,092515,Spitzer; Nicholas & Su; Chih-Ying,12,0,19,7
1653297060144,BIPN 140,A03,092516,Spitzer; Nicholas & Su; Chih-Ying,11,0,19,8
1653297060144,BIPN 140,A04,092517,Spitzer; Nicholas & Su; Chih-Ying,15,0,19,4
1653297060144,BIPN 140,B01,092952,Banghart; Matthew Ryan,12,0,19,7
1653297060144,BIPN 140,B02,092953,Banghart; Matthew Ryan,19,0,19,0
1653297060144,BIPN 140,B03,092954,Banghart; Matthew Ryan,19,0,19,0
1653297060144,BIPN 140,B04,092955,Banghart; Matthew Ryan,19,0,19,0
1653297060670,BIPN 145,A01,089973,Marino; Marc J,35,0,42,7
1653297060670,BIPN 145,A02,089974,Marino; Marc J,36,0,42,6
1653297060670,BIPN 145,B01,089976,Juavinett; Ashley Lauren,0,0,42,42
1653297061196,BIPN 148,A01,092960,Leutgeb; Jill K.,31,0,32,1
1653297061196,BIPN 148,A02,092961,Leutgeb; Jill K.,25,0,32,7
1653297061196,BIPN 148,A03,092962,Leutgeb; Jill K.,29,0,31,2
1653297061196,BIPN 148,A04,092963,Leutgeb; Jill K.,31,0,31,0
1653297061196,BIPN 148,A05,092964,Leutgeb; Jill K.,31,0,31,0
1653297061196,BIPN 148,A06,094351,Leutgeb; Jill K.,26,0,31,5
1653297061196,BIPN 148,A07,092966,Leutgeb; Jill K.,26,0,31,5
1653297061196,BIPN 148,A08,092967,Leutgeb; Jill K.,26,0,31,5
1653297061722,BIPN 189,A00,090665,Gentner; Tim,0,0,25,25
1653297062247,BIPN 194,A00,089978,Pekkurnaz Banghart; Gulcin,17,0,27,10
1653297062247,BIPN 194,B00,089979,Leutgeb; Stefan,24,0,27,3
1653297062774,BISP 194,A00,089980,Wertheim; Joel Okrent,8,0,27,19
1653297063322,CAT 1,A01,086671,Bronstein; Phoebe Malan,17,0,17,0
1653297063322,CAT 1,A02,086672,Bronstein; Phoebe Malan,13,0,17,4
1653297063322,CAT 1,A03,086673,Bronstein; Phoebe Malan,17,0,17,0
1653297063322,CAT 1,A04,086674,Bronstein; Phoebe Malan,15,0,17,2
1653297063322,CAT 1,A05,086675,Bronstein; Phoebe Malan,17,0,17,0
1653297063322,CAT 1,A06,086676,Bronstein; Phoebe Malan,17,0,17,0
1653297063322,CAT 1,A07,086677,Bronstein; Phoebe Malan,16,0,17,1
1653297063322,CAT 1,A08,086678,Bronstein; Phoebe Malan,17,0,17,0
1653297063322,CAT 1,A09,086679,Bronstein; Phoebe Malan,16,0,17,1
1653297063322,CAT 1,A10,086680,Bronstein; Phoebe Malan,17,0,17,0
1653297063322,CAT 1,A11,086681,Bronstein; Phoebe Malan,16,0,17,1
1653297063322,CAT 1,A12,086682,Bronstein; Phoebe Malan,17,0,17,0
1653297063322,CAT 1,A13,086683,Bronstein; Phoebe Malan,17,0,17,0
1653297063322,CAT 1,A14,086684,Bronstein; Phoebe Malan,17,0,17,0
1653297063322,CAT 1,A15,086685,Bronstein; Phoebe Malan,17,0,17,0
1653297063322,CAT 1,A16,086686,Bronstein; Phoebe Malan,17,0,17,0
1653297063322,CAT 1,B01,086688,Bigham; David Joseph,17,0,17,0
1653297063322,CAT 1,B02,086689,Bigham; David Joseph,16,0,17,1
1653297063322,CAT 1,B03,086690,Bigham; David Joseph,17,0,17,0
1653297063322,CAT 1,B04,086691,Bigham; David Joseph,17,0,17,0
1653297063322,CAT 1,B05,086692,Bigham; David Joseph,16,0,17,1
1653297063322,CAT 1,B06,086693,Bigham; David Joseph,17,0,17,0
1653297063322,CAT 1,B07,086694,Bigham; David Joseph,17,0,17,0
1653297063322,CAT 1,B08,086695,Bigham; David Joseph,17,0,17,0
1653297063322,CAT 1,B09,086696,Bigham; David Joseph,17,0,17,0
1653297063322,CAT 1,B10,086697,Bigham; David Joseph,17,0,17,0
1653297063322,CAT 1,B11,086698,Bigham; David Joseph,17,0,17,0
1653297063322,CAT 1,B12,086699,Bigham; David Joseph,17,0,17,0
1653297063322,CAT 1,B13,086700,Bigham; David Joseph,15,0,17,2
1653297063322,CAT 1,B14,086701,Bigham; David Joseph,17,0,17,0
1653297063322,CAT 1,C01,086703,Algaze; Guillermo,17,0,17,0
1653297063322,CAT 1,C02,086704,Algaze; Guillermo,17,0,17,0
1653297063322,CAT 1,C03,086705,Algaze; Guillermo,17,0,17,0
1653297063322,CAT 1,C04,086706,Algaze; Guillermo,17,0,17,0
1653297063322,CAT 1,C05,086707,Algaze; Guillermo,17,0,17,0
1653297063322,CAT 1,C06,086708,Algaze; Guillermo,17,0,17,0
1653297063322,CAT 1,C07,086709,Algaze; Guillermo,17,0,17,0
1653297063322,CAT 1,C08,086710,Algaze; Guillermo,17,0,17,0
1653297063322,CAT 1,C09,086711,Algaze; Guillermo,17,0,17,0
1653297063322,CAT 1,C10,086712,Algaze; Guillermo,17,0,17,0
1653297063322,CAT 1,C11,086713,Algaze; Guillermo,17,0,17,0
1653297063322,CAT 1,C12,086714,Algaze; Guillermo,17,0,17,0
1653297063322,CAT 1,C13,086715,Algaze; Guillermo,17,0,17,0
1653297063322,CAT 1,C14,086716,Algaze; Guillermo,16,0,17,1
1653297063322,CAT 1,C15,086717,Algaze; Guillermo,17,0,17,0
1653297063322,CAT 1,C16,086718,Algaze; Guillermo,16,0,17,1
1653297063322,CAT 1,D01,086720,Staff,17,0,17,0
1653297063322,CAT 1,D02,086721,Staff,17,0,17,0
1653297063322,CAT 1,D03,086722,Staff,17,0,17,0
1653297063322,CAT 1,D04,086723,Staff,17,0,17,0
1653297063322,CAT 1,D05,086724,Staff,16,0,17,1
1653297063322,CAT 1,D06,086725,Staff,16,0,17,1
1653297063322,CAT 1,D07,086726,Staff,17,0,17,0
1653297063322,CAT 1,D08,086727,Staff,17,0,17,0
1653297063322,CAT 1,D09,086728,Staff,16,0,17,1
1653297063322,CAT 1,D10,086729,Staff,17,0,17,0
1653297063322,CAT 1,D11,086730,Staff,17,0,17,0
1653297063322,CAT 1,D12,086731,Staff,17,0,17,0
1653297063322,CAT 1,D13,086732,Staff,17,0,17,0
1653297063322,CAT 1,D14,086733,Staff,17,0,17,0
1653297063855,CAT 3,A01,086735,Gumm; Elizabeth Ashley,14,0,15,1
1653297063855,CAT 3,A02,086736,Gumm; Elizabeth Ashley,14,0,15,1
1653297063855,CAT 3,A03,086737,Gumm; Elizabeth Ashley,15,0,15,0
1653297063855,CAT 3,A04,086738,Gumm; Elizabeth Ashley,15,0,15,0
1653297063855,CAT 3,A05,086739,Gumm; Elizabeth Ashley,15,0,15,0
1653297063855,CAT 3,A06,086740,Gumm; Elizabeth Ashley,15,0,15,0
1653297064382,CAT 124,A01,086742,Staff,15,0,15,0
1653297064908,CAT 125R,A01,094882,Staff,14,0,16,2
1653297064908,CAT 125R,A02,086745,Staff,16,0,16,0
1653297064908,CAT 125R,A03,086746,Staff,14,0,16,2
1653297064908,CAT 125R,A04,086747,Staff,13,0,16,3
1653297064908,CAT 125R,A05,086748,Staff,15,0,16,1
1653297064908,CAT 125R,A06,086749,Staff,12,0,16,4
1653297064908,CAT 125R,A07,086750,Staff,14,0,16,2
1653297064908,CAT 125R,A08,094883,Staff,14,0,16,2
1653297064908,CAT 125R,A09,094884,Staff,16,0,16,0
1653297064908,CAT 125R,A10,094885,Staff,15,0,16,1
1653297064908,CAT 125R,A14,086761,Staff,15,0,16,1
1653297064908,CAT 125R,A15,086762,Staff,16,0,16,0
1653297064908,CAT 125R,A16,086763,Staff,13,0,16,3
1653297064908,CAT 125R,A17,086764,Staff,14,0,16,2
1653297064908,CAT 125R,A18,086765,Staff,14,0,16,2
1653297064908,CAT 125R,A19,086766,Staff,14,0,16,2
1653297065432,CCS 101,A00,088353,Staff,29,0,35,6
1653297065967,CENG 4,A01,086204,Bae; Jinhye,30,0,30,0
1653297065967,CENG 4,A02,086205,Bae; Jinhye,30,0,30,0
1653297065967,CENG 4,B01,086207,Drews; Aaron,30,0,30,0
1653297065967,CENG 4,B02,086208,Drews; Aaron,30,0,30,0
1653297066498,CENG 15,A01,086210,Lubarda; Vlado,63,0,65,2
1653297066498,CENG 15,B01,086212,Lubarda; Vlado,65,0,65,0
1653297067022,CENG 100,A00,086213,Chen; Zheng,147,0,150,3
1653297067548,CENG 101A,A00,086214,Bae; Jinhye,142,0,150,8
1653297068073,CENG 120,A00,086215,Opatkiewicz; Justin Paul,125,0,150,25
1653297068611,CENG 122,A00,086216,Opatkiewicz; Justin Paul,137,0,150,13
1653297069146,CGS 2A,A01,086271,Shelby; Karen Lee,12,0,15,3
1653297069146,CGS 2A,A02,086272,Shelby; Karen Lee,13,0,15,2
1653297069146,CGS 2A,A03,086273,Shelby; Karen Lee,14,0,15,1
1653297069146,CGS 2A,A04,086274,Shelby; Karen Lee,15,0,15,0
1653297069677,CGS 100A,A00,086275,Perez; Roy,26,0,32,6
1653297070202,CGS 101,A00,086276,Shelby; Karen Lee,30,0,30,0
1653297070730,CGS 106,A00,086277,Shelby; Karen Lee,24,0,30,6
1653297071254,CGS 119,A00,086279,Nguyen; Hoang Tan,27,0,30,3
1653297071783,CGS 121,A00,086280,Martin Sandino; Amanda Maria Yoland,19,0,20,1
1653297072308,CGS 122,A00,086281,Whitley; Leila Marie,20,0,20,0
1653297072833,CGS 123,A00,086282,Staff,0,0,0,0
1653297073360,CGS 127,A00,086283,Whitley; Leila Marie,15,0,15,0
1653297073886,CGS 130,A00,086284,Martin Sandino; Amanda Maria Yoland,15,0,15,0
1653297074411,CGS 187,A00,086285,Perez; Roy,15,0,16,1
1653297074935,CGS 190,A00,086286,Staff,5,0,5,0
1653297075471,CHEM 4,A01,089669,Bussey; Thomas J,40,0,40,0
1653297075471,CHEM 4,A02,089670,Bussey; Thomas J,42,0,42,0
1653297075471,CHEM 4,A03,089671,Bussey; Thomas J,40,0,42,2
1653297075471,CHEM 4,A04,089672,Bussey; Thomas J,42,0,42,0
1653297075471,CHEM 4,A05,089673,Bussey; Thomas J,40,0,42,2
1653297075471,CHEM 4,A06,089674,Bussey; Thomas J,40,0,42,2
1653297075471,CHEM 4,A07,089675,Bussey; Thomas J,42,0,42,0
1653297075471,CHEM 4,A08,089676,Bussey; Thomas J,42,0,42,0
1653297075471,CHEM 4,A09,089677,Bussey; Thomas J,41,0,41,0
1653297075471,CHEM 4,A10,089678,Bussey; Thomas J,40,0,40,0
1653297076054,CHEM 6A,A01,092734,Pomeroy; Robert S.,4,0,4,0
1653297076054,CHEM 6A,A02,092735,Pomeroy; Robert S.,4,0,4,0
1653297076054,CHEM 6A,A03,092736,Pomeroy; Robert S.,4,0,4,0
1653297076054,CHEM 6A,A04,092737,Pomeroy; Robert S.,4,0,4,0
1653297076054,CHEM 6A,A05,092738,Pomeroy; Robert S.,4,0,4,0
1653297076054,CHEM 6A,A06,092739,Pomeroy; Robert S.,4,0,4,0
1653297076054,CHEM 6A,A07,092740,Pomeroy; Robert S.,4,0,4,0
1653297076054,CHEM 6A,A08,092741,Pomeroy; Robert S.,4,0,4,0
1653297076054,CHEM 6A,A09,092742,Pomeroy; Robert S.,0,0,0,0
1653297076054,CHEM 6A,B01,092744,Schurmeier; Kimberly,4,0,4,0
1653297076054,CHEM 6A,B02,092746,Schurmeier; Kimberly,4,0,4,0
1653297076054,CHEM 6A,B03,092749,Schurmeier; Kimberly,4,0,4,0
1653297076054,CHEM 6A,B04,092751,Schurmeier; Kimberly,4,0,4,0
1653297076054,CHEM 6A,B05,092753,Schurmeier; Kimberly,4,0,4,0
1653297076054,CHEM 6A,B06,092755,Schurmeier; Kimberly,3,0,4,1
1653297076054,CHEM 6A,B07,092756,Schurmeier; Kimberly,4,0,4,0
1653297076054,CHEM 6A,B08,092757,Schurmeier; Kimberly,4,0,4,0
1653297076054,CHEM 6A,B09,092758,Schurmeier; Kimberly,0,0,0,0
1653297076054,CHEM 6A,C01,092805,Schurmeier; Kimberly,4,0,4,0
1653297076054,CHEM 6A,C02,092806,Schurmeier; Kimberly,4,0,4,0
1653297076054,CHEM 6A,C03,092807,Schurmeier; Kimberly,4,0,4,0
1653297076054,CHEM 6A,C04,092808,Schurmeier; Kimberly,4,0,4,0
1653297076054,CHEM 6A,C05,092809,Schurmeier; Kimberly,4,0,4,0
1653297076054,CHEM 6A,C06,092810,Schurmeier; Kimberly,4,0,4,0
1653297076054,CHEM 6A,C07,092811,Schurmeier; Kimberly,4,0,4,0
1653297076054,CHEM 6A,C08,092812,Schurmeier; Kimberly,4,0,4,0
1653297076054,CHEM 6A,C09,092813,Schurmeier; Kimberly,0,0,0,0
1653297076054,CHEM 6A,D01,092837,Stallings; Dontarie M,4,0,4,0
1653297076054,CHEM 6A,D02,092838,Stallings; Dontarie M,4,0,4,0
1653297076054,CHEM 6A,D03,092839,Stallings; Dontarie M,4,0,4,0
1653297076054,CHEM 6A,D04,092840,Stallings; Dontarie M,4,0,4,0
1653297076054,CHEM 6A,D05,092841,Stallings; Dontarie M,4,0,4,0
1653297076054,CHEM 6A,D06,092842,Stallings; Dontarie M,4,0,4,0
1653297076054,CHEM 6A,D07,092843,Stallings; Dontarie M,4,0,4,0
1653297076054,CHEM 6A,D08,092844,Stallings; Dontarie M,4,0,4,0
1653297076054,CHEM 6A,D09,092845,Stallings; Dontarie M,0,0,0,0
1653297076054,CHEM 6A,E01,092796,Brydges; Stacey,4,0,4,0
1653297076054,CHEM 6A,E02,092797,Brydges; Stacey,3,0,4,1
1653297076054,CHEM 6A,E03,092798,Brydges; Stacey,4,0,4,0
1653297076054,CHEM 6A,E04,092799,Brydges; Stacey,3,0,4,1
1653297076054,CHEM 6A,E05,092800,Brydges; Stacey,4,0,4,0
1653297076054,CHEM 6A,E06,092801,Brydges; Stacey,4,0,4,0
1653297076054,CHEM 6A,E07,092802,Brydges; Stacey,4,0,4,0
1653297076054,CHEM 6A,E08,092803,Brydges; Stacey,4,0,4,0
1653297076054,CHEM 6A,E09,092804,Brydges; Stacey,0,0,0,0
1653297076054,CHEM 6A,F01,092759,Brydges; Stacey,4,0,4,0
1653297076054,CHEM 6A,F02,092760,Brydges; Stacey,4,0,4,0
1653297076054,CHEM 6A,F03,092761,Brydges; Stacey,3,0,4,1
1653297076054,CHEM 6A,F04,092762,Brydges; Stacey,4,0,4,0
1653297076054,CHEM 6A,F05,092763,Brydges; Stacey,4,0,4,0
1653297076054,CHEM 6A,F06,092764,Brydges; Stacey,4,0,4,0
1653297076054,CHEM 6A,F07,092765,Brydges; Stacey,4,0,4,0
1653297076054,CHEM 6A,F08,092766,Brydges; Stacey,4,0,4,0
1653297076054,CHEM 6A,F09,092767,Brydges; Stacey,0,0,0,0
1653297076054,CHEM 6A,G01,092774,Zid; Brian M,0,0,4,4
1653297076054,CHEM 6A,G02,092775,Zid; Brian M,2,0,4,2
1653297076054,CHEM 6A,G03,092776,Zid; Brian M,2,0,4,2
1653297076054,CHEM 6A,G04,092777,Zid; Brian M,2,0,4,2
1653297076054,CHEM 6A,G05,092778,Zid; Brian M,4,0,4,0
1653297076054,CHEM 6A,G06,092779,Zid; Brian M,4,0,4,0
1653297076054,CHEM 6A,G07,092780,Zid; Brian M,3,0,4,1
1653297076054,CHEM 6A,G08,092781,Zid; Brian M,3,0,4,1
1653297076054,CHEM 6A,G09,092782,Zid; Brian M,0,0,0,0
1653297076054,CHEM 6A,H01,092846,Stallings; Dontarie M,4,0,4,0
1653297076054,CHEM 6A,H02,092847,Stallings; Dontarie M,3,0,4,1
1653297076054,CHEM 6A,H03,092848,Stallings; Dontarie M,4,0,4,0
1653297076054,CHEM 6A,H04,092849,Stallings; Dontarie M,4,0,4,0
1653297076054,CHEM 6A,H05,092850,Stallings; Dontarie M,4,0,4,0
1653297076054,CHEM 6A,H06,092851,Stallings; Dontarie M,3,0,4,1
1653297076054,CHEM 6A,H07,092852,Stallings; Dontarie M,4,0,4,0
1653297076054,CHEM 6A,H08,092853,Stallings; Dontarie M,3,0,4,1
1653297076054,CHEM 6A,H09,092854,Stallings; Dontarie M,0,0,0,0
1653297076054,CHEM 6A,I01,092814,Staff,0,0,0,0
1653297076054,CHEM 6A,I02,092815,Staff,0,0,0,0
1653297076054,CHEM 6A,I04,092816,Staff,0,0,0,0
1653297076054,CHEM 6A,I05,092817,Staff,0,0,0,0
1653297076054,CHEM 6A,I06,092818,Staff,0,0,0,0
1653297076054,CHEM 6A,I07,092819,Staff,0,0,0,0
1653297076054,CHEM 6A,I08,092820,Staff,0,0,0,0
1653297076054,CHEM 6A,I09,092821,Staff,0,0,0,0
1653297076579,CHEM 6AH,A01,092793,Paesani; Francesco,15,0,16,1
1653297076579,CHEM 6AH,A02,092794,Paesani; Francesco,16,0,16,0
1653297076579,CHEM 6AH,A03,092795,Paesani; Francesco,16,0,16,0
1653297077105,CHEM 6B,A01,092691,Hopkins; Patrycja Anna,21,0,25,4
1653297077105,CHEM 6B,A02,092692,Hopkins; Patrycja Anna,23,0,25,2
1653297077105,CHEM 6B,A03,092693,Hopkins; Patrycja Anna,25,0,25,0
1653297077105,CHEM 6B,A04,092694,Hopkins; Patrycja Anna,0,0,0,0
1653297077105,CHEM 6B,A05,092695,Hopkins; Patrycja Anna,24,0,25,1
1653297077105,CHEM 6B,A06,092696,Hopkins; Patrycja Anna,22,0,25,3
1653297077105,CHEM 6B,A07,092697,Hopkins; Patrycja Anna,24,0,25,1
1653297077640,CHEM 6C,A01,092708,Albizati; Kim F.,31,0,38,7
1653297077640,CHEM 6C,A02,092709,Albizati; Kim F.,32,0,38,6
1653297077640,CHEM 6C,A03,092710,Albizati; Kim F.,37,0,38,1
1653297077640,CHEM 6C,A04,092711,Albizati; Kim F.,36,0,38,2
1653297077640,CHEM 6C,A05,092712,Albizati; Kim F.,0,0,0,0
1653297077640,CHEM 6C,A06,092714,Albizati; Kim F.,33,0,38,5
1653297077640,CHEM 6C,A07,092715,Albizati; Kim F.,32,0,38,6
1653297077640,CHEM 6C,A08,092716,Albizati; Kim F.,37,0,38,1
1653297077640,CHEM 6C,A09,092717,Albizati; Kim F.,38,0,38,0
1653297078181,CHEM 7L,A01,089692,Leigh; Brian,11,0,19,8
1653297078181,CHEM 7L,A02,089693,Leigh; Brian,23,0,24,1
1653297078181,CHEM 7L,A03,089694,Leigh; Brian,24,0,24,0
1653297078181,CHEM 7L,A04,089695,Leigh; Brian,24,0,24,0
1653297078181,CHEM 7L,A05,089696,Leigh; Brian,23,0,24,1
1653297078181,CHEM 7L,A06,089697,Leigh; Brian,22,0,24,2
1653297078181,CHEM 7L,A07,089698,Leigh; Brian,21,0,21,0
1653297078181,CHEM 7L,A08,089699,Leigh; Brian,17,0,24,7
1653297078181,CHEM 7L,A09,089700,Leigh; Brian,23,0,24,1
1653297078181,CHEM 7L,A10,089701,Leigh; Brian,0,0,0,0
1653297078181,CHEM 7L,B01,089703,Leigh; Brian,18,0,24,6
1653297078181,CHEM 7L,B02,089704,Leigh; Brian,18,0,24,6
1653297078181,CHEM 7L,B03,089705,Leigh; Brian,23,0,24,1
1653297078181,CHEM 7L,B04,089706,Leigh; Brian,20,0,21,1
1653297078181,CHEM 7L,B05,089707,Leigh; Brian,17,0,24,7
1653297078181,CHEM 7L,B06,089708,Leigh; Brian,17,0,24,7
1653297078181,CHEM 7L,B07,089709,Leigh; Brian,17,0,24,7
1653297078181,CHEM 7L,B08,089710,Leigh; Brian,21,0,24,3
1653297078181,CHEM 7L,B09,089711,Leigh; Brian,21,0,24,3
1653297078181,CHEM 7L,B10,089712,Leigh; Brian,0,0,0,0
1653297078181,CHEM 7L,C01,089714,Staff,23,0,24,1
1653297078181,CHEM 7L,C02,089715,Staff,22,0,24,2
1653297078181,CHEM 7L,C03,089716,Staff,23,0,24,1
1653297078181,CHEM 7L,C04,089717,Staff,24,0,24,0
1653297078181,CHEM 7L,C05,089718,Staff,21,0,24,3
1653297078181,CHEM 7L,C06,089719,Staff,22,0,24,2
1653297078181,CHEM 7L,C07,089720,Staff,23,0,24,1
1653297078181,CHEM 7L,C08,089721,Staff,24,0,24,0
1653297078181,CHEM 7L,C09,089722,Staff,24,0,24,0
1653297078181,CHEM 7L,C10,089723,Staff,0,0,0,0
1653297078713,CHEM 40A,A01,092871,Schmidt; Valerie A,31,0,31,0
1653297078713,CHEM 40A,A02,092872,Schmidt; Valerie A,31,0,31,0
1653297078713,CHEM 40A,A03,092873,Schmidt; Valerie A,31,0,31,0
1653297078713,CHEM 40A,A04,092874,Schmidt; Valerie A,0,0,0,0
1653297078713,CHEM 40A,A05,092875,Schmidt; Valerie A,31,0,31,0
1653297078713,CHEM 40A,A06,092876,Schmidt; Valerie A,29,0,31,2
1653297078713,CHEM 40A,A07,092877,Schmidt; Valerie A,31,0,31,0
1653297078713,CHEM 40A,A08,092878,Schmidt; Valerie A,28,0,28,0
1653297078713,CHEM 40A,B01,089726,Lam; Tin Yiu,31,0,31,0
1653297078713,CHEM 40A,B02,089727,Lam; Tin Yiu,31,0,31,0
1653297078713,CHEM 40A,B03,089728,Lam; Tin Yiu,31,0,31,0
1653297078713,CHEM 40A,B04,089729,Lam; Tin Yiu,30,0,31,1
1653297078713,CHEM 40A,B05,089730,Lam; Tin Yiu,31,0,31,0
1653297078713,CHEM 40A,B06,089731,Lam; Tin Yiu,30,0,31,1
1653297078713,CHEM 40A,B07,089732,Lam; Tin Yiu,29,0,31,2
1653297078713,CHEM 40A,B08,089733,Lam; Tin Yiu,0,0,0,0
1653297078713,CHEM 40A,C01,092718,Albizati; Kim F.,17,0,31,14
1653297078713,CHEM 40A,C02,092719,Albizati; Kim F.,24,0,31,7
1653297078713,CHEM 40A,C03,092720,Albizati; Kim F.,12,0,31,19
1653297078713,CHEM 40A,C04,092721,Albizati; Kim F.,24,0,31,7
1653297078713,CHEM 40A,C05,092722,Albizati; Kim F.,21,0,31,10
1653297078713,CHEM 40A,C06,092723,Albizati; Kim F.,24,0,31,7
1653297078713,CHEM 40A,C07,092724,Albizati; Kim F.,30,0,31,1
1653297078713,CHEM 40A,C08,092725,Albizati; Kim F.,0,0,0,0
1653297078713,CHEM 40A,D01,092863,Yang; Jerry,28,0,31,3
1653297078713,CHEM 40A,D02,092864,Yang; Jerry,28,0,31,3
1653297078713,CHEM 40A,D03,092865,Yang; Jerry,31,0,31,0
1653297078713,CHEM 40A,D04,092866,Yang; Jerry,31,0,31,0
1653297078713,CHEM 40A,D05,092867,Yang; Jerry,0,0,0,0
1653297078713,CHEM 40A,D06,092868,Yang; Jerry,31,0,31,0
1653297078713,CHEM 40A,D07,092869,Yang; Jerry,31,0,31,0
1653297078713,CHEM 40A,D08,092870,Yang; Jerry,31,0,31,0
1653297079237,CHEM 40B,A01,092698,Oconnor; Joseph M.,24,0,34,10
1653297079237,CHEM 40B,A02,092699,Oconnor; Joseph M.,34,0,34,0
1653297079237,CHEM 40B,A03,092700,Oconnor; Joseph M.,0,0,0,0
1653297079237,CHEM 40B,A04,092701,Oconnor; Joseph M.,30,0,34,4
1653297079237,CHEM 40B,A05,092702,Oconnor; Joseph M.,33,0,34,1
1653297079237,CHEM 40B,A06,092703,Oconnor; Joseph M.,34,0,34,0
1653297079237,CHEM 40B,A07,092704,Oconnor; Joseph M.,32,0,34,2
1653297079237,CHEM 40B,A08,092705,Oconnor; Joseph M.,33,0,34,1
1653297079237,CHEM 40B,A09,092706,Oconnor; Joseph M.,34,0,34,0
1653297079763,CHEM 40C,A01,089739,Lam; Tin Yiu,0,0,0,0
1653297079763,CHEM 40C,A02,089740,Lam; Tin Yiu,0,0,0,0
1653297079763,CHEM 40C,A03,089741,Lam; Tin Yiu,0,0,0,0
1653297079763,CHEM 40C,A04,089742,Lam; Tin Yiu,13,0,34,21
1653297079763,CHEM 40C,A05,089743,Lam; Tin Yiu,32,0,34,2
1653297079763,CHEM 40C,A06,089744,Lam; Tin Yiu,31,0,34,3
1653297080295,CHEM 41A,A01,093840,Ternansky; Robert J.,29,0,33,4
1653297080295,CHEM 41A,A02,093841,Ternansky; Robert J.,32,0,33,1
1653297080295,CHEM 41A,A03,093842,Ternansky; Robert J.,33,0,33,0
1653297080295,CHEM 41A,A04,093843,Ternansky; Robert J.,30,0,33,3
1653297080295,CHEM 41A,A05,093844,Ternansky; Robert J.,31,0,33,2
1653297080295,CHEM 41A,A06,093845,Ternansky; Robert J.,27,0,27,0
1653297080295,CHEM 41A,A07,093846,Ternansky; Robert J.,32,0,33,1
1653297080295,CHEM 41A,A08,093847,Ternansky; Robert J.,33,0,33,0
1653297080825,CHEM 43A,A01,089746,Klosterman; Jeremy K,11,0,24,13
1653297080825,CHEM 43A,A02,089747,Klosterman; Jeremy K,16,0,24,8
1653297080825,CHEM 43A,A03,089748,Klosterman; Jeremy K,21,0,24,3
1653297080825,CHEM 43A,A04,089749,Klosterman; Jeremy K,22,0,24,2
1653297080825,CHEM 43A,A05,089750,Klosterman; Jeremy K,23,0,24,1
1653297080825,CHEM 43A,A06,089751,Klosterman; Jeremy K,9,0,24,15
1653297080825,CHEM 43A,A07,089752,Klosterman; Jeremy K,17,0,24,7
1653297080825,CHEM 43A,A08,089753,Klosterman; Jeremy K,16,0,24,8
1653297080825,CHEM 43A,A09,089754,Klosterman; Jeremy K,21,0,24,3
1653297080825,CHEM 43A,A10,089755,Klosterman; Jeremy K,21,0,24,3
1653297080825,CHEM 43A,A11,089756,Klosterman; Jeremy K,0,0,0,0
1653297080825,CHEM 43A,A12,089757,Klosterman; Jeremy K,0,0,0,0
1653297080825,CHEM 43A,A13,089758,Klosterman; Jeremy K,0,0,0,0
1653297080825,CHEM 43A,B01,089760,Klosterman; Jeremy K,0,0,0,0
1653297080825,CHEM 43A,B02,089761,Klosterman; Jeremy K,0,0,0,0
1653297080825,CHEM 43A,B03,089762,Klosterman; Jeremy K,16,0,24,8
1653297080825,CHEM 43A,B04,089763,Klosterman; Jeremy K,22,0,24,2
1653297080825,CHEM 43A,B05,089764,Klosterman; Jeremy K,23,0,24,1
1653297080825,CHEM 43A,B06,089765,Klosterman; Jeremy K,23,0,24,1
1653297080825,CHEM 43A,B07,089766,Klosterman; Jeremy K,17,0,24,7
1653297080825,CHEM 43A,B08,089767,Klosterman; Jeremy K,23,0,24,1
1653297080825,CHEM 43A,B09,089768,Klosterman; Jeremy K,24,0,24,0
1653297080825,CHEM 43A,B10,089769,Klosterman; Jeremy K,23,0,24,1
1653297080825,CHEM 43A,B11,089770,Klosterman; Jeremy K,22,0,24,2
1653297080825,CHEM 43A,B12,089771,Klosterman; Jeremy K,21,0,24,3
1653297081347,CHEM 87,A00,089772,Bussey; Thomas J,20,0,20,0
1653297081878,CHEM 96,A00,089773,Bussey; Thomas J,20,0,25,5
1653297082408,CHEM 100A,A01,089775,Pomeroy; Robert S.,22,0,24,2
1653297082408,CHEM 100A,A02,089776,Pomeroy; Robert S.,19,0,24,5
1653297082408,CHEM 100A,A03,089777,Pomeroy; Robert S.,13,0,24,11
1653297082408,CHEM 100A,A04,089778,Pomeroy; Robert S.,18,0,24,6
1653297082408,CHEM 100A,A05,089779,Pomeroy; Robert S.,19,0,24,5
1653297082408,CHEM 100A,A06,089780,Pomeroy; Robert S.,24,0,24,0
1653297082408,CHEM 100A,A07,089781,Pomeroy; Robert S.,0,0,0,0
1653297082936,CHEM 105A,A01,089783,Young; Mark,0,0,39,39
1653297082936,CHEM 105A,B01,089785,Young; Mark,26,0,39,13
1653297083462,CHEM 108,A01,089787,Ghosh; Gourisankar,1,0,22,21
1653297083462,CHEM 108,A02,089788,Ghosh; Gourisankar,6,0,22,16
1653297083462,CHEM 108,B01,089790,Ghosh; Gourisankar,13,0,22,9
1653297083462,CHEM 108,B02,089791,Ghosh; Gourisankar,20,0,22,2
1653297083996,CHEM 109,A01,089793,Hamaoka; Brent Y,4,0,22,18
1653297083996,CHEM 109,A02,089794,Hamaoka; Brent Y,10,0,22,12
1653297083996,CHEM 109,B01,089796,Hamaoka; Brent Y,6,0,22,16
1653297083996,CHEM 109,B02,089797,Hamaoka; Brent Y,18,0,22,4
1653297084522,CHEM 114A,A01,092855,Toor; Navtej,21,0,25,4
1653297084522,CHEM 114A,A02,092856,Toor; Navtej,25,0,25,0
1653297084522,CHEM 114A,A03,092857,Toor; Navtej,19,0,25,6
1653297084522,CHEM 114A,A04,092858,Toor; Navtej,24,0,25,1
1653297084522,CHEM 114A,A05,092859,Toor; Navtej,0,0,0,0
1653297084522,CHEM 114A,A06,092860,Toor; Navtej,14,0,25,11
1653297084522,CHEM 114A,A07,092861,Toor; Navtej,24,0,25,1
1653297084522,CHEM 114A,A08,092862,Toor; Navtej,24,0,25,1
1653297085047,CHEM 116,A01,092707,Ferguson; Fleur,7,0,35,28
1653297085047,CHEM 116,A02,094887,Ferguson; Fleur,31,0,35,4
1653297085572,CHEM 120A,A01,092785,Schimpf; Alina M,16,0,28,12
1653297085572,CHEM 120A,A02,092786,Schimpf; Alina M,26,0,28,2
1653297085572,CHEM 120A,A03,092787,Schimpf; Alina M,20,0,28,8
1653297085572,CHEM 120A,A04,092788,Schimpf; Alina M,27,0,28,1
1653297085572,CHEM 120A,A05,092789,Schimpf; Alina M,27,0,28,1
1653297085572,CHEM 120A,A06,092790,Schimpf; Alina M,0,0,0,0
1653297085572,CHEM 120A,A07,092791,Schimpf; Alina M,15,0,28,13
1653297085572,CHEM 120A,A08,092792,Schimpf; Alina M,0,0,0,0
1653297086102,CHEM 126A,A01,092768,Schoeneberg; Johannes,16,0,35,19
1653297086102,CHEM 126A,A02,092769,Schoeneberg; Johannes,35,0,35,0
1653297086102,CHEM 126A,A03,092770,Schoeneberg; Johannes,29,0,35,6
1653297086102,CHEM 126A,A04,092771,Schoeneberg; Johannes,0,0,0,0
1653297086102,CHEM 126A,A05,092772,Schoeneberg; Johannes,30,0,35,5
1653297086102,CHEM 126A,A06,092773,Schoeneberg; Johannes,33,0,35,2
1653297086629,CHEM 130,A01,092685,Sinha; Amitabha,28,0,38,10
1653297086629,CHEM 130,A02,092686,Sinha; Amitabha,31,0,38,7
1653297086629,CHEM 130,A03,092687,Sinha; Amitabha,34,0,38,4
1653297087154,CHEM 142,A00,089803,Esko; Jeffrey D. & Godula; Kamil,9,0,46,37
1653297087677,CHEM 143C,A01,089805,Ternansky; Robert J.,17,0,22,5
1653297087677,CHEM 143C,A02,089806,Ternansky; Robert J.,18,0,22,4
1653297087677,CHEM 143C,A03,089807,Ternansky; Robert J.,19,0,22,3
1653297087677,CHEM 143C,A04,089808,Ternansky; Robert J.,20,0,22,2
1653297088203,CHEM 152,A00,089809,Romero; Nathan A & Schmidt; Valerie A,35,0,40,5
1653297088736,CHEM 171,A01,092688,Slade; Jonathan,35,0,45,10
1653297088736,CHEM 171,A02,092689,Slade; Jonathan,44,0,45,1
1653297088736,CHEM 171,A03,092690,Slade; Jonathan,45,0,45,0
1653297089261,CHEM 186,A00,089811,Paesani; Francesco,9,0,15,6
1653297089791,CHIN 10AD,A01,086223,Staff,13,0,13,0
1653297089791,CHIN 10AD,A02,086224,Staff,12,0,13,1
1653297089791,CHIN 10AD,B01,086227,Staff,14,0,15,1
1653297090320,CHIN 10AM,A01,086230,Chen; Pei-Chia,16,0,16,0
1653297090320,CHIN 10AM,A02,086231,Chen; Pei-Chia,16,0,16,0
1653297090852,CHIN 10AN,A01,086234,Xu; Li,14,0,14,0
1653297090852,CHIN 10AN,A02,086235,Xu; Li,14,0,14,0
1653297090852,CHIN 10AN,B01,086240,Xu; Li,14,0,14,0
1653297090852,CHIN 10AN,B02,086242,Xu; Li,0,0,0,0
1653297090852,CHIN 10AN,C01,086245,Xu; Li,14,0,14,0
1653297090852,CHIN 10AN,C02,086246,Xu; Li,14,0,14,0
1653297091378,CHIN 20AD,A01,086248,Wang; Xiao,14,0,14,0
1653297091378,CHIN 20AD,A02,086249,Wang; Xiao,14,0,14,0
1653297091378,CHIN 20AD,B01,086251,Wang; Xiao,13,0,14,1
1653297091378,CHIN 20AD,B02,086252,Wang; Xiao,14,0,14,0
1653297091921,CHIN 20AM,A01,086254,Wang; Xiao,11,0,14,3
1653297091921,CHIN 20AM,A02,086255,Wang; Xiao,13,0,14,1
1653297091921,CHIN 20AM,B01,086257,Staff,15,0,15,0
1653297092448,CHIN 20AN,A01,086259,Anderson; Qin-Hong,11,0,12,1
1653297092448,CHIN 20AN,A02,086260,Anderson; Qin-Hong,12,0,12,0
1653297092448,CHIN 20AN,A03,086261,Anderson; Qin-Hong,0,0,0,0
1653297092448,CHIN 20AN,B01,086263,Anderson; Qin-Hong,12,0,13,1
1653297092448,CHIN 20AN,B02,086264,Anderson; Qin-Hong,13,0,13,0
1653297092977,CHIN 100AM,A00,086265,Anderson; Qin-Hong,20,0,20,0
1653297093501,CHIN 100AN,A00,086266,Chen; Pei-Chia,17,0,20,3
1653297094025,CHIN 185A,A00,086268,Staff,20,0,20,0
1653297094571,COGS 1,A01,087834,Barrera; Steven James,57,0,60,3
1653297094571,COGS 1,A02,087835,Barrera; Steven James,52,0,60,8
1653297094571,COGS 1,A03,087836,Barrera; Steven James,57,0,60,3
1653297094571,COGS 1,A04,087837,Barrera; Steven James,59,0,60,1
1653297094571,COGS 1,A05,087838,Barrera; Steven James,60,0,60,0
1653297094571,COGS 1,A06,087839,Barrera; Steven James,59,0,60,1
1653297094571,COGS 1,A07,087840,Barrera; Steven James,54,0,57,3
1653297095099,COGS 2,A01,087842,Boyle; Mary E. T.,64,0,64,0
1653297095099,COGS 2,A02,087843,Boyle; Mary E. T.,61,0,64,3
1653297095099,COGS 2,A03,087844,Boyle; Mary E. T.,64,0,64,0
1653297095631,COGS 3,A01,094312,Boyle; Mary E. T.,30,0,35,5
1653297095631,COGS 3,A02,094313,Boyle; Mary E. T.,33,0,35,2
1653297095631,COGS 3,A03,094314,Boyle; Mary E. T.,35,0,35,0
1653297095631,COGS 3,A04,094315,Boyle; Mary E. T.,35,0,35,0
1653297095631,COGS 3,A05,094316,Boyle; Mary E. T.,35,0,35,0
1653297096158,COGS 8,A01,087846,Staff,35,0,35,0
1653297096684,COGS 10,A01,094357,Hollan; James D.,53,0,60,7
1653297096684,COGS 10,A02,094358,Hollan; James D.,58,0,60,2
1653297096684,COGS 10,A03,094359,Hollan; James D.,59,0,60,1
1653297096684,COGS 10,A04,094360,Hollan; James D.,60,0,60,0
1653297096684,COGS 10,A05,094361,Hollan; James D.,60,0,60,0
1653297097218,COGS 11,A01,087848,Boyle; Mary E. T.,46,0,47,1
1653297097218,COGS 11,A02,087849,Boyle; Mary E. T.,44,0,47,3
1653297097218,COGS 11,A03,087850,Boyle; Mary E. T.,46,0,46,0
1653297097743,COGS 13,A01,087852,Davis; Joshua Daniel,56,0,60,4
1653297097743,COGS 13,A02,087853,Davis; Joshua Daniel,55,0,60,5
1653297097743,COGS 13,A03,087854,Davis; Joshua Daniel,57,0,60,3
1653297097743,COGS 13,A04,087855,Davis; Joshua Daniel,58,0,60,2
1653297098268,COGS 14A,A01,087857,Creel; Sarah,58,0,65,7
1653297098268,COGS 14A,A02,087858,Creel; Sarah,62,0,65,3
1653297098268,COGS 14A,A03,087859,Creel; Sarah,63,0,65,2
1653297098268,COGS 14A,A04,087860,Creel; Sarah,63,0,65,2
1653297098792,COGS 14B,A01,087862,Hoffman; Drew Ellen,56,0,60,4
1653297098792,COGS 14B,A02,087863,Hoffman; Drew Ellen,53,0,60,7
1653297098792,COGS 14B,A03,087864,Hoffman; Drew Ellen,60,0,60,0
1653297099314,COGS 15,A01,087866,Bergen; Benjamin,60,0,60,0
1653297099314,COGS 15,A02,087867,Bergen; Benjamin,59,0,60,1
1653297099846,COGS 17,A01,087869,Johnson; Christine M.,55,0,60,5
1653297099846,COGS 17,A02,087870,Johnson; Christine M.,58,0,60,2
1653297099846,COGS 17,A03,087871,Johnson; Christine M.,55,0,60,5
1653297099846,COGS 17,A04,087872,Johnson; Christine M.,60,0,60,0
1653297099846,COGS 17,A05,087873,Johnson; Christine M.,59,0,60,1
1653297099846,COGS 17,A06,087874,Johnson; Christine M.,60,0,60,0
1653297100374,COGS 18,A01,087876,Fleischer; Jason G,22,0,35,13
1653297100374,COGS 18,A02,087877,Fleischer; Jason G,31,0,35,4
1653297100374,COGS 18,A03,087878,Fleischer; Jason G,33,0,35,2
1653297100374,COGS 18,A04,087879,Fleischer; Jason G,33,0,35,2
1653297100374,COGS 18,A05,087880,Fleischer; Jason G,28,0,35,7
1653297100374,COGS 18,A06,087881,Fleischer; Jason G,34,0,35,1
1653297100374,COGS 18,A07,087882,Fleischer; Jason G,33,0,35,2
1653297100374,COGS 18,A08,087883,Fleischer; Jason G,31,0,35,4
1653297100374,COGS 18,A09,087884,Fleischer; Jason G,33,0,35,2
1653297100906,COGS 20,A01,090761,Borgo; David Garcia,5,0,5,0
1653297100906,COGS 20,A02,090762,Borgo; David Garcia,5,0,5,0
1653297100906,COGS 20,A03,090763,Borgo; David Garcia,5,0,5,0
1653297101431,COGS 87,A00,087885,Deak; Gedeon O.,20,0,20,0
1653297101431,COGS 87,B00,087886,Fleischer; Jason G,20,0,20,0
1653297101955,COGS 100,A01,087892,Kirsh; David Joel,56,0,60,4
1653297101955,COGS 100,A02,087893,Kirsh; David Joel,54,0,60,6
1653297101955,COGS 100,A03,087894,Kirsh; David Joel,54,0,60,6
1653297101955,COGS 100,A04,087895,Kirsh; David Joel,51,0,60,9
1653297101955,COGS 100,A05,087896,Kirsh; David Joel,48,0,60,12
1653297102479,COGS 101A,A01,087898,Hoffman; Drew Ellen,48,0,60,12
1653297102479,COGS 101A,A02,087899,Hoffman; Drew Ellen,58,0,60,2
1653297102479,COGS 101A,A03,087900,Hoffman; Drew Ellen,55,0,60,5
1653297102479,COGS 101A,A04,087901,Hoffman; Drew Ellen,58,0,60,2
1653297102479,COGS 101A,A05,087902,Hoffman; Drew Ellen,59,0,60,1
1653297102479,COGS 101A,A06,087903,Hoffman; Drew Ellen,56,0,60,4
1653297103005,COGS 101B,A01,087905,Barrera; Steven James,30,0,60,30
1653297103005,COGS 101B,A02,087906,Barrera; Steven James,52,0,60,8
1653297103005,COGS 101B,A03,087907,Barrera; Steven James,54,0,60,6
1653297103534,COGS 101C,A01,094240,Cooperrider; Kensy A,70,0,75,5
1653297103534,COGS 101C,A02,094241,Cooperrider; Kensy A,73,0,75,2
1653297104062,COGS 102A,A01,087909,Scott; Taylor Jackson,58,0,60,2
1653297104062,COGS 102A,A02,087910,Scott; Taylor Jackson,51,0,60,9
1653297104587,COGS 107A,A01,087912,Rangel; Lara M,51,0,60,9
1653297104587,COGS 107A,A02,087913,Rangel; Lara M,54,0,60,6
1653297104587,COGS 107A,A03,087914,Rangel; Lara M,47,0,60,13
1653297104587,COGS 107A,A04,087915,Rangel; Lara M,53,0,60,7
1653297104587,COGS 107A,A05,087916,Rangel; Lara M,55,0,60,5
1653297104587,COGS 107A,A06,087917,Rangel; Lara M,50,0,60,10
1653297105112,COGS 108,A01,087919,Fleischer; Jason G,15,0,60,45
1653297105112,COGS 108,A02,087920,Fleischer; Jason G,25,0,60,35
1653297105112,COGS 108,A03,087921,Fleischer; Jason G,40,0,60,20
1653297105112,COGS 108,A04,087922,Fleischer; Jason G,40,0,60,20
1653297105112,COGS 108,A05,087923,Fleischer; Jason G,48,0,60,12
1653297105112,COGS 108,A06,087924,Fleischer; Jason G,55,0,60,5
1653297105112,COGS 108,A07,087925,Fleischer; Jason G,42,0,57,15
1653297105641,COGS 110,A01,087927,Deak; Gedeon O.,30,0,35,5
1653297105641,COGS 110,A02,087928,Deak; Gedeon O.,33,0,35,2
1653297106170,COGS 116,A01,094228,Greene; Deanna Jacquelyn,51,0,52,1
1653297106170,COGS 116,A02,094229,Greene; Deanna Jacquelyn,52,0,52,0
1653297106170,COGS 116,A03,094230,Greene; Deanna Jacquelyn,50,0,52,2
1653297106697,COGS 118B,A01,087930,De Sa; Virginia,24,0,35,11
1653297106697,COGS 118B,A02,087931,De Sa; Virginia,28,0,35,7
1653297106697,COGS 118B,A03,087932,De Sa; Virginia,18,0,35,17
1653297106697,COGS 118B,A04,087933,De Sa; Virginia,29,0,35,6
1653297106697,COGS 118B,A05,087934,De Sa; Virginia,27,0,35,8
1653297106697,COGS 118B,A06,087935,De Sa; Virginia,27,0,35,8
1653297107228,COGS 120,A01,087937,Xia; Haijun,38,0,50,12
1653297107228,COGS 120,A02,087938,Xia; Haijun,32,0,50,18
1653297107228,COGS 120,A03,087939,Xia; Haijun,26,0,50,24
1653297107228,COGS 120,A04,087940,Xia; Haijun,2,0,50,48
1653297107757,COGS 128,A01,087944,Scott; Taylor Jackson,11,0,56,45
1653297108282,COGS 143,A01,087947,Johnson; Christine M.,24,0,40,16
1653297108806,COGS 153,A00,087949,Davis; Joshua Daniel,46,0,75,29
1653297109332,COGS 160,A00,087950,Deak; Gedeon O.,20,0,20,0
1653297109332,COGS 160,B00,094232,Saygin; Ayse P,40,0,40,0
1653297109859,COGS 175,A01,094238,Staff,27,0,40,13
1653297110386,COGS 187A,A01,087958,Kirsh; David Joel,22,0,50,28
1653297110386,COGS 187A,A02,087959,Kirsh; David Joel,30,0,50,20
1653297110386,COGS 187A,A03,087960,Kirsh; David Joel,34,0,45,11
1653297110910,COGS 190A,A00,087961,Staff,9999,0,9999,0
1653297111434,COGS 194,A00,087962,Hill; Seth J,9999,0,9999,0
1653297111959,COMM 10,A02,090628,Schmidt; Thomas Rainer,1,0,5,4
1653297111959,COMM 10,A03,090629,Schmidt; Thomas Rainer,3,0,5,2
1653297111959,COMM 10,A04,090630,Schmidt; Thomas Rainer,4,0,5,1
1653297111959,COMM 10,A05,090631,Schmidt; Thomas Rainer,4,0,5,1
1653297111959,COMM 10,A06,090632,Schmidt; Thomas Rainer,5,0,5,0
1653297111959,COMM 10,A07,090633,Schmidt; Thomas Rainer,5,0,5,0
1653297111959,COMM 10,A08,090634,Schmidt; Thomas Rainer,5,0,5,0
1653297111959,COMM 10,A09,090635,Schmidt; Thomas Rainer,5,0,5,0
1653297111959,COMM 10,A10,090636,Schmidt; Thomas Rainer,2,0,5,3
1653297111959,COMM 10,A11,090637,Schmidt; Thomas Rainer,4,0,5,1
1653297111959,COMM 10,A12,094013,Schmidt; Thomas Rainer,2,0,5,3
1653297111959,COMM 10,A13,094014,Schmidt; Thomas Rainer,5,0,5,0
1653297111959,COMM 10,A14,094015,Schmidt; Thomas Rainer,4,0,5,1
1653297111959,COMM 10,A15,094016,Schmidt; Thomas Rainer,5,0,5,0
1653297112565,COMM 100A,A01,090639,Irani; Lilly C,5,0,5,0
1653297112565,COMM 100A,A02,090640,Irani; Lilly C,4,0,5,1
1653297112565,COMM 100A,A03,090641,Irani; Lilly C,5,0,5,0
1653297112565,COMM 100A,A04,090642,Irani; Lilly C,3,0,5,2
1653297112565,COMM 100A,A05,090643,Irani; Lilly C,3,0,5,2
1653297112565,COMM 100A,A06,090644,Irani; Lilly C,4,0,5,1
1653297112565,COMM 100A,A07,090645,Irani; Lilly C,5,0,5,0
1653297112565,COMM 100A,A08,090646,Irani; Lilly C,5,0,5,0
1653297112565,COMM 100A,A09,090647,Irani; Lilly C,5,0,5,0
1653297112565,COMM 100A,A10,090648,Irani; Lilly C,5,0,5,0
1653297112565,COMM 100A,A11,090649,Irani; Lilly C,3,0,5,2
1653297112565,COMM 100A,A12,090650,Irani; Lilly C,5,0,5,0
1653297113091,COMM 101,A01,090652,Halm; Gavin Patrick,14,0,15,1
1653297113091,COMM 101,A02,090653,Halm; Gavin Patrick,14,0,15,1
1653297113091,COMM 101,A03,090654,Halm; Gavin Patrick,12,0,15,3
1653297113091,COMM 101,A04,090655,Halm; Gavin Patrick,13,0,15,2
1653297113614,COMM 101D,A00,090656,Halm; Gavin Patrick,14,0,15,1
1653297114149,COMM 101K,A00,090657,Ahn; Patricia Jeehyun,16,0,20,4
1653297114675,COMM 101T,A00,093701,Staff,20,0,20,0
1653297115198,COMM 102C,A01,090660,Staff,4,0,6,2
1653297115198,COMM 102C,A02,090661,Staff,6,0,6,0
1653297115198,COMM 102C,A03,090662,Staff,4,0,6,2
1653297115723,COMM 103D,A00,090663,Davis; Zeinabu I.,38,0,40,2
1653297116255,COMM 106E,A00,090667,Geiger; Richard Stuart,26,0,30,4
1653297116779,COMM 106G,A00,090668,Cordoba Azcarate; Matilde,25,0,30,5
1653297117311,COMM 108G,A00,090670,Walkover; Lillian B,30,0,30,0
1653297117835,COMM 109I,A00,090671,Tanaka; Stefan A.,30,0,30,0
1653297118360,COMM 109N,A00,094205,Hallin; Daniel C,25,0,30,5
1653297118884,COMM 110G,A00,090672,Whitworth-Smith; Andrew C,45,0,50,5
1653297119414,COMM 111P,A00,090673,Conner; Thomas Hartnell,27,0,30,3
1653297119943,COMM 111T,A00,090674,Iatarola; Briana Marie,27,0,30,3
1653297120470,COMM 124A,A00,090677,Sims; Christopher O,79,0,80,1
1653297120995,COMM 131,A00,090678,Fields; Gary,22,0,25,3
1653297121523,COMM 134,A00,090679,Kidman; Shawna F,16,0,25,9
1653297122047,COMM 146,A00,090680,Staff,22,0,25,3
1653297122571,COMM 166,A00,094493,Staff,24,0,25,1
1653297123097,COMM 172,A00,094066,Staff,23,0,25,2
1653297123620,COMM 182,A00,094063,Staff,25,0,25,0
1653297124145,COMM 190,A00,090686,Kidman; Shawna F,17,0,23,6
1653297124145,COMM 190,B00,090687,Irani; Lilly C,0,0,0,0
1653297124145,COMM 190,C00,090688,Keith; Kerry,21,0,23,2
1653297124145,COMM 190,D00,090689,Zilberg; Elana,23,0,23,0
1653297124668,COMM 194,A00,091600,Hill; Seth J,9999,0,9999,0
1653297125197,COMM 196A,A00,090690,Schmidt; Thomas Rainer,0,0,0,0
1653297125744,COMM 198,001,091397,Ahn; Patricia Jeehyun,9999,0,9999,0
1653297125744,COMM 198,002,091398,Alac; Morana,9999,0,9999,0
1653297125744,COMM 198,003,091399,Anderson; Patrick W.,9999,0,9999,0
1653297125744,COMM 198,004,091400,Boateng; Boatema,9999,0,9999,0
1653297125744,COMM 198,005,091401,Booker; Angela N,9999,0,9999,0
1653297125744,COMM 198,008,091402,Cordoba Azcarate; Matilde,9999,0,9999,0
1653297125744,COMM 198,009,091403,Davis; Zeinabu I.,9999,0,9999,0
1653297125744,COMM 198,010,091404,Dewaard; Andrew Michael,9999,0,9999,0
1653297125744,COMM 198,011,091405,Dominguez Rubio; Fernando,9999,0,9999,0
1653297125744,COMM 198,012,091406,Fattal; Alexander Leor,9999,0,9999,0
1653297125744,COMM 198,013,091407,Fields; Gary,9999,0,9999,0
1653297125744,COMM 198,014,091408,Gates; Kelly,9999,0,9999,0
1653297125744,COMM 198,015,091409,Goldfarb; Brian,9999,0,9999,0
1653297125744,COMM 198,018,091410,Hill; Erin Truesdell,9999,0,9999,0
1653297125744,COMM 198,019,091411,Horwitz; Robert B,9999,0,9999,0
1653297125744,COMM 198,021,091412,Irani; Lilly C,9999,0,9999,0
1653297125744,COMM 198,022,091413,Jack; Caroline Sarah,9999,0,9999,0
1653297125744,COMM 198,023,091414,Kidman; Shawna F,9999,0,9999,0
1653297125744,COMM 198,024,091415,Martinico; Daniel J,9999,0,9999,0
1653297125744,COMM 198,026,091416,Schmidt; Thomas Rainer,9999,0,9999,0
1653297125744,COMM 198,027,091417,Serlin; David,9999,0,9999,0
1653297125744,COMM 198,028,091418,Sims; Christopher O,9999,0,9999,0
1653297125744,COMM 198,029,091419,Tanaka; Stefan A.,9999,0,9999,0
1653297125744,COMM 198,030,091420,Zilberg; Elana,9999,0,9999,0
1653297125744,COMM 198,031,091421,Walkover; Lillian B,9999,0,9999,0
1653297125744,COMM 198,032,091422,Geiger; Richard Stuart,9999,0,9999,0
1653297126278,CSE 8A,A50,089985,Soosai Raj; Adalbert Geral,7,0,10,3
1653297126278,CSE 8A,A51,089986,Soosai Raj; Adalbert Geral,1,0,10,9
1653297126278,CSE 8A,A52,089987,Soosai Raj; Adalbert Geral,5,0,10,5
1653297126278,CSE 8A,A53,089988,Soosai Raj; Adalbert Geral,9,0,10,1
1653297126278,CSE 8A,B50,089990,Soosai Raj; Adalbert Geral,0,0,10,10
1653297126278,CSE 8A,B51,089991,Soosai Raj; Adalbert Geral,5,0,10,5
1653297126278,CSE 8A,B52,089992,Soosai Raj; Adalbert Geral,5,0,10,5
1653297126278,CSE 8A,B53,089993,Soosai Raj; Adalbert Geral,9,0,10,1
1653297126278,CSE 8A,C50,089995,Lerner; Sorin,0,0,10,10
1653297126278,CSE 8A,C51,089996,Lerner; Sorin,6,0,10,4
1653297126278,CSE 8A,C52,089997,Lerner; Sorin,9,0,10,1
1653297126278,CSE 8A,C53,089998,Lerner; Sorin,8,0,10,2
1653297126802,CSE 8B,A01,090000,Ochoa; Benjamin Lawrence,94,0,100,6
1653297127327,CSE 11,A01,090002,Cao; Yingjun,39,0,49,10
1653297127327,CSE 11,B01,090004,Cao; Yingjun,45,0,49,4
1653297127327,CSE 11,C01,090006,Cao; Yingjun,35,0,49,14
1653297127852,CSE 12,A01,090008,Staff,73,0,73,0
1653297127852,CSE 12,B01,090010,Staff,67,0,73,6
1653297127852,CSE 12,C01,090012,Staff,61,0,73,12
1653297128377,CSE 15L,A01,090014,Politz; Joseph Gibbs,4,0,10,6
1653297128377,CSE 15L,A02,090015,Politz; Joseph Gibbs,7,0,10,3
1653297128377,CSE 15L,A03,090016,Politz; Joseph Gibbs,9,0,10,1
1653297128377,CSE 15L,A04,090017,Politz; Joseph Gibbs,9,0,10,1
1653297128377,CSE 15L,A05,090018,Politz; Joseph Gibbs,9,0,10,1
1653297128377,CSE 15L,B01,090020,Politz; Joseph Gibbs,9,0,10,1
1653297128377,CSE 15L,B02,090021,Politz; Joseph Gibbs,6,0,10,4
1653297128377,CSE 15L,B03,090022,Politz; Joseph Gibbs,7,0,10,3
1653297128377,CSE 15L,B04,090023,Politz; Joseph Gibbs,7,0,10,3
1653297128377,CSE 15L,B05,090024,Politz; Joseph Gibbs,7,0,10,3
1653297128900,CSE 20,A01,090026,Staff,204,0,210,6
1653297129423,CSE 21,A01,090028,Impagliazzo; Russell,0,0,0,0
1653297129423,CSE 21,A02,094488,Impagliazzo; Russell,0,0,0,0
1653297129423,CSE 21,A03,094489,Impagliazzo; Russell,0,0,0,0
1653297129955,CSE 30,A01,092463,Muller; P Keith,73,0,100,27
1653297129955,CSE 30,A02,092464,Staff,97,0,100,3
1653297130478,CSE 87,A00,094193,Moshiri; Alexander Niema,20,0,20,0
1653297131009,CSE 95,A00,090030,Minnes Kemp; Mor Mia,35,0,35,0
1653297131009,CSE 95,B00,093883,Minnes Kemp; Mor Mia,35,0,35,0
1653297131009,CSE 95,C00,093885,Minnes Kemp; Mor Mia,35,0,35,0
1653297131539,CSE 100,A01,090033,Moshiri; Alexander Niema,68,0,114,46
1653297132065,CSE 100R,A01,093837,Moshiri; Alexander Niema,334,0,350,16
1653297132594,CSE 101,A01,090035,Saha; Barna,152,0,237,85
1653297133120,CSE 103,A01,090037,Freund; Yoav,60,0,75,15
1653297133651,CSE 105,A01,090039,Lovett; Shachar,201,0,225,24
1653297134175,CSE 106,A50,090042,Paturi; Ramamohan,11,0,30,19
1653297134699,CSE 107,A01,090044,Bellare; Mihir,94,0,120,26
1653297135229,CSE 110,A50,090047,Powell; Thomas Allan,39,0,50,11
1653297135229,CSE 110,A51,090048,Powell; Thomas Allan,39,0,50,11
1653297135229,CSE 110,A52,090049,Powell; Thomas Allan,48,0,50,2
1653297135229,CSE 110,A53,090050,Powell; Thomas Allan,49,0,50,1
1653297135229,CSE 110,A54,090051,Powell; Thomas Allan,45,0,50,5
1653297135229,CSE 110,A55,090052,Powell; Thomas Allan,50,0,50,0
1653297135229,CSE 110,A56,090053,Powell; Thomas Allan,49,0,50,1
1653297135229,CSE 110,A57,090054,Powell; Thomas Allan,41,0,45,4
1653297135753,CSE 118,A00,094897,Weibel; Nadir,0,0,0,0
1653297136279,CSE 120,A01,090056,Voelker; Geoffrey M.,226,0,300,74
1653297136806,CSE 124,A01,090058,Porter; George M,123,0,189,66
1653297137330,CSE 127,A01,090060,Savage; Stefan,46,0,189,143
1653297137853,CSE 130,A01,090062,Polikarpova; Nadezhda,171,0,189,18
1653297138378,CSE 132A,A01,090064,Deutsch; Alin Bernard,47,0,189,142
1653297138908,CSE 140,A01,090068,Eldon; John,169,0,196,27
1653297138908,CSE 140,B01,090070,Orailoglu; Alex,48,0,49,1
1653297139432,CSE 140L,A01,090072,Eldon; John,161,0,192,31
1653297139432,CSE 140L,B01,090075,Orailoglu; Alex,44,0,49,5
1653297139960,CSE 142,A01,090078,Porter; Leonard Emerson,86,0,146,60
1653297139960,CSE 142,B01,090080,Porter; Leonard Emerson,107,0,146,39
1653297140484,CSE 142L,A01,090082,Swanson; Steven James,48,0,146,98
1653297140484,CSE 142L,B01,090084,Swanson; Steven James,120,0,146,26
1653297141019,CSE 151B,A01,090088,Cottrell; Garrison W,258,0,328,70
1653297141545,CSE 152A,A01,090090,Chandraker; Manmohan Krishna,153,0,189,36
1653297142072,CSE 158,A01,090092,McAuley; Julian John,84,0,197,113
1653297142596,CSE 158R,A01,090094,McAuley; Julian John,306,0,353,47
1653297143124,CSE 167,A01,090096,Chern; Albert Ren-Haur,165,0,189,24
1653297143653,CSE 170,A01,090098,Vaccaro; Kristen Marie,20,0,20,0
1653297143653,CSE 170,A02,090099,Vaccaro; Kristen Marie,14,0,20,6
1653297143653,CSE 170,A03,090100,Vaccaro; Kristen Marie,14,0,20,6
1653297143653,CSE 170,A04,090101,Vaccaro; Kristen Marie,14,0,20,6
1653297143653,CSE 170,A05,090102,Vaccaro; Kristen Marie,18,0,20,2
1653297144181,CSE 190,A00,090103,Shalev; Aaron D,40,0,40,0
1653297144181,CSE 190,B00,090104,Vaccaro; Kristen Marie,100,0,100,0
1653297144181,CSE 190,C00,090105,Pannuto; Patrick William,25,0,25,0
1653297144707,CSE 191,A00,093848,Minnes Kemp; Mor Mia,9999,0,9999,0
1653297145231,CSE 193,A01,090107,Elsherif; May Elhussein,49,0,49,0
1653297145757,CSE 194,A01,090109,Munyaka; Imani N. S.,20,0,49,29
1653297146285,CSS 1,A01,086486,Staff,22,0,24,2
1653297146285,CSS 1,A02,086487,Staff,21,0,24,3
1653297146285,CSS 1,A03,086488,Staff,20,0,24,4
1653297146285,CSS 1,A04,086489,Staff,23,0,24,1
1653297146844,DOC 1,A01,086773,Solomon; Amanda Lee Albaniel,0,0,0,0
1653297146844,DOC 1,A02,086774,Solomon; Amanda Lee Albaniel,0,0,0,0
1653297146844,DOC 1,A03,086775,Solomon; Amanda Lee Albaniel,5,0,6,1
1653297146844,DOC 1,A04,086776,Solomon; Amanda Lee Albaniel,6,0,6,0
1653297146844,DOC 1,A05,086777,Solomon; Amanda Lee Albaniel,6,0,6,0
1653297146844,DOC 1,A06,086778,Solomon; Amanda Lee Albaniel,6,0,6,0
1653297146844,DOC 1,A07,086779,Solomon; Amanda Lee Albaniel,5,0,6,1
1653297146844,DOC 1,A08,086849,Solomon; Amanda Lee Albaniel,6,0,6,0
1653297146844,DOC 1,A09,086780,Solomon; Amanda Lee Albaniel,6,0,6,0
1653297146844,DOC 1,A10,086781,Solomon; Amanda Lee Albaniel,6,0,6,0
1653297146844,DOC 1,A11,086782,Solomon; Amanda Lee Albaniel,5,0,6,1
1653297146844,DOC 1,A12,086783,Solomon; Amanda Lee Albaniel,6,0,6,0
1653297146844,DOC 1,A13,086784,Solomon; Amanda Lee Albaniel,6,0,6,0
1653297146844,DOC 1,A14,086785,Solomon; Amanda Lee Albaniel,6,0,6,0
1653297146844,DOC 1,A15,086786,Solomon; Amanda Lee Albaniel,6,0,6,0
1653297146844,DOC 1,A16,086787,Solomon; Amanda Lee Albaniel,6,0,6,0
1653297146844,DOC 1,A17,086788,Solomon; Amanda Lee Albaniel,0,0,0,0
1653297146844,DOC 1,A18,086789,Solomon; Amanda Lee Albaniel,0,0,0,0
1653297146844,DOC 1,B01,086791,Solomon; Amanda Lee Albaniel,6,0,6,0
1653297146844,DOC 1,B02,086792,Solomon; Amanda Lee Albaniel,6,0,6,0
1653297146844,DOC 1,B03,086793,Solomon; Amanda Lee Albaniel,6,0,6,0
1653297146844,DOC 1,B04,086794,Solomon; Amanda Lee Albaniel,6,0,6,0
1653297146844,DOC 1,B05,086795,Solomon; Amanda Lee Albaniel,3,0,6,3
1653297146844,DOC 1,B06,086796,Solomon; Amanda Lee Albaniel,6,0,6,0
1653297146844,DOC 1,B07,086797,Solomon; Amanda Lee Albaniel,6,0,6,0
1653297146844,DOC 1,B08,086798,Solomon; Amanda Lee Albaniel,6,0,6,0
1653297146844,DOC 1,B09,086799,Solomon; Amanda Lee Albaniel,6,0,6,0
1653297146844,DOC 1,B10,086800,Solomon; Amanda Lee Albaniel,6,0,6,0
1653297146844,DOC 1,B11,086801,Solomon; Amanda Lee Albaniel,5,0,6,1
1653297146844,DOC 1,B12,086802,Solomon; Amanda Lee Albaniel,6,0,6,0
1653297146844,DOC 1,B13,086803,Solomon; Amanda Lee Albaniel,6,0,6,0
1653297146844,DOC 1,B14,086804,Solomon; Amanda Lee Albaniel,6,0,6,0
1653297146844,DOC 1,B15,086805,Solomon; Amanda Lee Albaniel,5,0,6,1
1653297146844,DOC 1,B16,086806,Solomon; Amanda Lee Albaniel,6,0,6,0
1653297146844,DOC 1,B17,086807,Solomon; Amanda Lee Albaniel,0,0,0,0
1653297146844,DOC 1,B18,086808,Solomon; Amanda Lee Albaniel,0,0,0,0
1653297146844,DOC 1,C01,086810,Strom; Megan C.,6,0,6,0
1653297146844,DOC 1,C02,086811,Strom; Megan C.,5,0,6,1
1653297146844,DOC 1,C03,086812,Strom; Megan C.,6,0,6,0
1653297146844,DOC 1,C04,086813,Strom; Megan C.,5,0,6,1
1653297146844,DOC 1,C05,086814,Strom; Megan C.,5,0,6,1
1653297146844,DOC 1,C06,086815,Strom; Megan C.,6,0,6,0
1653297146844,DOC 1,C07,086816,Strom; Megan C.,6,0,6,0
1653297146844,DOC 1,C08,086817,Strom; Megan C.,6,0,6,0
1653297146844,DOC 1,C09,086818,Strom; Megan C.,6,0,6,0
1653297146844,DOC 1,C10,086819,Strom; Megan C.,6,0,6,0
1653297146844,DOC 1,C11,086820,Strom; Megan C.,6,0,6,0
1653297146844,DOC 1,C12,086821,Strom; Megan C.,6,0,6,0
1653297146844,DOC 1,C13,086822,Strom; Megan C.,6,0,6,0
1653297146844,DOC 1,C14,086823,Strom; Megan C.,6,0,6,0
1653297146844,DOC 1,C15,086824,Strom; Megan C.,6,0,6,0
1653297146844,DOC 1,C16,086825,Strom; Megan C.,6,0,6,0
1653297146844,DOC 1,C17,086826,Strom; Megan C.,0,0,0,0
1653297146844,DOC 1,C18,086827,Strom; Megan C.,0,0,0,0
1653297146844,DOC 1,D01,086829,Strom; Megan C.,6,0,6,0
1653297146844,DOC 1,D02,086830,Strom; Megan C.,6,0,6,0
1653297146844,DOC 1,D03,086831,Strom; Megan C.,5,0,6,1
1653297146844,DOC 1,D04,086832,Strom; Megan C.,6,0,6,0
1653297146844,DOC 1,D05,086833,Strom; Megan C.,6,0,6,0
1653297146844,DOC 1,D06,086834,Strom; Megan C.,6,0,6,0
1653297146844,DOC 1,D07,086835,Strom; Megan C.,6,0,6,0
1653297146844,DOC 1,D08,086836,Strom; Megan C.,6,0,6,0
1653297146844,DOC 1,D09,086837,Strom; Megan C.,0,0,0,0
1653297146844,DOC 1,D10,086838,Strom; Megan C.,0,0,0,0
1653297146844,DOC 1,D11,086839,Strom; Megan C.,6,0,6,0
1653297146844,DOC 1,D12,086840,Strom; Megan C.,6,0,6,0
1653297146844,DOC 1,D13,086841,Strom; Megan C.,6,0,6,0
1653297146844,DOC 1,D14,086842,Strom; Megan C.,5,0,6,1
1653297146844,DOC 1,D15,086843,Strom; Megan C.,6,0,6,0
1653297146844,DOC 1,D16,086844,Strom; Megan C.,5,0,6,1
1653297147368,DOC 100D,A00,086845,Pass; Natalye Joann,0,0,0,0
1653297147368,DOC 100D,B00,086846,Pass; Natalye Joann,21,0,25,4
1653297147368,DOC 100D,C00,086847,Pass; Natalye Joann,23,0,25,2
1653297147900,DSC 10,A01,088092,Tiefenbruck; Janine LoBue,13,0,15,2
1653297147900,DSC 10,B01,088095,Tiefenbruck; Janine LoBue,9,0,15,6
1653297147900,DSC 10,C01,088098,Rampure; Suraj,0,0,15,15
1653297148424,DSC 20,A01,088101,Langlois; Marina,148,0,150,2
1653297148959,DSC 30,A01,088105,Langlois; Marina,74,0,75,1
1653297149482,DSC 40A,A01,088107,Rampure; Suraj,97,0,100,3
1653297149482,DSC 40A,B01,088109,Rampure; Suraj,99,0,100,1
1653297150006,DSC 40B,A01,088111,Eldridge; Justin Matthew,73,0,75,2
1653297150006,DSC 40B,B01,088113,Wang; Yusu,75,0,75,0
1653297150533,DSC 80,A01,088115,Eldridge; Justin Matthew,95,0,100,5
1653297151057,DSC 95,A01,088117,Langlois; Marina,20,0,20,0
1653297151585,DSC 96,A00,088118,Liao; Soohyun Nam,50,0,50,0
1653297152113,DSC 100,A01,088120,Salimi; Babak,164,0,175,11
1653297152637,DSC 102,A01,094320,Kumar; Arun Kumar,77,0,125,48
1653297153167,DSC 180A,A01,088124,Fraenkel; Aaron Mcmillan,0,0,0,0
1653297153167,DSC 180A,A02,088125,Fraenkel; Aaron Mcmillan,0,0,0,0
1653297153167,DSC 180A,A03,088126,Fraenkel; Aaron Mcmillan,0,0,0,0
1653297153167,DSC 180A,A04,088127,Fraenkel; Aaron Mcmillan,0,0,0,0
1653297153167,DSC 180A,A05,088128,Fraenkel; Aaron Mcmillan,0,0,0,0
1653297153167,DSC 180A,A06,088129,Fraenkel; Aaron Mcmillan,0,0,0,0
1653297153167,DSC 180A,A07,088130,Fraenkel; Aaron Mcmillan,0,0,0,0
1653297153167,DSC 180A,A08,088131,Fraenkel; Aaron Mcmillan,0,0,0,0
1653297153167,DSC 180A,A09,088132,Fraenkel; Aaron Mcmillan,0,0,0,0
1653297153167,DSC 180A,A10,088133,Fraenkel; Aaron Mcmillan,0,0,0,0
1653297153167,DSC 180A,A11,088134,Fraenkel; Aaron Mcmillan,0,0,0,0
1653297153167,DSC 180A,A12,088135,Fraenkel; Aaron Mcmillan,0,0,0,0
1653297153167,DSC 180A,A13,088136,Fraenkel; Aaron Mcmillan,0,0,0,0
1653297153167,DSC 180A,A14,088137,Fraenkel; Aaron Mcmillan,0,0,0,0
1653297153167,DSC 180A,A15,088138,Fraenkel; Aaron Mcmillan,0,0,0,0
1653297153167,DSC 180A,B01,088141,Fraenkel; Aaron Mcmillan,0,0,0,0
1653297153167,DSC 180A,B02,088142,Fraenkel; Aaron Mcmillan,0,0,0,0
1653297153167,DSC 180A,B03,088143,Fraenkel; Aaron Mcmillan,0,0,0,0
1653297153167,DSC 180A,B04,088144,Fraenkel; Aaron Mcmillan,0,0,0,0
1653297153167,DSC 180A,B05,088145,Fraenkel; Aaron Mcmillan,0,0,0,0
1653297153167,DSC 180A,B06,088146,Fraenkel; Aaron Mcmillan,0,0,0,0
1653297153167,DSC 180A,B07,088147,Fraenkel; Aaron Mcmillan,0,0,0,0
1653297153167,DSC 180A,B08,088148,Fraenkel; Aaron Mcmillan,0,0,0,0
1653297153167,DSC 180A,B09,088149,Fraenkel; Aaron Mcmillan,0,0,0,0
1653297153167,DSC 180A,B10,088150,Fraenkel; Aaron Mcmillan,0,0,0,0
1653297153167,DSC 180A,B11,088151,Fraenkel; Aaron Mcmillan,0,0,0,0
1653297153167,DSC 180A,B12,088152,Fraenkel; Aaron Mcmillan,0,0,0,0
1653297153167,DSC 180A,B13,088153,Fraenkel; Aaron Mcmillan,0,0,0,0
1653297153167,DSC 180A,B14,088154,Fraenkel; Aaron Mcmillan,0,0,0,0
1653297153167,DSC 180A,B15,088155,Fraenkel; Aaron Mcmillan,0,0,0,0
1653297153696,DSC 190,A01,088158,Mishne; Gal,48,0,50,2
1653297153696,DSC 190,B01,088160,Silberman; Jack,16,0,21,5
1653297154220,DSC 197,001,088161,Eldridge; Justin Matthew,9999,0,9999,0
1653297154754,DSGN 1,A01,087888,Meyer; Michael Wayne,49,0,53,4
1653297154754,DSGN 1,A02,087889,Meyer; Michael Wayne,47,0,53,6
1653297154754,DSGN 1,A03,087890,Meyer; Michael Wayne,43,0,53,10
1653297155283,DSGN 100,A01,087983,Dow; Steven P,39,0,40,1
1653297155283,DSGN 100,A02,087984,Dow; Steven P,40,0,40,0
1653297155283,DSGN 100,A03,087985,Dow; Steven P,34,0,40,6
1653297155813,DSGN 118,A01,087987,Xia; Haijun,55,0,60,5
1653297155813,DSGN 118,A02,087988,Xia; Haijun,56,0,60,4
1653297156336,DSGN 119,A00,087989,Staff,51,0,70,19
1653297156862,ECE 5,A01,090699,Morris; Karcher William,0,0,0,0
1653297156862,ECE 5,A02,090700,Morris; Karcher William,0,0,0,0
1653297156862,ECE 5,A03,090701,Morris; Karcher William,0,0,0,0
1653297156862,ECE 5,A04,090702,Morris; Karcher William,0,0,0,0
1653297156862,ECE 5,A05,090703,Morris; Karcher William,0,0,0,0
1653297156862,ECE 5,A06,090704,Morris; Karcher William,0,0,0,0
1653297157386,ECE 15,A01,090706,Schurgers; Curt,0,0,0,0
1653297157386,ECE 15,A02,090707,Schurgers; Curt,0,0,0,0
1653297157924,ECE 16,A01,090709,Khoshabeh; Ramsin,24,0,30,6
1653297158452,ECE 17,A01,090711,Gilja; Vikash,55,0,60,5
1653297158981,ECE 25,A50,090714,Liu; Zhaowei,0,0,0,0
1653297158981,ECE 25,A51,090715,Liu; Zhaowei,0,0,0,0
1653297158981,ECE 25,A52,090716,Liu; Zhaowei,0,0,0,0
1653297159509,ECE 30,A50,094300,Mir Arabbaygi; Siavash,25,0,30,5
1653297159509,ECE 30,A51,094301,Mir Arabbaygi; Siavash,29,0,30,1
1653297159509,ECE 30,A52,094302,Mir Arabbaygi; Siavash,27,0,30,3
1653297159509,ECE 30,A53,094303,Mir Arabbaygi; Siavash,29,0,30,1
1653297159509,ECE 30,A54,094304,Mir Arabbaygi; Siavash,25,0,25,0
1653297160039,ECE 35,A50,090720,Schurgers; Curt,0,0,0,0
1653297160039,ECE 35,A51,090721,Schurgers; Curt,0,0,0,0
1653297160039,ECE 35,A52,090722,Schurgers; Curt,0,0,0,0
1653297160039,ECE 35,A53,090723,Schurgers; Curt,0,0,0,0
1653297160039,ECE 35,A54,090724,Schurgers; Curt,0,0,0,0
1653297160039,ECE 35,A55,090725,Schurgers; Curt,0,0,0,0
1653297160039,ECE 35,B50,090729,Schurgers; Curt,0,0,0,0
1653297160039,ECE 35,B51,090730,Schurgers; Curt,0,0,0,0
1653297160039,ECE 35,B52,090731,Schurgers; Curt,0,0,0,0
1653297160039,ECE 35,B53,090732,Schurgers; Curt,0,0,0,0
1653297160039,ECE 35,B54,090733,Schurgers; Curt,0,0,0,0
1653297160039,ECE 35,B55,090734,Schurgers; Curt,0,0,0,0
1653297160563,ECE 45,A01,090736,Franceschetti; Massimo,56,0,57,1
1653297160563,ECE 45,A02,090737,Franceschetti; Massimo,50,0,58,8
1653297161098,ECE 65,A50,090741,Baghdadchi; Saharnaz,13,0,15,2
1653297161098,ECE 65,A51,090742,Baghdadchi; Saharnaz,5,0,10,5
1653297161098,ECE 65,A52,090743,Baghdadchi; Saharnaz,14,0,15,1
1653297161098,ECE 65,A53,090744,Baghdadchi; Saharnaz,8,0,10,2
1653297161098,ECE 65,A54,094865,Baghdadchi; Saharnaz,14,0,15,1
1653297161098,ECE 65,A55,094866,Baghdadchi; Saharnaz,9,0,10,1
1653297161098,ECE 65,A56,094867,Baghdadchi; Saharnaz,14,0,15,1
1653297161098,ECE 65,A57,094868,Baghdadchi; Saharnaz,15,0,15,0
1653297161098,ECE 65,A58,094869,Baghdadchi; Saharnaz,10,0,10,0
1653297161623,ECE 100,A01,090746,Baghdadchi; Saharnaz,16,0,20,4
1653297161623,ECE 100,A02,090747,Baghdadchi; Saharnaz,20,0,20,0
1653297161623,ECE 100,A03,090748,Baghdadchi; Saharnaz,18,0,20,2
1653297161623,ECE 100,A04,090749,Baghdadchi; Saharnaz,20,0,20,0
1653297161623,ECE 100,A05,090750,Baghdadchi; Saharnaz,18,0,20,2
1653297161623,ECE 100,A06,090751,Baghdadchi; Saharnaz,18,0,20,2
1653297161623,ECE 100,A07,090752,Baghdadchi; Saharnaz,20,0,20,0
1653297162147,ECE 101,A01,090754,Siegel; Paul H.,62,0,75,13
1653297162147,ECE 101,A02,090755,Siegel; Paul H.,71,0,75,4
1653297162671,ECE 102,A00,090756,Hsueh; Tzu-Chien,57,0,75,18
1653297163200,ECE 103,A01,090767,Lo; Yu-Hwa,45,0,50,5
1653297163734,ECE 107,A01,090769,Lomakin; Vitaliy,72,0,75,3
1653297164258,ECE 109,A01,090771,Zeger; Kenneth A.,176,0,180,4
1653297164782,ECE 111,A01,090774,Koushanfar; Farinaz,100,0,120,20
1653297165315,ECE 121A,A50,090777,Esmaili; Gholamreza,17,0,24,7
1653297165315,ECE 121A,A51,090778,Esmaili; Gholamreza,9,0,24,15
1653297165315,ECE 121A,A52,090779,Esmaili; Gholamreza,22,0,24,2
1653297165926,ECE 128A,A00,090780,Staff,40,0,70,30
1653297166449,ECE 135A,A00,090781,Kuzum; Duygu,30,0,30,0
1653297166973,ECE 143,A00,090782,Unpingco; Jose H.,0,0,0,2
1653297167500,ECE 148,A01,090784,Staff,32,0,32,0
1653297168029,ECE 155,A01,090786,Milstein; Laurence B.,16,0,20,4
1653297168564,ECE 158A,A01,090788,Franceschetti; Massimo,56,0,65,9
1653297169092,ECE 161A,A01,090790,Rao; Bhaskar D.,103,0,115,12
1653297169615,ECE 164,A00,090791,Hall; Drew A.,87,0,115,28
1653297170148,ECE 166,A50,090796,Rebeiz; Gabriel,6,0,12,6
1653297170148,ECE 166,A51,090797,Rebeiz; Gabriel,9,0,12,3
1653297170148,ECE 166,A52,090799,Rebeiz; Gabriel,1,0,12,11
1653297170148,ECE 166,A53,090800,Rebeiz; Gabriel,6,0,12,6
1653297170148,ECE 166,A54,094335,Rebeiz; Gabriel,11,0,12,1
1653297170148,ECE 166,A55,094336,Rebeiz; Gabriel,12,0,12,0
1653297170148,ECE 166,A56,094349,Rebeiz; Gabriel,13,0,15,2
1653297170148,ECE 166,A57,094350,Rebeiz; Gabriel,14,0,15,1
1653297170674,ECE 171A,A01,090802,Atanasov; Nikolay A.,45,0,60,15
1653297171206,ECE 171B,A01,090804,Shi; Yuanyuan,44,0,50,6
1653297171731,ECE 174,A01,090806,Pal; Piya,125,0,146,21
1653297172256,ECE 182,A01,090808,Lomakin; Vitaliy,23,0,23,0
1653297172783,ECE 187,A00,090809,Liu; Zhaowei,19,0,20,1
1653297173311,ECE 196,A00,090812,Morris; Karcher William,19,0,24,5
1653297173311,ECE 196,B00,094833,Morris; Karcher William,24,0,24,0
1653297173838,ECE 197,001,090813,Sievenpiper; Daniel F.,9999,0,9999,0
1653297174374,ECON 1,A01,092535,Staff,0,0,0,0
1653297174374,ECON 1,A02,092536,Staff,0,0,0,0
1653297174374,ECON 1,A03,092537,Staff,0,0,0,0
1653297174374,ECON 1,A04,092538,Staff,0,0,0,0
1653297174374,ECON 1,A05,092539,Staff,0,0,0,0
1653297174374,ECON 1,B01,092540,Ma; Alyson Chan,42,0,45,3
1653297174374,ECON 1,B02,092541,Ma; Alyson Chan,45,0,45,0
1653297174374,ECON 1,B03,092542,Ma; Alyson Chan,45,0,45,0
1653297174374,ECON 1,B04,092543,Ma; Alyson Chan,40,0,40,0
1653297174374,ECON 1,B05,092544,Ma; Alyson Chan,40,0,40,0
1653297174374,ECON 1,C01,092545,Tocoian; Oana,0,0,0,0
1653297174374,ECON 1,C02,092546,Tocoian; Oana,0,0,0,0
1653297174374,ECON 1,C03,092547,Tocoian; Oana,0,0,0,0
1653297174374,ECON 1,C04,092548,Tocoian; Oana,0,0,0,0
1653297174374,ECON 1,D01,094253,Levkoff; Steven B.,41,0,45,4
1653297174374,ECON 1,D02,094254,Levkoff; Steven B.,44,0,45,1
1653297174374,ECON 1,D03,094255,Levkoff; Steven B.,45,0,45,0
1653297174374,ECON 1,D04,094256,Levkoff; Steven B.,36,0,40,4
1653297174374,ECON 1,D05,094257,Levkoff; Steven B.,40,0,40,0
1653297174898,ECON 2,A01,092549,Staff,0,0,0,0
1653297174898,ECON 2,A02,092550,Staff,0,0,0,0
1653297174898,ECON 2,A03,092551,Staff,0,0,0,0
1653297175503,ECON 4,A01,092554,Levkoff; Steven B.,29,0,30,1
1653297175503,ECON 4,A02,092555,Levkoff; Steven B.,27,0,30,3
1653297175503,ECON 4,A03,092556,Levkoff; Steven B.,30,0,30,0
1653297176032,ECON 100A,A01,092557,Newhouse; Herbert S,23,0,30,7
1653297176032,ECON 100A,A02,092558,Newhouse; Herbert S,28,0,30,2
1653297176032,ECON 100A,A03,092559,Newhouse; Herbert S,29,0,30,1
1653297176032,ECON 100A,A04,092560,Newhouse; Herbert S,35,0,35,0
1653297176032,ECON 100A,B01,092561,Newhouse; Herbert S,20,0,30,10
1653297176032,ECON 100A,B02,092562,Newhouse; Herbert S,28,0,30,2
1653297176032,ECON 100A,B03,092563,Newhouse; Herbert S,15,0,30,15
1653297176032,ECON 100A,B04,092564,Newhouse; Herbert S,35,0,35,0
1653297176561,ECON 100B,A01,092565,Galperti; Simone,27,0,30,3
1653297176561,ECON 100B,A02,092566,Galperti; Simone,18,0,20,2
1653297176561,ECON 100B,A03,094496,Staff,27,0,30,3
1653297176561,ECON 100B,A04,094497,Staff,16,0,20,4
1653297176561,ECON 100B,B01,092567,Galperti; Simone,16,0,25,9
1653297177092,ECON 100C,A01,092569,Du; Songzi,62,0,75,13
1653297177092,ECON 100C,B01,092570,Du; Songzi,70,0,75,5
1653297177092,ECON 100C,B02,094258,Du; Songzi,75,0,75,0
1653297177627,ECON 100CH,A00,088284,Andreoni; James,20,0,20,0
1653297178153,ECON 109,A01,092572,Watson; Joel Christopher,68,0,75,7
1653297178153,ECON 109,B01,092573,Watson; Joel Christopher,68,0,75,7
1653297178680,ECON 110A,A01,092574,Alon; Titan Michael,12,0,25,13
1653297178680,ECON 110A,A02,092575,Alon; Titan Michael,24,0,25,1
1653297178680,ECON 110A,B01,092576,Alon; Titan Michael,24,0,25,1
1653297178680,ECON 110A,B02,092577,Alon; Titan Michael,25,0,25,0
1653297179203,ECON 110B,A01,092578,Trottner; Fabian Gunter We,16,0,25,9
1653297179203,ECON 110B,A02,094054,Trottner; Fabian Gunter We,23,0,25,2
1653297179203,ECON 110B,B01,092579,Trottner; Fabian Gunter We,7,0,25,18
1653297179203,ECON 110B,B02,094055,Trottner; Fabian Gunter We,24,0,25,1
1653297179727,ECON 116,A00,088291,Lowes; Sara Rachel,58,0,70,12
1653297180262,ECON 120A,A01,092580,Elliott; Graham,18,0,25,7
1653297180262,ECON 120A,A02,092581,Elliott; Graham,22,0,25,3
1653297180262,ECON 120A,B01,092582,Elliott; Graham,18,0,25,7
1653297180262,ECON 120A,B02,092583,Elliott; Graham,20,0,25,5
1653297180262,ECON 120A,C01,092584,Tocoian; Oana,27,0,30,3
1653297180262,ECON 120A,C02,092585,Tocoian; Oana,28,0,30,2
1653297180262,ECON 120A,C03,092586,Tocoian; Oana,40,0,40,0
1653297180791,ECON 120B,A01,092587,Candido; Maria Teresa,58,0,70,12
1653297180791,ECON 120B,A02,092588,Candido; Maria Teresa,51,0,60,9
1653297180791,ECON 120B,A03,092589,Candido; Maria Teresa,56,0,60,4
1653297181322,ECON 120C,A01,092590,Candido; Maria Teresa,48,0,60,12
1653297181322,ECON 120C,A02,092591,Candido; Maria Teresa,59,0,60,1
1653297181322,ECON 120C,A03,094310,Candido; Maria Teresa,73,0,75,2
1653297181848,ECON 121,A00,088298,Vogl; Tom Saul,36,0,50,14
1653297182374,ECON 130,A00,088299,Staff,59,0,75,16
1653297182906,ECON 131,A00,088300,Jacobsen; Mark,129,0,150,21
1653297182906,ECON 131,B00,088301,Jacobsen; Mark,15,0,30,15
1653297183431,ECON 152,A00,088302,Fadlon; Yizhak,34,0,50,16
1653297183431,ECON 152,B00,088303,Fadlon; Yizhak,49,0,50,1
1653297183958,ECON 168,A00,088304,Staff,54,0,60,6
1653297184483,ECON 191B,A00,088312,Galperti; Simone,20,0,20,0
1653297185007,EDS 25,A01,087581,Staff,9,0,10,1
1653297185007,EDS 25,A02,087582,Staff,10,0,10,0
1653297185007,EDS 25,A03,087583,Staff,7,0,10,3
1653297185007,EDS 25,A04,087584,Staff,10,0,10,0
1653297185530,EDS 31,A00,087585,Bussey; Thomas J,9,0,10,1
1653297186054,EDS 110R,A01,087597,Cohen; Shana R,43,0,50,7
1653297186054,EDS 110R,B01,093579,Cohen; Shana R,10,0,10,0
1653297186590,EDS 113,A00,087598,Staff,45,0,50,5
1653297187113,EDS 114,A01,088091,Eguchi; Emi,17,0,20,3
1653297187113,EDS 114,A02,087600,Eguchi; Emi,19,0,20,1
1653297187641,EDS 117,A01,087603,Chung; Luz Marina,25,0,35,10
1653297187641,EDS 117,A02,087604,Chung; Luz Marina,34,0,35,1
1653297188181,EDS 124AR,A01,087606,Simon; Elizabeth A,0,0,19,19
1653297188181,EDS 124AR,A02,087607,Simon; Elizabeth A,13,0,19,6
1653297188181,EDS 124AR,A03,087608,Simon; Elizabeth A,15,0,19,4
1653297188181,EDS 124AR,A04,087609,Simon; Elizabeth A,4,0,19,15
1653297188181,EDS 124AR,B01,087611,Simon; Elizabeth A,14,0,19,5
1653297188181,EDS 124AR,B02,087612,Simon; Elizabeth A,18,0,19,1
1653297188181,EDS 124AR,B03,087613,Simon; Elizabeth A,18,0,19,1
1653297188181,EDS 124AR,B04,087614,Simon; Elizabeth A,19,0,19,0
1653297188181,EDS 124AR,C01,094210,Simon; Elizabeth A,6,0,6,0
1653297188181,EDS 124AR,C02,094211,Simon; Elizabeth A,6,0,6,0
1653297188181,EDS 124AR,C03,094212,Simon; Elizabeth A,6,0,6,0
1653297188181,EDS 124AR,C04,094213,Simon; Elizabeth A,6,0,6,0
1653297188181,EDS 124AR,D01,094215,Simon; Elizabeth A,6,0,6,0
1653297188181,EDS 124AR,D02,094216,Simon; Elizabeth A,6,0,6,0
1653297188181,EDS 124AR,D03,094217,Simon; Elizabeth A,6,0,6,0
1653297188181,EDS 124AR,D04,094218,Simon; Elizabeth A,6,0,6,0
1653297188703,EDS 124BR,A00,087615,Eguchi; Emi,65,0,75,10
1653297188703,EDS 124BR,B00,093580,Eguchi; Emi,25,0,25,0
1653297189227,EDS 125,A00,087616,Jones; Gabrielle Anastasia,51,0,60,9
1653297189750,EDS 129A,A01,087618,Heinzman; Erica M.,43,0,50,7
1653297190277,EDS 130,A01,087620,Holtzman; Caren Lynn,17,0,20,3
1653297190277,EDS 130,A02,087621,Holtzman; Caren Lynn,20,0,20,0
1653297190277,EDS 130,A03,087622,Holtzman; Caren Lynn,20,0,20,0
1653297190808,EDS 131,A01,087624,Wishard Guerra; Alison G.,37,0,40,3
1653297191333,EDS 133,A01,087627,Bintliff; Amy S.V.,17,0,20,3
1653297191333,EDS 133,A02,087628,Bintliff; Amy S.V.,19,0,20,1
1653297191862,EDS 139,A00,087629,Holtzman; Caren Lynn,55,0,60,5
1653297191862,EDS 139,B00,087630,Heinzman; Erica M.,51,0,60,9
1653297191862,EDS 139,C00,087631,Bintliff; Amy S.V.,57,0,60,3
1653297191862,EDS 139,D00,087632,Wishard Guerra; Alison G.,58,0,60,2
1653297191862,EDS 139,E00,087633,Holtzman; Caren Lynn,30,0,30,0
1653297191862,EDS 139,F00,094886,Staff,25,0,25,0
1653297192385,EDS 146,A01,094220,Staff,25,0,25,0
1653297192908,EDS 164R,A01,087644,Wishard Guerra; Alison G.,37,0,40,3
1653297192908,EDS 164R,B01,093582,Wishard Guerra; Alison G.,20,0,20,0
1653297193433,EDS 190,A00,087645,Bresser; Bernard George,20,0,20,0
1653297193433,EDS 190,B00,087646,Pappas; Elizabeth,20,0,20,0
1653297193433,EDS 190,C00,087647,Scharton; Susan Michelle,20,0,20,0
1653297193433,EDS 190,E00,087648,Staff,20,0,20,0
1653297193963,ENG 10,A00,086288,Staff,30,0,30,0
1653297193963,ENG 10,B00,086289,Staff,30,0,30,0
1653297194486,ENG 15,A01,086291,Staff,35,0,35,0
1653297195020,ENG 20,A00,086292,Evdokimenko; Ekaterina,33,0,35,2
1653297195547,ENG 100D,A00,086293,Ngo; Anh-Thu T.,45,0,50,5
1653297195547,ENG 100D,B00,094309,Staff,46,0,50,4
1653297196079,ENG 100L,A00,086295,Kleissl; Jan,6,0,6,0
1653297196079,ENG 100L,B00,086296,Bratton; Maryann,8,0,8,0
1653297196079,ENG 100L,C00,086297,Nguyen; Truong Quang,10,0,10,0
1653297196079,ENG 100L,E00,086299,de Oliveira; Mauricio,8,0,8,0
1653297196079,ENG 100L,F00,086300,Goldberg; Charles G.,6,0,6,0
1653297196079,ENG 100L,G00,086301,Bratton; Maryann,6,0,6,0
1653297196079,ENG 100L,H00,086302,Staff,6,0,6,0
1653297196604,ENVR 30,A01,093565,Staff,29,0,30,1
1653297196604,ENVR 30,A02,093567,Staff,28,0,30,2
1653297196604,ENVR 30,A03,093568,Staff,25,0,30,5
1653297196604,ENVR 30,A04,093569,Staff,30,0,30,0
1653297196604,ENVR 30,A05,093570,Staff,29,0,30,1
1653297196604,ENVR 30,A06,093566,Staff,29,0,30,1
1653297197129,ENVR 102,A00,093571,Daly; Heather Marie,25,0,30,5
1653297198188,ERC 1,A01,092328,Herbst; Matthew,20,0,20,0
1653297198188,ERC 1,A02,092330,Herbst; Matthew,20,0,20,0
1653297198188,ERC 1,A03,092331,Herbst; Matthew,20,0,20,0
1653297198188,ERC 1,A04,092332,Herbst; Matthew,20,0,20,0
1653297198188,ERC 1,A05,092333,Herbst; Matthew,20,0,20,0
1653297198188,ERC 1,A06,092334,Herbst; Matthew,20,0,20,0
1653297198716,ERC 2,A01,092336,Rahimi; Babak,20,0,20,0
1653297198716,ERC 2,A02,092337,Rahimi; Babak,20,0,20,0
1653297198716,ERC 2,A03,092338,Rahimi; Babak,20,0,20,0
1653297198716,ERC 2,A04,092339,Rahimi; Babak,20,0,20,0
1653297199244,ERC 20,A00,092340,Evans; Ivan T,30,0,30,0
1653297199244,ERC 20,B00,092341,Evans; Ivan T,30,0,30,0
1653297199767,ERC 87,A00,093850,Herbst; Matthew,20,0,20,0
1653297200293,ERC 92,A00,092342,Staff,1,0,1,0
1653297200293,ERC 92,B00,092343,Staff,1,0,1,0
1653297200293,ERC 92,C00,092344,Staff,1,0,1,0
1653297200293,ERC 92,D00,092345,Staff,1,0,1,0
1653297200293,ERC 92,E00,092346,Staff,1,0,1,0
1653297200293,ERC 92,F00,092347,Staff,1,0,1,0
1653297200823,ESYS 90,A00,086303,Teranes; Jane,12,0,12,0
1653297201347,ESYS 101,A01,086305,Taylor; Jennifer Rebecca & Diaz; Julia Michelle,25,0,27,2
1653297201347,ESYS 101,A02,086306,Taylor; Jennifer Rebecca & Diaz; Julia Michelle,15,0,27,12
1653297201347,ESYS 101,A03,086307,Taylor; Jennifer Rebecca & Diaz; Julia Michelle,21,0,27,6
1653297201347,ESYS 101,A04,086308,Taylor; Jennifer Rebecca & Diaz; Julia Michelle,27,0,27,0
1653297201871,ESYS 187A,A01,086310,Teranes; Jane,38,0,40,2
1653297201871,ESYS 187A,B01,086312,Teranes; Jane,30,0,40,10
1653297202399,ETHN 1,A01,086314,Frank; Ross H.,15,0,15,0
1653297202399,ETHN 1,A02,086315,Frank; Ross H.,15,0,15,0
1653297202399,ETHN 1,A03,086316,Frank; Ross H.,14,0,15,1
1653297202399,ETHN 1,A04,086317,Frank; Ross H.,15,0,15,0
1653297202399,ETHN 1,A05,086318,Frank; Ross H.,15,0,15,0
1653297202399,ETHN 1,A06,086319,Frank; Ross H.,13,0,15,2
1653297202399,ETHN 1,A07,086320,Frank; Ross H.,15,0,15,0
1653297202399,ETHN 1,A08,086321,Frank; Ross H.,14,0,15,1
1653297202399,ETHN 1,A09,086322,Frank; Ross H.,15,0,15,0
1653297202399,ETHN 1,A10,086323,Frank; Ross H.,15,0,15,0
1653297202399,ETHN 1,A11,086324,Frank; Ross H.,15,0,15,0
1653297202399,ETHN 1,A12,086325,Frank; Ross H.,15,0,15,0
1653297202399,ETHN 1,A13,086326,Frank; Ross H.,15,0,15,0
1653297202399,ETHN 1,A14,086327,Frank; Ross H.,15,0,15,0
1653297202399,ETHN 1,A15,086328,Frank; Ross H.,15,0,15,0
1653297202399,ETHN 1,A16,086329,Frank; Ross H.,15,0,15,0
1653297202935,ETHN 100A,A00,086330,Patel; Shaista,41,0,48,7
1653297203467,ETHN 103,A00,086331,Perreira; Christopher Michael,63,0,70,7
1653297203993,ETHN 104,A00,086332,Staff,0,0,0,0
1653297204516,ETHN 106,A00,086333,Staff,0,0,0,0
1653297205043,ETHN 121,A00,086341,Sasaki; Christen T,20,0,28,8
1653297205570,ETHN 139,A00,086342,Ruiz; Ariana,16,0,20,4
1653297206098,ETHN 144M,A00,086343,Jolivette; Andrew J,66,0,70,4
1653297206620,ETHN 159,A00,088427,Graham; Jessica Lynn,0,0,0,0
1653297207144,ETHN 163E,A00,086344,Patel; Shaista,37,0,40,3
1653297207667,ETHN 178R,A00,090798,Borgo; David Garcia,15,0,20,5
1653297208191,ETHN 187,A00,086345,Perez; Roy,14,0,16,2
1653297208715,EXPR 100,A00,085686,Staff,9999,0,9999,0
1653297209240,FMPH 40,A00,086370,Emory; Kristen,70,0,75,5
1653297209240,FMPH 40,B00,086371,Romero; Sally Ann Dominick,71,0,75,4
1653297209765,FMPH 101,A00,086372,Brouwer; Kimberly,43,0,55,12
1653297210301,FMPH 102,A50,094498,Rana; Brinda Kanti,42,0,55,13
1653297210828,FMPH 110,A00,086374,Zoumas-Morse; Christine E.,61,0,65,4
1653297211354,FMPH 120,A00,086375,Nguyen-Grozavu; France T.,45,0,65,20
1653297211354,FMPH 120,B00,086376,Nguyen-Grozavu; France T.,60,0,65,5
1653297211882,FMPH 130,A00,086377,Staff,48,0,65,17
1653297212938,FMPH 161,A00,086379,Zoumas-Morse; Christine E.,58,0,65,7
1653297213469,FMPH 191,A00,086380,Harrell; Maralee Mae,58,0,60,2
1653297213994,FMPH 196A,A00,086381,Binkin; Nancy Jeanne,0,0,0,0
1653297214520,GLBH 20,A00,086407,Walkover; Lillian B,85,0,90,5
1653297215044,GLBH 100,A00,086408,Staff,55,0,56,1
1653297215044,GLBH 100,B00,086409,Wu; Hua,52,0,56,4
1653297215044,GLBH 100,D00,086411,Staff,38,0,40,2
1653297215567,GLBH 103,A00,086412,Hannah; Seth Donal,48,0,50,2
1653297216104,GLBH 105,A00,086413,Olivas Hernandez; Olga Lid,36,0,38,2
1653297216629,GLBH 106,A00,086414,Kayser; Georgia Lyn,40,0,40,0
1653297217159,GLBH 111,A01,094330,Burgos; Jose L.,0,0,0,0
1653297217159,GLBH 111,B01,094332,Burgos; Jose L.,0,0,0,0
1653297217684,GLBH 148,A00,086415,Staff,69,0,73,4
1653297218207,GLBH 181,A00,086417,Burgos; Jose L.,144,0,146,2
1653297218730,GSS 20,A00,094269,Staff,73,0,75,2
1653297219325,HDS 1,A01,086423,Staff,24,0,25,1
1653297219325,HDS 1,A02,086424,Staff,24,0,25,1
1653297219325,HDS 1,A03,086425,Staff,23,0,25,2
1653297219325,HDS 1,A04,086426,Staff,25,0,25,0
1653297219325,HDS 1,A05,086427,Staff,24,0,25,1
1653297219325,HDS 1,A06,086428,Staff,25,0,25,0
1653297219325,HDS 1,A07,086429,Staff,30,0,30,0
1653297219848,HDS 60,A01,086431,Staff,23,0,25,2
1653297220373,HDS 111,A00,086432,Staff,73,0,80,7
1653297220897,HDS 121,A01,086434,Deak; Gedeon O.,11,0,15,4
1653297220897,HDS 121,A02,086435,Deak; Gedeon O.,13,0,15,2
1653297221424,HDS 150,A00,086436,Staff,25,0,25,0
1653297221424,HDS 150,B00,086437,Staff,25,0,25,0
1653297221947,HDS 173,A00,086439,Staff,27,0,30,3
1653297222470,HDS 181,A01,086441,Staff,30,0,30,0
1653297222995,HDS 191,A01,086443,Staff,25,0,25,0
1653297223522,HIEA 129,A00,088057,Schneewind; Sarah,0,0,0,0
1653297224046,HIEA 137,A00,088058,Lu; Weijing,53,0,55,2
1653297224578,HIEA 144,A00,088059,Henry; Todd A.,44,0,45,1
1653297225102,HIEA 171,A00,088060,Lu; Weijing,15,0,15,0
1653297225627,HIEU 102,A00,088061,Watts; Edward J.,0,0,0,0
1653297226159,HIEU 107,A00,088062,Caciola; Nancy A,0,0,0,0
1653297226682,HIEU 108,A00,088063,Balberg; Mira,53,0,60,7
1653297227206,HIEU 128,A00,088064,Neuheiser; Joerg,0,0,0,0
1653297227732,HIEU 144,A00,094327,Staff,48,0,50,2
1653297228257,HIEU 149,A00,088065,Devereux; Andrew W,38,0,45,7
1653297228786,HIEU 154,A00,088066,Biess; Frank Peter,58,0,65,7
1653297229311,HIGL 114,A00,088067,Edington; Claire Ellen,53,0,55,2
1653297229838,HILA 119,A00,088068,Vitz; Matthew,49,0,51,2
1653297230364,HILA 122,A00,088069,Widener; Daniel,61,0,65,4
1653297230892,HILD 2A,A01,088024,Hanna; Mark G.,28,0,28,0
1653297230892,HILD 2A,A02,088025,Hanna; Mark G.,25,0,25,0
1653297230892,HILD 2A,A03,088026,Hanna; Mark G.,27,0,28,1
1653297230892,HILD 2A,A04,088027,Hanna; Mark G.,28,0,28,0
1653297230892,HILD 2A,A05,088028,Hanna; Mark G.,28,0,28,0
1653297230892,HILD 2A,A06,088029,Hanna; Mark G.,28,0,28,0
1653297231416,HILD 7A,A01,088031,Graham; Jessica Lynn,28,0,28,0
1653297231416,HILD 7A,A02,088032,Graham; Jessica Lynn,27,0,28,1
1653297231416,HILD 7A,A03,088033,Graham; Jessica Lynn,27,0,28,1
1653297231416,HILD 7A,A04,088034,Graham; Jessica Lynn,26,0,28,2
1653297231416,HILD 7A,A05,088035,Graham; Jessica Lynn,26,0,28,2
1653297231416,HILD 7A,A06,088037,Graham; Jessica Lynn,22,0,28,6
1653297231416,HILD 7A,A07,088038,Graham; Jessica Lynn,28,0,28,0
1653297231416,HILD 7A,A08,088039,Graham; Jessica Lynn,28,0,28,0
1653297231416,HILD 7A,A09,088040,Graham; Jessica Lynn,27,0,28,1
1653297231416,HILD 7A,A10,088041,Graham; Jessica Lynn,28,0,28,0
1653297231416,HILD 7A,A11,088042,Graham; Jessica Lynn,28,0,28,0
1653297231416,HILD 7A,A12,088043,Graham; Jessica Lynn,28,0,28,0
1653297231940,HILD 10,A01,088045,Muscolino; Micah S,27,0,28,1
1653297231940,HILD 10,A02,088046,Muscolino; Micah S,27,0,28,1
1653297231940,HILD 10,A03,088047,Muscolino; Micah S,28,0,28,0
1653297231940,HILD 10,A04,088048,Muscolino; Micah S,27,0,28,1
1653297231940,HILD 10,A05,088049,Muscolino; Micah S,28,0,28,0
1653297231940,HILD 10,A06,088050,Muscolino; Micah S,27,0,28,1
1653297232467,HILD 30,A01,088052,Edington; Claire Ellen,24,0,28,4
1653297232467,HILD 30,A02,088053,Edington; Claire Ellen,28,0,28,0
1653297232994,HILD 41,A01,088055,Devereux; Andrew W,28,0,28,0
1653297232994,HILD 41,A02,088056,Devereux; Andrew W,28,0,28,0
1653297233526,HINE 116,A00,088070,Kayali; Hasan,47,0,50,3
1653297234047,HINE 144,A00,088071,Provence; Michael,40,0,45,5
1653297234576,HISC 106,A00,088072,Pineda De Avila; Nydia,47,0,50,3
1653297235104,HISC 115,A00,088073,Gere; Catherina M.,103,0,110,7
1653297235633,HITO 87,A00,094352,Patterson; Patrick H.,20,0,20,0
1653297235633,HITO 87,C00,094354,Patterson; Patrick H.,20,0,20,0
1653297235633,HITO 87,B00,094353,Hanna; Mark G.,20,0,20,0
1653297236159,HITO 100,A00,088074,Hanna; Mark G.,8,0,12,4
1653297236686,HITO 193,A00,091603,Hill; Seth J,9999,0,9999,0
1653297237209,HITO 196,A00,088075,Hendrickson; Gerald M.,20,0,20,0
1653297237737,HIUS 108B,A00,088076,Klann; Mary Cameron,48,0,51,3
1653297238268,HIUS 112,A00,088077,Plant; Rebecca Jo,144,0,148,4
1653297238799,HIUS 152A,A00,088078,Vandevelde; Kenneth Joseph,40,0,45,5
1653297239328,HIUS 155,A00,088079,Alvarez; Luis A,37,0,45,8
1653297239855,HIUS 183,A00,088080,Graham; Jessica Lynn,19,0,20,1
1653297240417,HUM 3,A01,087224,West; Geoffrey Scott,27,0,28,1
1653297240417,HUM 3,A02,087225,West; Geoffrey Scott,28,0,28,0
1653297240417,HUM 3,A03,087226,West; Geoffrey Scott,26,0,28,2
1653297240417,HUM 3,A04,087227,West; Geoffrey Scott,27,0,28,1
1653297240417,HUM 3,A05,087228,West; Geoffrey Scott,27,0,28,1
1653297240417,HUM 3,A06,087229,West; Geoffrey Scott,24,0,28,4
1653297240417,HUM 3,A07,087230,West; Geoffrey Scott,27,0,28,1
1653297240417,HUM 3,A08,087231,West; Geoffrey Scott,28,0,28,0
1653297240417,HUM 3,B01,087233,Staff,28,0,28,0
1653297240417,HUM 3,B02,087234,Staff,28,0,28,0
1653297240417,HUM 3,B03,087235,Staff,28,0,28,0
1653297240417,HUM 3,B04,087236,Staff,28,0,28,0
1653297240417,HUM 3,B05,087237,Staff,28,0,28,0
1653297240417,HUM 3,B06,087238,Staff,28,0,28,0
1653297240417,HUM 3,B07,087239,Staff,0,0,0,0
1653297240417,HUM 3,B08,087240,Staff,0,0,0,0
1653297240417,HUM 3,B09,087241,Staff,30,0,30,0
1653297240417,HUM 3,B10,087242,Staff,28,0,30,2
1653297240417,HUM 3,C01,087244,Patterson; Patrick H.,0,0,0,0
1653297240417,HUM 3,C02,087245,Patterson; Patrick H.,0,0,0,0
1653297240417,HUM 3,C03,087246,Patterson; Patrick H.,23,0,28,5
1653297240417,HUM 3,C04,087247,Patterson; Patrick H.,28,0,28,0
1653297240417,HUM 3,C05,087248,Patterson; Patrick H.,27,0,28,1
1653297240417,HUM 3,C06,087249,Patterson; Patrick H.,25,0,28,3
1653297240417,HUM 3,C07,087250,Patterson; Patrick H.,27,0,28,1
1653297240417,HUM 3,C08,087251,Patterson; Patrick H.,28,0,28,0
1653297240417,HUM 3,C09,087252,Patterson; Patrick H.,28,0,28,0
1653297240417,HUM 3,C10,087253,Patterson; Patrick H.,27,0,28,1
1653297240417,HUM 3,D01,087255,Lyon; Antony J.,24,0,28,4
1653297240417,HUM 3,D02,087256,Lyon; Antony J.,28,0,28,0
1653297240417,HUM 3,D03,087257,Lyon; Antony J.,0,0,0,0
1653297240417,HUM 3,D04,087258,Lyon; Antony J.,0,0,0,0
1653297240417,HUM 3,D05,087259,Lyon; Antony J.,27,0,28,1
1653297240417,HUM 3,D06,087260,Lyon; Antony J.,28,0,28,0
1653297240417,HUM 3,D07,087261,Lyon; Antony J.,21,0,28,7
1653297240417,HUM 3,D08,087262,Lyon; Antony J.,20,0,28,8
1653297240417,HUM 3,D09,087263,Lyon; Antony J.,28,0,28,0
1653297240417,HUM 3,D10,087264,Lyon; Antony J.,27,0,28,1
1653297240417,HUM 3,D11,087265,Lyon; Antony J.,30,0,30,0
1653297240417,HUM 3,D12,087266,Lyon; Antony J.,30,0,30,0
1653297240417,HUM 3,D13,087267,Lyon; Antony J.,26,0,28,2
1653297240417,HUM 3,D14,087268,Lyon; Antony J.,25,0,28,3
1653297240941,INTL 101,A01,088176,Day; Joel Keith,19,0,20,1
1653297240941,INTL 101,A02,088177,Day; Joel Keith,20,0,20,0
1653297240941,INTL 101,A03,088178,Day; Joel Keith,17,0,20,3
1653297240941,INTL 101,A04,088179,Day; Joel Keith,19,0,20,1
1653297240941,INTL 101,A05,088180,Day; Joel Keith,19,0,20,1
1653297240941,INTL 101,A06,088181,Day; Joel Keith,18,0,20,2
1653297241466,INTL 102,A01,088183,Walter; Barbara Florence,19,0,20,1
1653297241466,INTL 102,A02,088184,Walter; Barbara Florence,19,0,20,1
1653297241466,INTL 102,A03,088185,Walter; Barbara Florence,18,0,20,2
1653297241466,INTL 102,A04,088186,Walter; Barbara Florence,16,0,20,4
1653297241466,INTL 102,A05,088187,Walter; Barbara Florence,19,0,20,1
1653297241466,INTL 102,A06,088188,Walter; Barbara Florence,19,0,20,1
1653297242001,INTL 190,A00,088189,Auerbach; Bradford C,0,0,0,0
1653297242001,INTL 190,B00,088190,Auerbach; Bradford C,0,0,0,0
1653297242001,INTL 190,C00,088191,Fortier; Jana,0,0,0,0
1653297242001,INTL 190,D00,088192,Kshatriya; Krista C,0,0,0,0
1653297242001,INTL 190,E00,088193,Nadkarni; Vidya,0,0,0,0
1653297242001,INTL 190,F00,088194,Scott; Jeffrey F,0,0,0,0
1653297242001,INTL 190,G00,088195,Segui; Alan S,0,0,0,0
1653297242001,INTL 190,H00,088196,Segui; Alan S,0,0,0,0
1653297242531,INTL 190H,A00,088197,Gibson; Clark C,0,0,0,0
1653297243063,JAPN 10A,A01,086851,Maruyama; Rie,15,0,15,0
1653297243063,JAPN 10A,A02,086852,Maruyama; Rie,15,0,15,0
1653297243063,JAPN 10A,B01,086854,Staff,13,0,13,0
1653297243063,JAPN 10A,B02,086855,Staff,13,0,13,0
1653297243063,JAPN 10A,C01,086857,McKee; Mayumi Mochizuki,13,0,13,0
1653297243063,JAPN 10A,C02,086858,McKee; Mayumi Mochizuki,11,0,13,2
1653297243063,JAPN 10A,D01,086860,Sato; Kyoko,13,0,13,0
1653297243063,JAPN 10A,D02,086861,Sato; Kyoko,13,0,13,0
1653297243063,JAPN 10A,E01,086863,Kamioka; Sachiko,12,0,13,1
1653297243063,JAPN 10A,E02,086864,Kamioka; Sachiko,12,0,13,1
1653297243063,JAPN 10A,F01,086866,Sato; Kyoko,13,0,13,0
1653297243063,JAPN 10A,F02,086867,Sato; Kyoko,13,0,13,0
1653297243063,JAPN 10A,G01,086869,Maruyama; Rie,8,0,13,5
1653297243063,JAPN 10A,G02,086870,Maruyama; Rie,13,0,13,0
1653297243063,JAPN 10A,H01,086872,Kamioka; Sachiko,12,0,13,1
1653297243063,JAPN 10A,H02,086873,Kamioka; Sachiko,11,0,13,2
1653297243063,JAPN 10A,I01,086875,Staff,12,0,13,1
1653297243063,JAPN 10A,I02,086876,Staff,13,0,13,0
1653297243063,JAPN 10A,J01,086878,McKee; Mayumi Mochizuki,12,0,13,1
1653297243063,JAPN 10A,J02,086879,McKee; Mayumi Mochizuki,13,0,13,0
1653297243063,JAPN 10A,K01,086881,Inada; Minori,13,0,13,0
1653297243063,JAPN 10A,K02,086882,Inada; Minori,12,0,13,1
1653297243063,JAPN 10A,L01,086884,Tipton; Yuko,13,0,13,0
1653297243063,JAPN 10A,L02,086885,Tipton; Yuko,13,0,13,0
1653297243063,JAPN 10A,M01,086887,Inada; Minori,12,0,13,1
1653297243063,JAPN 10A,M02,086888,Inada; Minori,13,0,13,0
1653297243063,JAPN 10A,N01,086890,McKee; Mayumi Mochizuki,13,0,13,0
1653297243063,JAPN 10A,N02,086891,McKee; Mayumi Mochizuki,11,0,13,2
1653297243063,JAPN 10A,O01,086893,Staff,13,0,13,0
1653297243063,JAPN 10A,O02,086894,Staff,12,0,13,1
1653297243063,JAPN 10A,P01,086896,Tipton; Yuko,15,0,15,0
1653297243063,JAPN 10A,P02,086897,Tipton; Yuko,15,0,15,0
1653297243605,JAPN 20A,A01,086899,Simpson; Junko Tokuda,11,0,13,2
1653297243605,JAPN 20A,A02,086900,Simpson; Junko Tokuda,12,0,13,1
1653297243605,JAPN 20A,B01,086902,Takeda; Izumi,11,0,13,2
1653297243605,JAPN 20A,B02,086903,Takeda; Izumi,12,0,13,1
1653297243605,JAPN 20A,C01,086905,Ross; Kayoko F,12,0,13,1
1653297243605,JAPN 20A,C02,086906,Ross; Kayoko F,12,0,13,1
1653297243605,JAPN 20A,D01,086908,Takeda; Izumi,10,0,13,3
1653297243605,JAPN 20A,D02,086909,Takeda; Izumi,13,0,13,0
1653297243605,JAPN 20A,E01,086911,Maruyama; Rie,11,0,13,2
1653297243605,JAPN 20A,E02,086912,Maruyama; Rie,11,0,13,2
1653297243605,JAPN 20A,F01,086914,Kamioka; Sachiko,7,0,13,6
1653297243605,JAPN 20A,F02,086915,Kamioka; Sachiko,9,0,13,4
1653297243605,JAPN 20A,G01,086917,Ross; Kayoko F,13,0,13,0
1653297243605,JAPN 20A,G02,086918,Ross; Kayoko F,12,0,13,1
1653297244135,JAPN 130A,A01,086920,Simpson; Junko Tokuda,6,0,10,4
1653297244135,JAPN 130A,A02,086921,Simpson; Junko Tokuda,5,0,10,5
1653297244135,JAPN 130A,B01,086923,Ross; Kayoko F,9,0,10,1
1653297244135,JAPN 130A,B02,086924,Ross; Kayoko F,9,0,10,1
1653297244661,JAPN 135A,A00,086925,Inada; Minori,14,0,15,1
1653297244661,JAPN 135A,B00,086926,Takeda; Izumi,15,0,15,0
1653297245188,JAPN 140A,A00,086927,Sato; Kyoko,19,0,20,1
1653297245718,JWSP 1,A01,086445,Shuster; Alana,15,0,15,0
1653297245718,JWSP 1,A02,086446,Shuster; Alana,15,0,15,0
1653297246241,JWSP 104,A01,086448,Shuster; Alana,15,0,15,0
1653297246789,LATI 10,A01,093588,Kennemore; Amy Michelle,31,0,32,1
1653297246789,LATI 10,A02,093589,Kennemore; Amy Michelle,32,0,32,0
1653297246789,LATI 10,A03,093590,Kennemore; Amy Michelle,32,0,32,0
1653297247318,LATI 50,A01,093592,Kokinis; Troy Andreas,32,0,32,0
1653297247318,LATI 50,A02,093593,Kokinis; Troy Andreas,31,0,32,1
1653297247318,LATI 50,A03,093595,Kokinis; Troy Andreas,32,0,32,0
1653297247847,LATI 122A,A00,093649,Andrews; Abigail Leslie,0,0,0,0
1653297248374,LATI 180,A00,093597,Staff,36,0,40,4
1653297248906,LIAB 1A,A00,087085,Saab; Dima,13,0,14,1
1653297248906,LIAB 1A,B00,087086,Saab; Dima,13,0,14,1
1653297248906,LIAB 1A,C00,087087,Saab; Dima,14,0,14,0
1653297248906,LIAB 1A,D00,087088,El Cheddadi; Youniss,14,0,14,0
1653297249433,LIAB 1AX,A00,087089,Akjeje; Abdelhak,28,0,28,0
1653297249433,LIAB 1AX,B00,087091,Akjeje; Abdelhak,28,0,28,0
1653297249958,LIAB 1D,A00,087093,El Cheddadi; Youniss,13,0,14,1
1653297249958,LIAB 1D,B00,087094,El Cheddadi; Youniss,12,0,14,2
1653297250483,LIAB 1DX,A00,087095,Akjeje; Abdelhak,27,0,28,1
1653297251009,LIDS 19,001,095098,Goodall; Grant Todd,9999,0,9999,0
1653297251009,LIDS 19,002,095099,Goodall; Grant Todd,9999,0,9999,0
1653297251009,LIDS 19,003,095100,Goodall; Grant Todd,9999,0,9999,0
1653297251009,LIDS 19,004,095101,Goodall; Grant Todd,9999,0,9999,0
1653297251009,LIDS 19,005,095102,Goodall; Grant Todd,9999,0,9999,0
1653297251009,LIDS 19,006,095103,Goodall; Grant Todd,9999,0,9999,0
1653297251009,LIDS 19,007,095104,Goodall; Grant Todd,9999,0,9999,0
1653297251009,LIDS 19,008,095105,Goodall; Grant Todd,9999,0,9999,0
1653297251009,LIDS 19,009,095106,Goodall; Grant Todd,9999,0,9999,0
1653297251009,LIDS 19,010,095107,Goodall; Grant Todd,9999,0,9999,0
1653297251009,LIDS 19,011,095108,Goodall; Grant Todd,9999,0,9999,0
1653297251009,LIDS 19,012,095109,Goodall; Grant Todd,9999,0,9999,0
1653297251533,LIFR 1A,A00,087097,Goodall; Grant Todd,13,0,14,1
1653297251533,LIFR 1A,B00,087098,Goodall; Grant Todd,13,0,14,1
1653297251533,LIFR 1A,C00,087099,Goodall; Grant Todd,12,0,14,2
1653297251533,LIFR 1A,D00,087100,Goodall; Grant Todd,12,0,14,2
1653297251533,LIFR 1A,E00,087101,Goodall; Grant Todd,14,0,14,0
1653297251533,LIFR 1A,F00,087102,Goodall; Grant Todd,13,0,14,1
1653297252065,LIFR 1AX,A00,087103,Goodall; Grant Todd,27,0,28,1
1653297252065,LIFR 1AX,B00,087104,Goodall; Grant Todd,27,0,28,1
1653297252065,LIFR 1AX,C00,087105,Goodall; Grant Todd,25,0,28,3
1653297252601,LIFR 1B,A00,087106,Goodall; Grant Todd,14,0,14,0
1653297252601,LIFR 1B,B00,087107,Goodall; Grant Todd,13,0,14,1
1653297252601,LIFR 1B,C00,087108,Goodall; Grant Todd,13,0,14,1
1653297252601,LIFR 1B,D00,087109,Goodall; Grant Todd,13,0,14,1
1653297253130,LIFR 1BX,A00,087110,Goodall; Grant Todd,26,0,28,2
1653297253130,LIFR 1BX,B00,087111,Goodall; Grant Todd,26,0,28,2
1653297253654,LIFR 1D,A00,087112,Goodall; Grant Todd,14,0,14,0
1653297253654,LIFR 1D,B00,087113,Goodall; Grant Todd,12,0,14,2
1653297253654,LIFR 1D,C00,087114,Goodall; Grant Todd,11,0,14,3
1653297253654,LIFR 1D,D00,087115,Goodall; Grant Todd,10,0,14,4
1653297254179,LIFR 1DX,A00,087116,Goodall; Grant Todd,26,0,28,2
1653297254179,LIFR 1DX,B00,087117,Goodall; Grant Todd,23,0,28,5
1653297254702,LIFR 11,A00,087118,Goodall; Grant Todd,10,0,10,0
1653297255233,LIGM 1A,A00,087119,Riebeling; Elke,14,0,14,0
1653297255233,LIGM 1A,B00,087120,Riebeling; Elke,14,0,14,0
1653297255233,LIGM 1A,C00,087121,Riebeling; Elke,12,0,14,2
1653297255233,LIGM 1A,D00,087122,Riebeling; Elke,14,0,14,0
1653297255233,LIGM 1A,E00,087123,Riebeling; Elke,14,0,14,0
1653297255756,LIGM 1AX,A00,087124,Riebeling; Elke,28,0,28,0
1653297255756,LIGM 1AX,B00,087125,Riebeling; Elke,28,0,28,0
1653297255756,LIGM 1AX,C00,087126,Riebeling; Elke,27,0,28,1
1653297256285,LIGM 1D,A00,087127,Riebeling; Elke,14,0,14,0
1653297256285,LIGM 1D,B00,087128,Riebeling; Elke,12,0,14,2
1653297256811,LIGM 1DX,A00,087129,Riebeling; Elke,26,0,28,2
1653297257337,LIGM 11,A00,087130,Goodall; Grant Todd,10,0,10,0
1653297257861,LIGN 5,A00,087005,Goodall; Grant Todd,74,0,75,1
1653297258385,LIGN 7,A00,087006,Mayberry; Rachel,139,0,146,7
1653297258910,LIGN 8,A00,087007,McIntosh; Justin Daniel,244,0,250,6
1653297259434,LIGN 17,A00,087008,Kehler; Andrew Scott,218,0,220,2
1653297259958,LIGN 101,A01,087010,Styler; William Francis,29,0,30,1
1653297259958,LIGN 101,A02,087011,Styler; William Francis,29,0,30,1
1653297259958,LIGN 101,A03,087012,Styler; William Francis,29,0,30,1
1653297259958,LIGN 101,A04,087013,Styler; William Francis,29,0,30,1
1653297260482,LIGN 110,A01,087015,Garellek; Marc,29,0,30,1
1653297260482,LIGN 110,A02,087016,Garellek; Marc,26,0,30,4
1653297260482,LIGN 110,A03,087017,Garellek; Marc,26,0,30,4
1653297260482,LIGN 110,A04,087018,Garellek; Marc,28,0,30,2
1653297261007,LIGN 121,A01,087020,Drake; Emily C,23,0,25,2
1653297261007,LIGN 121,A02,087021,Drake; Emily C,24,0,25,1
1653297261532,LIGN 150,A00,093702,Staff,71,0,75,4
1653297262057,LIGN 152,A00,087023,Caballero; Gabriela Hernandez,16,0,20,4
1653297262586,LIGN 154,A00,087024,Kluender; Robert,70,0,70,0
1653297263111,LIGN 167,A00,087025,Bergen; Leon,70,0,100,30
1653297263633,LIGN 187,A00,087026,McIntosh; Justin Daniel,20,0,20,0
1653297264159,LIHL 112F,A00,086505,Alicio; Atilio,25,0,28,3
1653297264685,LIHL 114F,A00,086506,Staff,21,0,28,7
1653297265210,LIHL 117F,A00,086508,Sadegholvad; Elham,20,0,20,0
1653297265733,LIHL 118,A00,086509,Staff,25,0,28,3
1653297266256,LIHL 119F,A00,086510,Staff,26,0,28,2
1653297266779,LIHL 124F,A00,086511,Staff,27,0,28,1
1653297267303,LIHL 132F,A00,086512,Alicio; Atilio,28,0,28,0
1653297267827,LIIT 1A,A00,087131,Riebeling; Elke,14,0,14,0
1653297267827,LIIT 1A,B00,087132,Riebeling; Elke,14,0,14,0
1653297267827,LIIT 1A,C00,087133,Riebeling; Elke,12,0,14,2
1653297267827,LIIT 1A,D00,087134,Riebeling; Elke,14,0,14,0
1653297268350,LIIT 1AX,A00,087135,Riebeling; Elke,28,0,28,0
1653297268350,LIIT 1AX,B00,087136,Riebeling; Elke,26,0,28,2
1653297268878,LIPO 1A,A00,087137,Paladini; Denise,14,0,14,0
1653297268878,LIPO 1A,B00,087138,Paladini; Denise,10,0,14,4
1653297269402,LIPO 1AX,A00,087139,De Abreu; Cassia,18,0,22,4
1653297269402,LIPO 1AX,B00,087140,De Abreu; Cassia,22,0,22,0
1653297269928,LIPO 1D,A00,087141,Paladini; Denise,10,0,14,4
1653297270456,LIPO 1DX,A00,087143,De Abreu; Cassia,10,0,14,4
1653297270987,LISL 1A,A00,087145,Lott; Margaret S.,10,0,14,4
1653297270987,LISL 1A,B00,087146,Lott; Margaret S.,14,0,14,0
1653297270987,LISL 1A,C00,087147,Lott; Margaret S.,10,0,14,4
1653297270987,LISL 1A,D00,087148,Lott; Margaret S.,11,0,14,3
1653297270987,LISL 1A,E00,087149,Lott; Margaret S.,13,0,14,1
1653297270987,LISL 1A,F00,087150,Lott; Margaret S.,12,0,14,2
1653297270987,LISL 1A,G00,087151,Lott; Margaret S.,13,0,14,1
1653297270987,LISL 1A,H00,087152,Lott; Margaret S.,13,0,14,1
1653297271511,LISL 1AX,A00,087153,Lott; Margaret S.,28,0,28,0
1653297271511,LISL 1AX,B00,087154,Lott; Margaret S.,25,0,28,3
1653297271511,LISL 1AX,C00,087155,Lott; Margaret S.,25,0,28,3
1653297271511,LISL 1AX,D00,087156,Lott; Margaret S.,24,0,28,4
1653297272046,LISL 1B,A00,087157,Lott; Margaret S.,13,0,14,1
1653297272046,LISL 1B,B00,087158,Lott; Margaret S.,12,0,14,2
1653297272046,LISL 1B,C00,087159,Lott; Margaret S.,11,0,14,3
1653297272046,LISL 1B,D00,087160,Lott; Margaret S.,13,0,14,1
1653297272046,LISL 1B,E00,087161,Lott; Margaret S.,13,0,14,1
1653297272046,LISL 1B,F00,087162,Lott; Margaret S.,13,0,14,1
1653297272660,LISL 1BX,A00,087163,Lott; Margaret S.,23,0,28,5
1653297272660,LISL 1BX,B00,087164,Lott; Margaret S.,26,0,28,2
1653297272660,LISL 1BX,C00,087165,Lott; Margaret S.,28,0,28,0
1653297273184,LISL 1D,A00,087166,Lott; Margaret S.,14,0,14,0
1653297273184,LISL 1D,B00,087167,Lott; Margaret S.,14,0,14,0
1653297273184,LISL 1D,C00,087168,Lott; Margaret S.,8,0,14,6
1653297273184,LISL 1D,D00,087169,Lott; Margaret S.,13,0,14,1
1653297273707,LISL 1DX,A00,087170,Lott; Margaret S.,23,0,28,5
1653297273707,LISL 1DX,B00,087171,Lott; Margaret S.,26,0,28,2
1653297274233,LISP 1A,001,087172,Munoz Sanchez; Alicia,13,0,14,1
1653297274233,LISP 1A,002,087173,Munoz Sanchez; Alicia,12,0,14,2
1653297274233,LISP 1A,003,087174,Munoz Sanchez; Alicia,13,0,14,1
1653297274233,LISP 1A,004,087175,Munoz Sanchez; Alicia,12,0,14,2
1653297274233,LISP 1A,005,087176,Munoz Sanchez; Alicia,10,0,14,4
1653297274233,LISP 1A,006,087177,Munoz Sanchez; Alicia,12,0,14,2
1653297274233,LISP 1A,007,087178,Munoz Sanchez; Alicia,12,0,14,2
1653297274233,LISP 1A,008,087179,Munoz Sanchez; Alicia,14,0,14,0
1653297274756,LISP 1AX,A00,087180,Munoz Sanchez; Alicia,27,0,28,1
1653297274756,LISP 1AX,B00,087181,Munoz Sanchez; Alicia,24,0,28,4
1653297274756,LISP 1AX,C00,087182,Munoz Sanchez; Alicia,25,0,28,3
1653297274756,LISP 1AX,D00,087183,Munoz Sanchez; Alicia,25,0,28,3
1653297275290,LISP 1B,001,087184,Munoz Sanchez; Alicia,14,0,14,0
1653297275290,LISP 1B,002,087185,Munoz Sanchez; Alicia,14,0,14,0
1653297275290,LISP 1B,003,087186,Munoz Sanchez; Alicia,11,0,14,3
1653297275290,LISP 1B,004,087187,Munoz Sanchez; Alicia,12,0,14,2
1653297275290,LISP 1B,005,087188,Munoz Sanchez; Alicia,13,0,14,1
1653297275290,LISP 1B,006,087189,Munoz Sanchez; Alicia,13,0,14,1
1653297275290,LISP 1B,007,087190,Munoz Sanchez; Alicia,14,0,14,0
1653297275290,LISP 1B,008,087191,Munoz Sanchez; Alicia,13,0,14,1
1653297275290,LISP 1B,009,087192,Munoz Sanchez; Alicia,14,0,14,0
1653297275290,LISP 1B,010,087193,Munoz Sanchez; Alicia,13,0,14,1
1653297275290,LISP 1B,011,087194,Munoz Sanchez; Alicia,14,0,14,0
1653297275813,LISP 1BX,A00,087195,Munoz Sanchez; Alicia,28,0,28,0
1653297275813,LISP 1BX,B00,087196,Munoz Sanchez; Alicia,26,0,28,2
1653297275813,LISP 1BX,C00,087197,Munoz Sanchez; Alicia,26,0,28,2
1653297275813,LISP 1BX,D00,087198,Munoz Sanchez; Alicia,26,0,28,2
1653297275813,LISP 1BX,E00,087199,Munoz Sanchez; Alicia,28,0,28,0
1653297276338,LISP 1D,001,087200,Munoz Sanchez; Alicia,13,0,14,1
1653297276338,LISP 1D,002,087201,Munoz Sanchez; Alicia,14,0,14,0
1653297276338,LISP 1D,003,087202,Munoz Sanchez; Alicia,8,0,14,6
1653297276338,LISP 1D,004,087203,Munoz Sanchez; Alicia,5,0,14,9
1653297276338,LISP 1D,005,087204,Munoz Sanchez; Alicia,11,0,14,3
1653297276338,LISP 1D,006,087205,Munoz Sanchez; Alicia,13,0,14,1
1653297276338,LISP 1D,007,087206,Munoz Sanchez; Alicia,13,0,14,1
1653297276338,LISP 1D,008,087207,Munoz Sanchez; Alicia,13,0,14,1
1653297276338,LISP 1D,009,087208,Munoz Sanchez; Alicia,14,0,14,0
1653297276338,LISP 1D,010,087209,Munoz Sanchez; Alicia,12,0,14,2
1653297276338,LISP 1D,011,087210,Munoz Sanchez; Alicia,13,0,14,1
1653297276338,LISP 1D,012,087211,Munoz Sanchez; Alicia,14,0,14,0
1653297276338,LISP 1D,013,087212,Munoz Sanchez; Alicia,14,0,14,0
1653297276338,LISP 1D,014,087213,Munoz Sanchez; Alicia,14,0,14,0
1653297276861,LISP 1DX,A00,087214,Munoz Sanchez; Alicia,27,0,28,1
1653297276861,LISP 1DX,B00,087215,Munoz Sanchez; Alicia,23,0,28,5
1653297276861,LISP 1DX,C00,087216,Munoz Sanchez; Alicia,23,0,28,5
1653297276861,LISP 1DX,D00,087217,Munoz Sanchez; Alicia,25,0,28,3
1653297276861,LISP 1DX,E00,087218,Munoz Sanchez; Alicia,27,0,28,1
1653297276861,LISP 1DX,F00,087219,Munoz Sanchez; Alicia,25,0,28,3
1653297276861,LISP 1DX,G00,087220,Munoz Sanchez; Alicia,28,0,28,0
1653297277388,LISP 15,A00,087221,Munoz Sanchez; Alicia,19,0,20,1
1653297277914,LISP 18,A00,087222,Munoz Sanchez; Alicia,15,0,20,5
1653297278442,LTAM 110,A00,087352,Chacon; Gloria Elizabeth,35,0,40,5
1653297278973,LTCS 87,A00,094011,Nguyen; Hoang Tan,19,0,20,1
1653297279496,LTCS 111,A00,087353,Vitkus; Daniel J.,40,0,40,0
1653297280020,LTCS 119,A00,087354,Nguyen; Hoang Tan,29,0,30,1
1653297280548,LTCS 130,A00,087355,Kim; Joo Ok,37,0,40,3
1653297281073,LTCS 165,A00,087356,Kim; Joo Ok,38,0,40,2
1653297281597,LTEA 120A,A00,087357,Fiss; Geraldine Anna,291,0,300,9
1653297282125,LTEA 140,A00,094009,Lee; Jin-Kyung,28,0,32,4
1653297282652,LTEA 142,A00,087358,Lee; Jin-Kyung,103,0,120,17
1653297283178,LTEN 21,A01,087275,Lampert-Weissig; Lisa,25,0,25,0
1653297283178,LTEN 21,A02,087276,Lampert-Weissig; Lisa,25,0,25,0
1653297283178,LTEN 21,A03,087277,Lampert-Weissig; Lisa,25,0,25,0
1653297283178,LTEN 21,A04,087278,Lampert-Weissig; Lisa,25,0,25,0
1653297283707,LTEN 25,A01,087280,Johnson; Sara E.,25,0,25,0
1653297283707,LTEN 25,A02,087281,Johnson; Sara E.,25,0,25,0
1653297283707,LTEN 25,A03,087282,Johnson; Sara E.,23,0,25,2
1653297283707,LTEN 25,A04,087283,Johnson; Sara E.,25,0,25,0
1653297284231,LTEN 29,A01,087285,Ruiz; Ariana,24,0,25,1
1653297284231,LTEN 29,A02,087286,Ruiz; Ariana,25,0,25,0
1653297284231,LTEN 29,A03,087287,Ruiz; Ariana,24,0,25,1
1653297284231,LTEN 29,A04,087288,Ruiz; Ariana,24,0,25,1
1653297284763,LTEN 107,A00,087359,Lampert-Weissig; Lisa,39,0,40,1
1653297285286,LTEN 117,A00,087360,Vitkus; Daniel J.,40,0,40,0
1653297285830,LTEN 127,A00,087361,Loose; Margaret,38,0,40,2
1653297286354,LTEN 142,A00,094010,Loose; Margaret,38,0,40,2
1653297286879,LTEN 148,A00,087363,Walkiewicz; Kathryn A,40,0,40,0
1653297287408,LTEN 152,A00,087364,Walkiewicz; Kathryn A,37,0,40,3
1653297287937,LTEN 180,A00,087365,Ruiz; Ariana,18,0,20,2
1653297288464,LTFR 2A,A01,087290,Ploye; Catherine,23,0,25,2
1653297288989,LTFR 2B,A01,087292,Ploye; Catherine,25,0,25,0
1653297289516,LTFR 104,A00,087366,Ploye; Catherine,25,0,25,0
1653297290041,LTFR 116,A00,087367,Zhiri; Oumelbanine,13,0,15,2
1653297290574,LTGK 1,A00,087293,Myerston Santana; Jacobo,27,0,30,3
1653297291099,LTGK 103,A00,087368,duBois; Page Ann,14,0,15,1
1653297291625,LTGM 2A,A01,087295,Fischer-Grunski; Eva K,24,0,25,1
1653297292154,LTIT 2A,A01,087297,De Marchi Gherini; Adriana,24,0,25,1
1653297292689,LTKO 1A,A01,087299,Staff,24,0,25,1
1653297292689,LTKO 1A,B01,087301,Staff,25,0,25,0
1653297292689,LTKO 1A,C01,087303,Staff,25,0,25,0
1653297292689,LTKO 1A,D01,087305,Staff,25,0,25,0
1653297292689,LTKO 1A,E01,087307,Staff,24,0,25,1
1653297292689,LTKO 1A,F01,087309,Staff,25,0,25,0
1653297292689,LTKO 1A,G01,087311,Staff,25,0,25,0
1653297292689,LTKO 1A,H01,087313,Staff,24,0,25,1
1653297292689,LTKO 1A,I01,087315,Staff,25,0,25,0
1653297293219,LTKO 2A,A01,087317,Staff,24,0,25,1
1653297293219,LTKO 2A,B01,087319,Staff,22,0,25,3
1653297293219,LTKO 2A,C01,087321,Lee; Jeyseon,24,0,25,1
1653297293746,LTKO 130,A00,087369,Lee; Jeyseon,25,0,25,0
1653297294275,LTLA 1,A00,087322,Murray; Kourtney Kristine,38,0,40,2
1653297294801,LTLA 100,A00,087371,Kelting; Edward William,23,0,25,2
1653297295325,LTRU 1A,A01,087324,Wells; Patricia Rebecca,23,0,25,2
1653297295850,LTRU 2A,A01,087326,Wells; Patricia Rebecca,20,0,20,0
1653297296377,LTRU 104B,A01,087373,Wells; Patricia Rebecca,14,0,15,1
1653297296904,LTSP 2A,A01,087328,Staff,25,0,25,0
1653297296904,LTSP 2A,B01,087330,Staff,22,0,25,3
1653297296904,LTSP 2A,C01,087332,Staff,22,0,25,3
1653297297432,LTSP 2B,A01,087334,Staff,22,0,25,3
1653297297432,LTSP 2B,B01,087336,Staff,19,0,25,6
1653297297971,LTSP 2D,A00,087337,Staff,25,0,25,0
1653297297971,LTSP 2D,B00,087338,Staff,25,0,25,0
1653297297971,LTSP 2D,C00,087339,Staff,25,0,25,0
1653297298499,LTSP 100A,A00,087374,Arcos Herrera; Carol,23,0,25,2
1653297299023,LTSP 116,A00,087375,Blanco; John D,29,0,30,1
1653297299547,LTSP 140,A00,087376,Chacon; Gloria Elizabeth,30,0,30,0
1653297300075,LTSP 175,A00,087377,Arcos Herrera; Carol,30,0,30,0
1653297300605,LTTH 150,A00,087379,Cohen; Alain J. J.,40,0,40,0
1653297301130,LTWL 19A,A00,087340,Myerston Santana; Jacobo,39,0,40,1
1653297301658,LTWL 87,A00,094012,Lampert-Weissig; Lisa,20,0,20,0
1653297302181,LTWL 116,A00,087380,Nguyen; Hoang Tan,60,0,60,0
1653297302710,LTWL 120,A00,087381,Fiss; Geraldine Anna,37,0,40,3
1653297303232,LTWL 172,A00,087382,De Marchi Gherini; Adriana,40,0,40,0
1653297303759,LTWL 180,A00,087383,Kontje; Todd Curtis,39,0,40,1
1653297304282,LTWL 194,A00,087384,Suzuki; Erin M.,31,0,32,1
1653297304813,LTWR 8A,A01,087342,Jemc; Jaclyn,24,0,25,1
1653297304813,LTWR 8A,A02,087343,Jemc; Jaclyn,25,0,25,0
1653297304813,LTWR 8A,A03,087344,Jemc; Jaclyn,24,0,25,1
1653297304813,LTWR 8A,A04,087345,Jemc; Jaclyn,24,0,25,1
1653297305341,LTWR 8C,A01,087348,Forbes; Camille,25,0,25,0
1653297305341,LTWR 8C,A02,087349,Forbes; Camille,25,0,25,0
1653297305341,LTWR 8C,A03,087350,Forbes; Camille,25,0,25,0
1653297305341,LTWR 8C,A04,087351,Forbes; Camille,23,0,25,2
1653297305865,LTWR 100,A00,087385,Staff,12,0,15,3
1653297306400,LTWR 102,A00,087386,Staff,14,0,15,1
1653297306924,LTWR 115,A00,087387,Carroll; Amy Sara,24,0,30,6
1653297307450,LTWR 119,A00,087388,Staff,22,0,30,8
1653297307978,LTWR 140,A00,087389,Carroll; Amy Sara,37,0,40,3
1653297308517,LTWR 194,A00,087390,Som; Brandon D,35,0,40,5
1653297309043,MAE 2,A01,090334,Anderson; Mark Ronald,8,0,8,0
1653297309043,MAE 2,A02,090335,Anderson; Mark Ronald,8,0,8,0
1653297309043,MAE 2,A03,090336,Anderson; Mark Ronald,8,0,8,0
1653297309043,MAE 2,A04,090337,Anderson; Mark Ronald,8,0,8,0
1653297309043,MAE 2,A05,090338,Anderson; Mark Ronald,8,0,8,0
1653297309043,MAE 2,A06,090339,Anderson; Mark Ronald,8,0,8,0
1653297309043,MAE 2,A07,090340,Anderson; Mark Ronald,8,0,8,0
1653297309043,MAE 2,A08,090341,Anderson; Mark Ronald,7,0,8,1
1653297309043,MAE 2,A09,090342,Anderson; Mark Ronald,8,0,8,0
1653297309567,MAE 3,A01,090344,Delson; Nathan Joseph,21,0,22,1
1653297309567,MAE 3,A02,090345,Delson; Nathan Joseph,20,0,22,2
1653297309567,MAE 3,A03,090346,Delson; Nathan Joseph,21,0,22,1
1653297309567,MAE 3,A04,090347,Delson; Nathan Joseph,22,0,22,0
1653297309567,MAE 3,B01,090349,Qi; Huihui,18,0,22,4
1653297309567,MAE 3,B02,090350,Qi; Huihui,17,0,22,5
1653297309567,MAE 3,B03,090351,Qi; Huihui,20,0,22,2
1653297309567,MAE 3,B04,090352,Qi; Huihui,19,0,22,3
1653297310096,MAE 8,A01,090354,Pham; Hieu Tan,182,0,185,3
1653297310625,MAE 11,A00,090355,Nomura; Keiko K.,155,0,165,10
1653297311158,MAE 20,A00,090356,Bandaru; Prabhakar,160,0,160,0
1653297311158,MAE 20,B00,090357,Evdokimenko; Ekaterina,145,0,160,15
1653297311689,MAE 21,A01,090359,Cai; Shengqiang,8,0,9,1
1653297311689,MAE 21,A02,090360,Cai; Shengqiang,9,0,9,0
1653297311689,MAE 21,A03,090361,Cai; Shengqiang,6,0,9,3
1653297311689,MAE 21,A04,090362,Cai; Shengqiang,7,0,9,2
1653297311689,MAE 21,A05,090363,Cai; Shengqiang,0,0,0,0
1653297311689,MAE 21,A06,090364,Cai; Shengqiang,9,0,9,0
1653297311689,MAE 21,A07,090365,Cai; Shengqiang,9,0,9,0
1653297311689,MAE 21,A08,090366,Cai; Shengqiang,8,0,9,1
1653297311689,MAE 21,A09,090367,Cai; Shengqiang,8,0,9,1
1653297311689,MAE 21,A10,090368,Cai; Shengqiang,0,0,0,0
1653297311689,MAE 21,A11,090369,Cai; Shengqiang,9,0,9,0
1653297311689,MAE 21,A12,090370,Cai; Shengqiang,8,0,9,1
1653297312213,MAE 30A,A00,090371,Lal; Ratnesh,72,0,75,3
1653297312742,MAE 40,A00,090372,Bitmead; Robert R.,167,0,175,8
1653297313271,MAE 101A,A00,090373,Bahadori; Mohammad Yousef,105,0,115,10
1653297313798,MAE 101C,A00,090374,Poulikakos; Lisa Voula,41,0,110,69
1653297313798,MAE 101C,B00,090375,Chen; Renkun,96,0,110,14
1653297314328,MAE 104,A00,090376,Sanchez; Antonio Luis,78,0,120,42
1653297314857,MAE 105,A00,090377,Saintillan; David,154,0,170,16
1653297315390,MAE 107,A00,090378,Lindsey; Stephanie,104,0,110,6
1653297315390,MAE 107,B00,090379,Tolley; Michael Thomas,85,0,110,25
1653297315915,MAE 118,A00,090380,Krasheninnikov; Sergei,27,0,45,18
1653297316443,MAE 131A,A00,090381,Ghazinejad; Maziar,70,0,75,5
1653297316970,MAE 133,A00,090382,Frazier; Michael,26,0,33,7
1653297317495,MAE 143A,A00,090383,de Oliveira; Mauricio,74,0,100,26
1653297318022,MAE 144,A00,090384,Bewley; Thomas R,50,0,70,20
1653297318553,MAE 148,A01,091597,Staff,32,0,32,0
1653297319083,MAE 150,A00,090385,Friend; James Robert,69,0,90,21
1653297319083,MAE 150,B00,090386,Ghazinejad; Maziar,4,0,90,86
1653297319607,MAE 152,A00,090387,Tynan; George Robert,0,0,16,16
1653297319607,MAE 152,B00,090388,Tynan; George Robert,0,0,16,16
1653297319607,MAE 152,C00,090389,Tynan; George Robert,0,0,16,16
1653297319607,MAE 152,D00,090390,Tynan; George Robert,0,0,16,16
1653297320131,MAE 156A,A01,090392,Delson; Nathan Joseph,2,0,12,10
1653297320131,MAE 156A,A02,090393,Delson; Nathan Joseph,1,0,12,11
1653297320131,MAE 156A,A03,090394,Delson; Nathan Joseph,4,0,12,8
1653297320655,MAE 170,A01,090396,Lubarda; Marko,14,0,30,16
1653297320655,MAE 170,A02,090397,Lubarda; Marko,19,0,30,11
1653297320655,MAE 170,A03,090398,Lubarda; Marko,28,0,30,2
1653297320655,MAE 170,A04,090399,Lubarda; Marko,20,0,30,10
1653297320655,MAE 170,B01,090401,Diagne; Mamadou Lamine,30,0,30,0
1653297320655,MAE 170,B02,090402,Diagne; Mamadou Lamine,27,0,30,3
1653297320655,MAE 170,B03,090403,Diagne; Mamadou Lamine,28,0,30,2
1653297320655,MAE 170,B04,090404,Diagne; Mamadou Lamine,28,0,30,2
1653297321180,MAE 180A,A00,090405,McEneaney; William Michael,110,0,125,15
1653297321704,MAE 181,A00,090406,Bahadori; Mohammad Yousef,46,0,60,14
1653297322228,MAE 190,A00,090407,Anderson; Mark Ronald,27,0,45,18
1653297322757,MAE 191,A01,090409,Qi; Huihui,25,0,32,7
1653297323290,MATH 2,A01,089123,Hammock; Frances H,0,0,0,0
1653297323290,MATH 2,B01,089126,Hammock; Frances H,0,0,0,0
1653297323290,MATH 2,C01,089129,Hammock; Frances H,0,0,0,0
1653297323290,MATH 2,D01,094201,Harel; Guershon,0,0,0,0
1653297323825,MATH 3C,A01,089132,Bowers; Adam R.,0,0,0,0
1653297323825,MATH 3C,A02,089133,Bowers; Adam R.,0,0,0,0
1653297323825,MATH 3C,A03,089134,Bowers; Adam R.,0,0,0,0
1653297323825,MATH 3C,A04,089135,Bowers; Adam R.,0,0,0,0
1653297323825,MATH 3C,A05,089136,Bowers; Adam R.,0,0,0,0
1653297323825,MATH 3C,A06,089137,Bowers; Adam R.,0,0,0,0
1653297323825,MATH 3C,A07,089138,Bowers; Adam R.,0,0,0,0
1653297323825,MATH 3C,A08,089139,Bowers; Adam R.,0,0,0,0
1653297323825,MATH 3C,A09,089140,Bowers; Adam R.,0,0,0,0
1653297323825,MATH 3C,A10,089141,Bowers; Adam R.,0,0,0,0
1653297323825,MATH 3C,A11,089142,Bowers; Adam R.,0,0,0,0
1653297323825,MATH 3C,A12,089143,Bowers; Adam R.,0,0,0,0
1653297323825,MATH 3C,A13,089144,Bowers; Adam R.,0,0,0,0
1653297323825,MATH 3C,A14,089145,Bowers; Adam R.,0,0,0,0
1653297323825,MATH 3C,A15,089146,Bowers; Adam R.,0,0,0,0
1653297323825,MATH 3C,A16,089147,Bowers; Adam R.,0,0,0,0
1653297323825,MATH 3C,A17,089148,Bowers; Adam R.,0,0,0,0
1653297323825,MATH 3C,A18,089149,Bowers; Adam R.,0,0,0,0
1653297323825,MATH 3C,A19,089150,Bowers; Adam R.,0,0,0,0
1653297323825,MATH 3C,A20,089151,Bowers; Adam R.,0,0,0,0
1653297323825,MATH 3C,A21,089152,Bowers; Adam R.,0,0,0,0
1653297323825,MATH 3C,A22,089153,Bowers; Adam R.,0,0,0,0
1653297323825,MATH 3C,A23,089154,Bowers; Adam R.,0,0,0,0
1653297323825,MATH 3C,A24,089155,Bowers; Adam R.,0,0,0,0
1653297323825,MATH 3C,B01,089158,Staff,0,0,0,0
1653297323825,MATH 3C,B02,089159,Staff,0,0,0,0
1653297323825,MATH 3C,B03,089160,Staff,0,0,0,0
1653297323825,MATH 3C,B04,089161,Staff,0,0,0,0
1653297323825,MATH 3C,C01,094244,Staff,0,0,0,0
1653297323825,MATH 3C,C02,094245,Staff,0,0,0,0
1653297323825,MATH 3C,C03,094246,Staff,0,0,0,0
1653297323825,MATH 3C,C04,094247,Staff,0,0,0,0
1653297324350,MATH 4C,A01,089164,Staff,0,0,0,0
1653297324350,MATH 4C,A02,089165,Staff,0,0,0,0
1653297324350,MATH 4C,A03,089166,Staff,0,0,0,0
1653297324350,MATH 4C,B01,089169,Ganzberger; Geoffrey Michael,0,0,0,0
1653297324350,MATH 4C,B02,089170,Ganzberger; Geoffrey Michael,0,0,0,0
1653297324350,MATH 4C,B03,089171,Ganzberger; Geoffrey Michael,0,0,0,0
1653297324350,MATH 4C,C01,089174,Ganzberger; Geoffrey Michael,0,0,0,0
1653297324350,MATH 4C,C02,089175,Ganzberger; Geoffrey Michael,0,0,0,0
1653297324350,MATH 4C,C03,089176,Ganzberger; Geoffrey Michael,0,0,0,0
1653297324350,MATH 4C,D01,094249,Ganzberger; Geoffrey Michael,0,0,0,0
1653297324350,MATH 4C,D02,094250,Ganzberger; Geoffrey Michael,0,0,0,0
1653297324350,MATH 4C,D03,094251,Ganzberger; Geoffrey Michael,0,0,0,0
1653297324878,MATH 10A,A01,089179,Jin; Muzhi,5,0,5,0
1653297324878,MATH 10A,A02,089180,Jin; Muzhi,5,0,5,0
1653297324878,MATH 10A,A03,089181,Jin; Muzhi,4,0,5,1
1653297324878,MATH 10A,A04,089182,Jin; Muzhi,4,0,5,1
1653297324878,MATH 10A,A05,089183,Jin; Muzhi,5,0,5,0
1653297324878,MATH 10A,A06,089184,Jin; Muzhi,5,0,5,0
1653297324878,MATH 10A,A07,089185,Jin; Muzhi,5,0,5,0
1653297324878,MATH 10A,A08,089186,Jin; Muzhi,5,0,5,0
1653297324878,MATH 10A,B01,089188,Stevens; Laura Jeanne,1,0,5,4
1653297324878,MATH 10A,B02,089189,Stevens; Laura Jeanne,4,0,5,1
1653297324878,MATH 10A,B03,089190,Stevens; Laura Jeanne,4,0,5,1
1653297324878,MATH 10A,B04,089191,Stevens; Laura Jeanne,5,0,5,0
1653297324878,MATH 10A,B05,089192,Stevens; Laura Jeanne,4,0,5,1
1653297324878,MATH 10A,B06,089193,Stevens; Laura Jeanne,5,0,5,0
1653297324878,MATH 10A,B07,089194,Stevens; Laura Jeanne,5,0,5,0
1653297324878,MATH 10A,B08,089195,Stevens; Laura Jeanne,4,0,5,1
1653297324878,MATH 10A,C01,089197,Jin; Muzhi,1,0,5,4
1653297324878,MATH 10A,C02,089198,Jin; Muzhi,5,0,5,0
1653297324878,MATH 10A,C03,089199,Jin; Muzhi,5,0,5,0
1653297324878,MATH 10A,C04,089200,Jin; Muzhi,5,0,5,0
1653297324878,MATH 10A,C05,089201,Jin; Muzhi,5,0,5,0
1653297324878,MATH 10A,C06,089202,Jin; Muzhi,5,0,5,0
1653297324878,MATH 10A,D01,089204,Upton; James Thomas,4,0,5,1
1653297324878,MATH 10A,D02,089205,Upton; James Thomas,5,0,5,0
1653297324878,MATH 10A,D03,089206,Upton; James Thomas,5,0,5,0
1653297324878,MATH 10A,D04,089207,Upton; James Thomas,5,0,5,0
1653297324878,MATH 10A,E01,089211,Greenfeld; Be'Eri,5,0,5,0
1653297324878,MATH 10A,E02,089212,Greenfeld; Be'Eri,3,0,5,2
1653297324878,MATH 10A,E03,089213,Greenfeld; Be'Eri,4,0,5,1
1653297324878,MATH 10A,E04,089214,Greenfeld; Be'Eri,5,0,5,0
1653297324878,MATH 10A,E05,089215,Greenfeld; Be'Eri,5,0,5,0
1653297324878,MATH 10A,E06,089216,Greenfeld; Be'Eri,5,0,5,0
1653297325405,MATH 10B,A01,089218,Stevens; Laura Jeanne,7,0,8,1
1653297325405,MATH 10B,A02,089219,Stevens; Laura Jeanne,7,0,8,1
1653297325405,MATH 10B,A03,089220,Stevens; Laura Jeanne,8,0,8,0
1653297325405,MATH 10B,A04,089221,Stevens; Laura Jeanne,6,0,8,2
1653297325405,MATH 10B,A05,089222,Stevens; Laura Jeanne,2,0,8,6
1653297325405,MATH 10B,A06,089223,Stevens; Laura Jeanne,0,0,8,8
1653297325405,MATH 10B,A07,089224,Stevens; Laura Jeanne,6,0,8,2
1653297325405,MATH 10B,A08,089225,Stevens; Laura Jeanne,4,0,8,4
1653297325405,MATH 10B,B01,089227,Staff,8,0,8,0
1653297325405,MATH 10B,B02,089228,Staff,8,0,8,0
1653297325405,MATH 10B,B03,089229,Staff,7,0,8,1
1653297325405,MATH 10B,B04,089230,Staff,8,0,8,0
1653297325405,MATH 10B,B05,089231,Staff,8,0,8,0
1653297325405,MATH 10B,B06,089232,Staff,8,0,8,0
1653297325405,MATH 10B,B07,089233,Staff,8,0,8,0
1653297325405,MATH 10B,B08,089234,Staff,8,0,8,0
1653297325405,MATH 10B,C01,089236,McKinley; Gweneth Anne,4,0,8,4
1653297325405,MATH 10B,C02,089237,McKinley; Gweneth Anne,8,0,8,0
1653297325405,MATH 10B,C03,089238,McKinley; Gweneth Anne,8,0,8,0
1653297325405,MATH 10B,C04,089239,McKinley; Gweneth Anne,8,0,8,0
1653297325405,MATH 10B,C05,089240,McKinley; Gweneth Anne,8,0,8,0
1653297325405,MATH 10B,C06,089241,McKinley; Gweneth Anne,8,0,8,0
1653297326009,MATH 10C,A01,089243,Staff,13,0,20,7
1653297326009,MATH 10C,A02,089244,Staff,20,0,20,0
1653297326009,MATH 10C,A03,089245,Staff,18,0,20,2
1653297326009,MATH 10C,A04,089246,Staff,20,0,20,0
1653297326009,MATH 10C,A05,089247,Staff,19,0,20,1
1653297326009,MATH 10C,A06,089248,Staff,20,0,20,0
1653297326009,MATH 10C,A07,094505,Staff,20,0,20,0
1653297326009,MATH 10C,A08,094506,Staff,20,0,20,0
1653297326009,MATH 10C,B01,089250,Staff,19,0,20,1
1653297326009,MATH 10C,B02,089251,Staff,19,0,20,1
1653297326009,MATH 10C,B03,089252,Staff,14,0,20,6
1653297326009,MATH 10C,B04,089253,Staff,20,0,20,0
1653297326009,MATH 10C,B05,089254,Staff,20,0,20,0
1653297326009,MATH 10C,B06,089255,Staff,18,0,20,2
1653297326534,MATH 11,A01,089258,Rava; Denise,1,0,15,14
1653297326534,MATH 11,A02,089260,Rava; Denise,9,0,15,6
1653297326534,MATH 11,A03,089263,Rava; Denise,10,0,15,5
1653297326534,MATH 11,A04,089265,Rava; Denise,13,0,15,2
1653297326534,MATH 11,A05,089267,Rava; Denise,10,0,15,5
1653297326534,MATH 11,A06,089269,Rava; Denise,14,0,15,1
1653297326534,MATH 11,A07,089271,Rava; Denise,14,0,15,1
1653297326534,MATH 11,A08,089273,Rava; Denise,13,0,15,2
1653297326534,MATH 11,B01,089279,Staff,4,0,15,11
1653297326534,MATH 11,B02,089281,Staff,14,0,15,1
1653297326534,MATH 11,B03,089283,Staff,14,0,15,1
1653297326534,MATH 11,B04,089284,Staff,15,0,15,0
1653297326534,MATH 11,B05,089286,Staff,14,0,15,1
1653297326534,MATH 11,B06,089288,Staff,15,0,15,0
1653297326534,MATH 11,B07,089289,Staff,14,0,15,1
1653297326534,MATH 11,B08,089290,Staff,14,0,15,1
1653297327063,MATH 18,A01,089303,Anzaldo; Leesa B,5,0,10,5
1653297327063,MATH 18,A02,089304,Anzaldo; Leesa B,6,0,10,4
1653297327063,MATH 18,A03,089305,Anzaldo; Leesa B,10,0,10,0
1653297327063,MATH 18,A04,089306,Anzaldo; Leesa B,8,0,10,2
1653297327063,MATH 18,A05,089307,Anzaldo; Leesa B,10,0,10,0
1653297327063,MATH 18,A06,089308,Anzaldo; Leesa B,9,0,10,1
1653297327063,MATH 18,A07,089309,Anzaldo; Leesa B,10,0,10,0
1653297327063,MATH 18,A08,089310,Anzaldo; Leesa B,10,0,10,0
1653297327063,MATH 18,A09,089311,Anzaldo; Leesa B,10,0,10,0
1653297327063,MATH 18,A10,089312,Anzaldo; Leesa B,10,0,10,0
1653297327063,MATH 18,A11,089313,Anzaldo; Leesa B,9,0,10,1
1653297327063,MATH 18,A12,089314,Anzaldo; Leesa B,10,0,10,0
1653297327063,MATH 18,A13,089315,Anzaldo; Leesa B,9,0,10,1
1653297327063,MATH 18,A14,089316,Anzaldo; Leesa B,10,0,10,0
1653297327063,MATH 18,A15,089317,Anzaldo; Leesa B,9,0,10,1
1653297327063,MATH 18,A16,089318,Anzaldo; Leesa B,10,0,10,0
1653297327063,MATH 18,A17,089319,Anzaldo; Leesa B,9,0,10,1
1653297327063,MATH 18,A18,089320,Anzaldo; Leesa B,10,0,10,0
1653297327063,MATH 18,A19,089321,Anzaldo; Leesa B,0,0,0,0
1653297327063,MATH 18,A20,089322,Anzaldo; Leesa B,0,0,0,0
1653297327063,MATH 18,A21,089323,Anzaldo; Leesa B,9,0,10,1
1653297327063,MATH 18,A22,089324,Anzaldo; Leesa B,7,0,10,3
1653297327063,MATH 18,A23,089325,Anzaldo; Leesa B,10,0,10,0
1653297327063,MATH 18,A24,089326,Anzaldo; Leesa B,9,0,10,1
1653297327063,MATH 18,B01,089329,Staff,13,0,13,0
1653297327063,MATH 18,B02,089330,Staff,12,0,13,1
1653297327063,MATH 18,B03,089331,Staff,12,0,13,1
1653297327063,MATH 18,B04,089332,Staff,13,0,13,0
1653297327063,MATH 18,B05,089333,Staff,12,0,13,1
1653297327063,MATH 18,C01,089336,Staff,13,0,13,0
1653297327063,MATH 18,C02,089337,Staff,11,0,13,2
1653297327063,MATH 18,C03,089338,Staff,0,0,0,0
1653297327063,MATH 18,C04,089339,Staff,0,0,0,0
1653297327063,MATH 18,C05,089340,Staff,0,0,0,1
1653297327063,MATH 18,D01,094194,Staff,0,0,0,0
1653297327063,MATH 18,D02,094195,Staff,0,0,0,0
1653297327063,MATH 18,D03,094196,Staff,0,0,0,0
1653297327063,MATH 18,D04,094197,Staff,0,0,0,0
1653297327063,MATH 18,D05,094198,Staff,0,0,0,0
1653297327591,MATH 20A,A01,089343,Staff,5,0,5,0
1653297327591,MATH 20A,A02,089344,Staff,5,0,5,0
1653297327591,MATH 20A,A03,089345,Staff,5,0,5,0
1653297327591,MATH 20A,B01,089347,Suk; Andrew Hoon,2,0,3,1
1653297327591,MATH 20A,B02,089348,Suk; Andrew Hoon,3,0,3,0
1653297327591,MATH 20A,B03,089349,Suk; Andrew Hoon,3,0,3,0
1653297327591,MATH 20A,B04,089350,Suk; Andrew Hoon,3,0,3,0
1653297327591,MATH 20A,B05,089351,Suk; Andrew Hoon,3,0,3,0
1653297327591,MATH 20A,B06,089352,Suk; Andrew Hoon,2,0,3,1
1653297327591,MATH 20A,B07,089353,Suk; Andrew Hoon,3,0,3,0
1653297327591,MATH 20A,B08,089354,Suk; Andrew Hoon,3,0,3,0
1653297327591,MATH 20A,B09,089355,Suk; Andrew Hoon,3,0,3,0
1653297327591,MATH 20A,B10,089356,Suk; Andrew Hoon,3,0,3,0
1653297327591,MATH 20A,B11,089357,Suk; Andrew Hoon,3,0,3,0
1653297327591,MATH 20A,B12,089358,Suk; Andrew Hoon,3,0,3,0
1653297327591,MATH 20A,B13,089359,Suk; Andrew Hoon,2,0,3,1
1653297327591,MATH 20A,B14,089360,Suk; Andrew Hoon,3,0,3,0
1653297327591,MATH 20A,B15,089361,Suk; Andrew Hoon,3,0,3,0
1653297327591,MATH 20A,B16,089362,Suk; Andrew Hoon,3,0,3,0
1653297327591,MATH 20A,B17,089363,Suk; Andrew Hoon,3,0,3,0
1653297327591,MATH 20A,B18,089364,Suk; Andrew Hoon,0,0,0,0
1653297327591,MATH 20A,B19,089365,Suk; Andrew Hoon,3,0,3,0
1653297327591,MATH 20A,B20,089366,Suk; Andrew Hoon,3,0,3,0
1653297327591,MATH 20A,B21,089367,Suk; Andrew Hoon,3,0,3,0
1653297327591,MATH 20A,B22,089368,Suk; Andrew Hoon,3,0,3,0
1653297327591,MATH 20A,B23,089369,Suk; Andrew Hoon,3,0,3,0
1653297327591,MATH 20A,B24,089370,Suk; Andrew Hoon,3,0,3,0
1653297328118,MATH 20B,A01,089372,Quarfoot; David James,8,0,8,0
1653297328118,MATH 20B,A02,089373,Quarfoot; David James,8,0,8,0
1653297328118,MATH 20B,A03,089374,Quarfoot; David James,7,0,8,1
1653297328118,MATH 20B,A04,089375,Quarfoot; David James,7,0,8,1
1653297328118,MATH 20B,A05,089376,Quarfoot; David James,0,0,0,0
1653297328118,MATH 20B,A06,089377,Quarfoot; David James,0,0,0,0
1653297328118,MATH 20B,A07,089378,Quarfoot; David James,0,0,0,0
1653297328118,MATH 20B,A08,089379,Quarfoot; David James,0,0,0,0
1653297328118,MATH 20B,A09,089380,Quarfoot; David James,0,0,0,0
1653297328118,MATH 20B,A10,089381,Quarfoot; David James,0,0,0,0
1653297328118,MATH 20B,A11,089382,Quarfoot; David James,0,0,0,0
1653297328118,MATH 20B,A12,089383,Quarfoot; David James,0,0,0,0
1653297328118,MATH 20B,A13,089384,Quarfoot; David James,0,0,0,0
1653297328118,MATH 20B,A14,089385,Quarfoot; David James,0,0,0,0
1653297328118,MATH 20B,A15,089386,Quarfoot; David James,0,0,0,0
1653297328118,MATH 20B,A16,089387,Quarfoot; David James,0,0,0,0
1653297328118,MATH 20B,A17,089388,Quarfoot; David James,8,0,8,0
1653297328118,MATH 20B,A18,089389,Quarfoot; David James,8,0,8,0
1653297328118,MATH 20B,A19,089390,Quarfoot; David James,8,0,8,0
1653297328118,MATH 20B,A20,089391,Quarfoot; David James,8,0,8,0
1653297328118,MATH 20B,A21,089392,Quarfoot; David James,8,0,8,0
1653297328118,MATH 20B,A22,089393,Quarfoot; David James,7,0,8,1
1653297328118,MATH 20B,A23,089394,Quarfoot; David James,7,0,8,1
1653297328118,MATH 20B,A24,089395,Quarfoot; David James,8,0,8,0
1653297328118,MATH 20B,B01,089397,Lahiri; Aranya,7,0,10,3
1653297328118,MATH 20B,B02,089398,Lahiri; Aranya,10,0,10,0
1653297328118,MATH 20B,B03,089399,Lahiri; Aranya,10,0,10,0
1653297328118,MATH 20B,B04,089400,Lahiri; Aranya,10,0,10,0
1653297328118,MATH 20B,B05,089401,Lahiri; Aranya,10,0,10,0
1653297328118,MATH 20B,C01,089403,Lahiri; Aranya,0,0,0,0
1653297328118,MATH 20B,C02,089404,Lahiri; Aranya,8,0,10,2
1653297328118,MATH 20B,C03,089405,Lahiri; Aranya,10,0,10,0
1653297328118,MATH 20B,C04,089406,Lahiri; Aranya,9,0,10,1
1653297328118,MATH 20B,C05,089407,Lahiri; Aranya,9,0,10,1
1653297328667,MATH 20C,A01,089409,Um; Ko Woon,10,0,10,0
1653297328667,MATH 20C,A02,089410,Um; Ko Woon,10,0,10,0
1653297328667,MATH 20C,A03,089411,Um; Ko Woon,9,0,10,1
1653297328667,MATH 20C,A04,089412,Um; Ko Woon,9,0,10,1
1653297328667,MATH 20C,A05,089413,Um; Ko Woon,10,0,10,0
1653297328667,MATH 20C,A06,089414,Um; Ko Woon,9,0,10,1
1653297328667,MATH 20C,A07,094270,Um; Ko Woon,10,0,10,0
1653297328667,MATH 20C,A08,094271,Um; Ko Woon,10,0,10,0
1653297328667,MATH 20C,A09,094272,Um; Ko Woon,7,0,10,3
1653297328667,MATH 20C,A10,094273,Um; Ko Woon,10,0,10,0
1653297328667,MATH 20C,A11,094274,Um; Ko Woon,10,0,10,0
1653297328667,MATH 20C,A12,094275,Um; Ko Woon,8,0,10,2
1653297328667,MATH 20C,A13,094276,Um; Ko Woon,10,0,10,0
1653297328667,MATH 20C,A14,094277,Um; Ko Woon,10,0,10,0
1653297328667,MATH 20C,A15,094278,Um; Ko Woon,10,0,10,0
1653297328667,MATH 20C,A16,094279,Um; Ko Woon,10,0,10,0
1653297328667,MATH 20C,B03,089418,Zhang; Ming,7,0,15,8
1653297328667,MATH 20C,B04,089419,Zhang; Ming,13,0,15,2
1653297328667,MATH 20C,B05,089420,Zhang; Ming,13,0,15,2
1653297328667,MATH 20C,C01,089423,Staff,15,0,15,0
1653297328667,MATH 20C,C02,089424,Staff,15,0,15,0
1653297328667,MATH 20C,C03,089425,Staff,15,0,15,0
1653297328667,MATH 20C,C04,089426,Staff,15,0,15,0
1653297328667,MATH 20C,C05,089427,Staff,15,0,15,0
1653297328667,MATH 20C,D04,089433,Zhang; Ming,13,0,15,2
1653297328667,MATH 20C,D05,089434,Zhang; Ming,15,0,15,0
1653297328667,MATH 20C,E01,089439,Staff,15,0,15,0
1653297328667,MATH 20C,E02,089440,Staff,15,0,15,0
1653297328667,MATH 20C,E03,089441,Staff,15,0,15,0
1653297328667,MATH 20C,E04,089442,Staff,15,0,15,0
1653297328667,MATH 20C,E05,089443,Staff,15,0,15,0
1653297328667,MATH 20C,E06,089444,Staff,15,0,15,0
1653297328667,MATH 20C,A17,094280,Um; Ko Woon,0,0,0,0
1653297328667,MATH 20C,A18,094281,Um; Ko Woon,0,0,0,0
1653297328667,MATH 20C,A19,094282,Um; Ko Woon,0,0,0,0
1653297328667,MATH 20C,A20,094283,Um; Ko Woon,0,0,0,0
1653297328667,MATH 20C,A21,094284,Um; Ko Woon,0,0,0,0
1653297328667,MATH 20C,A22,094285,Um; Ko Woon,0,0,0,0
1653297328667,MATH 20C,A23,094286,Um; Ko Woon,0,0,0,0
1653297328667,MATH 20C,A24,094287,Um; Ko Woon,0,0,0,0
1653297328667,MATH 20C,B01,089416,Zhang; Ming,0,0,0,0
1653297328667,MATH 20C,B02,089417,Zhang; Ming,0,0,0,0
1653297328667,MATH 20C,D01,089430,Zhang; Ming,0,0,0,0
1653297328667,MATH 20C,D02,089431,Zhang; Ming,0,0,0,0
1653297328667,MATH 20C,D03,089432,Zhang; Ming,0,0,0,0
1653297329200,MATH 20D,A01,089455,Lee; Kisun,11,0,25,14
1653297329200,MATH 20D,A02,089456,Lee; Kisun,24,0,25,1
1653297329200,MATH 20D,A03,089457,Lee; Kisun,24,0,25,1
1653297329200,MATH 20D,A04,089458,Lee; Kisun,25,0,25,0
1653297329200,MATH 20D,A05,089459,Lee; Kisun,25,0,25,0
1653297329200,MATH 20D,A06,089460,Lee; Kisun,25,0,25,0
1653297329200,MATH 20D,B01,089463,Lee; Kisun,20,0,25,5
1653297329200,MATH 20D,B02,089464,Lee; Kisun,25,0,25,0
1653297329200,MATH 20D,B03,089465,Lee; Kisun,24,0,25,1
1653297329200,MATH 20D,B04,089466,Lee; Kisun,25,0,25,0
1653297329200,MATH 20D,B05,089467,Lee; Kisun,23,0,25,2
1653297329200,MATH 20D,B06,089468,Lee; Kisun,24,0,25,1
1653297329200,MATH 20D,C01,089471,Staff,23,0,25,2
1653297329200,MATH 20D,C02,089472,Staff,25,0,25,0
1653297329200,MATH 20D,C03,089473,Staff,25,0,25,0
1653297329200,MATH 20D,C04,089474,Staff,25,0,25,0
1653297329200,MATH 20D,C05,089475,Staff,25,0,25,0
1653297329200,MATH 20D,C06,089476,Staff,25,0,25,0
1653297329736,MATH 20E,A01,089479,Eggers; John Dietrich,17,0,24,7
1653297329736,MATH 20E,A02,089480,Eggers; John Dietrich,24,0,25,1
1653297329736,MATH 20E,A03,089481,Eggers; John Dietrich,25,0,25,0
1653297329736,MATH 20E,A04,089482,Eggers; John Dietrich,25,0,25,0
1653297329736,MATH 20E,A05,089483,Eggers; John Dietrich,19,0,25,6
1653297329736,MATH 20E,A06,089484,Eggers; John Dietrich,25,0,25,0
1653297329736,MATH 20E,A07,089485,Eggers; John Dietrich,24,0,25,1
1653297329736,MATH 20E,A08,089486,Eggers; John Dietrich,24,0,25,1
1653297329736,MATH 20E,B01,089488,Staff,15,0,25,10
1653297329736,MATH 20E,B02,089489,Staff,21,0,25,4
1653297329736,MATH 20E,B03,089490,Staff,25,0,25,0
1653297329736,MATH 20E,B04,089491,Staff,25,0,25,0
1653297329736,MATH 20E,B05,089492,Staff,24,0,25,1
1653297329736,MATH 20E,B06,089493,Staff,24,0,25,1
1653297329736,MATH 20E,B07,089494,Staff,25,0,25,0
1653297329736,MATH 20E,B08,089495,Staff,25,0,25,0
1653297329736,MATH 20E,C01,089497,Staff,23,0,25,2
1653297329736,MATH 20E,C02,089498,Staff,25,0,25,0
1653297329736,MATH 20E,C03,089499,Staff,25,0,25,0
1653297329736,MATH 20E,C04,089500,Staff,25,0,25,0
1653297329736,MATH 20E,C05,089501,Staff,25,0,25,0
1653297329736,MATH 20E,C06,089502,Staff,25,0,25,0
1653297329736,MATH 20E,C07,089503,Staff,25,0,25,0
1653297329736,MATH 20E,C08,089504,Staff,25,0,25,0
1653297330260,MATH 31AH,A01,089506,Rabin; Jeffrey Mark,35,0,35,0
1653297330260,MATH 31AH,A02,089507,Rabin; Jeffrey Mark,35,0,35,0
1653297330795,MATH 87,A00,094827,Meyer; David A.,20,0,20,0
1653297331328,MATH 96,A00,094836,Kane; Daniel Mertz,11,0,30,19
1653297331867,MATH 100A,A01,089509,Kedlaya; Kiran S.,23,0,30,7
1653297331867,MATH 100A,A02,089510,Kedlaya; Kiran S.,28,0,30,2
1653297331867,MATH 100A,B01,089512,Greenfeld; Be'Eri,24,0,30,6
1653297331867,MATH 100A,B02,089513,Greenfeld; Be'Eri,30,0,30,0
1653297332400,MATH 102,A01,089515,Hodges; Reuven Moses,25,0,30,5
1653297332400,MATH 102,A02,089516,Hodges; Reuven Moses,30,0,30,0
1653297332400,MATH 102,A03,089517,Hodges; Reuven Moses,30,0,30,0
1653297332400,MATH 102,A04,089518,Hodges; Reuven Moses,29,0,30,1
1653297332400,MATH 102,B01,089520,Hodges; Reuven Moses,29,0,30,1
1653297332400,MATH 102,B02,089521,Hodges; Reuven Moses,29,0,30,1
1653297332400,MATH 102,B03,089522,Hodges; Reuven Moses,29,0,30,1
1653297332400,MATH 102,B04,089523,Hodges; Reuven Moses,30,0,30,0
1653297332926,MATH 103A,A01,089525,Staff,27,0,30,3
1653297332926,MATH 103A,A02,089526,Staff,30,0,30,0
1653297332926,MATH 103A,B01,089528,Seward; Brandon M.,9,0,30,21
1653297332926,MATH 103A,B02,089529,Seward; Brandon M.,22,0,30,8
1653297332926,MATH 103A,C01,089531,Staff,27,0,30,3
1653297332926,MATH 103A,C02,089532,Staff,28,0,30,2
1653297332926,MATH 103A,D01,089534,Staff,28,0,30,2
1653297332926,MATH 103A,D02,089535,Staff,28,0,30,2
1653297333456,MATH 109,A01,089537,Chung; Kwun,9,0,10,1
1653297333456,MATH 109,A02,089538,Chung; Kwun,10,0,10,0
1653297333456,MATH 109,B01,089540,Belmont; Eva Kinoshita,9,0,10,1
1653297333456,MATH 109,B02,089541,Belmont; Eva Kinoshita,6,0,10,4
1653297333456,MATH 109,C01,089543,Chow; Bennett,8,0,10,2
1653297333456,MATH 109,C02,089544,Chow; Bennett,10,0,10,0
1653297333456,MATH 109,D01,089546,Chung; Kwun,9,0,10,1
1653297333456,MATH 109,D02,089547,Chung; Kwun,9,0,10,1
1653297333456,MATH 109,E01,089549,Schweinsberg; Jason,6,0,10,4
1653297333456,MATH 109,E02,089550,Schweinsberg; Jason,10,0,10,0
1653297333991,MATH 110,A01,089552,Wenzl; Hans G,27,0,35,8
1653297333991,MATH 110,A02,089553,Wenzl; Hans G,33,0,35,2
1653297334526,MATH 111A,A01,089555,Meyer; David A.,0,0,0,1
1653297335063,MATH 120A,A01,089557,Manners; Frederick,30,0,35,5
1653297335063,MATH 120A,A02,089558,Manners; Frederick,33,0,35,2
1653297335591,MATH 140A,A01,089560,Seward; Brandon M.,25,0,30,5
1653297335591,MATH 140A,A02,089561,Seward; Brandon M.,29,0,30,1
1653297335591,MATH 140A,B01,089563,Chan; Pak Yeung,30,0,30,0
1653297335591,MATH 140A,B02,089564,Chan; Pak Yeung,22,0,30,8
1653297336116,MATH 142A,A01,089566,Staff,29,0,30,1
1653297336116,MATH 142A,A02,089567,Staff,29,0,30,1
1653297336116,MATH 142A,B01,089569,Staff,30,0,30,0
1653297336116,MATH 142A,B02,089570,Staff,29,0,30,1
1653297336116,MATH 142A,C01,089572,Staff,26,0,30,4
1653297336116,MATH 142A,C02,089573,Staff,29,0,30,1
1653297336116,MATH 142A,D01,089575,Eggers; John Dietrich,15,0,30,15
1653297336116,MATH 142A,D02,089576,Eggers; John Dietrich,27,0,30,3
1653297336641,MATH 144,A01,089578,Bejenaru; Ioan,29,0,30,1
1653297337164,MATH 150A,A01,089580,Chow; Bennett,29,0,35,6
1653297337164,MATH 150A,A02,089581,Chow; Bennett,34,0,35,1
1653297338213,MATH 153,A01,094204,Harel; Guershon,33,0,35,2
1653297338752,MATH 154,A01,089590,Verstraete; Jacques Allan,3,0,30,27
1653297338752,MATH 154,A02,089591,Verstraete; Jacques Allan,23,0,30,7
1653297338752,MATH 154,A03,089592,Verstraete; Jacques Allan,28,0,30,2
1653297338752,MATH 154,A04,089593,Verstraete; Jacques Allan,26,0,30,4
1653297339284,MATH 155A,A01,089595,Buss; Samuel R,22,0,35,13
1653297339284,MATH 155A,A02,089596,Buss; Samuel R,32,0,35,3
1653297339809,MATH 160A,A01,089598,Manners; Frederick,28,0,35,7
1653297339809,MATH 160A,A02,094207,Manners; Frederick,34,0,35,1
1653297340334,MATH 170A,A01,089600,Liu; Shuang,24,0,25,1
1653297340334,MATH 170A,A02,089601,Liu; Shuang,24,0,25,1
1653297340334,MATH 170A,A03,089602,Liu; Shuang,24,0,25,1
1653297340334,MATH 170A,A04,089603,Liu; Shuang,23,0,25,2
1653297340334,MATH 170A,B01,089605,Dumitriu; Ioana,8,0,25,17
1653297340334,MATH 170A,B02,089606,Dumitriu; Ioana,20,0,25,5
1653297340334,MATH 170A,B03,089607,Dumitriu; Ioana,21,0,25,4
1653297340334,MATH 170A,B04,089608,Dumitriu; Ioana,25,0,25,0
1653297340858,MATH 173A,A01,089610,Cloninger; Alexander,0,0,35,35
1653297340858,MATH 173A,A02,089611,Cloninger; Alexander,2,0,35,33
1653297340858,MATH 173A,A03,089612,Cloninger; Alexander,20,0,35,15
1653297341755,MATH 174,A01,089614,Cheng; Li-Tien,23,0,25,2
1653297341755,MATH 174,A02,089615,Cheng; Li-Tien,25,0,25,0
1653297349776,MATH 180A,A01,089617,Jekel; David Andrew,0,0,25,25
1653297349776,MATH 180A,A02,089618,Jekel; David Andrew,23,0,25,2
1653297349776,MATH 180A,A03,089619,Jekel; David Andrew,22,0,25,3
1653297349776,MATH 180A,A04,089620,Jekel; David Andrew,22,0,25,3
1653297349776,MATH 180A,A05,089621,Jekel; David Andrew,24,0,25,1
1653297349776,MATH 180A,A06,089622,Jekel; David Andrew,23,0,25,2
1653297349776,MATH 180A,B01,089624,Agarwal; Pooja,23,0,25,2
1653297349776,MATH 180A,B02,089625,Agarwal; Pooja,24,0,25,1
1653297349776,MATH 180A,B03,089626,Agarwal; Pooja,22,0,25,3
1653297349776,MATH 180A,B04,089627,Agarwal; Pooja,25,0,25,0
1653297349776,MATH 180A,B05,089628,Agarwal; Pooja,24,0,25,1
1653297349776,MATH 180A,B06,089629,Agarwal; Pooja,25,0,25,0
1653297349776,MATH 180A,C01,089631,Staff,22,0,25,3
1653297349776,MATH 180A,C02,089632,Staff,25,0,25,0
1653297349776,MATH 180A,C03,089633,Staff,25,0,25,0
1653297349776,MATH 180A,C04,089634,Staff,25,0,25,0
1653297350301,MATH 180C,A01,089636,Fitzsimmons; Patrick J,4,0,25,21
1653297350301,MATH 180C,A02,089637,Fitzsimmons; Patrick J,21,0,25,4
1653297350830,MATH 181B,A01,089639,Rava; Denise,31,0,35,4
1653297350830,MATH 181B,A02,089640,Rava; Denise,34,0,35,1
1653297350830,MATH 181B,A03,089641,Rava; Denise,31,0,35,4
1653297350830,MATH 181B,A04,089642,Rava; Denise,35,0,35,0
1653297351358,MATH 183,A01,089644,Staff,10,0,25,15
1653297351358,MATH 183,A02,089645,Staff,23,0,25,2
1653297351358,MATH 183,A03,089646,Staff,23,0,25,2
1653297351358,MATH 183,A04,089647,Staff,25,0,25,0
1653297351358,MATH 183,A05,089648,Staff,19,0,25,6
1653297351358,MATH 183,A06,089649,Staff,22,0,25,3
1653297351358,MATH 183,A07,089650,Staff,25,0,25,0
1653297351358,MATH 183,A08,089651,Staff,25,0,25,0
1653297351893,MATH 184,A01,089653,Kane; Daniel Mertz,24,0,30,6
1653297351893,MATH 184,A02,089654,Kane; Daniel Mertz,30,0,30,0
1653297351893,MATH 184,A03,089655,Kane; Daniel Mertz,30,0,30,0
1653297351893,MATH 184,A04,089656,Kane; Daniel Mertz,30,0,30,0
1653297352433,MATH 187A,A01,089658,Bucur; Alina Ioana,0,0,25,25
1653297352433,MATH 187A,A02,089659,Bucur; Alina Ioana,12,0,25,13
1653297352433,MATH 187A,A03,089660,Bucur; Alina Ioana,1,0,25,24
1653297352433,MATH 187A,A04,089661,Bucur; Alina Ioana,17,0,25,8
1653297352957,MATH 187B,A01,089663,Bucur; Alina Ioana,28,0,35,7
1653297352957,MATH 187B,A02,089664,Bucur; Alina Ioana,34,0,35,1
1653297353495,MATH 188,A01,094817,Sam; Steven V,33,0,35,2
1653297354027,MATH 190A,A01,089666,Sam; Steven V,21,0,35,14
1653297354551,MATH 196,A00,089667,Spolaor; Luca,33,0,45,12
1653297355132,MCWP 40,004,093486,Wastal; Carrie King,0,0,3,3
1653297355132,MCWP 40,005,093487,Wastal; Carrie King,0,0,3,3
1653297355132,MCWP 40,006,093488,Wastal; Carrie King,3,0,3,0
1653297355132,MCWP 40,007,093489,Wastal; Carrie King,3,0,3,0
1653297355132,MCWP 40,008,093490,Wastal; Carrie King,2,0,3,1
1653297355132,MCWP 40,009,093491,Wastal; Carrie King,2,0,3,1
1653297355132,MCWP 40,013,093495,Wastal; Carrie King,3,0,3,0
1653297355132,MCWP 40,014,093496,Wastal; Carrie King,0,0,3,3
1653297355132,MCWP 40,015,093497,Wastal; Carrie King,3,0,3,0
1653297355132,MCWP 40,016,093498,Wastal; Carrie King,3,0,3,0
1653297355132,MCWP 40,017,093499,Wastal; Carrie King,3,0,3,0
1653297355132,MCWP 40,018,093500,Wastal; Carrie King,1,0,3,2
1653297355132,MCWP 40,020,093502,Wastal; Carrie King,0,0,0,0
1653297355132,MCWP 40,021,093503,Wastal; Carrie King,3,0,3,0
1653297355132,MCWP 40,022,093504,Wastal; Carrie King,2,0,3,1
1653297355132,MCWP 40,023,093505,Wastal; Carrie King,2,0,3,1
1653297355132,MCWP 40,024,093506,Wastal; Carrie King,2,0,3,1
1653297355132,MCWP 40,026,093508,Wastal; Carrie King,3,0,3,0
1653297355132,MCWP 40,027,093509,Wastal; Carrie King,3,0,3,0
1653297355132,MCWP 40,028,093510,Wastal; Carrie King,3,0,3,0
1653297355132,MCWP 40,029,093511,Wastal; Carrie King,3,0,3,0
1653297355132,MCWP 40,030,093512,Wastal; Carrie King,2,0,3,1
1653297355132,MCWP 40,032,093514,Wastal; Carrie King,2,0,3,1
1653297355132,MCWP 40,033,093515,Wastal; Carrie King,3,0,3,0
1653297355132,MCWP 40,034,093516,Wastal; Carrie King,3,0,3,0
1653297355132,MCWP 40,035,093517,Wastal; Carrie King,3,0,3,0
1653297355132,MCWP 40,038,093520,Wastal; Carrie King,2,0,3,1
1653297355132,MCWP 40,039,093521,Wastal; Carrie King,3,0,3,0
1653297355132,MCWP 40,041,093523,Wastal; Carrie King,2,0,3,1
1653297355132,MCWP 40,042,093524,Wastal; Carrie King,3,0,3,0
1653297355132,MCWP 40,043,093525,Wastal; Carrie King,0,0,0,0
1653297355132,MCWP 40,049,093531,Wastal; Carrie King,2,0,3,1
1653297355132,MCWP 40,050,093532,Wastal; Carrie King,3,0,3,0
1653297355132,MCWP 40,051,093533,Wastal; Carrie King,3,0,3,0
1653297355658,MCWP 50,001,093534,Wastal; Carrie King,0,0,0,0
1653297355658,MCWP 50,002,093535,Wastal; Carrie King,0,0,3,3
1653297355658,MCWP 50,003,093536,Wastal; Carrie King,0,0,3,3
1653297355658,MCWP 50,004,093537,Wastal; Carrie King,0,0,3,3
1653297355658,MCWP 50,005,093538,Wastal; Carrie King,0,0,3,3
1653297355658,MCWP 50,006,093539,Wastal; Carrie King,2,0,3,1
1653297355658,MCWP 50,007,093540,Wastal; Carrie King,0,0,3,3
1653297355658,MCWP 50,008,093541,Wastal; Carrie King,0,0,3,3
1653297355658,MCWP 50,009,093542,Wastal; Carrie King,0,0,3,3
1653297355658,MCWP 50,010,093543,Wastal; Carrie King,0,0,3,3
1653297355658,MCWP 50,013,093546,Wastal; Carrie King,1,0,3,2
1653297355658,MCWP 50,014,093547,Wastal; Carrie King,0,0,3,3
1653297355658,MCWP 50,015,093548,Wastal; Carrie King,0,0,3,3
1653297355658,MCWP 50,016,093549,Wastal; Carrie King,0,0,0,0
1653297356185,MCWP 125,A00,093550,Wilson; Marion E.,3,0,3,0
1653297356185,MCWP 125,B00,093551,Guillen; Melinda,3,0,3,0
1653297356185,MCWP 125,C00,093552,Guillen; Melinda,3,0,3,0
1653297356185,MCWP 125,D00,093553,Guillen; Melinda,3,0,3,0
1653297356185,MCWP 125,E00,093554,Miller; Elizabeth Deen,3,0,3,0
1653297356185,MCWP 125,F00,093555,Miller; Elizabeth Deen,3,0,3,0
1653297356185,MCWP 125,G00,093556,Miller; Elizabeth Deen,3,0,3,0
1653297356710,MGT 3,A00,087704,Wagner; Timothy Ryan,90,0,90,0
1653297357235,MGT 4,A01,087706,Levkoff; Steven B.,2,0,3,1
1653297357235,MGT 4,A02,087707,Levkoff; Steven B.,3,0,3,0
1653297357235,MGT 4,A03,092659,Levkoff; Steven B.,1,0,4,3
1653297357772,MGT 5,A00,087708,Houskeeper; Robert,194,0,196,2
1653297358315,MGT 12,A00,087709,Pecore; Joseph P.,91,0,100,9
1653297358315,MGT 12,B00,087710,Lindenberger; Wade Douglas,91,0,100,9
1653297358841,MGT 16,A00,087711,Campbell; Robert Harold,108,0,110,2
1653297358841,MGT 16,B00,087712,Campbell; Robert Harold,110,0,110,0
1653297358841,MGT 16,C00,087713,Lindenberger; Wade Douglas,100,0,110,10
1653297358841,MGT 16,D00,087714,Lindenberger; Wade Douglas,107,0,110,3
1653297358841,MGT 16,E00,094819,Buchanan; Harold G,99,0,100,1
1653297359390,MGT 18,A00,087715,McKay; Michael J,88,0,90,2
1653297359390,MGT 18,B00,087716,McKay; Michael J,90,0,90,0
1653297359390,MGT 18,C00,087717,McKay; Michael J,88,0,90,2
1653297359390,MGT 18,D00,087718,McKay; Mary A,90,0,90,0
1653297359390,MGT 18,E00,087719,McKay; Mary A,87,0,90,3
1653297359914,MGT 45,A00,087720,Pecore; Joseph P.,136,0,150,14
1653297359914,MGT 45,B00,087721,Pecore; Joseph P.,140,0,150,10
1653297360438,MGT 52,A00,087722,Deal; Jennifer Jean,83,0,90,7
1653297360963,MGT 71,A00,087723,August; Terrence,60,0,90,30
1653297362016,MGT 103,A00,087726,Ehrich; Kristine R,86,0,90,4
1653297362016,MGT 103,B00,087727,Ehrich; Kristine R,89,0,90,1
1653297362016,MGT 103,C00,087728,Eberhard; Craig A,89,0,90,1
1653297362016,MGT 103,D00,087729,Eberhard; Craig A,88,0,90,2
1653297362016,MGT 103,E00,087730,Demill; Burritt,75,0,90,15
1653297362016,MGT 103,F00,087731,Bates; Kenneth Walter,81,0,90,9
1653297362016,MGT 103,G00,087732,Bates; Kenneth Walter,88,0,90,2
1653297362540,MGT 105,A00,087733,Campbell; Robert Harold,102,0,120,18
1653297363064,MGT 106,A00,087734,Eberhard; Craig A,81,0,90,9
1653297363596,MGT 108R,A00,087735,Amir; On,84,0,90,6
1653297364120,MGT 109,A00,087736,Staff,77,0,90,13
1653297364657,MGT 112,A00,087737,Somasundaram; Tyagarajan,89,0,90,1
1653297364657,MGT 112,B00,087738,Somasundaram; Tyagarajan,86,0,90,4
1653297364657,MGT 112,C00,087739,Ehrich; Kristine R,86,0,90,4
1653297364657,MGT 112,D00,087740,Zimmermann; Carsten,65,0,90,25
1653297365181,MGT 121A,A00,087741,Wang; Helen Shan,65,0,70,5
1653297365181,MGT 121A,B00,087742,Wang; Helen Shan,64,0,70,6
1653297365705,MGT 131A,A00,087743,Houskeeper; Robert,146,0,150,4
1653297366230,MGT 132,A00,087744,Blakley; Bruce,88,0,90,2
1653297366758,MGT 134,A00,087745,Houskeeper; Robert,84,0,90,6
1653297367284,MGT 135,A00,087746,Anderson; John Charles,83,0,90,7
1653297367812,MGT 139,A00,087747,Perols; Johan Lars,88,0,90,2
1653297368342,MGT 153,A00,087748,Perols; Johan Lars,82,0,90,8
1653297368342,MGT 153,B00,087749,Phiroz; Zal Navroze,76,0,90,14
1653297368342,MGT 153,C00,087750,Phiroz; Zal Navroze,87,0,90,3
1653297368877,MGT 162R,A00,087751,Gneezy; Uri,64,0,90,26
1653297369405,MGT 164,A00,087752,McKay; Mary A,90,0,90,0
1653297369405,MGT 164,B00,087753,Meyer; Alison Bloomfield,0,0,0,0
1653297369405,MGT 164,C00,087754,Smith; Pamela Karen,82,0,90,8
1653297369931,MGT 166,A00,087755,Moran; Cathleen L.,89,0,90,1
1653297369931,MGT 166,B00,087756,Moran; Cathleen L.,90,0,90,0
1653297369931,MGT 166,C00,087757,Moran; Cathleen L.,90,0,90,0
1653297369931,MGT 166,D00,087758,Demill; Burritt,56,0,90,34
1653297370461,MGT 167,A00,087759,Klaas; Jeffrey David,88,0,90,2
1653297370461,MGT 167,B00,087760,Jacob; Jo Dee C,83,0,90,7
1653297370985,MGT 171,A00,087761,Phiroz; Zal Navroze,85,0,90,5
1653297371509,MGT 172,A00,087762,Hedges; Kathleen & Royal; Rebecca,96,0,100,4
1653297371509,MGT 172,B00,087763,Hedges; Kathleen,79,0,90,11
1653297371509,MGT 172,C00,087764,Zimmermann; Carsten,90,0,90,0
1653297372033,MGT 172R,A00,094888,Erat; Sanjiv,90,0,90,0
1653297372560,MGT 173,A00,087765,Hayes; Sherry Lorine,80,0,100,20
1653297373091,MGT 175,A00,087766,Gopal; Christopher S.,84,0,90,6
1653297373623,MGT 181,A00,087767,Buchanan; Harold G,114,0,120,6
1653297373623,MGT 181,B00,087768,Buchanan; Harold G,110,0,120,10
1653297373623,MGT 181,C00,087769,Bliss; Barbara Ann,109,0,120,11
1653297374679,MGT 185,A00,087771,Dunn; Louis Jean,84,0,90,6
1653297375214,MGT 187,A00,087772,Dunn; Louis Jean,138,0,146,8
1653297375757,MMW 11,A01,086931,duBois; Page Ann,4,0,4,0
1653297375757,MMW 11,A02,086932,duBois; Page Ann,4,0,4,0
1653297375757,MMW 11,A03,086933,duBois; Page Ann,3,0,4,1
1653297375757,MMW 11,A04,086934,duBois; Page Ann,3,0,4,1
1653297375757,MMW 11,A05,086935,duBois; Page Ann,4,0,4,0
1653297375757,MMW 11,A06,086936,duBois; Page Ann,3,0,4,1
1653297375757,MMW 11,A07,086937,duBois; Page Ann,4,0,4,0
1653297375757,MMW 11,A08,086938,duBois; Page Ann,4,0,4,0
1653297375757,MMW 11,A09,086939,duBois; Page Ann,4,0,4,0
1653297375757,MMW 11,A10,086940,duBois; Page Ann,4,0,4,0
1653297375757,MMW 11,A11,086941,duBois; Page Ann,4,0,4,0
1653297375757,MMW 11,A12,093877,duBois; Page Ann,3,0,4,1
1653297376283,MMW 11R,A01,093852,Herbst; Matthew,4,0,4,0
1653297376283,MMW 11R,A02,093853,Herbst; Matthew,4,0,4,0
1653297376283,MMW 11R,A03,093854,Herbst; Matthew,4,0,4,0
1653297376283,MMW 11R,A04,093855,Herbst; Matthew,4,0,4,0
1653297376283,MMW 11R,A05,093856,Herbst; Matthew,4,0,4,0
1653297376283,MMW 11R,A06,093857,Herbst; Matthew,4,0,4,0
1653297376283,MMW 11R,A07,093858,Herbst; Matthew,4,0,4,0
1653297376283,MMW 11R,A08,093859,Herbst; Matthew,4,0,4,0
1653297376283,MMW 11R,A09,093860,Herbst; Matthew,4,0,4,0
1653297376283,MMW 11R,A10,093861,Herbst; Matthew,4,0,4,0
1653297376283,MMW 11R,A11,093862,Herbst; Matthew,4,0,4,0
1653297376283,MMW 11R,A12,093863,Herbst; Matthew,4,0,4,0
1653297376283,MMW 11R,B01,093865,Herbst; Matthew,4,0,4,0
1653297376283,MMW 11R,B02,093866,Herbst; Matthew,4,0,4,0
1653297376283,MMW 11R,B03,093867,Herbst; Matthew,4,0,4,0
1653297376283,MMW 11R,B04,093868,Herbst; Matthew,4,0,4,0
1653297376283,MMW 11R,B05,093869,Herbst; Matthew,4,0,4,0
1653297376283,MMW 11R,B06,093870,Herbst; Matthew,4,0,4,0
1653297376283,MMW 11R,B07,093871,Herbst; Matthew,4,0,4,0
1653297376283,MMW 11R,B08,093872,Herbst; Matthew,4,0,4,0
1653297376283,MMW 11R,B09,093873,Herbst; Matthew,4,0,4,0
1653297376283,MMW 11R,B10,093874,Herbst; Matthew,4,0,4,0
1653297376283,MMW 11R,B11,093875,Herbst; Matthew,4,0,4,0
1653297376283,MMW 11R,B12,093876,Herbst; Matthew,4,0,4,0
1653297376809,MMW 14,A01,086968,Chang; Edmond Yi-Teh,28,0,28,0
1653297376809,MMW 14,A02,086969,Chang; Edmond Yi-Teh,27,0,28,1
1653297376809,MMW 14,A03,086970,Chang; Edmond Yi-Teh,21,0,28,7
1653297376809,MMW 14,A04,086971,Chang; Edmond Yi-Teh,27,0,28,1
1653297376809,MMW 14,A05,086972,Chang; Edmond Yi-Teh,26,0,28,2
1653297376809,MMW 14,A06,086973,Chang; Edmond Yi-Teh,28,0,28,0
1653297376809,MMW 14,A07,086974,Chang; Edmond Yi-Teh,27,0,28,1
1653297376809,MMW 14,A08,086975,Chang; Edmond Yi-Teh,25,0,28,3
1653297376809,MMW 14,A09,086976,Chang; Edmond Yi-Teh,0,0,0,0
1653297376809,MMW 14,A10,086977,Chang; Edmond Yi-Teh,27,0,28,1
1653297376809,MMW 14,A11,086978,Chang; Edmond Yi-Teh,26,0,28,2
1653297376809,MMW 14,A12,086979,Chang; Edmond Yi-Teh,27,0,28,1
1653297376809,MMW 14,A13,086980,Chang; Edmond Yi-Teh,28,0,28,0
1653297377333,MMW 121,A01,086982,Chang; Edmond Yi-Teh,0,0,0,0
1653297377333,MMW 121,A02,086983,Chang; Edmond Yi-Teh,0,0,0,0
1653297377333,MMW 121,A03,086984,Chang; Edmond Yi-Teh,2,0,4,2
1653297377333,MMW 121,A04,086985,Chang; Edmond Yi-Teh,4,0,4,0
1653297377333,MMW 121,A05,086986,Chang; Edmond Yi-Teh,4,0,4,0
1653297377333,MMW 121,A06,086987,Chang; Edmond Yi-Teh,4,0,4,0
1653297377333,MMW 121,A07,086988,Chang; Edmond Yi-Teh,4,0,4,0
1653297377333,MMW 121,A08,086989,Chang; Edmond Yi-Teh,4,0,4,0
1653297377333,MMW 121,B01,086991,Patterson; Patrick H.,4,0,4,0
1653297377333,MMW 121,B02,086992,Patterson; Patrick H.,4,0,4,0
1653297377333,MMW 121,B03,086993,Patterson; Patrick H.,4,0,4,0
1653297377333,MMW 121,B04,086994,Patterson; Patrick H.,3,0,4,1
1653297377333,MMW 121,B05,086995,Patterson; Patrick H.,4,0,4,0
1653297377333,MMW 121,B06,086996,Patterson; Patrick H.,4,0,4,0
1653297377333,MMW 121,B07,086997,Patterson; Patrick H.,4,0,4,0
1653297377333,MMW 121,B08,086998,Patterson; Patrick H.,4,0,4,0
1653297377333,MMW 121,B09,086999,Patterson; Patrick H.,4,0,4,0
1653297377333,MMW 121,B10,087000,Patterson; Patrick H.,4,0,4,0
1653297377333,MMW 121,B11,087001,Patterson; Patrick H.,0,0,0,0
1653297377333,MMW 121,B12,087002,Patterson; Patrick H.,0,0,0,0
1653297377858,MUS 1A,A01,090497,Staff,19,0,20,1
1653297377858,MUS 1A,A02,090498,Staff,13,0,20,7
1653297377858,MUS 1A,A03,090499,Staff,18,0,20,2
1653297377858,MUS 1A,A04,090500,Staff,19,0,20,1
1653297377858,MUS 1A,A05,090501,Staff,20,0,20,0
1653297377858,MUS 1A,A06,090502,Staff,20,0,20,0
1653297377858,MUS 1A,B01,090504,Staff,18,0,20,2
1653297377858,MUS 1A,B02,090505,Staff,20,0,20,0
1653297377858,MUS 1A,B03,090506,Staff,18,0,20,2
1653297377858,MUS 1A,B04,090507,Staff,18,0,20,2
1653297377858,MUS 1A,B05,090508,Staff,16,0,20,4
1653297377858,MUS 1A,B06,090509,Staff,20,0,20,0
1653297378384,MUS 2A,A01,090511,Carlson; Erik Norman,19,0,20,1
1653297378919,MUS 2AK,A00,090512,Ohnishi; Takae,24,0,25,1
1653297378919,MUS 2AK,B00,090513,Ohnishi; Takae,15,0,15,0
1653297379447,MUS 4,A01,090515,Staff,24,0,25,1
1653297379447,MUS 4,A02,090516,Staff,24,0,25,1
1653297379447,MUS 4,A03,090517,Staff,22,0,25,3
1653297379447,MUS 4,A04,090518,Staff,24,0,25,1
1653297379447,MUS 4,A05,090519,Staff,25,0,25,0
1653297379447,MUS 4,A06,090520,Staff,25,0,25,0
1653297379447,MUS 4,A07,090521,Staff,24,0,25,1
1653297379447,MUS 4,A08,090522,Staff,24,0,25,1
1653297379971,MUS 5,A01,090524,Staff,20,0,20,0
1653297379971,MUS 5,A02,090525,Staff,18,0,20,2
1653297379971,MUS 5,A03,090526,Staff,20,0,20,0
1653297379971,MUS 5,A04,090527,Staff,20,0,20,0
1653297379971,MUS 5,A05,090528,Staff,19,0,20,1
1653297380502,MUS 6,A01,090530,Staff,22,0,25,3
1653297380502,MUS 6,A02,090531,Staff,25,0,25,0
1653297380502,MUS 6,A03,090532,Staff,25,0,25,0
1653297380502,MUS 6,A04,090533,Staff,23,0,25,2
1653297381026,MUS 8,A01,090535,Kenyatta; Kamau,17,0,25,8
1653297381026,MUS 8,A02,090536,Kenyatta; Kamau,19,0,25,6
1653297381026,MUS 8,A03,090537,Kenyatta; Kamau,17,0,25,8
1653297381026,MUS 8,A04,090538,Kenyatta; Kamau,21,0,25,4
1653297381549,MUS 12,A01,090540,Narucki; Susan M,20,0,20,0
1653297381549,MUS 12,A02,090541,Narucki; Susan M,20,0,20,0
1653297381549,MUS 12,A03,090542,Narucki; Susan M,17,0,20,3
1653297382078,MUS 15,A01,090544,Staff,21,0,25,4
1653297382078,MUS 15,A02,090545,Staff,23,0,25,2
1653297382078,MUS 15,A03,090546,Staff,24,0,25,1
1653297382078,MUS 15,A04,090547,Staff,22,0,25,3
1653297382078,MUS 15,A05,090548,Staff,25,0,25,0
1653297382078,MUS 15,A06,090549,Staff,24,0,25,1
1653297382605,MUS 19R,A01,090551,Britt; King James,17,0,20,3
1653297382605,MUS 19R,A02,090552,Britt; King James,19,0,20,1
1653297382605,MUS 19R,A03,090553,Britt; King James,20,0,20,0
1653297382605,MUS 19R,A04,090554,Britt; King James,19,0,20,1
1653297382605,MUS 19R,A05,090555,Britt; King James,20,0,20,0
1653297382605,MUS 19R,A06,090556,Britt; King James,18,0,20,2
1653297382605,MUS 19R,A07,090557,Britt; King James,19,0,20,1
1653297382605,MUS 19R,A08,090558,Britt; King James,19,0,20,1
1653297382605,MUS 19R,A09,090559,Britt; King James,20,0,20,0
1653297382605,MUS 19R,A10,090560,Britt; King James,20,0,20,0
1653297382605,MUS 19R,B01,090562,Britt; King James,10,0,10,0
1653297382605,MUS 19R,B02,090563,Britt; King James,10,0,10,0
1653297382605,MUS 19R,B03,090564,Britt; King James,10,0,10,0
1653297382605,MUS 19R,B04,090565,Britt; King James,10,0,10,0
1653297382605,MUS 19R,B05,090566,Britt; King James,10,0,10,0
1653297382605,MUS 19R,B06,090567,Britt; King James,10,0,10,0
1653297382605,MUS 19R,B07,090568,Britt; King James,10,0,10,0
1653297382605,MUS 19R,B08,090569,Britt; King James,10,0,10,0
1653297382605,MUS 19R,B09,090570,Britt; King James,10,0,10,0
1653297382605,MUS 19R,B10,090571,Britt; King James,10,0,10,0
1653297383129,MUS 20,A01,090573,Borgo; David Garcia,12,0,15,3
1653297383129,MUS 20,A02,090574,Borgo; David Garcia,14,0,15,1
1653297383129,MUS 20,A03,090575,Borgo; David Garcia,13,0,15,2
1653297383653,MUS 32,001,094074,Staff,10,0,10,0
1653297383653,MUS 32,002,094075,Kenyatta; Kamau,10,0,10,0
1653297383653,MUS 32,003,094076,Curtis; Charles Rector,10,0,10,0
1653297383653,MUS 32,005,094078,Terrazas Perez; Wilfrido D,10,0,10,0
1653297383653,MUS 32,006,094079,Ohnishi; Takae,10,0,10,0
1653297383653,MUS 32,007,094080,Burr; Anthony I,10,0,10,0
1653297383653,MUS 32,008,094081,Carlson; Erik Norman,10,0,10,0
1653297383653,MUS 32,009,094082,Dresser; Mark Stuart,10,0,10,0
1653297383653,MUS 32,011,094084,Richards; Stephanie F,10,0,10,0
1653297383653,MUS 32,012,094085,Borgo; David Garcia,10,0,10,0
1653297383653,MUS 32,013,094086,Paganos Koukakis; Dimitrios,10,0,10,0
1653297383653,MUS 32,014,094087,Jones; Michael David,10,0,10,0
1653297384176,MUS 32V,A00,094355,Zazueta Cervera; Miguel Angel,10,0,10,0
1653297384176,MUS 32V,B00,094089,Flores; Mariana,10,0,10,0
1653297384701,MUS 32VM,A00,094090,Zazueta Cervera; Miguel Angel,15,0,15,0
1653297385227,MUS 33A,A00,090576,Liang; Lei,24,0,25,1
1653297385751,MUS 43,A00,090577,Burr; Anthony I,92,0,100,8
1653297386276,MUS 95C,B00,094829,Staff,28,0,30,2
1653297386799,MUS 95D,A00,090579,Staff,30,0,30,0
1653297387413,MUS 95E,A00,090580,Staff,30,0,30,0
1653297387941,MUS 95G,A00,090581,Anderson; Kenneth,384,0,395,11
1653297387941,MUS 95G,B00,090582,Anderson; Kenneth,393,0,395,2
1653297388467,MUS 95JC,A00,090583,Kenyatta; Kamau,35,0,35,0
1653297388991,MUS 95L,A00,090584,Staff,30,0,30,0
1653297389516,MUS 95W,A00,090585,Seshadri; Kartik,60,0,60,0
1653297389516,MUS 95W,B00,090586,Seshadri; Kartik,30,0,30,0
1653297390050,MUS 101A,A01,090588,Staff,29,0,30,1
1653297390577,MUS 103A,A00,090589,Ung; Chinary,15,0,15,0
1653297391100,MUS 107,A00,090590,Terrazas Perez; Wilfrido D,30,0,30,0
1653297391629,MUS 111,A00,090591,Yadegari; Shahrokh D,124,0,130,6
1653297392153,MUS 114,A00,090592,Curtis; Charles Rector,117,0,125,8
1653297392681,MUS 120A,A01,090594,Cimini; Amy Marie,29,0,30,1
1653297393214,MUS 126R,A00,090595,Borgo; David Garcia,106,0,115,9
1653297393743,MUS 130,A00,090596,Ohnishi; Takae,30,0,30,0
1653297394272,MUS 132,001,094091,Nourai; Keyarash,10,0,10,0
1653297394272,MUS 132,002,094093,Kenyatta; Kamau,10,0,10,0
1653297394272,MUS 132,003,094094,Curtis; Charles Rector,10,0,10,0
1653297394272,MUS 132,005,094096,Terrazas Perez; Wilfrido D,10,0,10,0
1653297394272,MUS 132,006,094097,Ohnishi; Takae,10,0,10,0
1653297394272,MUS 132,007,094098,Burr; Anthony I,10,0,10,0
1653297394272,MUS 132,008,094099,Carlson; Erik Norman,10,0,10,0
1653297394272,MUS 132,009,094100,Dresser; Mark Stuart,10,0,10,0
1653297394272,MUS 132,011,094102,Richards; Stephanie F,10,0,10,0
1653297394272,MUS 132,012,094103,Borgo; David Garcia,10,0,10,0
1653297394272,MUS 132,013,094104,Jones; Michael David,10,0,10,0
1653297394272,MUS 132,014,094105,Staff,10,0,10,0
1653297394796,MUS 132V,A00,094106,Narucki; Susan M,15,0,15,0
1653297395342,MUS 134,A00,090597,Staff,30,0,30,0
1653297395869,MUS 137A,A00,090598,Kenyatta; Kamau,30,0,30,0
1653297396403,MUS 143,A00,090599,Staff,26,0,30,4
1653297397453,MUS 173,A00,090600,Britt; King James,19,0,30,11
1653297397977,MUS 174A,A00,090601,Staff,8,0,15,7
1653297399032,NANO 4,A01,088199,Vazquez Mena; Oscar,20,0,20,0
1653297399032,NANO 4,B01,088201,Vazquez Mena; Oscar,20,0,20,0
1653297399032,NANO 4,C01,088203,Vazquez Mena; Oscar,20,0,20,0
1653297399559,NANO 15,A01,088205,Lubarda; Vlado,50,0,50,0
1653297399559,NANO 15,B01,088207,Lubarda; Vlado,50,0,50,0
1653297400084,NANO 20L,A00,088208,Sirbuly; Donald,27,0,30,3
1653297400084,NANO 20L,B00,088209,Sirbuly; Donald,29,0,30,1
1653297400608,NANO 100L,A00,088210,Vecchio; Kenneth S,24,0,30,6
1653297401137,NANO 102,A00,088211,Tao; Andrea Rae,94,0,100,6
1653297401667,NANO 110,A00,088212,Pascal; Tod A,99,0,100,1
1653297402192,NANO 111,A00,088213,Fenning; David,45,0,50,5
1653297402719,NANO 117,A00,088214,Cubukcu; Ertugrul,71,0,75,4
1653297403243,NANO 119,A00,088215,Vazquez Mena; Oscar,50,0,50,0
1653297403770,NANO 159,A00,088216,Wang; Joseph,33,0,40,7
1653297404295,NANO 181,A01,088218,Ong; Shyue Ping,22,0,25,3
1653297404819,PHIL 1,A00,090815,Sher; Gila,57,0,60,3
1653297405348,PHIL 10,A01,090817,Grush; Rick Scott,37,0,40,3
1653297405348,PHIL 10,A02,090818,Grush; Rick Scott,37,0,40,3
1653297405348,PHIL 10,A03,090819,Grush; Rick Scott,38,0,40,2
1653297405348,PHIL 10,A04,090820,Grush; Rick Scott,40,0,40,0
1653297405348,PHIL 10,A05,090821,Grush; Rick Scott,38,0,40,2
1653297405348,PHIL 10,A06,090822,Grush; Rick Scott,39,0,40,1
1653297405884,PHIL 12,A01,090824,Bechtel; William,20,0,25,5
1653297405884,PHIL 12,A02,090825,Bechtel; William,24,0,25,1
1653297405884,PHIL 12,A03,090826,Bechtel; William,25,0,25,0
1653297405884,PHIL 12,A04,090827,Bechtel; William,25,0,25,0
1653297406417,PHIL 13,A01,090829,Wonderly; Monique L.,25,0,25,0
1653297406417,PHIL 13,A02,090830,Wonderly; Monique L.,24,0,25,1
1653297406417,PHIL 13,A03,090831,Wonderly; Monique L.,24,0,25,1
1653297406417,PHIL 13,A04,090832,Wonderly; Monique L.,25,0,25,0
1653297406941,PHIL 27,A01,090834,Harrell; Maralee Mae,23,0,35,12
1653297406941,PHIL 27,A02,090835,Harrell; Maralee Mae,35,0,35,0
1653297406941,PHIL 27,A03,090836,Harrell; Maralee Mae,33,0,35,2
1653297406941,PHIL 27,A04,090837,Harrell; Maralee Mae,33,0,35,2
1653297406941,PHIL 27,A05,090838,Harrell; Maralee Mae,35,0,35,0
1653297406941,PHIL 27,A06,090839,Harrell; Maralee Mae,35,0,35,0
1653297407465,PHIL 28,A01,090841,Bazargan-Forward; Saba,31,0,35,4
1653297407465,PHIL 28,A02,090842,Bazargan-Forward; Saba,31,0,35,4
1653297407465,PHIL 28,A03,090843,Bazargan-Forward; Saba,35,0,35,0
1653297407465,PHIL 28,A04,090844,Bazargan-Forward; Saba,30,0,35,5
1653297407465,PHIL 28,A05,090845,Bazargan-Forward; Saba,33,0,35,2
1653297407465,PHIL 28,A06,090846,Bazargan-Forward; Saba,34,0,35,1
1653297407465,PHIL 28,A07,090847,Bazargan-Forward; Saba,32,0,35,3
1653297407465,PHIL 28,A08,090848,Bazargan-Forward; Saba,33,0,35,2
1653297407990,PHIL 31,A00,090849,Johnson; Monte,59,0,60,1
1653297408512,PHIL 100,A00,090852,Nelkin; Dana Kay,28,0,35,7
1653297409041,PHIL 110,A00,090853,Johnson; Monte,29,0,30,1
1653297409569,PHIL 120,A00,090854,Rickless; Samuel Charles,23,0,35,12
1653297410094,PHIL 123,A00,090855,Sher; Gila,38,0,40,2
1653297410619,PHIL 131,A00,090856,Cohen; Jonathan David,34,0,35,1
1653297411145,PHIL 132,A00,090857,Carr; Jennifer Rose,33,0,35,2
1653297411672,PHIL 138,A00,090858,Brink; David O.,34,0,40,6
1653297412197,PHIL 147,A00,090860,Fulkerson; Matthew Todd,33,0,35,2
1653297412722,PHIL 150,A00,090861,Bechtel; William,36,0,40,4
1653297413251,PHIL 155,A00,090862,Vargas; Manuel Rogelio,38,0,40,2
1653297413777,PHIL 165,A00,090863,Rickless; Samuel Charles,58,0,70,12
1653297414303,PHIL 172,A00,090864,Bazargan-Forward; Saba,37,0,40,3
1653297414828,PHIL 173,A00,090865,Wonderly; Monique L.,33,0,40,7
1653297415353,PHYS 1A,A00,088555,Koslover; Elena F,354,0,362,8
1653297415353,PHYS 1A,B00,088556,Koslover; Elena F,343,0,362,19
1653297415353,PHYS 1A,C00,088557,Shpyrko; Oleg,326,0,362,36
1653297415882,PHYS 1AL,001,088558,Tsai; Philbert S,30,0,30,0
1653297415882,PHYS 1AL,002,088559,Tsai; Philbert S,30,0,30,0
1653297415882,PHYS 1AL,003,088560,Tsai; Philbert S,23,0,30,7
1653297415882,PHYS 1AL,004,088561,Tsai; Philbert S,26,0,30,4
1653297415882,PHYS 1AL,005,088562,Tsai; Philbert S,24,0,30,6
1653297415882,PHYS 1AL,006,088563,Tsai; Philbert S,30,0,30,0
1653297415882,PHYS 1AL,007,088564,Tsai; Philbert S,26,0,30,4
1653297415882,PHYS 1AL,008,088565,Tsai; Philbert S,29,0,30,1
1653297415882,PHYS 1AL,009,088566,Tsai; Philbert S,28,0,30,2
1653297415882,PHYS 1AL,010,088567,Tsai; Philbert S,30,0,30,0
1653297415882,PHYS 1AL,011,088568,Tsai; Philbert S,29,0,30,1
1653297415882,PHYS 1AL,012,088569,Tsai; Philbert S,29,0,30,1
1653297415882,PHYS 1AL,013,088570,Tsai; Philbert S,30,0,30,0
1653297415882,PHYS 1AL,014,088571,Tsai; Philbert S,29,0,30,1
1653297415882,PHYS 1AL,015,088572,Tsai; Philbert S,23,0,30,7
1653297415882,PHYS 1AL,016,088573,Tsai; Philbert S,28,0,30,2
1653297415882,PHYS 1AL,017,088574,Tsai; Philbert S,29,0,30,1
1653297415882,PHYS 1AL,018,088575,Tsai; Philbert S,28,0,30,2
1653297415882,PHYS 1AL,019,088576,Tsai; Philbert S,26,0,30,4
1653297415882,PHYS 1AL,020,088577,Tsai; Philbert S,29,0,30,1
1653297415882,PHYS 1AL,021,088578,Tsai; Philbert S,30,0,30,0
1653297415882,PHYS 1AL,022,088579,Tsai; Philbert S,30,0,30,0
1653297415882,PHYS 1AL,023,088580,Tsai; Philbert S,30,0,30,0
1653297415882,PHYS 1AL,024,088581,Tsai; Philbert S,30,0,30,0
1653297415882,PHYS 1AL,025,088582,Tsai; Philbert S,26,0,30,4
1653297415882,PHYS 1AL,026,088583,Tsai; Philbert S,29,0,30,1
1653297415882,PHYS 1AL,027,088584,Tsai; Philbert S,28,0,30,2
1653297415882,PHYS 1AL,028,088585,Tsai; Philbert S,30,0,30,0
1653297415882,PHYS 1AL,029,088586,Tsai; Philbert S,27,0,30,3
1653297415882,PHYS 1AL,030,088587,Tsai; Philbert S,29,0,30,1
1653297415882,PHYS 1AL,031,088588,Tsai; Philbert S,30,0,30,0
1653297415882,PHYS 1AL,032,088589,Tsai; Philbert S,30,0,30,0
1653297415882,PHYS 1AL,033,088590,Tsai; Philbert S,30,0,30,0
1653297415882,PHYS 1AL,034,088591,Tsai; Philbert S,30,0,30,0
1653297415882,PHYS 1AL,035,088592,Tsai; Philbert S,29,0,30,1
1653297415882,PHYS 1AL,036,088593,Tsai; Philbert S,30,0,30,0
1653297416406,PHYS 1B,A00,088594,Groisman; Alexander,351,0,360,9
1653297416933,PHYS 1BL,001,088595,Tsai; Philbert S,30,0,30,0
1653297416933,PHYS 1BL,002,088596,Tsai; Philbert S,25,0,30,5
1653297416933,PHYS 1BL,003,088597,Tsai; Philbert S,27,0,30,3
1653297416933,PHYS 1BL,004,088598,Tsai; Philbert S,30,0,30,0
1653297416933,PHYS 1BL,005,088599,Tsai; Philbert S,29,0,30,1
1653297416933,PHYS 1BL,006,088600,Tsai; Philbert S,25,0,30,5
1653297416933,PHYS 1BL,007,088601,Tsai; Philbert S,30,0,30,0
1653297416933,PHYS 1BL,008,088602,Tsai; Philbert S,29,0,30,1
1653297416933,PHYS 1BL,009,088603,Tsai; Philbert S,30,0,30,0
1653297416933,PHYS 1BL,010,088604,Tsai; Philbert S,30,0,30,0
1653297416933,PHYS 1BL,011,088605,Tsai; Philbert S,28,0,30,2
1653297416933,PHYS 1BL,012,088606,Tsai; Philbert S,26,0,30,4
1653297417456,PHYS 1C,A00,088607,Tsai; Philbert S,334,0,360,26
1653297417994,PHYS 1CL,001,088608,Tsai; Philbert S,30,0,30,0
1653297417994,PHYS 1CL,002,088609,Tsai; Philbert S,24,0,30,6
1653297417994,PHYS 1CL,003,088610,Tsai; Philbert S,24,0,30,6
1653297417994,PHYS 1CL,004,088611,Tsai; Philbert S,29,0,30,1
1653297417994,PHYS 1CL,005,088612,Tsai; Philbert S,17,0,30,13
1653297417994,PHYS 1CL,006,088613,Tsai; Philbert S,19,0,30,11
1653297417994,PHYS 1CL,007,088614,Tsai; Philbert S,30,0,30,0
1653297417994,PHYS 1CL,008,088615,Tsai; Philbert S,26,0,30,4
1653297417994,PHYS 1CL,009,088616,Tsai; Philbert S,27,0,30,3
1653297417994,PHYS 1CL,010,088617,Tsai; Philbert S,29,0,30,1
1653297417994,PHYS 1CL,011,088618,Tsai; Philbert S,27,0,30,3
1653297417994,PHYS 1CL,012,088619,Tsai; Philbert S,24,0,30,6
1653297418529,PHYS 2A,A01,092602,Meyertholen; Andrew D.,26,0,30,4
1653297418529,PHYS 2A,A02,092603,Meyertholen; Andrew D.,28,0,30,2
1653297418529,PHYS 2A,A03,092604,Meyertholen; Andrew D.,29,0,30,1
1653297418529,PHYS 2A,A04,092605,Meyertholen; Andrew D.,30,0,30,0
1653297418529,PHYS 2A,A05,092606,Meyertholen; Andrew D.,29,0,30,1
1653297418529,PHYS 2A,A06,092607,Meyertholen; Andrew D.,29,0,30,1
1653297418529,PHYS 2A,A07,092608,Meyertholen; Andrew D.,30,0,30,0
1653297418529,PHYS 2A,A08,092609,Meyertholen; Andrew D.,30,0,30,0
1653297418529,PHYS 2A,A09,092610,Meyertholen; Andrew D.,27,0,30,3
1653297418529,PHYS 2A,A10,092611,Meyertholen; Andrew D.,30,0,30,0
1653297418529,PHYS 2A,A11,092612,Meyertholen; Andrew D.,30,0,30,0
1653297418529,PHYS 2A,A12,094499,Meyertholen; Andrew D.,27,0,30,3
1653297419056,PHYS 2B,A01,092613,Branson; James G,28,0,30,2
1653297419056,PHYS 2B,A02,092614,Branson; James G,29,0,30,1
1653297419056,PHYS 2B,A03,092615,Branson; James G,30,0,30,0
1653297419056,PHYS 2B,A04,092616,Branson; James G,30,0,30,0
1653297419056,PHYS 2B,A05,092617,Branson; James G,29,0,30,1
1653297419056,PHYS 2B,A06,092618,Branson; James G,29,0,30,1
1653297419056,PHYS 2B,A07,092619,Branson; James G,29,0,30,1
1653297419056,PHYS 2B,A08,092620,Branson; James G,0,0,0,0
1653297419056,PHYS 2B,A09,092621,Branson; James G,0,0,0,0
1653297419056,PHYS 2B,A10,092622,Branson; James G,0,0,0,0
1653297419056,PHYS 2B,A11,092623,Branson; James G,0,0,0,0
1653297419056,PHYS 2B,A12,092624,Branson; James G,30,0,30,0
1653297419590,PHYS 2C,A01,092625,Barreiro Guerrero; Julio,27,0,30,3
1653297419590,PHYS 2C,A02,092626,Barreiro Guerrero; Julio,28,0,30,2
1653297419590,PHYS 2C,A03,092627,Barreiro Guerrero; Julio,29,0,30,1
1653297419590,PHYS 2C,A04,092628,Barreiro Guerrero; Julio,29,0,30,1
1653297419590,PHYS 2C,A05,092629,Barreiro Guerrero; Julio,30,0,30,0
1653297419590,PHYS 2C,A06,092630,Barreiro Guerrero; Julio,30,0,30,0
1653297419590,PHYS 2C,A07,092631,Barreiro Guerrero; Julio,30,0,30,0
1653297419590,PHYS 2C,A08,092632,Barreiro Guerrero; Julio,30,0,30,0
1653297419590,PHYS 2C,A09,092633,Barreiro Guerrero; Julio,29,0,30,1
1653297419590,PHYS 2C,A10,092634,Barreiro Guerrero; Julio,29,0,30,1
1653297419590,PHYS 2C,A11,092635,Barreiro Guerrero; Julio,27,0,30,3
1653297419590,PHYS 2C,A12,092636,Barreiro Guerrero; Julio,29,0,30,1
1653297419590,PHYS 2C,B01,092637,Barreiro Guerrero; Julio,29,0,30,1
1653297419590,PHYS 2C,B02,092638,Barreiro Guerrero; Julio,30,0,30,0
1653297419590,PHYS 2C,B03,092639,Barreiro Guerrero; Julio,28,0,30,2
1653297419590,PHYS 2C,B04,092640,Barreiro Guerrero; Julio,29,0,30,1
1653297419590,PHYS 2C,B05,092641,Barreiro Guerrero; Julio,26,0,30,4
1653297419590,PHYS 2C,B06,092642,Barreiro Guerrero; Julio,28,0,30,2
1653297419590,PHYS 2C,B07,092643,Barreiro Guerrero; Julio,29,0,30,1
1653297419590,PHYS 2C,B08,092644,Barreiro Guerrero; Julio,30,0,30,0
1653297419590,PHYS 2C,B09,092645,Barreiro Guerrero; Julio,29,0,30,1
1653297419590,PHYS 2C,B10,092646,Barreiro Guerrero; Julio,29,0,30,1
1653297419590,PHYS 2C,B11,092647,Barreiro Guerrero; Julio,30,0,30,0
1653297419590,PHYS 2C,B12,092648,Barreiro Guerrero; Julio,30,0,30,0
1653297420114,PHYS 2CL,A01,088625,Du; Chunhui,26,0,30,4
1653297420114,PHYS 2CL,A02,088626,Du; Chunhui,29,0,30,1
1653297420114,PHYS 2CL,A03,088627,Du; Chunhui,21,0,30,9
1653297420114,PHYS 2CL,A04,088628,Du; Chunhui,30,0,30,0
1653297420114,PHYS 2CL,A05,088629,Du; Chunhui,29,0,30,1
1653297420114,PHYS 2CL,A06,088630,Du; Chunhui,24,0,30,6
1653297420114,PHYS 2CL,A07,088631,Du; Chunhui,28,0,30,2
1653297420114,PHYS 2CL,A08,088632,Du; Chunhui,28,0,30,2
1653297420114,PHYS 2CL,A09,088633,Du; Chunhui,24,0,30,6
1653297420114,PHYS 2CL,A10,088634,Du; Chunhui,29,0,30,1
1653297420114,PHYS 2CL,A11,088635,Du; Chunhui,27,0,30,3
1653297420114,PHYS 2CL,A12,088636,Du; Chunhui,30,0,30,0
1653297420645,PHYS 2D,A01,092649,Hirsch; Jorge Eduardo,30,0,30,0
1653297420645,PHYS 2D,A02,092650,Hirsch; Jorge Eduardo,28,0,30,2
1653297420645,PHYS 2D,A03,092651,Hirsch; Jorge Eduardo,30,0,30,0
1653297420645,PHYS 2D,A04,092652,Hirsch; Jorge Eduardo,30,0,30,0
1653297420645,PHYS 2D,A05,092653,Hirsch; Jorge Eduardo,30,0,30,0
1653297420645,PHYS 2D,A06,092654,Hirsch; Jorge Eduardo,30,0,30,0
1653297421175,PHYS 2DL,A01,088639,Butov; Leonid,7,0,16,9
1653297421175,PHYS 2DL,A02,088640,Butov; Leonid,13,0,16,3
1653297421175,PHYS 2DL,A03,094501,Butov; Leonid,13,0,16,3
1653297421175,PHYS 2DL,A04,094502,Butov; Leonid,16,0,16,0
1653297421701,PHYS 4C,A01,092655,Averitt; Richard Douglas,28,0,30,2
1653297421701,PHYS 4C,A02,092656,Averitt; Richard Douglas,30,0,30,0
1653297421701,PHYS 4C,A03,092657,Averitt; Richard Douglas,30,0,30,0
1653297421701,PHYS 4C,A04,092658,Staff,30,0,30,0
1653297422230,PHYS 5,A01,092662,Konopacky; Quinn Morgan,197,0,200,3
1653297422779,PHYS 10,A01,092663,Tytler; David Robert,191,0,192,1
1653297423318,PHYS 100A,A01,092660,Shpyrko; Oleg,114,0,120,6
1653297423845,PHYS 110A,A01,092664,Arovas; Daniel P,116,0,120,4
1653297424375,PHYS 122,A01,088647,Yang; Liang,30,0,40,10
1653297424898,PHYS 130B,A01,092661,Grover; Tarun,106,0,120,14
1653297425429,PHYS 139,A00,088649,Kuti; Julius,19,0,20,1
1653297425958,PHYS 140A,A01,092665,Shotwell; Brian,105,0,120,15
1653297426487,PHYS 161,A01,092666,Fuller; George Michael,46,0,65,19
1653297427012,PHYS 163,A01,092667,Keres; Dusan,48,0,50,2
1653297427535,PHYS 175,A00,088653,Dudko; Olga,18,0,20,2
1653297428064,PHYS 191,A00,088654,Shpyrko; Oleg,26,0,30,4
1653297428590,POLI 11D,A01,090896,Ferree; Karen E,29,0,30,1
1653297428590,POLI 11D,A02,090897,Ferree; Karen E,28,0,30,2
1653297428590,POLI 11D,A03,090899,Ferree; Karen E,28,0,30,2
1653297428590,POLI 11D,A04,090900,Ferree; Karen E,29,0,30,1
1653297429119,POLI 12D,A01,090902,Roeder; Philip G,26,0,30,4
1653297429119,POLI 12D,A02,090903,Roeder; Philip G,27,0,30,3
1653297429119,POLI 12D,A05,090906,Roeder; Philip G,28,0,30,2
1653297429119,POLI 12D,A06,090907,Roeder; Philip G,30,0,30,0
1653297429649,POLI 13DR,A01,090909,Forman; Fonna,26,0,30,4
1653297429649,POLI 13DR,A02,090910,Forman; Fonna,30,0,30,0
1653297429649,POLI 13DR,A03,090911,Forman; Fonna,28,0,30,2
1653297429649,POLI 13DR,A04,090912,Forman; Fonna,30,0,30,0
1653297429649,POLI 13DR,A05,090913,Forman; Fonna,28,0,30,2
1653297429649,POLI 13DR,A06,090914,Forman; Fonna,34,0,34,0
1653297430176,POLI 27,A01,090916,Elgin; Samuel Zincke,23,0,30,7
1653297430176,POLI 27,A02,090917,Elgin; Samuel Zincke,26,0,30,4
1653297430176,POLI 27,A03,090918,Elgin; Samuel Zincke,30,0,30,0
1653297430176,POLI 27,A04,090919,Elgin; Samuel Zincke,28,0,30,2
1653297430176,POLI 27,A05,090920,Elgin; Samuel Zincke,24,0,30,6
1653297430176,POLI 27,A06,090921,Elgin; Samuel Zincke,29,0,30,1
1653297430706,POLI 28,A01,090923,Elgin; Samuel Zincke,23,0,30,7
1653297430706,POLI 28,A02,090924,Elgin; Samuel Zincke,26,0,30,4
1653297430706,POLI 28,A05,090927,Elgin; Samuel Zincke,23,0,30,7
1653297430706,POLI 28,A06,090928,Elgin; Samuel Zincke,23,0,30,7
1653297431231,POLI 30D,A01,090930,Desposato; Scott,22,0,24,2
1653297431231,POLI 30D,A02,090931,Desposato; Scott,22,0,24,2
1653297431231,POLI 30D,A03,090932,Desposato; Scott,23,0,24,1
1653297431231,POLI 30D,A04,090933,Desposato; Scott,24,0,24,0
1653297431231,POLI 30D,A05,090934,Desposato; Scott,23,0,24,1
1653297431231,POLI 30D,A06,090935,Desposato; Scott,24,0,24,0
1653297431756,POLI 100G,A00,090936,Fletcher; Nathan,199,0,208,9
1653297432284,POLI 100V,A00,090937,Gause; LaGina,111,0,115,4
1653297432812,POLI 100W,A00,090938,Paglayan; Agustina,161,0,165,4
1653297433336,POLI 104A,A00,090940,Smith; Glenn Chatmas,186,0,195,9
1653297433860,POLI 104F,A00,090941,Smith; Glenn Chatmas,11,0,19,8
1653297434385,POLI 104M,A00,090942,Stephens; Mattheus E,156,0,165,9
1653297434919,POLI 110A,A00,090943,Wiens; David,39,0,44,5
1653297435446,POLI 110F,A00,090944,Elgin; Samuel Zincke,50,0,50,0
1653297435972,POLI 113A,A00,090945,Magagna; Victor Valentine,469,0,475,6
1653297435972,POLI 113A,B00,090946,Magagna; Victor Valentine,467,0,475,8
1653297436499,POLI 117R,A00,090947,Forman; Fonna,16,0,40,24
1653297437029,POLI 120E,A00,090948,Strom; Kaare,47,0,50,3
1653297437553,POLI 120G,A00,090949,Fisk; David Lee,110,0,115,5
1653297438075,POLI 120H,A00,090950,Fisk; David Lee,111,0,115,4
1653297438596,POLI 133A,A00,090951,Naoi; Megumi,156,0,165,9
1653297439125,POLI 135,A00,090952,Fisk; David Lee,111,0,115,4
1653297439653,POLI 142J,A00,090953,Slantchev; Branislav,45,0,50,5
1653297440177,POLI 143,A00,090954,Gartzke; Erik,111,0,115,4
1653297440775,POLI 149,A00,090955,Joseph; Michael F,152,0,165,13
1653297441304,POLI 151,A00,090956,Schneider; Christina,92,0,100,8
1653297441833,POLI 165,A00,090957,Warren; Scott,45,0,50,5
1653297442361,POLI 178,A00,090958,Joseph; Michael F,34,0,50,16
1653297442885,POLI 191A,A00,090959,Forman; Fonna & Hoston; Germaine,25,0,25,0
1653297443412,POLI 194,A00,090960,Hill; Seth J,9999,0,9999,0
1653297443939,POLI 194SD,A00,090961,Nichter; Maysa,9999,0,9999,0
1653297444463,POLI 197SD,001,090962,Nichter; Maysa,9999,0,9999,0
1653297444988,PSYC 1,A00,088391,Ferreira; Victor,194,0,200,6
1653297445517,PSYC 2,A00,093916,Moranton; Nirelia Melbina-,192,0,195,3
1653297446040,PSYC 3,A00,088392,Pilegard; Celeste Cristine,221,0,225,4
1653297446568,PSYC 6,A00,088393,McCullough; Michael E,198,0,200,2
1653297447109,PSYC 7,A00,088394,Powell; Lindsey Jane,196,0,200,4
1653297447639,PSYC 60,A01,088397,Lowe; Angela Beth,12,0,25,13
1653297447639,PSYC 60,A02,088398,Lowe; Angela Beth,25,0,25,0
1653297447639,PSYC 60,A03,088399,Lowe; Angela Beth,24,0,25,1
1653297447639,PSYC 60,A04,088400,Lowe; Angela Beth,23,0,25,2
1653297447639,PSYC 60,A05,088401,Lowe; Angela Beth,24,0,25,1
1653297447639,PSYC 60,A06,088402,Lowe; Angela Beth,25,0,25,0
1653297447639,PSYC 60,A07,088403,Lowe; Angela Beth,24,0,25,1
1653297447639,PSYC 60,B01,088405,Rickard; Timothy C.,25,0,25,0
1653297447639,PSYC 60,B02,088406,Rickard; Timothy C.,25,0,25,0
1653297447639,PSYC 60,B03,088407,Rickard; Timothy C.,25,0,25,0
1653297447639,PSYC 60,B04,088408,Rickard; Timothy C.,23,0,25,2
1653297447639,PSYC 60,B05,088410,Rickard; Timothy C.,24,0,25,1
1653297447639,PSYC 60,B06,088411,Rickard; Timothy C.,24,0,25,1
1653297447639,PSYC 60,B07,088412,Rickard; Timothy C.,24,0,25,1
1653297448163,PSYC 70,A01,088414,Pilegard; Celeste Cristine,17,0,25,8
1653297448163,PSYC 70,A02,088415,Pilegard; Celeste Cristine,24,0,25,1
1653297448163,PSYC 70,A03,088416,Pilegard; Celeste Cristine,25,0,25,0
1653297448163,PSYC 70,A04,088417,Pilegard; Celeste Cristine,25,0,25,0
1653297448163,PSYC 70,A05,088418,Pilegard; Celeste Cristine,22,0,25,3
1653297448163,PSYC 70,A06,088419,Pilegard; Celeste Cristine,19,0,25,6
1653297448692,PSYC 71,A01,088421,Lowe; Angela Beth,15,0,25,10
1653297448692,PSYC 71,A02,088422,Lowe; Angela Beth,21,0,25,4
1653297448692,PSYC 71,B01,088424,Steiner; Eric Tomas,20,0,25,5
1653297448692,PSYC 71,B02,088425,Steiner; Eric Tomas,23,0,25,2
1653297449215,PSYC 87,A00,093915,Gorman; Michael R.,20,0,20,0
1653297449848,PSYC 88,A00,088426,Dobkins; Karen R.,61,0,65,4
1653297450372,PSYC 100,A00,088428,Chapman; Eddie Nathaniel,125,0,170,45
1653297450901,PSYC 101,A00,088429,Heyman; Gail D.,148,0,170,22
1653297451423,PSYC 102,A00,093917,Moranton; Nirelia Melbina-,162,0,170,8
1653297451948,PSYC 104,A00,088430,Fine; Rachel,163,0,175,12
1653297452473,PSYC 116A,A01,088433,Lang; Ariel,25,0,25,0
1653297452994,PSYC 122,A00,088434,Miller; Cory T.,103,0,115,12
1653297453520,PSYC 125,A00,088436,Rose; Fred E.,90,0,120,30
1653297454045,PSYC 134,A00,088437,Kaye; Walter H.,235,0,250,15
1653297454570,PSYC 137,A00,088438,Fine; Rachel,210,0,216,6
1653297455100,PSYC 145,A00,093918,Staff,73,0,90,17
1653297455626,PSYC 147,A00,088441,Wong; Lauren Hitomi,120,0,146,26
1653297456149,PSYC 154,A00,093919,Lacefield; Katharine I,270,0,295,25
1653297456676,PSYC 158,A00,088443,Willis; Jarryd Thomas,250,0,295,45
1653297457200,PSYC 162,A00,088444,Wixted; John T,210,0,225,15
1653297457726,PSYC 167,A00,088445,Walker; Caren Michelle,0,0,30,30
1653297458250,PSYC 168,A00,088446,Chapman; Eddie Nathaniel,222,0,250,28
1653297458777,PSYC 171,A00,088447,Mukku; Dhananjaya,66,0,75,9
1653297459300,PSYC 178,A00,088448,Glaser; Dale,105,0,120,15
1653297459828,PSYC 179,A00,088449,Lacefield; Katharine I,193,0,250,57
1653297460351,PSYC 181,A00,088450,Anagnostaras; Stephan,284,0,300,16
1653297460879,PSYC 189,A00,088451,Gentner; Tim,19,0,31,12
1653297461402,PSYC 193,A00,088452,Gremel; Christina M,19,0,20,1
1653297461402,PSYC 193,B00,088453,Staff,19,0,20,1
1653297461938,PSYC 193L,A01,088455,Staff,33,0,35,2
1653297462462,PSYC 194A,A01,088461,Heyman; Gail D.,35,0,35,0
1653297463004,RELI 1,A01,086478,Kalleres; Dayna,20,0,20,0
1653297463004,RELI 1,A02,086479,Kalleres; Dayna,19,0,20,1
1653297463528,RELI 147,A00,088409,Caciola; Nancy A,0,0,0,0
1653297464051,REV 1,A01,092308,Leigh; Brian,24,0,24,0
1653297464051,REV 1,A02,092310,Leigh; Brian,24,0,24,0
1653297464051,REV 1,A03,092312,Leigh; Brian,24,0,24,0
1653297464051,REV 1,A04,092314,Leigh; Brian,24,0,24,0
1653297464051,REV 1,A05,092316,Leigh; Brian,24,0,24,0
1653297464576,REV 2,A01,092318,Staff,28,0,28,0
1653297464576,REV 2,A02,092319,Staff,28,0,28,0
1653297465099,REV 20,A00,092320,Staff,40,0,40,0
1653297465626,REV 87,A00,092321,Lyon; Antony J.,20,0,20,0
1653297466149,SE 1,A01,088674,Van Den Einde; Yael Dahlia,48,0,48,0
1653297466149,SE 1,A02,088675,Van Den Einde; Yael Dahlia,47,0,48,1
1653297466149,SE 1,A03,088676,Van Den Einde; Yael Dahlia,46,0,48,2
1653297466672,SE 101A,A00,088677,Morrison; Machel Leigh,191,0,200,9
1653297467197,SE 101C,A00,088678,Zhu; Qiang,137,0,145,8
1653297467722,SE 125,A00,088679,Conte; Joel P,143,0,145,2
1653297468250,SE 130A,A00,088680,Loh; Kenneth J. H.,110,0,115,5
1653297468778,SE 131B,A00,088681,Krysl; Petr,84,0,115,31
1653297469303,SE 142,A01,088683,Staff,11,0,18,7
1653297469303,SE 142,A02,088684,Staff,13,0,18,5
1653297469828,SE 164,A01,088686,Loh; Kenneth J. H.,14,0,16,2
1653297470355,SE 180,A00,088687,Elgamal; Ahmed,66,0,75,9
1653297470887,SE 181,A01,088689,McCartney; John Scott,25,0,30,5
1653297470887,SE 181,A02,088690,McCartney; John Scott,14,0,30,16
1653297470887,SE 181,A03,088691,McCartney; John Scott,25,0,25,0
1653297470887,SE 181,A04,088692,McCartney; John Scott,25,0,25,0
1653297471412,SIO 12,A00,088342,Staff,141,0,146,5
1653297471936,SIO 15,A00,088343,Laske; Gabi,333,0,340,7
1653297472463,SIO 30,A01,092382,Castillo; Paterno R.,28,0,35,7
1653297472463,SIO 30,A02,092383,Castillo; Paterno R.,32,0,35,3
1653297472463,SIO 30,A03,092384,Castillo; Paterno R.,35,0,35,0
1653297472463,SIO 30,A04,092385,Castillo; Paterno R.,35,0,35,0
1653297472994,SIO 40,A00,088345,Barbeau; Katherine,144,0,146,2
1653297473525,SIO 50,A01,088347,Cook; Geoffrey W,11,0,14,3
1653297473525,SIO 50,A02,088348,Cook; Geoffrey W,11,0,14,3
1653297474051,SIO 87,A00,088350,Cook; Geoffrey W,20,0,20,0
1653297474051,SIO 87,B00,088351,Cook; Geoffrey W,20,0,20,0
1653297474051,SIO 87,C00,094017,Gilbert; Jack Anthony,20,0,20,0
1653297474051,SIO 87,D00,094018,Gerwick; William Henry,20,0,20,0
1653297474578,SIO 90,A00,088352,Staff,56,0,60,4
1653297475102,SIO 100,A00,088354,Norris; Richard D. & Gee; Jeffrey S,10,0,20,10
1653297475627,SIO 101,A01,088356,Aluwihare; Lihini & Decima; Moira R.,1,0,30,29
1653297475627,SIO 101,A02,088357,Aluwihare; Lihini & Decima; Moira R.,15,0,30,15
1653297476153,SIO 103,A01,088359,Parnell-Turner; Ross Ernes,21,0,25,4
1653297476677,SIO 105,A00,088360,Driscoll; Neal W.,18,0,20,2
1653297477200,SIO 108,A01,088363,Teranes; Jane,15,0,20,5
1653297477733,SIO 109R,A00,088364,Forman; Fonna,27,0,40,13
1653297478259,SIO 110,A01,088366,Staff,8,0,29,21
1653297478792,SIO 117,A01,088368,Keeling; Ralph F.,31,0,36,5
1653297479315,SIO 123,A00,088369,Allen; Andrew Ellis,61,0,70,9
1653297479847,SIO 132,A01,092386,Hechinger; Ryan F. & Kacev; David,17,0,28,11
1653297479847,SIO 132,A02,092387,Hechinger; Ryan F. & Kacev; David,26,0,28,2
1653297479847,SIO 132,A03,092388,Hechinger; Ryan F. & Kacev; David,28,0,28,0
1653297479847,SIO 132,A04,092389,Hechinger; Ryan F. & Kacev; David,23,0,28,5
1653297479847,SIO 132,A05,092390,Hechinger; Ryan F. & Kacev; David,27,0,28,1
1653297479847,SIO 132,A06,092391,Hechinger; Ryan F. & Kacev; David,27,0,28,1
1653297480376,SIO 136,A01,088373,Kacev; David & Bowman; Jeff Shovlowsky,0,0,5,7
1653297480376,SIO 136,B01,088376,Kacev; David & Bowman; Jeff Shovlowsky,0,0,5,5
1653297480901,SIO 155,A01,088379,Day; James M.D.,1,0,5,4
1653297481428,SIO 170,A00,088380,Cook; Geoffrey W,29,0,30,1
1653297481952,SIO 171,A01,088382,Rudnick; Daniel Lars,37,0,40,3
1653297482475,SIO 175,A01,088384,Merrifield; Mark A,22,0,25,3
1653297483013,SIO 177,A00,088385,Becker; Janet Maria,15,0,20,5
1653297483548,SIO 179,A01,088387,Martz; Todd R.,7,0,15,8
1653297484594,SIO 189,A00,088390,Hamdoun; Amr,35,0,60,25
1653297485121,SIO 194,A00,091602,Hill; Seth J,9999,0,9999,0
1653297485648,SOCE 194,A00,091601,Hill; Seth J,9999,0,9999,0
1653297486175,SOCI 1,A01,093704,Skrentny; John David,19,0,20,1
1653297486175,SOCI 1,A02,093705,Skrentny; John David,20,0,20,0
1653297486175,SOCI 1,A03,093706,Skrentny; John David,18,0,20,2
1653297486175,SOCI 1,A04,093707,Skrentny; John David,19,0,20,1
1653297486175,SOCI 1,A05,093708,Skrentny; John David,17,0,20,3
1653297486175,SOCI 1,A06,093709,Skrentny; John David,20,0,20,0
1653297486175,SOCI 1,A07,093710,Skrentny; John David,20,0,20,0
1653297486175,SOCI 1,A08,093711,Skrentny; John David,20,0,20,0
1653297486175,SOCI 1,A09,093712,Skrentny; John David,20,0,20,0
1653297486175,SOCI 1,A10,093713,Skrentny; John David,20,0,20,0
1653297486175,SOCI 1,A11,093714,Skrentny; John David,20,0,20,0
1653297486704,SOCI 30,A01,093716,Staff,30,0,30,0
1653297486704,SOCI 30,A02,093717,Staff,30,0,30,0
1653297487230,SOCI 60,A01,093719,Staff,17,0,20,3
1653297487230,SOCI 60,A02,093720,Staff,18,0,20,2
1653297487230,SOCI 60,A03,093721,Staff,20,0,20,0
1653297487230,SOCI 60,A04,093722,Staff,20,0,20,0
1653297487752,SOCI 87,A00,093819,Blair-Loy; Mary,20,0,20,0
1653297488281,SOCI 100,A01,093724,Estefan; Michel,15,0,20,5
1653297488281,SOCI 100,A02,093725,Estefan; Michel,5,0,20,15
1653297488808,SOCI 104,A00,093728,Gong; Neil M,22,0,25,3
1653297489330,SOCI 104Q,A00,093729,Staff,23,0,25,2
1653297489854,SOCI 106,A00,093730,Staff,25,0,25,0
1653297490380,SOCI 109,A00,093731,Staff,21,0,25,4
1653297490906,SOCI 110,A00,093732,Binder; Amy,24,0,25,1
1653297492483,SOCI 117,A01,091568,Chung; Luz Marina,29,0,35,6
1653297492483,SOCI 117,A02,091569,Chung; Luz Marina,35,0,35,0
1653297493007,SOCI 118,A00,093735,Staff,0,0,0,0
1653297493533,SOCI 120T,A00,093736,Lampland; Martha,50,0,50,0
1653297493533,SOCI 120T,B00,094832,Staff,69,0,70,1
1653297494168,SOCI 122,A00,093737,Lewis; Kevin Michael,62,0,70,8
1653297494695,SOCI 123,A00,094831,Staff,57,0,65,8
1653297495219,SOCI 125,A00,093738,Staff,115,0,120,5
1653297495743,SOCI 127,A00,094894,Staff,54,0,56,2
1653297496270,SOCI 132,A00,093739,Blair-Loy; Mary,51,0,60,9
1653297497321,SOCI 136F,A00,094830,Staff,45,0,56,11
1653297497849,SOCI 138,A00,093741,Navon; Daniel,117,0,120,3
1653297498372,SOCI 140A,A00,093743,Gong; Neil M,53,0,60,7
1653297498914,SOCI 141,A00,093744,Summers; Valerie R.,111,0,120,9
1653297499971,SOCI 144,A00,093746,Staff,0,0,0,0
1653297502069,SOCI 159,A00,094902,Staff,49,0,50,1
1653297502597,SOCI 160,A00,093750,Staff,0,0,0,0
1653297503121,SOCI 165,A00,093751,Rona-Tas; Akos,43,0,48,5
1653297503650,SOCI 165A,A00,094206,Hallin; Daniel C,3,0,4,1
1653297504173,SOCI 166,A00,093752,Lampland; Martha,52,0,56,4
1653297504701,SOCI 176,A00,093753,Turner; Christena L.,44,0,48,4
1653297505226,SOCI 180,A00,094901,Staff,56,0,56,0
1653297505750,SOCI 185,A00,094903,Staff,55,0,56,1
1653297506276,SOCI 196A,A00,093754,Shafir; Gershon,20,0,20,0
1653297506800,SXTH 1,A01,092351,Bronstein; Phoebe Malan,18,0,18,0
1653297506800,SXTH 1,A02,092352,Bronstein; Phoebe Malan,18,0,18,0
1653297506800,SXTH 1,A03,092353,Bronstein; Phoebe Malan,18,0,18,0
1653297507324,SXTH 20A,A00,092355,Chilukuri; Lakshmi N,56,0,56,0
1653297507891,SYN 2,001,091487,Gladstein; Jill M,13,0,15,2
1653297507891,SYN 2,002,091488,Gladstein; Jill M,14,0,15,1
1653297507891,SYN 2,003,091490,Gladstein; Jill M,12,0,15,3
1653297507891,SYN 2,004,091491,Gladstein; Jill M,15,0,15,0
1653297507891,SYN 2,005,091493,Gladstein; Jill M,15,0,15,0
1653297507891,SYN 2,006,091495,Gladstein; Jill M,15,0,15,0
1653297507891,SYN 2,007,091496,Gladstein; Jill M,15,0,15,0
1653297507891,SYN 2,008,091497,Gladstein; Jill M,14,0,15,1
1653297507891,SYN 2,009,091499,Gladstein; Jill M,13,0,15,2
1653297507891,SYN 2,010,091501,Gladstein; Jill M,13,0,15,2
1653297507891,SYN 2,011,091502,Gladstein; Jill M,13,0,15,2
1653297507891,SYN 2,012,091503,Gladstein; Jill M,15,0,15,0
1653297507891,SYN 2,013,091505,Gladstein; Jill M,13,0,15,2
1653297507891,SYN 2,014,091506,Gladstein; Jill M,12,0,15,3
1653297507891,SYN 2,015,091508,Gladstein; Jill M,14,0,15,1
1653297507891,SYN 2,016,091509,Gladstein; Jill M,12,0,15,3
1653297507891,SYN 2,017,091510,Gladstein; Jill M,14,0,15,1
1653297507891,SYN 2,018,091512,Gladstein; Jill M,15,0,15,0
1653297507891,SYN 2,019,091513,Gladstein; Jill M,15,0,15,0
1653297507891,SYN 2,020,091514,Gladstein; Jill M,15,0,15,0
1653297507891,SYN 2,021,091516,Gladstein; Jill M,12,0,15,3
1653297507891,SYN 2,022,091517,Gladstein; Jill M,13,0,15,2
1653297507891,SYN 2,023,091518,Gladstein; Jill M,15,0,15,0
1653297507891,SYN 2,024,091519,Gladstein; Jill M,15,0,15,0
1653297507891,SYN 2,025,091520,Gladstein; Jill M,11,0,15,4
1653297507891,SYN 2,026,091521,Gladstein; Jill M,15,0,15,0
1653297507891,SYN 2,027,091522,Gladstein; Jill M,0,0,0,0
1653297507891,SYN 2,028,091523,Gladstein; Jill M,0,0,0,0
1653297507891,SYN 2,029,091524,Gladstein; Jill M,0,0,0,0
1653297507891,SYN 2,030,091525,Gladstein; Jill M,0,0,0,0
1653297507891,SYN 2,031,091526,Gladstein; Jill M,14,0,15,1
1653297507891,SYN 2,032,091527,Gladstein; Jill M,15,0,15,0
1653297507891,SYN 2,033,091528,Gladstein; Jill M,0,0,0,0
1653297507891,SYN 2,034,091529,Gladstein; Jill M,15,0,15,0
1653297507891,SYN 2,035,091530,Gladstein; Jill M,15,0,15,0
1653297507891,SYN 2,036,091531,Gladstein; Jill M,15,0,15,0
1653297507891,SYN 2,037,091532,Gladstein; Jill M,15,0,15,0
1653297507891,SYN 2,038,091533,Gladstein; Jill M,15,0,15,0
1653297507891,SYN 2,039,091534,Gladstein; Jill M,15,0,15,0
1653297507891,SYN 2,040,091535,Gladstein; Jill M,15,0,15,0
1653297508422,SYN 100,A01,091537,Gladstein; Jill M,26,0,30,4
1653297508422,SYN 100,B01,091539,Gladstein; Jill M,26,0,30,4
1653297508422,SYN 100,C01,091541,Gladstein; Jill M,26,0,30,4
1653297508422,SYN 100,D01,091543,Gladstein; Jill M,25,0,30,5
1653297508422,SYN 100,E01,091545,Gladstein; Jill M,28,0,30,2
1653297508947,TDAC 1,A00,088922,Walsh; Kim C.,10,0,10,0
1653297508947,TDAC 1,B00,088923,Walsh; Kim C.,8,0,10,2
1653297508947,TDAC 1,C00,088924,Walsh; Kim C.,0,0,10,10
1653297508947,TDAC 1,D00,088925,Walsh; Kim C.,7,0,10,3
1653297508947,TDAC 1,E00,088926,Walsh; Kim C.,2,0,10,8
1653297508947,TDAC 1,F00,088927,Walsh; Kim C.,9,0,10,1
1653297509481,TDAC 101,A00,088972,Harting; Carla Kelso,9,0,10,1
1653297509481,TDAC 101,B00,088973,Salovey; Todd,8,0,10,2
1653297509481,TDAC 101,C00,088974,Walsh; Kim C.,6,0,10,4
1653297510005,TDAC 102,A00,088975,Basso; Beatrice,9,0,10,1
1653297510005,TDAC 102,B00,088976,Basso; Beatrice,7,0,10,3
1653297510538,TDAC 103A,A00,094044,Castro; Robert Jess,32,0,35,3
1653297511064,TDAC 108,A00,088977,Staff,20,0,20,0
1653297511589,TDAC 109,A00,088978,Blair; Kyle Adam,20,0,20,0
1653297512116,TDAC 115,A00,088979,Newcomb; James,20,0,20,0
1653297512642,TDAC 122,A00,088981,Staff,30,0,30,0
1653297513169,TDAC 123,A00,088982,Staff,30,0,30,0
1653297513694,TDDE 1,A01,088929,Benzoni; Elisa,9,0,11,2
1653297513694,TDDE 1,A02,088930,Benzoni; Elisa,11,0,11,0
1653297513694,TDDE 1,A03,088931,Benzoni; Elisa,11,0,11,0
1653297513694,TDDE 1,A04,088932,Benzoni; Elisa,10,0,11,1
1653297513694,TDDE 1,A05,088933,Benzoni; Elisa,11,0,11,0
1653297514220,TDDE 130,A00,088983,Staff,20,0,20,0
1653297514743,TDDE 132,A00,094263,Staff,20,0,20,0
1653297515269,TDDE 169A,A00,094046,Petrovich; Victoria A.,18,0,20,2
1653297515794,TDDM 1,A00,088934,Snaith; Yolande,6,0,10,4
1653297516320,TDDM 5,A00,088935,Smith; Alison D,30,0,30,0
1653297516855,TDDR 101,A00,088986,Powell; Lora,34,0,35,1
1653297517378,TDDR 111,A00,088987,Stalling; Vanessa,24,0,30,6
1653297517378,TDDR 111,B00,094045,Castro; Robert Jess,14,0,16,2
1653297517904,TDDR 190,A00,088988,Stalling; Vanessa,10,0,10,0
1653297518427,TDGE 1,A01,088937,Salovey; Todd,12,0,12,0
1653297518427,TDGE 1,A02,088938,Salovey; Todd,10,0,12,2
1653297518427,TDGE 1,A03,088939,Salovey; Todd,8,0,12,4
1653297518427,TDGE 1,A04,088940,Salovey; Todd,12,0,12,0
1653297518427,TDGE 1,A05,088941,Salovey; Todd,11,0,12,1
1653297518427,TDGE 1,A06,088942,Salovey; Todd,12,0,12,0
1653297518951,TDGE 10,A00,088943,Havis; Allan,191,0,200,9
1653297519478,TDGE 11,A00,088944,Staff,200,0,200,0
1653297520008,TDGE 25,A00,088945,Harting; Carla Kelso,19,0,20,1
1653297520008,TDGE 25,B00,088946,Harting; Carla Kelso,19,0,20,1
1653297520008,TDGE 25,C00,088947,Harting; Carla Kelso,20,0,20,0
1653297520008,TDGE 25,D00,088948,Harting; Carla Kelso,19,0,20,1
1653297520008,TDGE 25,E00,088949,Harting; Carla Kelso,20,0,20,0
1653297520008,TDGE 25,F00,088950,Harting; Carla Kelso,19,0,20,1
1653297520008,TDGE 25,G00,088951,Harting; Carla Kelso,19,0,20,1
1653297520534,TDGE 127,A00,088990,Havis; Allan,188,0,200,12
1653297521064,TDHD 21,A00,088952,Jun; Grace Shin Hae,20,0,20,0
1653297521592,TDHT 10,A00,088953,Power; Jade Yukana,14,0,14,0
1653297521592,TDHT 10,B00,088954,Power; Jade Yukana,13,0,14,1
1653297522118,TDHT 21,A01,088956,Power; Jade Yukana,17,0,18,1
1653297522118,TDHT 21,A02,088957,Power; Jade Yukana,7,0,11,4
1653297522118,TDHT 21,A03,088958,Power; Jade Yukana,11,0,11,0
1653297522647,TDHT 101,A00,088994,Burelle; Julie Sara Veronique,21,0,25,4
1653297523171,TDHT 114,A00,094208,Williams; Madison Mae,47,0,50,3
1653297523698,TDHT 119,A00,094299,Burelle; Julie Sara Veronique,25,0,25,0
1653297524224,TDMV 1,A00,088959,Weinberg; Sadie,23,0,30,7
1653297524748,TDMV 2,A00,088960,Sammartano; Tonnie,27,0,30,3
1653297524748,TDMV 2,B00,094043,Duran; Marcos Antonio,29,0,30,1
1653297525273,TDMV 3,A00,088961,Arcidiacono; Kristin,27,0,30,3
1653297525811,TDMV 110,A00,088995,Wilson; Terry A.,0,0,0,0
1653297526350,TDMV 120,A00,088996,Smith; Alison D,17,0,20,3
1653297526879,TDMV 122,A00,088997,Chaleff; Rebecca,28,0,30,2
1653297527403,TDMV 130,A00,094042,Rincon; Alicia,30,0,30,0
1653297527925,TDMV 138,A00,088998,Jun; Grace Shin Hae,12,0,40,28
1653297528453,TDMV 142,A00,088999,Caligagan; Tony,28,0,40,12
1653297528982,TDMV 143,A00,094041,Foster-King; Sandra,37,0,40,3
1653297529506,TDMV 146,A00,089000,Caligagan; Tony,39,0,40,1
1653297530031,TDPF 160,A00,094264,Snaith; Yolande,30,0,30,0
1653297530031,TDPF 160,B00,094265,Smith; Alison D,30,0,30,0
1653297530031,TDPF 160,C00,094266,Weinberg; Sadie,30,0,30,0
1653297530556,TDPR 6,A01,088963,Benzoni; Elisa,25,0,25,0
1653297530556,TDPR 6,A02,088964,Benzoni; Elisa,25,0,25,0
1653297531085,TDPR 102,A00,089003,Staff,15,0,15,0
1653297531613,TDPR 104,A00,089004,Powell; Lora,15,0,15,0
1653297532137,TDPW 1,A00,088965,Staff,10,0,10,0
1653297532137,TDPW 1,B00,088966,Staff,10,0,10,0
1653297532137,TDPW 1,C00,088967,Staff,9,0,10,1
1653297532137,TDPW 1,D00,088968,Staff,9,0,10,1
1653297532137,TDPW 1,E00,088969,Staff,10,0,10,0
1653297532137,TDPW 1,F00,088970,Staff,9,0,10,1
1653297532662,TDTR 10,A00,088971,Wilson; Terry A.,22,0,25,3
1653297533187,TMC 2,A01,092358,Carver; Leslie J.,20,0,20,0
1653297533187,TMC 2,A02,092359,Carver; Leslie J.,20,0,20,0
1653297533187,TMC 2,A03,092360,Carver; Leslie J.,20,0,20,0
1653297533187,TMC 2,A04,092361,Carver; Leslie J.,20,0,20,0
1653297533187,TMC 2,A05,092362,Carver; Leslie J.,20,0,20,0
1653297533187,TMC 2,A06,092363,Carver; Leslie J.,20,0,20,0
1653297533712,TMC 15,A00,092364,Atkinson; Arthur Laird,20,0,20,0
1653297534239,TMC 20,A00,092365,Carver; Leslie J.,20,0,20,0
1653297534770,TMC 90,A00,092366,Mell; Loren K.,20,0,20,0
1653297535294,TMC 120,A01,092368,Staff,20,0,20,0
1653297535819,USP 1,A01,087520,Kwak; Nancy,19,0,20,1
1653297535819,USP 1,A02,087521,Kwak; Nancy,17,0,20,3
1653297535819,USP 1,A03,087522,Kwak; Nancy,16,0,20,4
1653297535819,USP 1,A04,087523,Kwak; Nancy,19,0,20,1
1653297536348,USP 2,A01,087525,Lerner; Amy M,29,0,30,1
1653297536348,USP 2,A02,087526,Lerner; Amy M,29,0,30,1
1653297536878,USP 4,A00,094267,Polat; Soydan Alihan,16,0,20,4
1653297536878,USP 4,B00,094268,Staff,20,0,20,0
1653297537404,USP 5,A01,087532,Staff,26,0,30,4
1653297537404,USP 5,A02,087533,Staff,27,0,30,3
1653297537932,USP 6,A01,094322,Shvartzberg Carrio; Manuel,20,0,20,0
1653297537932,USP 6,A02,094323,Shvartzberg Carrio; Manuel,20,0,20,0
1653297538459,USP 15,A01,087535,Anderson; William Raymond,20,0,25,5
1653297538459,USP 15,A02,087536,Anderson; William Raymond,23,0,25,2
1653297538984,USP 25,A00,087537,Staff,0,0,7,7
1653297539508,USP 50,A00,087538,Martin; Isaac,38,0,40,2
1653297540036,USP 124,A00,087539,Bussell; Mirle Rabinowitz,26,0,35,9
1653297540560,USP 125,A00,087540,Staff,17,0,23,6
1653297541089,USP 136,A00,087541,Staff,23,0,25,2
1653297541615,USP 144,A00,087542,Staff,136,0,146,10
1653297542138,USP 151,A00,087543,Boomhower; Matthew Charles,18,0,20,2
1653297542663,USP 152,A01,087545,Moeder; Nathan L,17,0,20,3
1653297542663,USP 152,A02,087546,Moeder; Nathan L,20,0,20,0
1653297543186,USP 153,A00,087547,Moden; Kelly Kjestine,27,0,30,3
1653297543709,USP 161,A00,094854,Wartell; Julie Dara,25,0,25,0
1653297544235,USP 169,A00,087548,Bajaj; Ravi Siddharth,30,0,35,5
1653297544760,USP 170,A00,087549,Hinds; Juli Beth,30,0,35,5
1653297545287,USP 171,A00,087550,Lerner; Amy M,38,0,50,12
1653297545821,USP 176,A00,094853,Staff,24,0,25,1
1653297546348,USP 177A,A00,087551,Peerson; Susan,20,0,22,2
1653297546876,USP 184,A00,094324,Shvartzberg Carrio; Manuel,24,0,25,1
1653297547484,USP 185A,A01,087553,Norr; Alex Vaughn,28,0,30,2
1653297547484,USP 185A,B01,087555,Boomhower; Matthew Charles,26,0,30,4
1653297548012,USP 186,A01,087557,Pezzoli; Keith,22,0,25,3
1653297548012,USP 186,A02,087558,Pezzoli; Keith,20,0,25,5
1653297549075,USP 191A,A00,087561,Rothberg; Scott Jacob,18,0,20,2
1653297549599,USP 194,A00,091599,Hill; Seth J,9999,0,9999,0
1653297550133,VIS 1,A01,088809,Tonies; Joshua Vanjaymes,10,0,10,0
1653297550133,VIS 1,A02,088810,Tonies; Joshua Vanjaymes,10,0,10,0
1653297550133,VIS 1,A03,088811,Tonies; Joshua Vanjaymes,3,0,10,7
1653297550133,VIS 1,A04,088812,Tonies; Joshua Vanjaymes,8,0,10,2
1653297550133,VIS 1,A05,088813,Tonies; Joshua Vanjaymes,4,0,10,6
1653297550133,VIS 1,A06,088814,Tonies; Joshua Vanjaymes,6,0,10,4
1653297550133,VIS 1,A07,088815,Tonies; Joshua Vanjaymes,6,0,10,4
1653297550133,VIS 1,A08,088816,Tonies; Joshua Vanjaymes,9,0,10,1
1653297550133,VIS 1,A09,088817,Tonies; Joshua Vanjaymes,8,0,10,2
1653297550133,VIS 1,A10,088818,Tonies; Joshua Vanjaymes,8,0,10,2
1653297550133,VIS 1,A11,088819,Tonies; Joshua Vanjaymes,3,0,10,7
1653297550133,VIS 1,A12,088820,Tonies; Joshua Vanjaymes,6,0,10,4
1653297550133,VIS 1,A13,088821,Tonies; Joshua Vanjaymes,6,0,10,4
1653297550133,VIS 1,A14,088822,Tonies; Joshua Vanjaymes,7,0,10,3
1653297550133,VIS 1,A15,088823,Tonies; Joshua Vanjaymes,7,0,10,3
1653297550133,VIS 1,A16,088824,Tonies; Joshua Vanjaymes,8,0,10,2
1653297550665,VIS 20,A01,088826,Woods; Ann,19,0,20,1
1653297550665,VIS 20,A02,088827,Woods; Ann,20,0,20,0
1653297550665,VIS 20,A03,088828,Woods; Ann,18,0,20,2
1653297550665,VIS 20,A04,088829,Woods; Ann,17,0,20,3
1653297550665,VIS 20,A05,088830,Woods; Ann,20,0,20,0
1653297550665,VIS 20,A06,088831,Woods; Ann,20,0,20,0
1653297550665,VIS 20,A07,088832,Woods; Ann,20,0,20,0
1653297550665,VIS 20,A08,088833,Woods; Ann,20,0,20,0
1653297550665,VIS 20,A09,088834,Woods; Ann,18,0,20,2
1653297550665,VIS 20,A10,088835,Woods; Ann,19,0,20,1
1653297550665,VIS 20,A11,088836,Woods; Ann,20,0,20,0
1653297550665,VIS 20,A12,088837,Woods; Ann,20,0,20,0
1653297551188,VIS 23,A00,088838,Rose; Jordan M,3,0,3,0
1653297551717,VIS 30,A01,088840,Stone; Patricia,11,0,11,0
1653297551717,VIS 30,A02,088841,Stone; Patricia,7,0,11,4
1653297551717,VIS 30,A03,094821,Stone; Patricia,8,0,11,3
1653297551717,VIS 30,A04,094822,Stone; Patricia,11,0,11,0
1653297552242,VIS 41,A01,088844,D'Elena-Tweed; Jessica Erin,9,0,10,1
1653297552242,VIS 41,A02,088845,D'Elena-Tweed; Jessica Erin,9,0,10,1
1653297552242,VIS 41,A03,088846,D'Elena-Tweed; Jessica Erin,9,0,10,1
1653297552242,VIS 41,A04,088847,D'Elena-Tweed; Jessica Erin,9,0,10,1
1653297552242,VIS 41,A05,088848,D'Elena-Tweed; Jessica Erin,10,0,10,0
1653297552242,VIS 41,A06,088849,D'Elena-Tweed; Jessica Erin,10,0,10,0
1653297552242,VIS 41,A07,088850,D'Elena-Tweed; Jessica Erin,10,0,10,0
1653297552242,VIS 41,A08,088851,D'Elena-Tweed; Jessica Erin,10,0,10,0
1653297552766,VIS 60,A01,088853,Sepuya; Paul Mpagi,9,0,10,1
1653297552766,VIS 60,A02,088854,Sepuya; Paul Mpagi,10,0,10,0
1653297552766,VIS 60,A03,088855,Sepuya; Paul Mpagi,10,0,10,0
1653297552766,VIS 60,A04,088856,Sepuya; Paul Mpagi,10,0,10,0
1653297552766,VIS 60,A05,088857,Sepuya; Paul Mpagi,10,0,10,0
1653297552766,VIS 60,A06,088858,Sepuya; Paul Mpagi,10,0,10,0
1653297552766,VIS 60,A07,088859,Sepuya; Paul Mpagi,9,0,10,1
1653297552766,VIS 60,A08,093932,Sepuya; Paul Mpagi,10,0,10,0
1653297553298,VIS 70N,A01,088861,Segade; Alexandro Abraham,8,0,8,0
1653297553298,VIS 70N,A02,088862,Segade; Alexandro Abraham,8,0,8,0
1653297553298,VIS 70N,A03,088863,Segade; Alexandro Abraham,8,0,8,0
1653297553298,VIS 70N,A04,088864,Segade; Alexandro Abraham,8,0,8,0
1653297553298,VIS 70N,A05,088865,Segade; Alexandro Abraham,7,0,8,1
1653297553298,VIS 70N,A06,088866,Segade; Alexandro Abraham,8,0,8,0
1653297553821,VIS 80,A01,088868,Adler; Amy,9,0,10,1
1653297553821,VIS 80,A02,088869,Adler; Amy,8,0,10,2
1653297553821,VIS 80,A03,088870,Adler; Amy,9,0,10,1
1653297553821,VIS 80,A04,088871,Adler; Amy,8,0,10,2
1653297553821,VIS 80,A05,088872,Adler; Amy,10,0,10,0
1653297553821,VIS 80,A06,088873,Adler; Amy,7,0,10,3
1653297554347,VIS 100,A00,088874,Cruz; Edwin Teddy,65,0,75,10
1653297554876,VIS 105A,A00,088875,Tonies; Joshua Vanjaymes,26,0,30,4
1653297555400,VIS 105B,A00,088876,Staff,25,0,30,5
1653297555923,VIS 106A,A00,088877,Tobe; Geoffroy,21,0,25,4
1653297556448,VIS 106B,A00,088878,Staff,21,0,25,4
1653297556970,VIS 106C,A00,088879,Staff,9,0,15,6
1653297557495,VIS 107B,A00,088880,Gallaccio; Anya,24,0,25,1
1653297558019,VIS 108,A00,093894,Gallaccio; Anya,6,0,15,9
1653297558541,VIS 110A,A00,093895,Dean; Danielle Adobi,15,0,15,0
1653297559068,VIS 110B,A00,088881,Adler; Amy,14,0,15,1
1653297559595,VIS 125E,A00,093896,Welchman; John C.,75,0,75,0
1653297560120,VIS 126HN,A00,088882,Newsome; Elizabeth Ann,74,0,75,1
1653297560644,VIS 126P,A00,088883,Wardwell; Mariana Razo,72,0,75,3
1653297561170,VIS 128E,A00,088884,Staff,68,0,75,7
1653297561696,VIS 132,A00,088885,Miller; Nicole L,15,0,15,0
1653297562218,VIS 133,A01,094348,D'Elena-Tweed; Jessica Erin,34,0,34,0
1653297562218,VIS 133,A02,094492,D'Elena-Tweed; Jessica Erin,33,0,34,1
1653297562746,VIS 142,A01,088887,Stalbaum; Brett,14,0,15,1
1653297562746,VIS 142,A02,088888,Stalbaum; Brett,9,0,15,6
1653297562746,VIS 142,A03,088889,Stalbaum; Brett,15,0,15,0
1653297562746,VIS 142,A04,088890,Stalbaum; Brett,8,0,15,7
1653297562746,VIS 142,A05,088891,Stalbaum; Brett,14,0,15,1
1653297562746,VIS 142,A06,094828,Stalbaum; Brett,15,0,15,0
1653297563272,VIS 143,A00,088892,Akten; Mehmet,11,0,22,11
1653297563796,VIS 147A,A01,088894,Stalbaum; Brett,20,0,22,2
1653297563796,VIS 147A,A02,088895,Stalbaum; Brett,17,0,22,5
1653297564321,VIS 149,A00,088896,Akten; Mehmet,11,0,15,4
1653297564850,VIS 150,A00,093893,Tufenkian; Armand Yervant,24,0,30,6
1653297565376,VIS 151A,A00,088897,Williams; Alena J,13,0,15,2
1653297565903,VIS 163,A00,088901,Bratton; Benjamin H.,75,0,75,0
1653297566427,VIS 164,A00,088902,Nakayama; Yue,22,0,22,0
1653297566957,VIS 165A,A00,093892,Cross; Brian R,19,0,22,3
1653297567490,VIS 167,A00,088903,Ortiz-Torres; Ruben,19,0,22,3
1653297568013,VIS 174,A00,088905,Staff,21,0,22,1
1653297568013,VIS 174,B00,088906,Kauffmann; Casey,22,0,22,0
1653297568538,VIS 175,A00,093891,Staff,18,0,22,4
1653297569063,VIS 177,A00,088907,Segade; Alexandro Abraham,20,0,22,2
1653297569590,VIS 178,A00,093890,Staff,17,0,22,5
1653297570113,VIS 179,A00,093889,Kauffmann; Casey,21,0,22,1
1653297570645,VIS 180A,A00,093888,Nakayama; Yue,16,0,22,6
1653297571173,VIS 180B,A00,088908,Miller; Nicole L,21,0,22,1
1653297571697,VIS 183A,A00,088909,Sepuya; Paul Mpagi,20,0,22,2
1653297572227,WCWP 10A,001,086588,Gagnon; Jeffrey C,15,0,15,0
1653297572227,WCWP 10A,002,086589,Gagnon; Jeffrey C,14,0,15,1
1653297572227,WCWP 10A,003,086590,Gagnon; Jeffrey C,15,0,15,0
1653297572227,WCWP 10A,004,086591,Gagnon; Jeffrey C,15,0,15,0
1653297572227,WCWP 10A,005,086592,Gagnon; Jeffrey C,15,0,15,0
1653297572227,WCWP 10A,006,086593,Gagnon; Jeffrey C,15,0,15,0
1653297572227,WCWP 10A,007,086594,Gagnon; Jeffrey C,15,0,15,0
1653297572227,WCWP 10A,008,086595,Gagnon; Jeffrey C,15,0,15,0
1653297572227,WCWP 10A,009,086596,Gagnon; Jeffrey C,15,0,15,0
1653297572227,WCWP 10A,010,086597,Gagnon; Jeffrey C,15,0,15,0
1653297572227,WCWP 10A,011,086598,Gagnon; Jeffrey C,20,0,20,0
1653297572227,WCWP 10A,012,086599,Gagnon; Jeffrey C,20,0,20,0
1653297572227,WCWP 10A,013,086600,Gagnon; Jeffrey C,20,0,20,0
1653297572227,WCWP 10A,014,086601,Gagnon; Jeffrey C,20,0,20,0
1653297572227,WCWP 10A,015,086602,Gagnon; Jeffrey C,20,0,20,0
1653297572227,WCWP 10A,016,086603,Gagnon; Jeffrey C,20,0,20,0
1653297572227,WCWP 10A,017,086604,Gagnon; Jeffrey C,20,0,20,0
1653297572227,WCWP 10A,018,086605,Gagnon; Jeffrey C,19,0,20,1
1653297572227,WCWP 10A,019,086606,Gagnon; Jeffrey C,19,0,20,1
1653297572227,WCWP 10A,020,086607,Gagnon; Jeffrey C,20,0,20,0
1653297572227,WCWP 10A,021,086608,Gagnon; Jeffrey C,20,0,20,0
1653297572227,WCWP 10A,022,086609,Gagnon; Jeffrey C,20,0,20,0
1653297572227,WCWP 10A,023,086610,Gagnon; Jeffrey C,19,0,20,1
1653297572227,WCWP 10A,024,086611,Gagnon; Jeffrey C,20,0,20,0
1653297572227,WCWP 10A,025,086612,Gagnon; Jeffrey C,0,0,0,0
1653297572227,WCWP 10A,026,086613,Gagnon; Jeffrey C,0,0,0,0
1653297572227,WCWP 10A,027,086614,Gagnon; Jeffrey C,0,0,0,0
1653297572227,WCWP 10A,028,086615,Gagnon; Jeffrey C,0,0,0,0
1653297572227,WCWP 10A,029,086616,Gagnon; Jeffrey C,0,0,0,0
1653297572227,WCWP 10A,030,086617,Gagnon; Jeffrey C,15,0,15,0
1653297572227,WCWP 10A,031,086618,Gagnon; Jeffrey C,15,0,15,0
1653297572227,WCWP 10A,032,093687,Gagnon; Jeffrey C,15,0,15,0
1653297572227,WCWP 10A,033,093688,Gagnon; Jeffrey C,15,0,15,0
1653297572227,WCWP 10A,034,093689,Gagnon; Jeffrey C,0,0,0,0
1653297572227,WCWP 10A,035,093690,Gagnon; Jeffrey C,0,0,0,0
1653297572750,WCWP 10B,003,086621,Gagnon; Jeffrey C,0,0,0,0
1653297572750,WCWP 10B,004,086622,Gagnon; Jeffrey C,16,0,20,4
1653297572750,WCWP 10B,005,086623,Gagnon; Jeffrey C,18,0,20,2
1653297572750,WCWP 10B,006,086624,Gagnon; Jeffrey C,20,0,20,0
1653297572750,WCWP 10B,007,086625,Gagnon; Jeffrey C,0,0,0,0
1653297573278,WCWP 100,A00,086626,McCleary; Keith Long,20,0,20,0
1653297573278,WCWP 100,B00,086627,McCleary; Keith Long,20,0,20,0
1653297573278,WCWP 100,C00,086628,McCleary; Keith Long,18,0,20,2
1653297573278,WCWP 100,D00,086629,Twohig; Niall Ivan,17,0,20,3
1653297573278,WCWP 100,E00,086630,Twohig; Niall Ivan,17,0,20,3
1653297573278,WCWP 100,F00,086631,Twohig; Niall Ivan,18,0,20,2
1653297573278,WCWP 100,G00,086632,Young; Mark T,20,0,20,0
1653297573278,WCWP 100,H00,086633,Young; Mark T,20,0,20,0
1653297631460,AAS 10,A01,085689,Butler; Elizabeth Annette,28,0,34,6
1653297631460,AAS 10,A02,085690,Butler; Elizabeth Annette,34,0,34,0
1653297631984,AAS 170,A00,085691,Butler; Elizabeth Annette,30,0,32,2
1653297632511,AIP 197,001,085683,Staff,100,0,100,0
1653297632511,AIP 197,002,085684,Rao; Ramesh R,50,0,50,0
1653297633040,AIP 197DC,001,085696,Anderson; Patrick W.,27,0,27,0
1653297633563,AIP 197T,A00,085685,Anderson; Patrick W.,15,0,15,0
1653297634087,ANAR 100,A00,094326,Fortier; Jana,22,0,25,3
1653297634612,ANAR 104,A01,085846,Staff,13,0,15,2
1653297635140,ANAR 120,A00,085847,Staff,15,0,15,0
1653297635664,ANAR 143,A00,094288,Staff,31,0,32,1
1653297636190,ANBI 100,A00,085849,Marchetto; Maria Carolina,31,0,34,3
1653297636713,ANBI 112,A00,085850,Marchetto; Maria Carolina,21,0,28,7
1653297637237,ANBI 118,A00,085851,Fox; Patrick Keolu Ozer,32,0,32,0
1653297637761,ANBI 136,A00,085852,Semendeferi; Ekaterini,20,0,22,2
1653297638285,ANBI 141,A00,085854,Gagneux; Pascal,186,0,192,6
1653297638810,ANBI 145,A00,085855,Staff,30,0,32,2
1653297639332,ANBI 175,A00,085857,Staff,30,0,32,2
1653297639859,ANSC 104,A00,094290,Yeh; Rihan Wen Xin,40,0,46,6
1653297640383,ANSC 105,A00,085859,Olivas Hernandez; Olga Lid,36,0,37,1
1653297640911,ANSC 120,A00,085860,Jassal; Aftab,51,0,56,5
1653297641439,ANSC 121,A00,085861,Staff,29,0,32,3
1653297642492,ANSC 148,A00,085866,Staff,71,0,73,2
1653297643019,ANSC 169,A00,085869,Fortier; Jana,23,0,25,2
1653297643545,ANSC 175,A00,085871,Pedersen; David,28,0,32,4
1653297644069,ANTH 1,A00,085803,Varma; Saiba,146,0,146,0
1653297644593,ANTH 2,A01,085805,Staff,43,0,44,1
1653297644593,ANTH 2,A02,085806,Staff,42,0,44,2
1653297644593,ANTH 2,A03,085807,Staff,44,0,44,0
1653297644593,ANTH 2,A04,085808,Staff,44,0,44,0
1653297644593,ANTH 2,A05,085809,Staff,40,0,40,0
1653297645122,ANTH 4,A01,085811,Yeh; Rihan Wen Xin,32,0,32,0
1653297645122,ANTH 4,A02,095113,Yeh; Rihan Wen Xin,32,0,32,0
1653297645122,ANTH 4,A03,095114,Yeh; Rihan Wen Xin,32,0,32,0
1653297645122,ANTH 4,A04,095115,Yeh; Rihan Wen Xin,34,0,34,0
1653297645662,ANTH 10,A00,085814,Stewart; Alexander B,215,0,216,1
1653297646187,ANTH 21,A01,085816,Kang; Byung Chu,35,0,35,0
1653297646187,ANTH 21,A02,085817,Kang; Byung Chu,35,0,35,0
1653297646187,ANTH 21,A03,085818,Kang; Byung Chu,35,0,35,0
1653297646187,ANTH 21,A04,085819,Kang; Byung Chu,35,0,35,0
1653297646187,ANTH 21,A05,085820,Kang; Byung Chu,33,0,35,2
1653297646187,ANTH 21,A06,085821,Kang; Byung Chu,33,0,35,2
1653297646187,ANTH 21,A07,085822,Kang; Byung Chu,35,0,35,0
1653297646187,ANTH 21,A08,085823,Kang; Byung Chu,35,0,35,0
1653297646187,ANTH 21,A09,085824,Kang; Byung Chu,0,0,0,0
1653297646187,ANTH 21,A10,085825,Kang; Byung Chu,0,0,0,0
1653297646187,ANTH 21,A11,095111,Kang; Byung Chu,30,0,30,0
1653297646187,ANTH 21,A12,095112,Kang; Byung Chu,30,0,30,0
1653297646187,ANTH 21,B01,085827,Staff,36,0,36,0
1653297646187,ANTH 21,B02,085828,Staff,36,0,36,0
1653297646187,ANTH 21,B03,085829,Staff,36,0,36,0
1653297646187,ANTH 21,B04,085830,Staff,38,0,38,0
1653297646718,ANTH 23,A01,085832,Stewart; Alexander B,31,0,31,0
1653297646718,ANTH 23,A02,085833,Stewart; Alexander B,31,0,31,0
1653297646718,ANTH 23,A03,085834,Stewart; Alexander B,31,0,31,0
1653297646718,ANTH 23,A04,085835,Stewart; Alexander B,31,0,31,0
1653297646718,ANTH 23,A05,085836,Stewart; Alexander B,31,0,31,0
1653297646718,ANTH 23,A06,085837,Stewart; Alexander B,0,0,0,0
1653297646718,ANTH 23,A07,085838,Stewart; Alexander B,0,0,0,0
1653297647243,ANTH 87,A00,085842,Staff,20,0,20,0
1653297647243,ANTH 87,B00,085843,Staff,20,0,20,0
1653297647772,ANTH 101,A01,085873,Goldstein; Paul S,33,0,36,3
1653297647772,ANTH 101,A02,085874,Goldstein; Paul S,33,0,36,3
1653297647772,ANTH 101,A03,085875,Goldstein; Paul S,36,0,36,0
1653297647772,ANTH 101,A04,085876,Goldstein; Paul S,36,0,38,2
1653297648297,ANTH 105,A00,085877,Staff,39,0,40,1
1653297648820,ANTH 108,A00,085878,Staff,31,0,32,1
1653297649343,ANTH 192,A00,094234,Kaiser; Bronwyn Nicole & Non; Amy L,20,0,20,0
1653297649867,ANTH 196A,A00,085879,Varma; Saiba,20,0,20,0
1653297650413,AWP 3,001,085697,Staff,13,0,13,0
1653297650413,AWP 3,002,085698,Staff,13,0,13,0
1653297650413,AWP 3,003,085699,Staff,13,0,13,0
1653297650413,AWP 3,004,085700,Staff,0,0,0,0
1653297650413,AWP 3,005,085701,Staff,0,0,0,0
1653297650413,AWP 3,006,085703,Staff,0,0,0,0
1653297650413,AWP 3,007,085704,Staff,13,0,13,0
1653297650413,AWP 3,008,085707,Staff,0,0,0,0
1653297650413,AWP 3,009,085709,Staff,13,0,13,0
1653297650413,AWP 3,010,085710,Staff,13,0,13,0
1653297650413,AWP 3,011,085711,Staff,0,0,0,0
1653297650413,AWP 3,012,085712,Staff,0,0,0,0
1653297650413,AWP 3,013,085713,Staff,13,0,13,0
1653297650413,AWP 3,014,085715,Staff,13,0,13,0
1653297650413,AWP 3,015,085717,Staff,13,0,13,0
1653297650413,AWP 3,016,085719,Staff,13,0,13,0
1653297650413,AWP 3,017,085720,Staff,13,0,13,0
1653297650413,AWP 3,018,085721,Staff,13,0,13,0
1653297650413,AWP 3,019,085722,Staff,13,0,13,0
1653297650413,AWP 3,020,085723,Staff,13,0,13,0
1653297650413,AWP 3,021,085724,Staff,13,0,13,0
1653297650413,AWP 3,022,085725,Staff,13,0,13,0
1653297650413,AWP 3,023,085726,Staff,13,0,13,0
1653297650413,AWP 3,024,085727,Staff,13,0,13,0
1653297650413,AWP 3,025,085728,Staff,13,0,13,0
1653297650413,AWP 3,026,085729,Staff,13,0,13,0
1653297650413,AWP 3,027,085730,Staff,13,0,13,0
1653297650413,AWP 3,028,085731,Staff,13,0,13,0
1653297650413,AWP 3,029,085732,Staff,13,0,13,0
1653297650413,AWP 3,030,085733,Staff,13,0,13,0
1653297650413,AWP 3,031,085734,Staff,13,0,13,0
1653297650413,AWP 3,032,085735,Staff,13,0,13,0
1653297650413,AWP 3,033,085736,Staff,13,0,13,0
1653297650413,AWP 3,034,085737,Staff,13,0,13,0
1653297650413,AWP 3,035,085738,Staff,13,0,13,0
1653297650413,AWP 3,036,085739,Staff,13,0,13,0
1653297650413,AWP 3,037,085740,Staff,13,0,13,0
1653297650413,AWP 3,038,085741,Staff,13,0,13,0
1653297650413,AWP 3,039,085742,Staff,13,0,13,0
1653297650413,AWP 3,040,085743,Staff,13,0,13,0
1653297650413,AWP 3,041,085744,Staff,13,0,13,0
1653297650413,AWP 3,042,085745,Staff,13,0,13,0
1653297650413,AWP 3,043,085746,Staff,13,0,13,0
1653297650413,AWP 3,044,085747,Staff,13,0,13,0
1653297650413,AWP 3,045,085748,Staff,13,0,13,0
1653297650413,AWP 3,046,085749,Staff,13,0,13,0
1653297650413,AWP 3,047,085750,Staff,13,0,13,0
1653297650413,AWP 3,048,085751,Staff,13,0,13,0
1653297650413,AWP 3,049,085752,Staff,13,0,13,0
1653297650413,AWP 3,050,085753,Staff,13,0,13,0
1653297650413,AWP 3,051,085754,Staff,13,0,13,0
1653297650413,AWP 3,052,085755,Staff,0,0,0,0
1653297650413,AWP 3,053,085756,Staff,13,0,13,0
1653297650413,AWP 3,054,085757,Staff,0,0,0,0
1653297650413,AWP 3,055,085758,Staff,13,0,13,0
1653297650413,AWP 3,056,085759,Staff,13,0,13,0
1653297650413,AWP 3,057,085760,Staff,13,0,13,0
1653297650413,AWP 3,058,085761,Staff,13,0,13,0
1653297650413,AWP 3,059,085762,Staff,13,0,13,0
1653297650413,AWP 3,060,085763,Staff,13,0,13,0
1653297650413,AWP 3,061,085764,Staff,13,0,13,0
1653297650413,AWP 3,062,085765,Staff,13,0,13,0
1653297650413,AWP 3,063,085766,Staff,13,0,13,0
1653297650413,AWP 3,064,085767,Staff,13,0,13,0
1653297650413,AWP 3,065,085768,Staff,13,0,13,0
1653297650413,AWP 3,066,085769,Staff,0,0,0,0
1653297650949,AWP 4A,001,085770,Staff,0,0,0,0
1653297650949,AWP 4A,002,085771,Staff,13,0,13,0
1653297650949,AWP 4A,003,085772,Staff,13,0,13,0
1653297650949,AWP 4A,004,085773,Staff,13,0,13,0
1653297650949,AWP 4A,005,085774,Staff,0,0,0,0
1653297650949,AWP 4A,006,085775,Staff,13,0,13,0
1653297650949,AWP 4A,007,085776,Staff,0,0,0,0
1653297650949,AWP 4A,008,085777,Staff,0,0,0,0
1653297650949,AWP 4A,009,085778,Staff,0,0,0,0
1653297650949,AWP 4A,010,085779,Staff,13,0,13,0
1653297650949,AWP 4A,011,085780,Staff,13,0,13,0
1653297650949,AWP 4A,012,085781,Staff,0,0,0,0
1653297650949,AWP 4A,013,085782,Staff,13,0,13,0
1653297650949,AWP 4A,014,085783,Staff,13,0,13,0
1653297650949,AWP 4A,015,085784,Staff,13,0,13,0
1653297650949,AWP 4A,016,085785,Staff,13,0,13,0
1653297650949,AWP 4A,017,085786,Staff,13,0,13,0
1653297650949,AWP 4A,018,085787,Staff,0,0,0,0
1653297650949,AWP 4A,019,085788,Staff,13,0,13,0
1653297650949,AWP 4A,020,085789,Staff,13,0,13,0
1653297650949,AWP 4A,021,085790,Staff,0,0,0,0
1653297650949,AWP 4A,022,085791,Staff,13,0,13,0
1653297650949,AWP 4A,023,085792,Staff,0,0,0,0
1653297650949,AWP 4A,024,085793,Staff,0,0,0,0
1653297650949,AWP 4A,025,085794,Staff,13,0,13,0
1653297650949,AWP 4A,026,085795,Staff,13,0,13,0
1653297650949,AWP 4A,027,085796,Staff,13,0,13,0
1653297650949,AWP 4A,028,085797,Staff,13,0,13,0
1653297650949,AWP 4A,029,085798,Staff,0,0,0,0
1653297650949,AWP 4A,030,085799,Staff,0,0,0,0
1653297650949,AWP 4A,031,093835,Staff,0,0,0,0
1653297651472,AWP 4B,001,085800,Staff,0,0,0,0
1653297651472,AWP 4B,002,085801,Staff,0,0,0,0
1653297652004,BENG 2,A00,085936,Wheeler; Bruce Christopher,28,0,30,2
1653297652529,BENG 110,A01,085939,Mc Culloch; Andrew Douglas,20,0,30,10
1653297652529,BENG 110,A02,085940,Mc Culloch; Andrew Douglas,18,0,30,12
1653297652529,BENG 110,A03,085941,Mc Culloch; Andrew Douglas,27,0,30,3
1653297653054,BENG 119A,A01,085943,Wheeler; Bruce Christopher,29,0,30,1
1653297653578,BENG 122A,A01,085945,Cauwenberghs; Gert,18,0,25,7
1653297653578,BENG 122A,A02,085946,Cauwenberghs; Gert,22,0,25,3
1653297653578,BENG 122A,A03,085947,Cauwenberghs; Gert,22,0,25,3
1653297654102,BENG 126A,A01,085949,Wheeler; Bruce Christopher,30,0,30,0
1653297654626,BENG 127A,A01,085951,Wheeler; Bruce Christopher,28,0,30,2
1653297655237,BENG 128A,A01,085953,Wheeler; Bruce Christopher,29,0,30,1
1653297655762,BENG 134,A01,085955,Smarr; Benjamin,0,0,0,0
1653297656289,BENG 135,A00,085956,Wheeler; Bruce Christopher,23,0,30,7
1653297656813,BENG 141,A00,085958,Lal; Ratnesh,20,0,30,10
1653297657338,BENG 147A,A01,085963,Wheeler; Bruce Christopher,30,0,30,0
1653297657860,BENG 148A,A01,085967,Wheeler; Bruce Christopher,30,0,30,0
1653297658384,BENG 149A,A01,085969,Wheeler; Bruce Christopher,30,0,30,0
1653297658916,BENG 161A,A01,085971,Fraley; Stephanie I.,20,0,25,5
1653297658916,BENG 161A,A02,085972,Fraley; Stephanie I.,13,0,25,12
1653297658916,BENG 161A,A03,085973,Fraley; Stephanie I.,9,0,25,16
1653297659443,BENG 162,A01,085975,Mali; Prashant Gulab Ram,0,0,35,35
1653297659443,BENG 162,A02,085976,Mali; Prashant Gulab Ram,26,0,35,9
1653297659968,BENG 166A,A00,085977,Sah; Robert Lie-Yuan,0,0,0,0
1653297660491,BENG 169A,A01,085982,Wheeler; Bruce Christopher,28,0,30,2
1653297661016,BENG 179A,A01,085984,Wheeler; Bruce Christopher,30,0,30,0
1653297661541,BENG 183,A01,085986,Zhong; Sheng,13,0,30,17
1653297661541,BENG 183,A02,085987,Zhong; Sheng,15,0,30,15
1653297661541,BENG 183,A03,085988,Zhong; Sheng,20,0,30,10
1653297662065,BENG 187B,A00,085989,Wheeler; Bruce Christopher,105,0,170,65
1653297662592,BENG 196,001,094047,Engler; Adam J.,9999,0,9999,0
1653297663125,BIBC 100,A01,092918,Huffaker; Alisa,0,0,19,19
1653297663125,BIBC 100,A02,092919,Huffaker; Alisa,19,0,19,0
1653297663125,BIBC 100,A03,092920,Huffaker; Alisa,18,0,19,1
1653297663125,BIBC 100,A04,092921,Huffaker; Alisa,18,0,19,1
1653297663125,BIBC 100,A05,092922,Huffaker; Alisa,19,0,19,0
1653297663125,BIBC 100,A06,092923,Huffaker; Alisa,18,0,19,1
1653297663125,BIBC 100,A07,092924,Huffaker; Alisa,10,0,19,9
1653297663125,BIBC 100,A08,092925,Huffaker; Alisa,17,0,19,2
1653297663125,BIBC 100,A09,092926,Huffaker; Alisa,19,0,19,0
1653297663125,BIBC 100,A10,092927,Huffaker; Alisa,11,0,19,8
1653297663650,BIBC 102,A01,092997,Schmelz; Eric Alexander,16,0,19,3
1653297663650,BIBC 102,A02,092998,Schmelz; Eric Alexander,5,0,19,14
1653297663650,BIBC 102,A03,092999,Schmelz; Eric Alexander,1,0,19,18
1653297663650,BIBC 102,A04,093000,Schmelz; Eric Alexander,17,0,19,2
1653297663650,BIBC 102,A05,093001,Schmelz; Eric Alexander,9,0,19,10
1653297663650,BIBC 102,A06,093002,Schmelz; Eric Alexander,16,0,19,3
1653297663650,BIBC 102,A07,093003,Schmelz; Eric Alexander,19,0,19,0
1653297663650,BIBC 102,A08,093004,Schmelz; Eric Alexander,19,0,19,0
1653297663650,BIBC 102,A09,093005,Schmelz; Eric Alexander,14,0,19,5
1653297663650,BIBC 102,B01,093064,Coleman; Aaron B.,19,0,19,0
1653297663650,BIBC 102,B02,093065,Coleman; Aaron B.,17,0,19,2
1653297663650,BIBC 102,B03,093066,Coleman; Aaron B.,16,0,19,3
1653297663650,BIBC 102,B04,093067,Coleman; Aaron B.,11,0,19,8
1653297663650,BIBC 102,B05,093068,Coleman; Aaron B.,18,0,19,1
1653297663650,BIBC 102,B06,093069,Coleman; Aaron B.,16,0,19,3
1653297663650,BIBC 102,B07,093070,Coleman; Aaron B.,19,0,19,0
1653297663650,BIBC 102,B08,093071,Coleman; Aaron B.,15,0,19,4
1653297663650,BIBC 102,B09,093072,Coleman; Aaron B.,17,0,19,2
1653297664183,BIBC 103,A01,089887,Bozinovic; Goran,19,0,24,5
1653297664183,BIBC 103,A02,089888,Bozinovic; Goran,23,0,24,1
1653297664183,BIBC 103,B01,089890,Burg; Michael,2,0,24,22
1653297664183,BIBC 103,B02,089891,Burg; Michael,20,0,24,4
1653297664183,BIBC 103,C01,089893,Beyhan; Sinem,14,0,24,10
1653297664183,BIBC 103,C02,089894,Beyhan; Sinem,22,0,24,2
1653297664183,BIBC 103,D01,089896,Coleman; Aaron B.,10,0,24,14
1653297664183,BIBC 103,D02,089897,Coleman; Aaron B.,22,0,24,2
1653297664706,BIBC 194,A00,089898,Hui; Enfu,16,0,27,11
1653297665241,BICD 100,A01,092396,Smith; Laurie,21,0,22,1
1653297665241,BICD 100,A02,092397,Smith; Laurie,22,0,22,0
1653297665241,BICD 100,A03,092398,Smith; Laurie,21,0,22,1
1653297665241,BICD 100,A04,092399,Smith; Laurie,22,0,22,0
1653297665241,BICD 100,A05,092400,Smith; Laurie,21,0,22,1
1653297665241,BICD 100,A06,092401,Smith; Laurie,22,0,22,0
1653297665241,BICD 100,A07,092402,Smith; Laurie,22,0,22,0
1653297665241,BICD 100,A08,092403,Smith; Laurie,22,0,22,0
1653297665241,BICD 100,B01,093073,Mueller; Liam O'Connor,21,0,22,1
1653297665241,BICD 100,B02,093074,Mueller; Liam O'Connor,22,0,22,0
1653297665241,BICD 100,B03,093075,Mueller; Liam O'Connor,22,0,22,0
1653297665241,BICD 100,B04,093076,Mueller; Liam O'Connor,22,0,22,0
1653297665241,BICD 100,B05,093077,Mueller; Liam O'Connor,22,0,22,0
1653297665241,BICD 100,B06,093078,Mueller; Liam O'Connor,22,0,22,0
1653297665241,BICD 100,B07,093079,Mueller; Liam O'Connor,21,0,22,1
1653297665241,BICD 100,B08,093080,Mueller; Liam O'Connor,22,0,22,0
1653297665241,BICD 100,C01,093021,McDonnell; Lisa Marie,21,0,22,1
1653297665241,BICD 100,C02,093022,McDonnell; Lisa Marie,20,0,22,2
1653297665241,BICD 100,C03,093023,McDonnell; Lisa Marie,22,0,22,0
1653297665241,BICD 100,C04,093024,McDonnell; Lisa Marie,22,0,22,0
1653297665241,BICD 100,C05,093025,McDonnell; Lisa Marie,22,0,22,0
1653297665241,BICD 100,C06,093026,McDonnell; Lisa Marie,22,0,22,0
1653297665241,BICD 100,C07,093027,McDonnell; Lisa Marie,20,0,22,2
1653297665241,BICD 100,C08,093028,McDonnell; Lisa Marie,22,0,22,0
1653297665241,BICD 100,D01,093081,Day; Christopher D,22,0,22,0
1653297665241,BICD 100,D02,093082,Day; Christopher D,17,0,22,5
1653297665241,BICD 100,D03,093083,Day; Christopher D,21,0,22,1
1653297665241,BICD 100,D04,093084,Day; Christopher D,19,0,22,3
1653297665241,BICD 100,D05,093085,Day; Christopher D,22,0,22,0
1653297665241,BICD 100,D06,093086,Day; Christopher D,20,0,22,2
1653297665241,BICD 100,D07,093087,Day; Christopher D,19,0,22,3
1653297665241,BICD 100,D08,093088,Day; Christopher D,20,0,22,2
1653297665776,BICD 110,A01,093089,Kiger; Amy,29,0,32,3
1653297665776,BICD 110,A02,093091,Kiger; Amy,32,0,32,0
1653297665776,BICD 110,A03,093092,Kiger; Amy,31,0,32,1
1653297665776,BICD 110,A04,093093,Kiger; Amy,31,0,32,1
1653297665776,BICD 110,A05,093094,Kiger; Amy,26,0,32,6
1653297665776,BICD 110,A06,093095,Kiger; Amy,31,0,32,1
1653297665776,BICD 110,A07,093096,Kiger; Amy,31,0,32,1
1653297665776,BICD 110,B01,093029,Grossman; Emily N,21,0,32,11
1653297665776,BICD 110,B02,093030,Grossman; Emily N,28,0,32,4
1653297665776,BICD 110,B03,093031,Grossman; Emily N,32,0,32,0
1653297665776,BICD 110,B04,093032,Grossman; Emily N,28,0,32,4
1653297665776,BICD 110,B05,093033,Grossman; Emily N,26,0,32,6
1653297665776,BICD 110,B06,093034,Grossman; Emily N,19,0,32,13
1653297665776,BICD 110,B07,093035,Grossman; Emily N,20,0,32,12
1653297666304,BICD 140,A01,093097,Zuniga; Elina I,19,0,32,13
1653297666304,BICD 140,A02,093098,Zuniga; Elina I,17,0,32,15
1653297666304,BICD 140,A03,093099,Zuniga; Elina I,30,0,32,2
1653297666304,BICD 140,A04,093100,Zuniga; Elina I,32,0,32,0
1653297666304,BICD 140,A05,093101,Zuniga; Elina I,29,0,32,3
1653297666304,BICD 140,A06,093102,Zuniga; Elina I,27,0,32,5
1653297666829,BIEB 102,A01,092528,Butler; Shannon Rhey,22,0,27,5
1653297666829,BIEB 102,A02,092529,Butler; Shannon Rhey,17,0,27,10
1653297666829,BIEB 102,A03,092530,Butler; Shannon Rhey,24,0,27,3
1653297666829,BIEB 102,A04,092531,Butler; Shannon Rhey,26,0,27,1
1653297666829,BIEB 102,A05,092532,Butler; Shannon Rhey,25,0,27,2
1653297666829,BIEB 102,A06,092533,Butler; Shannon Rhey,24,0,27,3
1653297666829,BIEB 102,A07,092534,Butler; Shannon Rhey,23,0,27,4
1653297667354,BIEB 121,A00,089907,Holway; David A.,0,0,32,32
1653297667878,BIEB 126,A01,092974,Kohn; Joshua R,24,0,27,3
1653297667878,BIEB 126,A02,092975,Kohn; Joshua R,26,0,27,1
1653297667878,BIEB 126,A03,092976,Kohn; Joshua R,23,0,27,4
1653297667878,BIEB 126,A04,092977,Kohn; Joshua R,26,0,27,1
1653297667878,BIEB 126,A05,092978,Kohn; Joshua R,27,0,27,0
1653297668410,BIEB 146,A01,093054,Petrie; Katherine Lynn,1,0,27,26
1653297668410,BIEB 146,A02,093055,Petrie; Katherine Lynn,4,0,27,23
1653297668410,BIEB 146,A03,093056,Petrie; Katherine Lynn,0,0,27,27
1653297668410,BIEB 146,A04,093057,Petrie; Katherine Lynn,0,0,27,27
1653297668410,BIEB 146,A05,093058,Petrie; Katherine Lynn,20,0,27,7
1653297668410,BIEB 146,A06,093059,Petrie; Katherine Lynn,26,0,27,1
1653297668410,BIEB 146,A07,093060,Petrie; Katherine Lynn,16,0,27,11
1653297668410,BIEB 146,A08,093061,Petrie; Katherine Lynn,25,0,27,2
1653297668410,BIEB 146,A09,093062,Petrie; Katherine Lynn,17,0,27,10
1653297668935,BIEB 150,A01,093103,Rennison; Diana,16,0,27,11
1653297668935,BIEB 150,A02,093104,Rennison; Diana,21,0,27,6
1653297668935,BIEB 150,A03,093105,Rennison; Diana,26,0,27,1
1653297668935,BIEB 150,A04,093106,Rennison; Diana,24,0,27,3
1653297668935,BIEB 150,A05,093107,Rennison; Diana,25,0,27,2
1653297668935,BIEB 150,A06,093108,Rennison; Diana,27,0,27,0
1653297669459,BIEB 158,A01,094057,Reese; Aspen Taylor & Jackrel; Sara,31,0,32,1
1653297669459,BIEB 158,A02,094058,Reese; Aspen Taylor & Jackrel; Sara,28,0,32,4
1653297669459,BIEB 158,A03,094059,Reese; Aspen Taylor & Jackrel; Sara,31,0,32,1
1653297669459,BIEB 158,A04,094060,Reese; Aspen Taylor & Jackrel; Sara,32,0,32,0
1653297669985,BIEB 174,A01,092465,Cleland; Elsa Eleanor & Barton; Andrew David,27,0,27,0
1653297669985,BIEB 174,A02,092466,Cleland; Elsa Eleanor & Barton; Andrew David,27,0,27,0
1653297669985,BIEB 174,A03,092467,Cleland; Elsa Eleanor & Barton; Andrew David,23,0,27,4
1653297669985,BIEB 174,A04,092468,Cleland; Elsa Eleanor & Barton; Andrew David,20,0,27,7
1653297669985,BIEB 174,A05,092469,Cleland; Elsa Eleanor & Barton; Andrew David,25,0,27,2
1653297669985,BIEB 174,A06,092470,Cleland; Elsa Eleanor & Barton; Andrew David,27,0,27,0
1653297669985,BIEB 174,A07,092471,Cleland; Elsa Eleanor & Barton; Andrew David,25,0,27,2
1653297670516,BILD 1,A01,092884,Pickett; Brooke Elizabeth,16,0,19,3
1653297670516,BILD 1,A02,092885,Pickett; Brooke Elizabeth,19,0,19,0
1653297670516,BILD 1,A03,092886,Pickett; Brooke Elizabeth,19,0,19,0
1653297670516,BILD 1,A04,092887,Pickett; Brooke Elizabeth,18,0,19,1
1653297670516,BILD 1,A05,092888,Pickett; Brooke Elizabeth,19,0,19,0
1653297670516,BILD 1,A06,092889,Pickett; Brooke Elizabeth,19,0,19,0
1653297670516,BILD 1,A07,092890,Pickett; Brooke Elizabeth,17,0,19,2
1653297670516,BILD 1,B01,092891,Pekkurnaz Banghart; Gulcin,19,0,19,0
1653297670516,BILD 1,B02,092892,Pekkurnaz Banghart; Gulcin,16,0,19,3
1653297670516,BILD 1,B03,092893,Pekkurnaz Banghart; Gulcin,19,0,19,0
1653297670516,BILD 1,B04,092894,Pekkurnaz Banghart; Gulcin,19,0,19,0
1653297670516,BILD 1,B05,092895,Pekkurnaz Banghart; Gulcin,17,0,19,2
1653297670516,BILD 1,B06,092896,Pekkurnaz Banghart; Gulcin,19,0,19,0
1653297670516,BILD 1,B07,092897,Pekkurnaz Banghart; Gulcin,19,0,19,0
1653297670516,BILD 1,C01,092421,Meaders; Clara Leigh,18,0,19,1
1653297670516,BILD 1,C02,092422,Meaders; Clara Leigh,18,0,19,1
1653297670516,BILD 1,C03,092423,Meaders; Clara Leigh,17,0,19,2
1653297670516,BILD 1,C04,092424,Meaders; Clara Leigh,16,0,19,3
1653297670516,BILD 1,C05,092425,Meaders; Clara Leigh,19,0,19,0
1653297670516,BILD 1,C06,092426,Meaders; Clara Leigh,19,0,19,0
1653297670516,BILD 1,C07,092427,Meaders; Clara Leigh,19,0,19,0
1653297670516,BILD 1,D01,092428,Meaders; Clara Leigh,14,0,19,5
1653297670516,BILD 1,D02,092429,Meaders; Clara Leigh,19,0,19,0
1653297670516,BILD 1,D03,092430,Meaders; Clara Leigh,19,0,19,0
1653297670516,BILD 1,D04,092431,Meaders; Clara Leigh,19,0,19,0
1653297670516,BILD 1,D05,092432,Meaders; Clara Leigh,19,0,19,0
1653297670516,BILD 1,D06,092433,Meaders; Clara Leigh,19,0,19,0
1653297670516,BILD 1,D07,092434,Meaders; Clara Leigh,19,0,19,0
1653297670516,BILD 1,E01,092445,Cooper; Andrew Michael,19,0,19,0
1653297670516,BILD 1,E02,092446,Cooper; Andrew Michael,19,0,19,0
1653297670516,BILD 1,E03,092447,Cooper; Andrew Michael,19,0,19,0
1653297670516,BILD 1,E04,092448,Cooper; Andrew Michael,19,0,19,0
1653297670516,BILD 1,E05,092449,Cooper; Andrew Michael,17,0,19,2
1653297670516,BILD 1,E06,092450,Cooper; Andrew Michael,19,0,19,0
1653297670516,BILD 1,E07,092451,Cooper; Andrew Michael,19,0,19,0
1653297671043,BILD 2,A01,092822,Glasgow; Stacey Marie,25,0,25,0
1653297671043,BILD 2,A02,092823,Glasgow; Stacey Marie,24,0,25,1
1653297671043,BILD 2,A03,092824,Glasgow; Stacey Marie,24,0,25,1
1653297671043,BILD 2,A04,092825,Glasgow; Stacey Marie,25,0,25,0
1653297671043,BILD 2,A05,092826,Glasgow; Stacey Marie,25,0,25,0
1653297671043,BILD 2,A06,092827,Glasgow; Stacey Marie,25,0,25,0
1653297671043,BILD 2,A07,092828,Glasgow; Stacey Marie,25,0,25,0
1653297671043,BILD 2,B01,092830,Owens; Melinda Tsao-Ying,25,0,25,0
1653297671043,BILD 2,B02,092831,Owens; Melinda Tsao-Ying,21,0,25,4
1653297671043,BILD 2,B03,092832,Owens; Melinda Tsao-Ying,23,0,25,2
1653297671043,BILD 2,B04,092833,Owens; Melinda Tsao-Ying,25,0,25,0
1653297671043,BILD 2,B05,092834,Owens; Melinda Tsao-Ying,24,0,25,1
1653297671043,BILD 2,B06,092835,Owens; Melinda Tsao-Ying,21,0,25,4
1653297671043,BILD 2,B07,092836,Owens; Melinda Tsao-Ying,25,0,25,0
1653297671043,BILD 2,C01,092668,Owens; Melinda Tsao-Ying,24,0,25,1
1653297671043,BILD 2,C02,092669,Owens; Melinda Tsao-Ying,23,0,25,2
1653297671043,BILD 2,C03,092670,Owens; Melinda Tsao-Ying,22,0,25,3
1653297671043,BILD 2,C04,092671,Owens; Melinda Tsao-Ying,25,0,25,0
1653297671043,BILD 2,C05,092672,Owens; Melinda Tsao-Ying,25,0,25,0
1653297671043,BILD 2,C06,092673,Owens; Melinda Tsao-Ying,24,0,25,1
1653297671043,BILD 2,C07,092674,Owens; Melinda Tsao-Ying,25,0,25,0
1653297671584,BILD 3,A01,092454,Stockwell; Sarah R,17,0,19,2
1653297671584,BILD 3,A02,092455,Stockwell; Sarah R,17,0,19,2
1653297671584,BILD 3,A03,092456,Stockwell; Sarah R,18,0,19,1
1653297671584,BILD 3,A04,092457,Stockwell; Sarah R,19,0,19,0
1653297671584,BILD 3,A05,092458,Stockwell; Sarah R,19,0,19,0
1653297671584,BILD 3,A06,092459,Stockwell; Sarah R,18,0,19,1
1653297671584,BILD 3,A07,092460,Stockwell; Sarah R,18,0,19,1
1653297671584,BILD 3,A08,092461,Stockwell; Sarah R,19,0,19,0
1653297671584,BILD 3,A09,092462,Stockwell; Sarah R,19,0,19,0
1653297671584,BILD 3,B01,092479,Stockwell; Sarah R,19,0,19,0
1653297671584,BILD 3,B02,092480,Stockwell; Sarah R,18,0,19,1
1653297671584,BILD 3,B03,092481,Stockwell; Sarah R,18,0,19,1
1653297671584,BILD 3,B04,092482,Stockwell; Sarah R,19,0,19,0
1653297671584,BILD 3,B05,092483,Stockwell; Sarah R,19,0,19,0
1653297671584,BILD 3,B06,092484,Stockwell; Sarah R,19,0,19,0
1653297671584,BILD 3,B07,092485,Stockwell; Sarah R,19,0,19,0
1653297671584,BILD 3,B08,092486,Stockwell; Sarah R,18,0,19,1
1653297671584,BILD 3,B09,092487,Stockwell; Sarah R,18,0,19,1
1653297671584,BILD 3,C01,092412,Butler; Shannon Rhey,18,0,19,1
1653297671584,BILD 3,C02,092413,Butler; Shannon Rhey,15,0,19,4
1653297671584,BILD 3,C03,092414,Butler; Shannon Rhey,19,0,19,0
1653297671584,BILD 3,C04,092415,Butler; Shannon Rhey,19,0,19,0
1653297671584,BILD 3,C05,092416,Butler; Shannon Rhey,19,0,19,0
1653297671584,BILD 3,C06,092417,Butler; Shannon Rhey,19,0,19,0
1653297671584,BILD 3,C07,092418,Butler; Shannon Rhey,19,0,19,0
1653297671584,BILD 3,C08,092419,Butler; Shannon Rhey,19,0,19,0
1653297671584,BILD 3,C09,092420,Butler; Shannon Rhey,19,0,19,0
1653297671584,BILD 3,D01,092898,Reuther; Keefe,18,0,19,1
1653297671584,BILD 3,D02,092899,Reuther; Keefe,19,0,19,0
1653297671584,BILD 3,D03,092900,Reuther; Keefe,19,0,19,0
1653297671584,BILD 3,D04,092901,Reuther; Keefe,19,0,19,0
1653297671584,BILD 3,D05,092902,Reuther; Keefe,19,0,19,0
1653297671584,BILD 3,D06,092903,Reuther; Keefe,19,0,19,0
1653297671584,BILD 3,D07,092904,Reuther; Keefe,18,0,19,1
1653297671584,BILD 3,D08,092905,Reuther; Keefe,19,0,19,0
1653297671584,BILD 3,D09,092906,Reuther; Keefe,19,0,19,0
1653297672111,BILD 4,A01,089840,Mel; Stephanie,0,0,0,0
1653297672111,BILD 4,A02,089841,Mel; Stephanie,0,0,0,0
1653297672111,BILD 4,A03,089842,Mel; Stephanie,0,0,0,0
1653297672111,BILD 4,A04,089843,Mel; Stephanie,0,0,0,0
1653297672111,BILD 4,A05,089844,Mel; Stephanie,0,0,0,0
1653297672111,BILD 4,A06,089845,Mel; Stephanie,0,0,0,0
1653297672111,BILD 4,A07,089846,Mel; Stephanie,0,0,0,0
1653297672111,BILD 4,A08,089847,Mel; Stephanie,0,0,0,0
1653297672111,BILD 4,A09,089848,Mel; Stephanie,0,0,0,0
1653297672111,BILD 4,A10,089849,Mel; Stephanie,0,0,0,0
1653297672111,BILD 4,A11,089850,Mel; Stephanie,0,0,0,0
1653297672111,BILD 4,A12,089851,Mel; Stephanie,0,0,0,0
1653297672111,BILD 4,A13,089852,Mel; Stephanie,0,0,0,0
1653297672111,BILD 4,A14,089853,Mel; Stephanie,0,0,0,0
1653297672111,BILD 4,A15,089854,Mel; Stephanie,0,0,0,0
1653297672111,BILD 4,A16,089855,Mel; Stephanie,0,0,0,0
1653297672111,BILD 4,B01,089857,Lo; Stanley M.,0,0,0,0
1653297672111,BILD 4,B02,089858,Lo; Stanley M.,0,0,0,0
1653297672111,BILD 4,B03,089859,Lo; Stanley M.,0,0,0,0
1653297672111,BILD 4,B04,089860,Lo; Stanley M.,0,0,0,0
1653297672111,BILD 4,B05,089861,Lo; Stanley M.,0,0,0,0
1653297672111,BILD 4,B06,089862,Lo; Stanley M.,0,0,0,0
1653297672111,BILD 4,B07,089863,Lo; Stanley M.,0,0,0,0
1653297672111,BILD 4,B08,089864,Lo; Stanley M.,0,0,0,0
1653297672111,BILD 4,B09,089865,Lo; Stanley M.,0,0,0,0
1653297672111,BILD 4,B10,089866,Lo; Stanley M.,0,0,0,0
1653297672111,BILD 4,B11,089867,Lo; Stanley M.,0,0,0,0
1653297672111,BILD 4,B12,089868,Lo; Stanley M.,0,0,0,0
1653297672111,BILD 4,B13,089869,Lo; Stanley M.,0,0,0,0
1653297672111,BILD 4,B14,089870,Lo; Stanley M.,0,0,0,0
1653297672111,BILD 4,B15,089871,Lo; Stanley M.,0,0,0,0
1653297672111,BILD 4,B16,089872,Lo; Stanley M.,0,0,0,0
1653297672647,BILD 5,A01,092907,Reuther; Keefe,31,0,32,1
1653297672647,BILD 5,A02,092908,Reuther; Keefe,30,0,32,2
1653297673172,BILD 10,A01,092909,Gustafson-Brown; Cindy,27,0,27,0
1653297673172,BILD 10,A02,092910,Gustafson-Brown; Cindy,27,0,27,0
1653297673172,BILD 10,A03,092911,Gustafson-Brown; Cindy,27,0,27,0
1653297673172,BILD 10,A04,092912,Gustafson-Brown; Cindy,27,0,27,0
1653297673172,BILD 10,A05,092913,Gustafson-Brown; Cindy,25,0,27,2
1653297673172,BILD 10,A06,092914,Gustafson-Brown; Cindy,26,0,27,1
1653297673172,BILD 10,A07,092915,Gustafson-Brown; Cindy,27,0,27,0
1653297673172,BILD 10,A08,092916,Gustafson-Brown; Cindy,27,0,27,0
1653297673172,BILD 10,A09,092917,Gustafson-Brown; Cindy,27,0,27,0
1653297673705,BILD 20,A01,092956,Rana; Brinda Kanti,24,0,27,3
1653297673705,BILD 20,A02,092957,Rana; Brinda Kanti,24,0,27,3
1653297673705,BILD 20,A03,092958,Rana; Brinda Kanti,27,0,27,0
1653297673705,BILD 20,A04,092959,Rana; Brinda Kanti,27,0,27,0
1653297674229,BILD 32,A01,092990,Burg; Michael,27,0,27,0
1653297674229,BILD 32,A02,092991,Burg; Michael,26,0,27,1
1653297674229,BILD 32,A03,092992,Burg; Michael,27,0,27,0
1653297674229,BILD 32,A04,092993,Burg; Michael,26,0,27,1
1653297674229,BILD 32,A05,092994,Burg; Michael,27,0,27,0
1653297674229,BILD 32,A06,092995,Burg; Michael,27,0,27,0
1653297674229,BILD 32,A07,092996,Burg; Michael,27,0,27,0
1653297674754,BILD 60,A01,092392,Hammond; LaTisha Marie,24,0,24,0
1653297674754,BILD 60,A02,092393,Hammond; LaTisha Marie,24,0,24,0
1653297674754,BILD 60,B01,092394,Macagno; Eduardo R.,23,0,24,1
1653297674754,BILD 60,B02,092395,Macagno; Eduardo R.,24,0,24,0
1653297675280,BILD 62,A01,092949,Aljadeff; Johnatan,31,0,32,1
1653297675280,BILD 62,A02,092950,Aljadeff; Johnatan,32,0,32,0
1653297675280,BILD 62,A03,092951,Aljadeff; Johnatan,32,0,32,0
1653297675805,BILD 80,A00,089880,Pogliano; Joseph,27,0,30,3
1653297676336,BIMM 100,A01,092435,Pasquinelli; Amy,32,0,32,0
1653297676336,BIMM 100,A02,092436,Pasquinelli; Amy,30,0,32,2
1653297676336,BIMM 100,A03,092437,Pasquinelli; Amy,32,0,32,0
1653297676336,BIMM 100,A04,092438,Pasquinelli; Amy,31,0,32,1
1653297676336,BIMM 100,A05,092439,Pasquinelli; Amy,32,0,32,0
1653297676336,BIMM 100,A06,092440,Pasquinelli; Amy,32,0,32,0
1653297676336,BIMM 100,A07,092441,Pasquinelli; Amy,32,0,32,0
1653297676336,BIMM 100,A08,092442,Pasquinelli; Amy,32,0,32,0
1653297676336,BIMM 100,A09,092443,Pasquinelli; Amy,32,0,32,0
1653297676336,BIMM 100,A10,092444,Pasquinelli; Amy,32,0,32,0
1653297676336,BIMM 100,B01,092518,Pruneda-Paz; Jose L.,26,0,32,6
1653297676336,BIMM 100,B02,092519,Pruneda-Paz; Jose L.,19,0,32,13
1653297676336,BIMM 100,B03,092520,Pruneda-Paz; Jose L.,20,0,32,12
1653297676336,BIMM 100,B04,092521,Pruneda-Paz; Jose L.,24,0,32,8
1653297676336,BIMM 100,B05,092522,Pruneda-Paz; Jose L.,23,0,32,9
1653297676336,BIMM 100,B06,092523,Pruneda-Paz; Jose L.,24,0,32,8
1653297676336,BIMM 100,B07,092524,Pruneda-Paz; Jose L.,28,0,32,4
1653297676336,BIMM 100,B08,092525,Pruneda-Paz; Jose L.,25,0,32,7
1653297676336,BIMM 100,B09,092526,Pruneda-Paz; Jose L.,26,0,32,6
1653297676336,BIMM 100,B10,092527,Pruneda-Paz; Jose L.,24,0,32,8
1653297676860,BIMM 101,A01,089915,Rusert; Jessica Marie,22,0,24,2
1653297676860,BIMM 101,A02,089916,Rusert; Jessica Marie,21,0,24,3
1653297676860,BIMM 101,A03,089917,Rusert; Jessica Marie,21,0,24,3
1653297676860,BIMM 101,A04,089918,Rusert; Jessica Marie,20,0,24,4
1653297676860,BIMM 101,B01,089920,Grossman; Emily N,0,0,24,24
1653297676860,BIMM 101,B02,089921,Grossman; Emily N,1,0,24,23
1653297676860,BIMM 101,C01,089923,Day; Christopher D,0,0,24,24
1653297676860,BIMM 101,C02,089924,Day; Christopher D,0,0,24,24
1653297676860,BIMM 101,D01,089926,Cooper; Andrew Michael,18,0,24,6
1653297676860,BIMM 101,D02,089927,Cooper; Andrew Michael,24,0,24,0
1653297676860,BIMM 101,E01,089929,McDonnell; Lisa Marie,1,0,24,23
1653297676860,BIMM 101,E02,089930,McDonnell; Lisa Marie,12,0,24,12
1653297677386,BIMM 110,A01,092472,Tour; Ella,26,0,32,6
1653297677386,BIMM 110,A02,092473,Tour; Ella,23,0,32,9
1653297677386,BIMM 110,A03,092474,Tour; Ella,29,0,32,3
1653297677386,BIMM 110,A04,092475,Tour; Ella,27,0,32,5
1653297677386,BIMM 110,A05,092476,Tour; Ella,32,0,32,0
1653297677386,BIMM 110,A06,092477,Tour; Ella,30,0,32,2
1653297677386,BIMM 110,A07,092478,Tour; Ella,29,0,32,3
1653297677910,BIMM 120,A01,092979,Allen; Eric,28,0,32,4
1653297677910,BIMM 120,A02,092980,Allen; Eric,1,0,32,31
1653297677910,BIMM 120,A03,092981,Allen; Eric,14,0,32,18
1653297677910,BIMM 120,A04,092982,Allen; Eric,27,0,32,5
1653297677910,BIMM 120,A05,092983,Allen; Eric,30,0,32,2
1653297677910,BIMM 120,A06,092984,Allen; Eric,29,0,32,3
1653297677910,BIMM 120,A07,092985,Allen; Eric,20,0,32,12
1653297677910,BIMM 120,A08,092986,Allen; Eric,30,0,32,2
1653297677910,BIMM 120,A09,092987,Allen; Eric,30,0,32,2
1653297677910,BIMM 120,A10,092988,Allen; Eric,30,0,32,2
1653297677910,BIMM 120,A11,092989,Allen; Eric,32,0,32,0
1653297678436,BIMM 121,A01,089934,Petrie; Katherine Lynn,0,0,24,24
1653297678436,BIMM 121,A02,089935,Petrie; Katherine Lynn,0,0,24,24
1653297678436,BIMM 121,B01,089937,Pickett; Brooke Elizabeth,0,0,24,24
1653297678436,BIMM 121,B02,089938,Pickett; Brooke Elizabeth,0,0,24,24
1653297678436,BIMM 121,C01,089940,Pirino; Giorgia,0,0,24,24
1653297678436,BIMM 121,C02,089941,Pirino; Giorgia,0,0,24,24
1653297678436,BIMM 121,C03,089942,Pirino; Giorgia,0,0,24,24
1653297678436,BIMM 121,C04,089943,Pirino; Giorgia,0,0,24,24
1653297678962,BIMM 122,A01,093006,Russell; Alistair B,18,0,32,14
1653297678962,BIMM 122,A02,093007,Russell; Alistair B,16,0,32,16
1653297678962,BIMM 122,A03,093008,Russell; Alistair B,26,0,32,6
1653297678962,BIMM 122,A04,093009,Russell; Alistair B,32,0,32,0
1653297678962,BIMM 122,A05,093010,Russell; Alistair B,30,0,32,2
1653297679492,BIMM 124,A01,092404,Gustafson-Brown; Cindy,26,0,32,6
1653297679492,BIMM 124,A02,092405,Gustafson-Brown; Cindy,29,0,32,3
1653297679492,BIMM 124,A03,092406,Gustafson-Brown; Cindy,30,0,32,2
1653297679492,BIMM 124,A04,092407,Gustafson-Brown; Cindy,32,0,32,0
1653297679492,BIMM 124,A05,092408,Gustafson-Brown; Cindy,28,0,32,4
1653297679492,BIMM 124,A06,092409,Gustafson-Brown; Cindy,31,0,32,1
1653297679492,BIMM 124,A07,092410,Gustafson-Brown; Cindy,32,0,32,0
1653297680024,BIMM 140,A01,089947,Suel; Gurol Mehmet & Hao; Nan,16,0,27,11
1653297680024,BIMM 140,A02,089948,Suel; Gurol Mehmet & Hao; Nan,24,0,27,3
1653297680024,BIMM 140,A03,089949,Suel; Gurol Mehmet & Hao; Nan,21,0,27,6
1653297680024,BIMM 140,A04,089950,Suel; Gurol Mehmet & Hao; Nan,25,0,27,2
1653297680024,BIMM 140,A05,089951,Suel; Gurol Mehmet & Hao; Nan,24,0,27,3
1653297680559,BIMM 143,A01,089953,Grant; Barry J,0,0,40,40
1653297680559,BIMM 143,B01,089955,Fan; Chun Chieh,39,0,40,1
1653297680559,BIMM 143,C01,089957,Bozinovic; Goran,29,0,40,11
1653297681095,BIMM 194,A00,089958,Hasty; Jeff M,15,0,27,12
1653297681095,BIMM 194,B00,089959,Golden; James W,19,0,27,8
1653297681095,BIMM 194,C00,089960,Lykke-Andersen; Jens,2,0,27,25
1653297681095,BIMM 194,D00,094317,Golden; Susan S.,25,0,27,2
1653297681622,BIPN 100,A01,093011,Cooke; James Edward,7,0,19,12
1653297681622,BIPN 100,A02,093012,Cooke; James Edward,10,0,19,9
1653297681622,BIPN 100,A03,093013,Cooke; James Edward,8,0,19,11
1653297681622,BIPN 100,A04,093014,Cooke; James Edward,12,0,19,7
1653297681622,BIPN 100,A05,093015,Cooke; James Edward,17,0,19,2
1653297681622,BIPN 100,A06,093016,Cooke; James Edward,12,0,19,7
1653297681622,BIPN 100,A07,093017,Cooke; James Edward,12,0,19,7
1653297681622,BIPN 100,A08,093018,Cooke; James Edward,18,0,19,1
1653297681622,BIPN 100,A09,093019,Cooke; James Edward,17,0,19,2
1653297681622,BIPN 100,A10,093020,Cooke; James Edward,18,0,19,1
1653297681622,BIPN 100,B01,093036,Reyes Gonzalez; Catalina,17,0,19,2
1653297681622,BIPN 100,B02,093037,Reyes Gonzalez; Catalina,14,0,19,5
1653297681622,BIPN 100,B03,093038,Reyes Gonzalez; Catalina,16,0,19,3
1653297681622,BIPN 100,B04,093039,Reyes Gonzalez; Catalina,19,0,19,0
1653297681622,BIPN 100,B05,093040,Reyes Gonzalez; Catalina,19,0,19,0
1653297681622,BIPN 100,B06,093041,Reyes Gonzalez; Catalina,19,0,19,0
1653297681622,BIPN 100,B07,093042,Reyes Gonzalez; Catalina,14,0,19,5
1653297681622,BIPN 100,B08,093043,Reyes Gonzalez; Catalina,16,0,19,3
1653297681622,BIPN 100,B09,093044,Reyes Gonzalez; Catalina,19,0,19,0
1653297681622,BIPN 100,B10,093045,Reyes Gonzalez; Catalina,19,0,19,0
1653297682146,BIPN 102,A01,093046,Reyes Gonzalez; Catalina,28,0,32,4
1653297682146,BIPN 102,A02,093047,Reyes Gonzalez; Catalina,17,0,32,15
1653297682146,BIPN 102,A05,093050,Reyes Gonzalez; Catalina,29,0,32,3
1653297682146,BIPN 102,A06,093051,Reyes Gonzalez; Catalina,15,0,32,17
1653297682146,BIPN 102,A07,093052,Reyes Gonzalez; Catalina,29,0,32,3
1653297682146,BIPN 102,A08,093053,Reyes Gonzalez; Catalina,31,0,32,1
1653297682671,BIPN 105,A01,089966,Armour; Jon Christopher,0,0,21,21
1653297682671,BIPN 105,A02,089967,Armour; Jon Christopher,0,0,21,21
1653297682671,BIPN 105,A03,089968,Armour; Jon Christopher,3,0,21,18
1653297682671,BIPN 105,A04,089969,Armour; Jon Christopher,10,0,21,11
1653297683204,BIPN 140,A01,092514,Spitzer; Nicholas & Su; Chih-Ying,9,0,19,10
1653297683204,BIPN 140,A02,092515,Spitzer; Nicholas & Su; Chih-Ying,12,0,19,7
1653297683204,BIPN 140,A03,092516,Spitzer; Nicholas & Su; Chih-Ying,11,0,19,8
1653297683204,BIPN 140,A04,092517,Spitzer; Nicholas & Su; Chih-Ying,15,0,19,4
1653297683204,BIPN 140,B01,092952,Banghart; Matthew Ryan,12,0,19,7
1653297683204,BIPN 140,B02,092953,Banghart; Matthew Ryan,19,0,19,0
1653297683204,BIPN 140,B03,092954,Banghart; Matthew Ryan,19,0,19,0
1653297683204,BIPN 140,B04,092955,Banghart; Matthew Ryan,19,0,19,0
1653297683733,BIPN 145,A01,089973,Marino; Marc J,35,0,42,7
1653297683733,BIPN 145,A02,089974,Marino; Marc J,36,0,42,6
1653297683733,BIPN 145,B01,089976,Juavinett; Ashley Lauren,0,0,42,42
1653297684260,BIPN 148,A01,092960,Leutgeb; Jill K.,31,0,32,1
1653297684260,BIPN 148,A02,092961,Leutgeb; Jill K.,25,0,32,7
1653297684260,BIPN 148,A03,092962,Leutgeb; Jill K.,29,0,31,2
1653297684260,BIPN 148,A04,092963,Leutgeb; Jill K.,31,0,31,0
1653297684260,BIPN 148,A05,092964,Leutgeb; Jill K.,31,0,31,0
1653297684260,BIPN 148,A06,094351,Leutgeb; Jill K.,26,0,31,5
1653297684260,BIPN 148,A07,092966,Leutgeb; Jill K.,26,0,31,5
1653297684260,BIPN 148,A08,092967,Leutgeb; Jill K.,26,0,31,5
1653297684786,BIPN 189,A00,090665,Gentner; Tim,0,0,25,25
1653297685309,BIPN 194,A00,089978,Pekkurnaz Banghart; Gulcin,17,0,27,10
1653297685309,BIPN 194,B00,089979,Leutgeb; Stefan,24,0,27,3
1653297685836,BISP 194,A00,089980,Wertheim; Joel Okrent,8,0,27,19
1653297686365,CAT 1,A01,086671,Bronstein; Phoebe Malan,17,0,17,0
1653297686365,CAT 1,A02,086672,Bronstein; Phoebe Malan,13,0,17,4
1653297686365,CAT 1,A03,086673,Bronstein; Phoebe Malan,17,0,17,0
1653297686365,CAT 1,A04,086674,Bronstein; Phoebe Malan,15,0,17,2
1653297686365,CAT 1,A05,086675,Bronstein; Phoebe Malan,17,0,17,0
1653297686365,CAT 1,A06,086676,Bronstein; Phoebe Malan,17,0,17,0
1653297686365,CAT 1,A07,086677,Bronstein; Phoebe Malan,16,0,17,1
1653297686365,CAT 1,A08,086678,Bronstein; Phoebe Malan,17,0,17,0
1653297686365,CAT 1,A09,086679,Bronstein; Phoebe Malan,16,0,17,1
1653297686365,CAT 1,A10,086680,Bronstein; Phoebe Malan,17,0,17,0
1653297686365,CAT 1,A11,086681,Bronstein; Phoebe Malan,16,0,17,1
1653297686365,CAT 1,A12,086682,Bronstein; Phoebe Malan,17,0,17,0
1653297686365,CAT 1,A13,086683,Bronstein; Phoebe Malan,17,0,17,0
1653297686365,CAT 1,A14,086684,Bronstein; Phoebe Malan,17,0,17,0
1653297686365,CAT 1,A15,086685,Bronstein; Phoebe Malan,17,0,17,0
1653297686365,CAT 1,A16,086686,Bronstein; Phoebe Malan,17,0,17,0
1653297686365,CAT 1,B01,086688,Bigham; David Joseph,17,0,17,0
1653297686365,CAT 1,B02,086689,Bigham; David Joseph,16,0,17,1
1653297686365,CAT 1,B03,086690,Bigham; David Joseph,17,0,17,0
1653297686365,CAT 1,B04,086691,Bigham; David Joseph,17,0,17,0
1653297686365,CAT 1,B05,086692,Bigham; David Joseph,16,0,17,1
1653297686365,CAT 1,B06,086693,Bigham; David Joseph,17,0,17,0
1653297686365,CAT 1,B07,086694,Bigham; David Joseph,17,0,17,0
1653297686365,CAT 1,B08,086695,Bigham; David Joseph,17,0,17,0
1653297686365,CAT 1,B09,086696,Bigham; David Joseph,17,0,17,0
1653297686365,CAT 1,B10,086697,Bigham; David Joseph,17,0,17,0
1653297686365,CAT 1,B11,086698,Bigham; David Joseph,17,0,17,0
1653297686365,CAT 1,B12,086699,Bigham; David Joseph,17,0,17,0
1653297686365,CAT 1,B13,086700,Bigham; David Joseph,15,0,17,2
1653297686365,CAT 1,B14,086701,Bigham; David Joseph,17,0,17,0
1653297686365,CAT 1,C01,086703,Algaze; Guillermo,17,0,17,0
1653297686365,CAT 1,C02,086704,Algaze; Guillermo,17,0,17,0
1653297686365,CAT 1,C03,086705,Algaze; Guillermo,17,0,17,0
1653297686365,CAT 1,C04,086706,Algaze; Guillermo,17,0,17,0
1653297686365,CAT 1,C05,086707,Algaze; Guillermo,17,0,17,0
1653297686365,CAT 1,C06,086708,Algaze; Guillermo,17,0,17,0
1653297686365,CAT 1,C07,086709,Algaze; Guillermo,17,0,17,0
1653297686365,CAT 1,C08,086710,Algaze; Guillermo,17,0,17,0
1653297686365,CAT 1,C09,086711,Algaze; Guillermo,17,0,17,0
1653297686365,CAT 1,C10,086712,Algaze; Guillermo,17,0,17,0
1653297686365,CAT 1,C11,086713,Algaze; Guillermo,17,0,17,0
1653297686365,CAT 1,C12,086714,Algaze; Guillermo,17,0,17,0
1653297686365,CAT 1,C13,086715,Algaze; Guillermo,17,0,17,0
1653297686365,CAT 1,C14,086716,Algaze; Guillermo,16,0,17,1
1653297686365,CAT 1,C15,086717,Algaze; Guillermo,17,0,17,0
1653297686365,CAT 1,C16,086718,Algaze; Guillermo,16,0,17,1
1653297686365,CAT 1,D01,086720,Staff,17,0,17,0
1653297686365,CAT 1,D02,086721,Staff,17,0,17,0
1653297686365,CAT 1,D03,086722,Staff,17,0,17,0
1653297686365,CAT 1,D04,086723,Staff,17,0,17,0
1653297686365,CAT 1,D05,086724,Staff,16,0,17,1
1653297686365,CAT 1,D06,086725,Staff,16,0,17,1
1653297686365,CAT 1,D07,086726,Staff,17,0,17,0
1653297686365,CAT 1,D08,086727,Staff,17,0,17,0
1653297686365,CAT 1,D09,086728,Staff,16,0,17,1
1653297686365,CAT 1,D10,086729,Staff,17,0,17,0
1653297686365,CAT 1,D11,086730,Staff,17,0,17,0
1653297686365,CAT 1,D12,086731,Staff,17,0,17,0
1653297686365,CAT 1,D13,086732,Staff,17,0,17,0
1653297686365,CAT 1,D14,086733,Staff,17,0,17,0
1653297686887,CAT 3,A01,086735,Gumm; Elizabeth Ashley,14,0,15,1
1653297686887,CAT 3,A02,086736,Gumm; Elizabeth Ashley,14,0,15,1
1653297686887,CAT 3,A03,086737,Gumm; Elizabeth Ashley,15,0,15,0
1653297686887,CAT 3,A04,086738,Gumm; Elizabeth Ashley,15,0,15,0
1653297686887,CAT 3,A05,086739,Gumm; Elizabeth Ashley,15,0,15,0
1653297686887,CAT 3,A06,086740,Gumm; Elizabeth Ashley,15,0,15,0
1653297687408,CAT 124,A01,086742,Staff,15,0,15,0
1653297687932,CAT 125R,A01,094882,Staff,14,0,16,2
1653297687932,CAT 125R,A02,086745,Staff,16,0,16,0
1653297687932,CAT 125R,A03,086746,Staff,14,0,16,2
1653297687932,CAT 125R,A04,086747,Staff,13,0,16,3
1653297687932,CAT 125R,A05,086748,Staff,15,0,16,1
1653297687932,CAT 125R,A06,086749,Staff,12,0,16,4
1653297687932,CAT 125R,A07,086750,Staff,14,0,16,2
1653297687932,CAT 125R,A08,094883,Staff,14,0,16,2
1653297687932,CAT 125R,A09,094884,Staff,16,0,16,0
1653297687932,CAT 125R,A10,094885,Staff,15,0,16,1
1653297687932,CAT 125R,A14,086761,Staff,15,0,16,1
1653297687932,CAT 125R,A15,086762,Staff,16,0,16,0
1653297687932,CAT 125R,A16,086763,Staff,13,0,16,3
1653297687932,CAT 125R,A17,086764,Staff,14,0,16,2
1653297687932,CAT 125R,A18,086765,Staff,14,0,16,2
1653297687932,CAT 125R,A19,086766,Staff,14,0,16,2
1653297688461,CCS 101,A00,088353,Staff,29,0,35,6
1653297688984,CENG 4,A01,086204,Bae; Jinhye,30,0,30,0
1653297688984,CENG 4,A02,086205,Bae; Jinhye,30,0,30,0
1653297688984,CENG 4,B01,086207,Drews; Aaron,30,0,30,0
1653297688984,CENG 4,B02,086208,Drews; Aaron,30,0,30,0
1653297689508,CENG 15,A01,086210,Lubarda; Vlado,63,0,65,2
1653297689508,CENG 15,B01,086212,Lubarda; Vlado,65,0,65,0
1653297690047,CENG 100,A00,086213,Chen; Zheng,147,0,150,3
1653297690574,CENG 101A,A00,086214,Bae; Jinhye,142,0,150,8
1653297691099,CENG 120,A00,086215,Opatkiewicz; Justin Paul,125,0,150,25
1653297691624,CENG 122,A00,086216,Opatkiewicz; Justin Paul,137,0,150,13
1653297692149,CGS 2A,A01,086271,Shelby; Karen Lee,12,0,15,3
1653297692149,CGS 2A,A02,086272,Shelby; Karen Lee,13,0,15,2
1653297692149,CGS 2A,A03,086273,Shelby; Karen Lee,14,0,15,1
1653297692149,CGS 2A,A04,086274,Shelby; Karen Lee,15,0,15,0
1653297692672,CGS 100A,A00,086275,Perez; Roy,26,0,32,6
1653297693201,CGS 101,A00,086276,Shelby; Karen Lee,30,0,30,0
1653297693725,CGS 106,A00,086277,Shelby; Karen Lee,24,0,30,6
1653297694250,CGS 119,A00,086279,Nguyen; Hoang Tan,27,0,30,3
1653297694773,CGS 121,A00,086280,Martin Sandino; Amanda Maria Yoland,19,0,20,1
1653297695304,CGS 122,A00,086281,Whitley; Leila Marie,20,0,20,0
1653297695828,CGS 123,A00,086282,Staff,0,0,0,0
1653297696353,CGS 127,A00,086283,Whitley; Leila Marie,15,0,15,0
1653297696874,CGS 130,A00,086284,Martin Sandino; Amanda Maria Yoland,15,0,15,0
1653297697396,CGS 187,A00,086285,Perez; Roy,15,0,16,1
1653297697926,CGS 190,A00,086286,Staff,5,0,5,0
1653297698451,CHEM 4,A01,089669,Bussey; Thomas J,40,0,40,0
1653297698451,CHEM 4,A02,089670,Bussey; Thomas J,42,0,42,0
1653297698451,CHEM 4,A03,089671,Bussey; Thomas J,40,0,42,2
1653297698451,CHEM 4,A04,089672,Bussey; Thomas J,42,0,42,0
1653297698451,CHEM 4,A05,089673,Bussey; Thomas J,40,0,42,2
1653297698451,CHEM 4,A06,089674,Bussey; Thomas J,40,0,42,2
1653297698451,CHEM 4,A07,089675,Bussey; Thomas J,42,0,42,0
1653297698451,CHEM 4,A08,089676,Bussey; Thomas J,42,0,42,0
1653297698451,CHEM 4,A09,089677,Bussey; Thomas J,41,0,41,0
1653297698451,CHEM 4,A10,089678,Bussey; Thomas J,40,0,40,0
1653297699004,CHEM 6A,A01,092734,Pomeroy; Robert S.,4,0,4,0
1653297699004,CHEM 6A,A02,092735,Pomeroy; Robert S.,4,0,4,0
1653297699004,CHEM 6A,A03,092736,Pomeroy; Robert S.,4,0,4,0
1653297699004,CHEM 6A,A04,092737,Pomeroy; Robert S.,4,0,4,0
1653297699004,CHEM 6A,A05,092738,Pomeroy; Robert S.,4,0,4,0
1653297699004,CHEM 6A,A06,092739,Pomeroy; Robert S.,4,0,4,0
1653297699004,CHEM 6A,A07,092740,Pomeroy; Robert S.,4,0,4,0
1653297699004,CHEM 6A,A08,092741,Pomeroy; Robert S.,4,0,4,0
1653297699004,CHEM 6A,A09,092742,Pomeroy; Robert S.,0,0,0,0
1653297699004,CHEM 6A,B01,092744,Schurmeier; Kimberly,4,0,4,0
1653297699004,CHEM 6A,B02,092746,Schurmeier; Kimberly,4,0,4,0
1653297699004,CHEM 6A,B03,092749,Schurmeier; Kimberly,4,0,4,0
1653297699004,CHEM 6A,B04,092751,Schurmeier; Kimberly,4,0,4,0
1653297699004,CHEM 6A,B05,092753,Schurmeier; Kimberly,4,0,4,0
1653297699004,CHEM 6A,B06,092755,Schurmeier; Kimberly,3,0,4,1
1653297699004,CHEM 6A,B07,092756,Schurmeier; Kimberly,4,0,4,0
1653297699004,CHEM 6A,B08,092757,Schurmeier; Kimberly,4,0,4,0
1653297699004,CHEM 6A,B09,092758,Schurmeier; Kimberly,0,0,0,0
1653297699004,CHEM 6A,C01,092805,Schurmeier; Kimberly,4,0,4,0
1653297699004,CHEM 6A,C02,092806,Schurmeier; Kimberly,4,0,4,0
1653297699004,CHEM 6A,C03,092807,Schurmeier; Kimberly,4,0,4,0
1653297699004,CHEM 6A,C04,092808,Schurmeier; Kimberly,4,0,4,0
1653297699004,CHEM 6A,C05,092809,Schurmeier; Kimberly,4,0,4,0
1653297699004,CHEM 6A,C06,092810,Schurmeier; Kimberly,4,0,4,0
1653297699004,CHEM 6A,C07,092811,Schurmeier; Kimberly,4,0,4,0
1653297699004,CHEM 6A,C08,092812,Schurmeier; Kimberly,4,0,4,0
1653297699004,CHEM 6A,C09,092813,Schurmeier; Kimberly,0,0,0,0
1653297699004,CHEM 6A,D01,092837,Stallings; Dontarie M,4,0,4,0
1653297699004,CHEM 6A,D02,092838,Stallings; Dontarie M,4,0,4,0
1653297699004,CHEM 6A,D03,092839,Stallings; Dontarie M,4,0,4,0
1653297699004,CHEM 6A,D04,092840,Stallings; Dontarie M,4,0,4,0
1653297699004,CHEM 6A,D05,092841,Stallings; Dontarie M,4,0,4,0
1653297699004,CHEM 6A,D06,092842,Stallings; Dontarie M,4,0,4,0
1653297699004,CHEM 6A,D07,092843,Stallings; Dontarie M,4,0,4,0
1653297699004,CHEM 6A,D08,092844,Stallings; Dontarie M,4,0,4,0
1653297699004,CHEM 6A,D09,092845,Stallings; Dontarie M,0,0,0,0
1653297699004,CHEM 6A,E01,092796,Brydges; Stacey,4,0,4,0
1653297699004,CHEM 6A,E02,092797,Brydges; Stacey,3,0,4,1
1653297699004,CHEM 6A,E03,092798,Brydges; Stacey,4,0,4,0
1653297699004,CHEM 6A,E04,092799,Brydges; Stacey,3,0,4,1
1653297699004,CHEM 6A,E05,092800,Brydges; Stacey,4,0,4,0
1653297699004,CHEM 6A,E06,092801,Brydges; Stacey,4,0,4,0
1653297699004,CHEM 6A,E07,092802,Brydges; Stacey,4,0,4,0
1653297699004,CHEM 6A,E08,092803,Brydges; Stacey,4,0,4,0
1653297699004,CHEM 6A,E09,092804,Brydges; Stacey,0,0,0,0
1653297699004,CHEM 6A,F01,092759,Brydges; Stacey,4,0,4,0
1653297699004,CHEM 6A,F02,092760,Brydges; Stacey,4,0,4,0
1653297699004,CHEM 6A,F03,092761,Brydges; Stacey,3,0,4,1
1653297699004,CHEM 6A,F04,092762,Brydges; Stacey,4,0,4,0
1653297699004,CHEM 6A,F05,092763,Brydges; Stacey,4,0,4,0
1653297699004,CHEM 6A,F06,092764,Brydges; Stacey,4,0,4,0
1653297699004,CHEM 6A,F07,092765,Brydges; Stacey,4,0,4,0
1653297699004,CHEM 6A,F08,092766,Brydges; Stacey,4,0,4,0
1653297699004,CHEM 6A,F09,092767,Brydges; Stacey,0,0,0,0
1653297699004,CHEM 6A,G01,092774,Zid; Brian M,0,0,4,4
1653297699004,CHEM 6A,G02,092775,Zid; Brian M,2,0,4,2
1653297699004,CHEM 6A,G03,092776,Zid; Brian M,2,0,4,2
1653297699004,CHEM 6A,G04,092777,Zid; Brian M,2,0,4,2
1653297699004,CHEM 6A,G05,092778,Zid; Brian M,4,0,4,0
1653297699004,CHEM 6A,G06,092779,Zid; Brian M,4,0,4,0
1653297699004,CHEM 6A,G07,092780,Zid; Brian M,3,0,4,1
1653297699004,CHEM 6A,G08,092781,Zid; Brian M,3,0,4,1
1653297699004,CHEM 6A,G09,092782,Zid; Brian M,0,0,0,0
1653297699004,CHEM 6A,H01,092846,Stallings; Dontarie M,4,0,4,0
1653297699004,CHEM 6A,H02,092847,Stallings; Dontarie M,3,0,4,1
1653297699004,CHEM 6A,H03,092848,Stallings; Dontarie M,4,0,4,0
1653297699004,CHEM 6A,H04,092849,Stallings; Dontarie M,4,0,4,0
1653297699004,CHEM 6A,H05,092850,Stallings; Dontarie M,4,0,4,0
1653297699004,CHEM 6A,H06,092851,Stallings; Dontarie M,3,0,4,1
1653297699004,CHEM 6A,H07,092852,Stallings; Dontarie M,4,0,4,0
1653297699004,CHEM 6A,H08,092853,Stallings; Dontarie M,3,0,4,1
1653297699004,CHEM 6A,H09,092854,Stallings; Dontarie M,0,0,0,0
1653297699004,CHEM 6A,I01,092814,Staff,0,0,0,0
1653297699004,CHEM 6A,I02,092815,Staff,0,0,0,0
1653297699004,CHEM 6A,I04,092816,Staff,0,0,0,0
1653297699004,CHEM 6A,I05,092817,Staff,0,0,0,0
1653297699004,CHEM 6A,I06,092818,Staff,0,0,0,0
1653297699004,CHEM 6A,I07,092819,Staff,0,0,0,0
1653297699004,CHEM 6A,I08,092820,Staff,0,0,0,0
1653297699004,CHEM 6A,I09,092821,Staff,0,0,0,0
1653297699528,CHEM 6AH,A01,092793,Paesani; Francesco,15,0,16,1
1653297699528,CHEM 6AH,A02,092794,Paesani; Francesco,16,0,16,0
1653297699528,CHEM 6AH,A03,092795,Paesani; Francesco,16,0,16,0
1653297700052,CHEM 6B,A01,092691,Hopkins; Patrycja Anna,21,0,25,4
1653297700052,CHEM 6B,A02,092692,Hopkins; Patrycja Anna,23,0,25,2
1653297700052,CHEM 6B,A03,092693,Hopkins; Patrycja Anna,25,0,25,0
1653297700052,CHEM 6B,A04,092694,Hopkins; Patrycja Anna,0,0,0,0
1653297700052,CHEM 6B,A05,092695,Hopkins; Patrycja Anna,24,0,25,1
1653297700052,CHEM 6B,A06,092696,Hopkins; Patrycja Anna,22,0,25,3
1653297700052,CHEM 6B,A07,092697,Hopkins; Patrycja Anna,24,0,25,1
1653297700576,CHEM 6C,A01,092708,Albizati; Kim F.,31,0,38,7
1653297700576,CHEM 6C,A02,092709,Albizati; Kim F.,32,0,38,6
1653297700576,CHEM 6C,A03,092710,Albizati; Kim F.,37,0,38,1
1653297700576,CHEM 6C,A04,092711,Albizati; Kim F.,36,0,38,2
1653297700576,CHEM 6C,A05,092712,Albizati; Kim F.,0,0,0,0
1653297700576,CHEM 6C,A06,092714,Albizati; Kim F.,33,0,38,5
1653297700576,CHEM 6C,A07,092715,Albizati; Kim F.,32,0,38,6
1653297700576,CHEM 6C,A08,092716,Albizati; Kim F.,37,0,38,1
1653297700576,CHEM 6C,A09,092717,Albizati; Kim F.,38,0,38,0
1653297701112,CHEM 7L,A01,089692,Leigh; Brian,11,0,19,8
1653297701112,CHEM 7L,A02,089693,Leigh; Brian,23,0,24,1
1653297701112,CHEM 7L,A03,089694,Leigh; Brian,24,0,24,0
1653297701112,CHEM 7L,A04,089695,Leigh; Brian,24,0,24,0
1653297701112,CHEM 7L,A05,089696,Leigh; Brian,23,0,24,1
1653297701112,CHEM 7L,A06,089697,Leigh; Brian,22,0,24,2
1653297701112,CHEM 7L,A07,089698,Leigh; Brian,21,0,21,0
1653297701112,CHEM 7L,A08,089699,Leigh; Brian,17,0,24,7
1653297701112,CHEM 7L,A09,089700,Leigh; Brian,23,0,24,1
1653297701112,CHEM 7L,A10,089701,Leigh; Brian,0,0,0,0
1653297701112,CHEM 7L,B01,089703,Leigh; Brian,18,0,24,6
1653297701112,CHEM 7L,B02,089704,Leigh; Brian,18,0,24,6
1653297701112,CHEM 7L,B03,089705,Leigh; Brian,23,0,24,1
1653297701112,CHEM 7L,B04,089706,Leigh; Brian,20,0,21,1
1653297701112,CHEM 7L,B05,089707,Leigh; Brian,17,0,24,7
1653297701112,CHEM 7L,B06,089708,Leigh; Brian,17,0,24,7
1653297701112,CHEM 7L,B07,089709,Leigh; Brian,17,0,24,7
1653297701112,CHEM 7L,B08,089710,Leigh; Brian,21,0,24,3
1653297701112,CHEM 7L,B09,089711,Leigh; Brian,21,0,24,3
1653297701112,CHEM 7L,B10,089712,Leigh; Brian,0,0,0,0
1653297701112,CHEM 7L,C01,089714,Staff,23,0,24,1
1653297701112,CHEM 7L,C02,089715,Staff,22,0,24,2
1653297701112,CHEM 7L,C03,089716,Staff,23,0,24,1
1653297701112,CHEM 7L,C04,089717,Staff,24,0,24,0
1653297701112,CHEM 7L,C05,089718,Staff,21,0,24,3
1653297701112,CHEM 7L,C06,089719,Staff,22,0,24,2
1653297701112,CHEM 7L,C07,089720,Staff,23,0,24,1
1653297701112,CHEM 7L,C08,089721,Staff,24,0,24,0
1653297701112,CHEM 7L,C09,089722,Staff,24,0,24,0
1653297701112,CHEM 7L,C10,089723,Staff,0,0,0,0
1653297701638,CHEM 40A,A01,092871,Schmidt; Valerie A,31,0,31,0
1653297701638,CHEM 40A,A02,092872,Schmidt; Valerie A,31,0,31,0
1653297701638,CHEM 40A,A03,092873,Schmidt; Valerie A,31,0,31,0
1653297701638,CHEM 40A,A04,092874,Schmidt; Valerie A,0,0,0,0
1653297701638,CHEM 40A,A05,092875,Schmidt; Valerie A,31,0,31,0
1653297701638,CHEM 40A,A06,092876,Schmidt; Valerie A,29,0,31,2
1653297701638,CHEM 40A,A07,092877,Schmidt; Valerie A,31,0,31,0
1653297701638,CHEM 40A,A08,092878,Schmidt; Valerie A,28,0,28,0
1653297701638,CHEM 40A,B01,089726,Lam; Tin Yiu,31,0,31,0
1653297701638,CHEM 40A,B02,089727,Lam; Tin Yiu,31,0,31,0
1653297701638,CHEM 40A,B03,089728,Lam; Tin Yiu,31,0,31,0
1653297701638,CHEM 40A,B04,089729,Lam; Tin Yiu,30,0,31,1
1653297701638,CHEM 40A,B05,089730,Lam; Tin Yiu,31,0,31,0
1653297701638,CHEM 40A,B06,089731,Lam; Tin Yiu,30,0,31,1
1653297701638,CHEM 40A,B07,089732,Lam; Tin Yiu,29,0,31,2
1653297701638,CHEM 40A,B08,089733,Lam; Tin Yiu,0,0,0,0
1653297701638,CHEM 40A,C01,092718,Albizati; Kim F.,17,0,31,14
1653297701638,CHEM 40A,C02,092719,Albizati; Kim F.,24,0,31,7
1653297701638,CHEM 40A,C03,092720,Albizati; Kim F.,12,0,31,19
1653297701638,CHEM 40A,C04,092721,Albizati; Kim F.,24,0,31,7
1653297701638,CHEM 40A,C05,092722,Albizati; Kim F.,21,0,31,10
1653297701638,CHEM 40A,C06,092723,Albizati; Kim F.,24,0,31,7
1653297701638,CHEM 40A,C07,092724,Albizati; Kim F.,30,0,31,1
1653297701638,CHEM 40A,C08,092725,Albizati; Kim F.,0,0,0,0
1653297701638,CHEM 40A,D01,092863,Yang; Jerry,28,0,31,3
1653297701638,CHEM 40A,D02,092864,Yang; Jerry,28,0,31,3
1653297701638,CHEM 40A,D03,092865,Yang; Jerry,31,0,31,0
1653297701638,CHEM 40A,D04,092866,Yang; Jerry,31,0,31,0
1653297701638,CHEM 40A,D05,092867,Yang; Jerry,0,0,0,0
1653297701638,CHEM 40A,D06,092868,Yang; Jerry,31,0,31,0
1653297701638,CHEM 40A,D07,092869,Yang; Jerry,31,0,31,0
1653297701638,CHEM 40A,D08,092870,Yang; Jerry,31,0,31,0
1653297702168,CHEM 40B,A01,092698,Oconnor; Joseph M.,24,0,34,10
1653297702168,CHEM 40B,A02,092699,Oconnor; Joseph M.,34,0,34,0
1653297702168,CHEM 40B,A03,092700,Oconnor; Joseph M.,0,0,0,0
1653297702168,CHEM 40B,A04,092701,Oconnor; Joseph M.,30,0,34,4
1653297702168,CHEM 40B,A05,092702,Oconnor; Joseph M.,33,0,34,1
1653297702168,CHEM 40B,A06,092703,Oconnor; Joseph M.,34,0,34,0
1653297702168,CHEM 40B,A07,092704,Oconnor; Joseph M.,32,0,34,2
1653297702168,CHEM 40B,A08,092705,Oconnor; Joseph M.,33,0,34,1
1653297702168,CHEM 40B,A09,092706,Oconnor; Joseph M.,34,0,34,0
1653297702695,CHEM 40C,A01,089739,Lam; Tin Yiu,0,0,0,0
1653297702695,CHEM 40C,A02,089740,Lam; Tin Yiu,0,0,0,0
1653297702695,CHEM 40C,A03,089741,Lam; Tin Yiu,0,0,0,0
1653297702695,CHEM 40C,A04,089742,Lam; Tin Yiu,13,0,34,21
1653297702695,CHEM 40C,A05,089743,Lam; Tin Yiu,32,0,34,2
1653297702695,CHEM 40C,A06,089744,Lam; Tin Yiu,31,0,34,3
1653297703219,CHEM 41A,A01,093840,Ternansky; Robert J.,29,0,33,4
1653297703219,CHEM 41A,A02,093841,Ternansky; Robert J.,32,0,33,1
1653297703219,CHEM 41A,A03,093842,Ternansky; Robert J.,33,0,33,0
1653297703219,CHEM 41A,A04,093843,Ternansky; Robert J.,30,0,33,3
1653297703219,CHEM 41A,A05,093844,Ternansky; Robert J.,31,0,33,2
1653297703219,CHEM 41A,A06,093845,Ternansky; Robert J.,27,0,27,0
1653297703219,CHEM 41A,A07,093846,Ternansky; Robert J.,32,0,33,1
1653297703219,CHEM 41A,A08,093847,Ternansky; Robert J.,33,0,33,0
1653297703757,CHEM 43A,A01,089746,Klosterman; Jeremy K,11,0,24,13
1653297703757,CHEM 43A,A02,089747,Klosterman; Jeremy K,16,0,24,8
1653297703757,CHEM 43A,A03,089748,Klosterman; Jeremy K,21,0,24,3
1653297703757,CHEM 43A,A04,089749,Klosterman; Jeremy K,22,0,24,2
1653297703757,CHEM 43A,A05,089750,Klosterman; Jeremy K,23,0,24,1
1653297703757,CHEM 43A,A06,089751,Klosterman; Jeremy K,9,0,24,15
1653297703757,CHEM 43A,A07,089752,Klosterman; Jeremy K,17,0,24,7
1653297703757,CHEM 43A,A08,089753,Klosterman; Jeremy K,16,0,24,8
1653297703757,CHEM 43A,A09,089754,Klosterman; Jeremy K,21,0,24,3
1653297703757,CHEM 43A,A10,089755,Klosterman; Jeremy K,21,0,24,3
1653297703757,CHEM 43A,A11,089756,Klosterman; Jeremy K,0,0,0,0
1653297703757,CHEM 43A,A12,089757,Klosterman; Jeremy K,0,0,0,0
1653297703757,CHEM 43A,A13,089758,Klosterman; Jeremy K,0,0,0,0
1653297703757,CHEM 43A,B01,089760,Klosterman; Jeremy K,0,0,0,0
1653297703757,CHEM 43A,B02,089761,Klosterman; Jeremy K,0,0,0,0
1653297703757,CHEM 43A,B03,089762,Klosterman; Jeremy K,16,0,24,8
1653297703757,CHEM 43A,B04,089763,Klosterman; Jeremy K,22,0,24,2
1653297703757,CHEM 43A,B05,089764,Klosterman; Jeremy K,23,0,24,1
1653297703757,CHEM 43A,B06,089765,Klosterman; Jeremy K,23,0,24,1
1653297703757,CHEM 43A,B07,089766,Klosterman; Jeremy K,17,0,24,7
1653297703757,CHEM 43A,B08,089767,Klosterman; Jeremy K,23,0,24,1
1653297703757,CHEM 43A,B09,089768,Klosterman; Jeremy K,24,0,24,0
1653297703757,CHEM 43A,B10,089769,Klosterman; Jeremy K,23,0,24,1
1653297703757,CHEM 43A,B11,089770,Klosterman; Jeremy K,22,0,24,2
1653297703757,CHEM 43A,B12,089771,Klosterman; Jeremy K,21,0,24,3
1653297704283,CHEM 87,A00,089772,Bussey; Thomas J,20,0,20,0
1653297704811,CHEM 96,A00,089773,Bussey; Thomas J,20,0,25,5
1653297705340,CHEM 100A,A01,089775,Pomeroy; Robert S.,22,0,24,2
1653297705340,CHEM 100A,A02,089776,Pomeroy; Robert S.,19,0,24,5
1653297705340,CHEM 100A,A03,089777,Pomeroy; Robert S.,13,0,24,11
1653297705340,CHEM 100A,A04,089778,Pomeroy; Robert S.,18,0,24,6
1653297705340,CHEM 100A,A05,089779,Pomeroy; Robert S.,19,0,24,5
1653297705340,CHEM 100A,A06,089780,Pomeroy; Robert S.,24,0,24,0
1653297705340,CHEM 100A,A07,089781,Pomeroy; Robert S.,0,0,0,0
1653297705869,CHEM 105A,A01,089783,Young; Mark,0,0,39,39
1653297705869,CHEM 105A,B01,089785,Young; Mark,26,0,39,13
1653297706396,CHEM 108,A01,089787,Ghosh; Gourisankar,1,0,22,21
1653297706396,CHEM 108,A02,089788,Ghosh; Gourisankar,6,0,22,16
1653297706396,CHEM 108,B01,089790,Ghosh; Gourisankar,13,0,22,9
1653297706396,CHEM 108,B02,089791,Ghosh; Gourisankar,20,0,22,2
1653297706925,CHEM 109,A01,089793,Hamaoka; Brent Y,4,0,22,18
1653297706925,CHEM 109,A02,089794,Hamaoka; Brent Y,10,0,22,12
1653297706925,CHEM 109,B01,089796,Hamaoka; Brent Y,6,0,22,16
1653297706925,CHEM 109,B02,089797,Hamaoka; Brent Y,18,0,22,4
1653297707450,CHEM 114A,A01,092855,Toor; Navtej,21,0,25,4
1653297707450,CHEM 114A,A02,092856,Toor; Navtej,25,0,25,0
1653297707450,CHEM 114A,A03,092857,Toor; Navtej,19,0,25,6
1653297707450,CHEM 114A,A04,092858,Toor; Navtej,24,0,25,1
1653297707450,CHEM 114A,A05,092859,Toor; Navtej,0,0,0,0
1653297707450,CHEM 114A,A06,092860,Toor; Navtej,14,0,25,11
1653297707450,CHEM 114A,A07,092861,Toor; Navtej,24,0,25,1
1653297707450,CHEM 114A,A08,092862,Toor; Navtej,24,0,25,1
1653297707975,CHEM 116,A01,092707,Ferguson; Fleur,7,0,35,28
1653297707975,CHEM 116,A02,094887,Ferguson; Fleur,31,0,35,4
1653297708580,CHEM 120A,A01,092785,Schimpf; Alina M,16,0,28,12
1653297708580,CHEM 120A,A02,092786,Schimpf; Alina M,26,0,28,2
1653297708580,CHEM 120A,A03,092787,Schimpf; Alina M,20,0,28,8
1653297708580,CHEM 120A,A04,092788,Schimpf; Alina M,27,0,28,1
1653297708580,CHEM 120A,A05,092789,Schimpf; Alina M,27,0,28,1
1653297708580,CHEM 120A,A06,092790,Schimpf; Alina M,0,0,0,0
1653297708580,CHEM 120A,A07,092791,Schimpf; Alina M,15,0,28,13
1653297708580,CHEM 120A,A08,092792,Schimpf; Alina M,0,0,0,0
1653297709107,CHEM 126A,A01,092768,Schoeneberg; Johannes,16,0,35,19
1653297709107,CHEM 126A,A02,092769,Schoeneberg; Johannes,35,0,35,0
1653297709107,CHEM 126A,A03,092770,Schoeneberg; Johannes,29,0,35,6
1653297709107,CHEM 126A,A04,092771,Schoeneberg; Johannes,0,0,0,0
1653297709107,CHEM 126A,A05,092772,Schoeneberg; Johannes,30,0,35,5
1653297709107,CHEM 126A,A06,092773,Schoeneberg; Johannes,33,0,35,2
1653297709631,CHEM 130,A01,092685,Sinha; Amitabha,28,0,38,10
1653297709631,CHEM 130,A02,092686,Sinha; Amitabha,31,0,38,7
1653297709631,CHEM 130,A03,092687,Sinha; Amitabha,34,0,38,4
1653297710155,CHEM 142,A00,089803,Esko; Jeffrey D. & Godula; Kamil,9,0,46,37
1653297710678,CHEM 143C,A01,089805,Ternansky; Robert J.,17,0,22,5
1653297710678,CHEM 143C,A02,089806,Ternansky; Robert J.,18,0,22,4
1653297710678,CHEM 143C,A03,089807,Ternansky; Robert J.,19,0,22,3
1653297710678,CHEM 143C,A04,089808,Ternansky; Robert J.,20,0,22,2
1653297711206,CHEM 152,A00,089809,Romero; Nathan A & Schmidt; Valerie A,35,0,40,5
1653297711729,CHEM 171,A01,092688,Slade; Jonathan,35,0,45,10
1653297711729,CHEM 171,A02,092689,Slade; Jonathan,44,0,45,1
1653297711729,CHEM 171,A03,092690,Slade; Jonathan,45,0,45,0
1653297712254,CHEM 186,A00,089811,Paesani; Francesco,9,0,15,6
1653297712780,CHIN 10AD,A01,086223,Staff,13,0,13,0
1653297712780,CHIN 10AD,A02,086224,Staff,12,0,13,1
1653297712780,CHIN 10AD,B01,086227,Staff,14,0,15,1
1653297713305,CHIN 10AM,A01,086230,Chen; Pei-Chia,16,0,16,0
1653297713305,CHIN 10AM,A02,086231,Chen; Pei-Chia,16,0,16,0
1653297713836,CHIN 10AN,A01,086234,Xu; Li,14,0,14,0
1653297713836,CHIN 10AN,A02,086235,Xu; Li,14,0,14,0
1653297713836,CHIN 10AN,B01,086240,Xu; Li,14,0,14,0
1653297713836,CHIN 10AN,B02,086242,Xu; Li,0,0,0,0
1653297713836,CHIN 10AN,C01,086245,Xu; Li,14,0,14,0
1653297713836,CHIN 10AN,C02,086246,Xu; Li,14,0,14,0
1653297714366,CHIN 20AD,A01,086248,Wang; Xiao,14,0,14,0
1653297714366,CHIN 20AD,A02,086249,Wang; Xiao,14,0,14,0
1653297714366,CHIN 20AD,B01,086251,Wang; Xiao,13,0,14,1
1653297714366,CHIN 20AD,B02,086252,Wang; Xiao,14,0,14,0
1653297714893,CHIN 20AM,A01,086254,Wang; Xiao,11,0,14,3
1653297714893,CHIN 20AM,A02,086255,Wang; Xiao,13,0,14,1
1653297714893,CHIN 20AM,B01,086257,Staff,15,0,15,0
1653297715417,CHIN 20AN,A01,086259,Anderson; Qin-Hong,11,0,12,1
1653297715417,CHIN 20AN,A02,086260,Anderson; Qin-Hong,12,0,12,0
1653297715417,CHIN 20AN,A03,086261,Anderson; Qin-Hong,0,0,0,0
1653297715417,CHIN 20AN,B01,086263,Anderson; Qin-Hong,12,0,13,1
1653297715417,CHIN 20AN,B02,086264,Anderson; Qin-Hong,13,0,13,0
1653297715949,CHIN 100AM,A00,086265,Anderson; Qin-Hong,20,0,20,0
1653297716474,CHIN 100AN,A00,086266,Chen; Pei-Chia,17,0,20,3
1653297716999,CHIN 185A,A00,086268,Staff,20,0,20,0
1653297717530,COGS 1,A01,087834,Barrera; Steven James,57,0,60,3
1653297717530,COGS 1,A02,087835,Barrera; Steven James,52,0,60,8
1653297717530,COGS 1,A03,087836,Barrera; Steven James,57,0,60,3
1653297717530,COGS 1,A04,087837,Barrera; Steven James,59,0,60,1
1653297717530,COGS 1,A05,087838,Barrera; Steven James,60,0,60,0
1653297717530,COGS 1,A06,087839,Barrera; Steven James,59,0,60,1
1653297717530,COGS 1,A07,087840,Barrera; Steven James,54,0,57,3
1653297718053,COGS 2,A01,087842,Boyle; Mary E. T.,64,0,64,0
1653297718053,COGS 2,A02,087843,Boyle; Mary E. T.,61,0,64,3
1653297718053,COGS 2,A03,087844,Boyle; Mary E. T.,64,0,64,0
1653297718580,COGS 3,A01,094312,Boyle; Mary E. T.,30,0,35,5
1653297718580,COGS 3,A02,094313,Boyle; Mary E. T.,33,0,35,2
1653297718580,COGS 3,A03,094314,Boyle; Mary E. T.,35,0,35,0
1653297718580,COGS 3,A04,094315,Boyle; Mary E. T.,35,0,35,0
1653297718580,COGS 3,A05,094316,Boyle; Mary E. T.,35,0,35,0
1653297719105,COGS 8,A01,087846,Staff,35,0,35,0
1653297719629,COGS 10,A01,094357,Hollan; James D.,53,0,60,7
1653297719629,COGS 10,A02,094358,Hollan; James D.,58,0,60,2
1653297719629,COGS 10,A03,094359,Hollan; James D.,59,0,60,1
1653297719629,COGS 10,A04,094360,Hollan; James D.,60,0,60,0
1653297719629,COGS 10,A05,094361,Hollan; James D.,60,0,60,0
1653297720154,COGS 11,A01,087848,Boyle; Mary E. T.,46,0,47,1
1653297720154,COGS 11,A02,087849,Boyle; Mary E. T.,44,0,47,3
1653297720154,COGS 11,A03,087850,Boyle; Mary E. T.,46,0,46,0
1653297720682,COGS 13,A01,087852,Davis; Joshua Daniel,56,0,60,4
1653297720682,COGS 13,A02,087853,Davis; Joshua Daniel,55,0,60,5
1653297720682,COGS 13,A03,087854,Davis; Joshua Daniel,57,0,60,3
1653297720682,COGS 13,A04,087855,Davis; Joshua Daniel,58,0,60,2
1653297721205,COGS 14A,A01,087857,Creel; Sarah,58,0,65,7
1653297721205,COGS 14A,A02,087858,Creel; Sarah,62,0,65,3
1653297721205,COGS 14A,A03,087859,Creel; Sarah,63,0,65,2
1653297721205,COGS 14A,A04,087860,Creel; Sarah,63,0,65,2
1653297721731,COGS 14B,A01,087862,Hoffman; Drew Ellen,56,0,60,4
1653297721731,COGS 14B,A02,087863,Hoffman; Drew Ellen,53,0,60,7
1653297721731,COGS 14B,A03,087864,Hoffman; Drew Ellen,60,0,60,0
1653297722254,COGS 15,A01,087866,Bergen; Benjamin,60,0,60,0
1653297722254,COGS 15,A02,087867,Bergen; Benjamin,59,0,60,1
1653297722780,COGS 17,A01,087869,Johnson; Christine M.,55,0,60,5
1653297722780,COGS 17,A02,087870,Johnson; Christine M.,58,0,60,2
1653297722780,COGS 17,A03,087871,Johnson; Christine M.,55,0,60,5
1653297722780,COGS 17,A04,087872,Johnson; Christine M.,60,0,60,0
1653297722780,COGS 17,A05,087873,Johnson; Christine M.,59,0,60,1
1653297722780,COGS 17,A06,087874,Johnson; Christine M.,60,0,60,0
1653297723316,COGS 18,A01,087876,Fleischer; Jason G,22,0,35,13
1653297723316,COGS 18,A02,087877,Fleischer; Jason G,31,0,35,4
1653297723316,COGS 18,A03,087878,Fleischer; Jason G,33,0,35,2
1653297723316,COGS 18,A04,087879,Fleischer; Jason G,33,0,35,2
1653297723316,COGS 18,A05,087880,Fleischer; Jason G,28,0,35,7
1653297723316,COGS 18,A06,087881,Fleischer; Jason G,34,0,35,1
1653297723316,COGS 18,A07,087882,Fleischer; Jason G,33,0,35,2
1653297723316,COGS 18,A08,087883,Fleischer; Jason G,31,0,35,4
1653297723316,COGS 18,A09,087884,Fleischer; Jason G,33,0,35,2
1653297723844,COGS 20,A01,090761,Borgo; David Garcia,5,0,5,0
1653297723844,COGS 20,A02,090762,Borgo; David Garcia,5,0,5,0
1653297723844,COGS 20,A03,090763,Borgo; David Garcia,5,0,5,0
1653297724370,COGS 87,A00,087885,Deak; Gedeon O.,20,0,20,0
1653297724370,COGS 87,B00,087886,Fleischer; Jason G,20,0,20,0
1653297724894,COGS 100,A01,087892,Kirsh; David Joel,56,0,60,4
1653297724894,COGS 100,A02,087893,Kirsh; David Joel,54,0,60,6
1653297724894,COGS 100,A03,087894,Kirsh; David Joel,54,0,60,6
1653297724894,COGS 100,A04,087895,Kirsh; David Joel,51,0,60,9
1653297724894,COGS 100,A05,087896,Kirsh; David Joel,48,0,60,12
1653297725418,COGS 101A,A01,087898,Hoffman; Drew Ellen,48,0,60,12
1653297725418,COGS 101A,A02,087899,Hoffman; Drew Ellen,58,0,60,2
1653297725418,COGS 101A,A03,087900,Hoffman; Drew Ellen,55,0,60,5
1653297725418,COGS 101A,A04,087901,Hoffman; Drew Ellen,58,0,60,2
1653297725418,COGS 101A,A05,087902,Hoffman; Drew Ellen,59,0,60,1
1653297725418,COGS 101A,A06,087903,Hoffman; Drew Ellen,56,0,60,4
1653297725942,COGS 101B,A01,087905,Barrera; Steven James,30,0,60,30
1653297725942,COGS 101B,A02,087906,Barrera; Steven James,52,0,60,8
1653297725942,COGS 101B,A03,087907,Barrera; Steven James,54,0,60,6
1653297726466,COGS 101C,A01,094240,Cooperrider; Kensy A,70,0,75,5
1653297726466,COGS 101C,A02,094241,Cooperrider; Kensy A,73,0,75,2
1653297726993,COGS 102A,A01,087909,Scott; Taylor Jackson,58,0,60,2
1653297726993,COGS 102A,A02,087910,Scott; Taylor Jackson,51,0,60,9
1653297727521,COGS 107A,A01,087912,Rangel; Lara M,51,0,60,9
1653297727521,COGS 107A,A02,087913,Rangel; Lara M,54,0,60,6
1653297727521,COGS 107A,A03,087914,Rangel; Lara M,47,0,60,13
1653297727521,COGS 107A,A04,087915,Rangel; Lara M,53,0,60,7
1653297727521,COGS 107A,A05,087916,Rangel; Lara M,55,0,60,5
1653297727521,COGS 107A,A06,087917,Rangel; Lara M,50,0,60,10
1653297728045,COGS 108,A01,087919,Fleischer; Jason G,15,0,60,45
1653297728045,COGS 108,A02,087920,Fleischer; Jason G,25,0,60,35
1653297728045,COGS 108,A03,087921,Fleischer; Jason G,40,0,60,20
1653297728045,COGS 108,A04,087922,Fleischer; Jason G,40,0,60,20
1653297728045,COGS 108,A05,087923,Fleischer; Jason G,48,0,60,12
1653297728045,COGS 108,A06,087924,Fleischer; Jason G,55,0,60,5
1653297728045,COGS 108,A07,087925,Fleischer; Jason G,42,0,57,15
1653297728569,COGS 110,A01,087927,Deak; Gedeon O.,30,0,35,5
1653297728569,COGS 110,A02,087928,Deak; Gedeon O.,33,0,35,2
1653297729100,COGS 116,A01,094228,Greene; Deanna Jacquelyn,51,0,52,1
1653297729100,COGS 116,A02,094229,Greene; Deanna Jacquelyn,52,0,52,0
1653297729100,COGS 116,A03,094230,Greene; Deanna Jacquelyn,50,0,52,2
1653297729625,COGS 118B,A01,087930,De Sa; Virginia,24,0,35,11
1653297729625,COGS 118B,A02,087931,De Sa; Virginia,28,0,35,7
1653297729625,COGS 118B,A03,087932,De Sa; Virginia,18,0,35,17
1653297729625,COGS 118B,A04,087933,De Sa; Virginia,29,0,35,6
1653297729625,COGS 118B,A05,087934,De Sa; Virginia,27,0,35,8
1653297729625,COGS 118B,A06,087935,De Sa; Virginia,27,0,35,8
1653297730153,COGS 120,A01,087937,Xia; Haijun,38,0,50,12
1653297730153,COGS 120,A02,087938,Xia; Haijun,32,0,50,18
1653297730153,COGS 120,A03,087939,Xia; Haijun,26,0,50,24
1653297730153,COGS 120,A04,087940,Xia; Haijun,1,0,50,49
1653297730675,COGS 128,A01,087944,Scott; Taylor Jackson,11,0,56,45
1653297731198,COGS 143,A01,087947,Johnson; Christine M.,23,0,40,17
1653297731721,COGS 153,A00,087949,Davis; Joshua Daniel,46,0,75,29
1653297732247,COGS 160,A00,087950,Deak; Gedeon O.,20,0,20,0
1653297732247,COGS 160,B00,094232,Saygin; Ayse P,40,0,40,0
1653297732775,COGS 175,A01,094238,Staff,27,0,40,13
1653297733304,COGS 187A,A01,087958,Kirsh; David Joel,22,0,50,28
1653297733304,COGS 187A,A02,087959,Kirsh; David Joel,30,0,50,20
1653297733304,COGS 187A,A03,087960,Kirsh; David Joel,34,0,45,11
1653297733828,COGS 190A,A00,087961,Staff,9999,0,9999,0
1653297734352,COGS 194,A00,087962,Hill; Seth J,9999,0,9999,0
1653297734883,COMM 10,A02,090628,Schmidt; Thomas Rainer,1,0,5,4
1653297734883,COMM 10,A03,090629,Schmidt; Thomas Rainer,3,0,5,2
1653297734883,COMM 10,A04,090630,Schmidt; Thomas Rainer,4,0,5,1
1653297734883,COMM 10,A05,090631,Schmidt; Thomas Rainer,4,0,5,1
1653297734883,COMM 10,A06,090632,Schmidt; Thomas Rainer,5,0,5,0
1653297734883,COMM 10,A07,090633,Schmidt; Thomas Rainer,5,0,5,0
1653297734883,COMM 10,A08,090634,Schmidt; Thomas Rainer,5,0,5,0
1653297734883,COMM 10,A09,090635,Schmidt; Thomas Rainer,5,0,5,0
1653297734883,COMM 10,A10,090636,Schmidt; Thomas Rainer,2,0,5,3
1653297734883,COMM 10,A11,090637,Schmidt; Thomas Rainer,4,0,5,1
1653297734883,COMM 10,A12,094013,Schmidt; Thomas Rainer,2,0,5,3
1653297734883,COMM 10,A13,094014,Schmidt; Thomas Rainer,5,0,5,0
1653297734883,COMM 10,A14,094015,Schmidt; Thomas Rainer,4,0,5,1
1653297734883,COMM 10,A15,094016,Schmidt; Thomas Rainer,5,0,5,0
1653297735407,COMM 100A,A01,090639,Irani; Lilly C,5,0,5,0
1653297735407,COMM 100A,A02,090640,Irani; Lilly C,4,0,5,1
1653297735407,COMM 100A,A03,090641,Irani; Lilly C,5,0,5,0
1653297735407,COMM 100A,A04,090642,Irani; Lilly C,3,0,5,2
1653297735407,COMM 100A,A05,090643,Irani; Lilly C,3,0,5,2
1653297735407,COMM 100A,A06,090644,Irani; Lilly C,4,0,5,1
1653297735407,COMM 100A,A07,090645,Irani; Lilly C,5,0,5,0
1653297735407,COMM 100A,A08,090646,Irani; Lilly C,5,0,5,0
1653297735407,COMM 100A,A09,090647,Irani; Lilly C,5,0,5,0
1653297735407,COMM 100A,A10,090648,Irani; Lilly C,5,0,5,0
1653297735407,COMM 100A,A11,090649,Irani; Lilly C,3,0,5,2
1653297735407,COMM 100A,A12,090650,Irani; Lilly C,5,0,5,0
1653297735932,COMM 101,A01,090652,Halm; Gavin Patrick,14,0,15,1
1653297735932,COMM 101,A02,090653,Halm; Gavin Patrick,14,0,15,1
1653297735932,COMM 101,A03,090654,Halm; Gavin Patrick,12,0,15,3
1653297735932,COMM 101,A04,090655,Halm; Gavin Patrick,13,0,15,2
1653297736458,COMM 101D,A00,090656,Halm; Gavin Patrick,14,0,15,1
1653297736981,COMM 101K,A00,090657,Ahn; Patricia Jeehyun,16,0,20,4
1653297737508,COMM 101T,A00,093701,Staff,20,0,20,0
1653297738030,COMM 102C,A01,090660,Staff,4,0,6,2
1653297738030,COMM 102C,A02,090661,Staff,6,0,6,0
1653297738030,COMM 102C,A03,090662,Staff,4,0,6,2
1653297738554,COMM 103D,A00,090663,Davis; Zeinabu I.,38,0,40,2
1653297739078,COMM 106E,A00,090667,Geiger; Richard Stuart,26,0,30,4
1653297739606,COMM 106G,A00,090668,Cordoba Azcarate; Matilde,25,0,30,5
1653297740130,COMM 108G,A00,090670,Walkover; Lillian B,30,0,30,0
1653297740654,COMM 109I,A00,090671,Tanaka; Stefan A.,30,0,30,0
1653297741180,COMM 109N,A00,094205,Hallin; Daniel C,25,0,30,5
1653297741705,COMM 110G,A00,090672,Whitworth-Smith; Andrew C,45,0,50,5
1653297742227,COMM 111P,A00,090673,Conner; Thomas Hartnell,27,0,30,3
1653297742751,COMM 111T,A00,090674,Iatarola; Briana Marie,27,0,30,3
1653297743278,COMM 124A,A00,090677,Sims; Christopher O,79,0,80,1
1653297743807,COMM 131,A00,090678,Fields; Gary,22,0,25,3
1653297744332,COMM 134,A00,090679,Kidman; Shawna F,16,0,25,9
1653297744855,COMM 146,A00,090680,Staff,22,0,25,3
1653297745376,COMM 166,A00,094493,Staff,24,0,25,1
1653297745900,COMM 172,A00,094066,Staff,23,0,25,2
1653297746426,COMM 182,A00,094063,Staff,25,0,25,0
1653297746954,COMM 190,A00,090686,Kidman; Shawna F,17,0,23,6
1653297746954,COMM 190,B00,090687,Irani; Lilly C,0,0,0,0
1653297746954,COMM 190,C00,090688,Keith; Kerry,21,0,23,2
1653297746954,COMM 190,D00,090689,Zilberg; Elana,23,0,23,0
1653297747481,COMM 194,A00,091600,Hill; Seth J,9999,0,9999,0
1653297748004,COMM 196A,A00,090690,Schmidt; Thomas Rainer,0,0,0,0
1653297748534,COMM 198,001,091397,Ahn; Patricia Jeehyun,9999,0,9999,0
1653297748534,COMM 198,002,091398,Alac; Morana,9999,0,9999,0
1653297748534,COMM 198,003,091399,Anderson; Patrick W.,9999,0,9999,0
1653297748534,COMM 198,004,091400,Boateng; Boatema,9999,0,9999,0
1653297748534,COMM 198,005,091401,Booker; Angela N,9999,0,9999,0
1653297748534,COMM 198,008,091402,Cordoba Azcarate; Matilde,9999,0,9999,0
1653297748534,COMM 198,009,091403,Davis; Zeinabu I.,9999,0,9999,0
1653297748534,COMM 198,010,091404,Dewaard; Andrew Michael,9999,0,9999,0
1653297748534,COMM 198,011,091405,Dominguez Rubio; Fernando,9999,0,9999,0
1653297748534,COMM 198,012,091406,Fattal; Alexander Leor,9999,0,9999,0
1653297748534,COMM 198,013,091407,Fields; Gary,9999,0,9999,0
1653297748534,COMM 198,014,091408,Gates; Kelly,9999,0,9999,0
1653297748534,COMM 198,015,091409,Goldfarb; Brian,9999,0,9999,0
1653297748534,COMM 198,018,091410,Hill; Erin Truesdell,9999,0,9999,0
1653297748534,COMM 198,019,091411,Horwitz; Robert B,9999,0,9999,0
1653297748534,COMM 198,021,091412,Irani; Lilly C,9999,0,9999,0
1653297748534,COMM 198,022,091413,Jack; Caroline Sarah,9999,0,9999,0
1653297748534,COMM 198,023,091414,Kidman; Shawna F,9999,0,9999,0
1653297748534,COMM 198,024,091415,Martinico; Daniel J,9999,0,9999,0
1653297748534,COMM 198,026,091416,Schmidt; Thomas Rainer,9999,0,9999,0
1653297748534,COMM 198,027,091417,Serlin; David,9999,0,9999,0
1653297748534,COMM 198,028,091418,Sims; Christopher O,9999,0,9999,0
1653297748534,COMM 198,029,091419,Tanaka; Stefan A.,9999,0,9999,0
1653297748534,COMM 198,030,091420,Zilberg; Elana,9999,0,9999,0
1653297748534,COMM 198,031,091421,Walkover; Lillian B,9999,0,9999,0
1653297748534,COMM 198,032,091422,Geiger; Richard Stuart,9999,0,9999,0
1653297749061,CSE 8A,A50,089985,Soosai Raj; Adalbert Geral,7,0,10,3
1653297749061,CSE 8A,A51,089986,Soosai Raj; Adalbert Geral,1,0,10,9
1653297749061,CSE 8A,A52,089987,Soosai Raj; Adalbert Geral,5,0,10,5
1653297749061,CSE 8A,A53,089988,Soosai Raj; Adalbert Geral,9,0,10,1
1653297749061,CSE 8A,B50,089990,Soosai Raj; Adalbert Geral,0,0,10,10
1653297749061,CSE 8A,B51,089991,Soosai Raj; Adalbert Geral,5,0,10,5
1653297749061,CSE 8A,B52,089992,Soosai Raj; Adalbert Geral,5,0,10,5
1653297749061,CSE 8A,B53,089993,Soosai Raj; Adalbert Geral,9,0,10,1
1653297749061,CSE 8A,C50,089995,Lerner; Sorin,0,0,10,10
1653297749061,CSE 8A,C51,089996,Lerner; Sorin,6,0,10,4
1653297749061,CSE 8A,C52,089997,Lerner; Sorin,9,0,10,1
1653297749061,CSE 8A,C53,089998,Lerner; Sorin,8,0,10,2
1653297749591,CSE 8B,A01,090000,Ochoa; Benjamin Lawrence,94,0,100,6
1653297750119,CSE 11,A01,090002,Cao; Yingjun,39,0,49,10
1653297750119,CSE 11,B01,090004,Cao; Yingjun,45,0,49,4
1653297750119,CSE 11,C01,090006,Cao; Yingjun,35,0,49,14
1653297750644,CSE 12,A01,090008,Staff,73,0,73,0
1653297750644,CSE 12,B01,090010,Staff,67,0,73,6
1653297750644,CSE 12,C01,090012,Staff,60,0,73,13
1653297751168,CSE 15L,A01,090014,Politz; Joseph Gibbs,4,0,10,6
1653297751168,CSE 15L,A02,090015,Politz; Joseph Gibbs,7,0,10,3
1653297751168,CSE 15L,A03,090016,Politz; Joseph Gibbs,9,0,10,1
1653297751168,CSE 15L,A04,090017,Politz; Joseph Gibbs,9,0,10,1
1653297751168,CSE 15L,A05,090018,Politz; Joseph Gibbs,9,0,10,1
1653297751168,CSE 15L,B01,090020,Politz; Joseph Gibbs,8,0,10,2
1653297751168,CSE 15L,B02,090021,Politz; Joseph Gibbs,6,0,10,4
1653297751168,CSE 15L,B03,090022,Politz; Joseph Gibbs,7,0,10,3
1653297751168,CSE 15L,B04,090023,Politz; Joseph Gibbs,7,0,10,3
1653297751168,CSE 15L,B05,090024,Politz; Joseph Gibbs,7,0,10,3
1653297751697,CSE 20,A01,090026,Staff,204,0,210,6
1653297752224,CSE 21,A01,090028,Impagliazzo; Russell,0,0,0,0
1653297752224,CSE 21,A02,094488,Impagliazzo; Russell,0,0,0,0
1653297752224,CSE 21,A03,094489,Impagliazzo; Russell,0,0,0,0
1653297752748,CSE 30,A01,092463,Muller; P Keith,73,0,100,27
1653297752748,CSE 30,A02,092464,Staff,97,0,100,3
1653297753270,CSE 87,A00,094193,Moshiri; Alexander Niema,20,0,20,0
1653297753795,CSE 95,A00,090030,Minnes Kemp; Mor Mia,35,0,35,0
1653297753795,CSE 95,B00,093883,Minnes Kemp; Mor Mia,35,0,35,0
1653297753795,CSE 95,C00,093885,Minnes Kemp; Mor Mia,35,0,35,0
1653297754323,CSE 100,A01,090033,Moshiri; Alexander Niema,68,0,114,46
1653297754845,CSE 100R,A01,093837,Moshiri; Alexander Niema,334,0,350,16
1653297755371,CSE 101,A01,090035,Saha; Barna,152,0,237,85
1653297755894,CSE 103,A01,090037,Freund; Yoav,60,0,75,15
1653297756420,CSE 105,A01,090039,Lovett; Shachar,201,0,225,24
1653297756951,CSE 106,A50,090042,Paturi; Ramamohan,11,0,30,19
1653297757475,CSE 107,A01,090044,Bellare; Mihir,94,0,120,26
1653297758004,CSE 110,A50,090047,Powell; Thomas Allan,39,0,50,11
1653297758004,CSE 110,A51,090048,Powell; Thomas Allan,39,0,50,11
1653297758004,CSE 110,A52,090049,Powell; Thomas Allan,48,0,50,2
1653297758004,CSE 110,A53,090050,Powell; Thomas Allan,49,0,50,1
1653297758004,CSE 110,A54,090051,Powell; Thomas Allan,45,0,50,5
1653297758004,CSE 110,A55,090052,Powell; Thomas Allan,50,0,50,0
1653297758004,CSE 110,A56,090053,Powell; Thomas Allan,49,0,50,1
1653297758004,CSE 110,A57,090054,Powell; Thomas Allan,41,0,45,4
1653297758531,CSE 118,A00,094897,Weibel; Nadir,0,0,0,0
1653297759054,CSE 120,A01,090056,Voelker; Geoffrey M.,226,0,300,74
1653297759578,CSE 124,A01,090058,Porter; George M,123,0,189,66
1653297760105,CSE 127,A01,090060,Savage; Stefan,46,0,189,143
1653297760629,CSE 130,A01,090062,Polikarpova; Nadezhda,171,0,189,18
1653297761156,CSE 132A,A01,090064,Deutsch; Alin Bernard,47,0,189,142
1653297761755,CSE 140,A01,090068,Eldon; John,169,0,196,27
1653297761755,CSE 140,B01,090070,Orailoglu; Alex,48,0,49,1
1653297762279,CSE 140L,A01,090072,Eldon; John,161,0,192,31
1653297762279,CSE 140L,B01,090075,Orailoglu; Alex,44,0,49,5
1653297762806,CSE 142,A01,090078,Porter; Leonard Emerson,86,0,146,60
1653297762806,CSE 142,B01,090080,Porter; Leonard Emerson,107,0,146,39
1653297763332,CSE 142L,A01,090082,Swanson; Steven James,48,0,146,98
1653297763332,CSE 142L,B01,090084,Swanson; Steven James,120,0,146,26
1653297763859,CSE 151B,A01,090088,Cottrell; Garrison W,258,0,328,70
1653297764392,CSE 152A,A01,090090,Chandraker; Manmohan Krishna,153,0,189,36
1653297764917,CSE 158,A01,090092,McAuley; Julian John,84,0,197,113
1653297765441,CSE 158R,A01,090094,McAuley; Julian John,306,0,353,47
1653297765968,CSE 167,A01,090096,Chern; Albert Ren-Haur,165,0,189,24
1653297766491,CSE 170,A01,090098,Vaccaro; Kristen Marie,20,0,20,0
1653297766491,CSE 170,A02,090099,Vaccaro; Kristen Marie,14,0,20,6
1653297766491,CSE 170,A03,090100,Vaccaro; Kristen Marie,14,0,20,6
1653297766491,CSE 170,A04,090101,Vaccaro; Kristen Marie,14,0,20,6
1653297766491,CSE 170,A05,090102,Vaccaro; Kristen Marie,18,0,20,2
1653297767015,CSE 190,A00,090103,Shalev; Aaron D,40,0,40,0
1653297767015,CSE 190,B00,090104,Vaccaro; Kristen Marie,100,0,100,0
1653297767015,CSE 190,C00,090105,Pannuto; Patrick William,25,0,25,0
1653297767538,CSE 191,A00,093848,Minnes Kemp; Mor Mia,9999,0,9999,0
1653297768066,CSE 193,A01,090107,Elsherif; May Elhussein,49,0,49,0
1653297768593,CSE 194,A01,090109,Munyaka; Imani N. S.,20,0,49,29
1653297769121,CSS 1,A01,086486,Staff,22,0,24,2
1653297769121,CSS 1,A02,086487,Staff,21,0,24,3
1653297769121,CSS 1,A03,086488,Staff,20,0,24,4
1653297769121,CSS 1,A04,086489,Staff,23,0,24,1
1653297769662,DOC 1,A01,086773,Solomon; Amanda Lee Albaniel,0,0,0,0
1653297769662,DOC 1,A02,086774,Solomon; Amanda Lee Albaniel,0,0,0,0
1653297769662,DOC 1,A03,086775,Solomon; Amanda Lee Albaniel,5,0,6,1
1653297769662,DOC 1,A04,086776,Solomon; Amanda Lee Albaniel,6,0,6,0
1653297769662,DOC 1,A05,086777,Solomon; Amanda Lee Albaniel,6,0,6,0
1653297769662,DOC 1,A06,086778,Solomon; Amanda Lee Albaniel,6,0,6,0
1653297769662,DOC 1,A07,086779,Solomon; Amanda Lee Albaniel,5,0,6,1
1653297769662,DOC 1,A08,086849,Solomon; Amanda Lee Albaniel,6,0,6,0
1653297769662,DOC 1,A09,086780,Solomon; Amanda Lee Albaniel,6,0,6,0
1653297769662,DOC 1,A10,086781,Solomon; Amanda Lee Albaniel,6,0,6,0
1653297769662,DOC 1,A11,086782,Solomon; Amanda Lee Albaniel,5,0,6,1
1653297769662,DOC 1,A12,086783,Solomon; Amanda Lee Albaniel,6,0,6,0
1653297769662,DOC 1,A13,086784,Solomon; Amanda Lee Albaniel,6,0,6,0
1653297769662,DOC 1,A14,086785,Solomon; Amanda Lee Albaniel,6,0,6,0
1653297769662,DOC 1,A15,086786,Solomon; Amanda Lee Albaniel,6,0,6,0
1653297769662,DOC 1,A16,086787,Solomon; Amanda Lee Albaniel,6,0,6,0
1653297769662,DOC 1,A17,086788,Solomon; Amanda Lee Albaniel,0,0,0,0
1653297769662,DOC 1,A18,086789,Solomon; Amanda Lee Albaniel,0,0,0,0
1653297769662,DOC 1,B01,086791,Solomon; Amanda Lee Albaniel,6,0,6,0
1653297769662,DOC 1,B02,086792,Solomon; Amanda Lee Albaniel,6,0,6,0
1653297769662,DOC 1,B03,086793,Solomon; Amanda Lee Albaniel,6,0,6,0
1653297769662,DOC 1,B04,086794,Solomon; Amanda Lee Albaniel,6,0,6,0
1653297769662,DOC 1,B05,086795,Solomon; Amanda Lee Albaniel,3,0,6,3
1653297769662,DOC 1,B06,086796,Solomon; Amanda Lee Albaniel,6,0,6,0
1653297769662,DOC 1,B07,086797,Solomon; Amanda Lee Albaniel,6,0,6,0
1653297769662,DOC 1,B08,086798,Solomon; Amanda Lee Albaniel,6,0,6,0
1653297769662,DOC 1,B09,086799,Solomon; Amanda Lee Albaniel,6,0,6,0
1653297769662,DOC 1,B10,086800,Solomon; Amanda Lee Albaniel,6,0,6,0
1653297769662,DOC 1,B11,086801,Solomon; Amanda Lee Albaniel,5,0,6,1
1653297769662,DOC 1,B12,086802,Solomon; Amanda Lee Albaniel,6,0,6,0
1653297769662,DOC 1,B13,086803,Solomon; Amanda Lee Albaniel,6,0,6,0
1653297769662,DOC 1,B14,086804,Solomon; Amanda Lee Albaniel,6,0,6,0
1653297769662,DOC 1,B15,086805,Solomon; Amanda Lee Albaniel,5,0,6,1
1653297769662,DOC 1,B16,086806,Solomon; Amanda Lee Albaniel,6,0,6,0
1653297769662,DOC 1,B17,086807,Solomon; Amanda Lee Albaniel,0,0,0,0
1653297769662,DOC 1,B18,086808,Solomon; Amanda Lee Albaniel,0,0,0,0
1653297769662,DOC 1,C01,086810,Strom; Megan C.,6,0,6,0
1653297769662,DOC 1,C02,086811,Strom; Megan C.,5,0,6,1
1653297769662,DOC 1,C03,086812,Strom; Megan C.,6,0,6,0
1653297769662,DOC 1,C04,086813,Strom; Megan C.,5,0,6,1
1653297769662,DOC 1,C05,086814,Strom; Megan C.,5,0,6,1
1653297769662,DOC 1,C06,086815,Strom; Megan C.,6,0,6,0
1653297769662,DOC 1,C07,086816,Strom; Megan C.,6,0,6,0
1653297769662,DOC 1,C08,086817,Strom; Megan C.,6,0,6,0
1653297769662,DOC 1,C09,086818,Strom; Megan C.,6,0,6,0
1653297769662,DOC 1,C10,086819,Strom; Megan C.,6,0,6,0
1653297769662,DOC 1,C11,086820,Strom; Megan C.,6,0,6,0
1653297769662,DOC 1,C12,086821,Strom; Megan C.,6,0,6,0
1653297769662,DOC 1,C13,086822,Strom; Megan C.,6,0,6,0
1653297769662,DOC 1,C14,086823,Strom; Megan C.,6,0,6,0
1653297769662,DOC 1,C15,086824,Strom; Megan C.,6,0,6,0
1653297769662,DOC 1,C16,086825,Strom; Megan C.,6,0,6,0
1653297769662,DOC 1,C17,086826,Strom; Megan C.,0,0,0,0
1653297769662,DOC 1,C18,086827,Strom; Megan C.,0,0,0,0
1653297769662,DOC 1,D01,086829,Strom; Megan C.,6,0,6,0
1653297769662,DOC 1,D02,086830,Strom; Megan C.,6,0,6,0
1653297769662,DOC 1,D03,086831,Strom; Megan C.,5,0,6,1
1653297769662,DOC 1,D04,086832,Strom; Megan C.,6,0,6,0
1653297769662,DOC 1,D05,086833,Strom; Megan C.,6,0,6,0
1653297769662,DOC 1,D06,086834,Strom; Megan C.,6,0,6,0
1653297769662,DOC 1,D07,086835,Strom; Megan C.,6,0,6,0
1653297769662,DOC 1,D08,086836,Strom; Megan C.,6,0,6,0
1653297769662,DOC 1,D09,086837,Strom; Megan C.,0,0,0,0
1653297769662,DOC 1,D10,086838,Strom; Megan C.,0,0,0,0
1653297769662,DOC 1,D11,086839,Strom; Megan C.,6,0,6,0
1653297769662,DOC 1,D12,086840,Strom; Megan C.,6,0,6,0
1653297769662,DOC 1,D13,086841,Strom; Megan C.,6,0,6,0
1653297769662,DOC 1,D14,086842,Strom; Megan C.,5,0,6,1
1653297769662,DOC 1,D15,086843,Strom; Megan C.,6,0,6,0
1653297769662,DOC 1,D16,086844,Strom; Megan C.,5,0,6,1
1653297770192,DOC 100D,A00,086845,Pass; Natalye Joann,0,0,0,0
1653297770192,DOC 100D,B00,086846,Pass; Natalye Joann,21,0,25,4
1653297770192,DOC 100D,C00,086847,Pass; Natalye Joann,23,0,25,2
1653297770718,DSC 10,A01,088092,Tiefenbruck; Janine LoBue,13,0,15,2
1653297770718,DSC 10,B01,088095,Tiefenbruck; Janine LoBue,9,0,15,6
1653297770718,DSC 10,C01,088098,Rampure; Suraj,0,0,15,15
1653297771251,DSC 20,A01,088101,Langlois; Marina,148,0,150,2
1653297771777,DSC 30,A01,088105,Langlois; Marina,74,0,75,1
1653297772303,DSC 40A,A01,088107,Rampure; Suraj,97,0,100,3
1653297772303,DSC 40A,B01,088109,Rampure; Suraj,99,0,100,1
1653297772829,DSC 40B,A01,088111,Eldridge; Justin Matthew,73,0,75,2
1653297772829,DSC 40B,B01,088113,Wang; Yusu,75,0,75,0
1653297773352,DSC 80,A01,088115,Eldridge; Justin Matthew,95,0,100,5
1653297773879,DSC 95,A01,088117,Langlois; Marina,20,0,20,0
1653297774404,DSC 96,A00,088118,Liao; Soohyun Nam,50,0,50,0
1653297774929,DSC 100,A01,088120,Salimi; Babak,164,0,175,11
1653297775452,DSC 102,A01,094320,Kumar; Arun Kumar,77,0,125,48
1653297775978,DSC 180A,A01,088124,Fraenkel; Aaron Mcmillan,0,0,0,0
1653297775978,DSC 180A,A02,088125,Fraenkel; Aaron Mcmillan,0,0,0,0
1653297775978,DSC 180A,A03,088126,Fraenkel; Aaron Mcmillan,0,0,0,0
1653297775978,DSC 180A,A04,088127,Fraenkel; Aaron Mcmillan,0,0,0,0
1653297775978,DSC 180A,A05,088128,Fraenkel; Aaron Mcmillan,0,0,0,0
1653297775978,DSC 180A,A06,088129,Fraenkel; Aaron Mcmillan,0,0,0,0
1653297775978,DSC 180A,A07,088130,Fraenkel; Aaron Mcmillan,0,0,0,0
1653297775978,DSC 180A,A08,088131,Fraenkel; Aaron Mcmillan,0,0,0,0
1653297775978,DSC 180A,A09,088132,Fraenkel; Aaron Mcmillan,0,0,0,0
1653297775978,DSC 180A,A10,088133,Fraenkel; Aaron Mcmillan,0,0,0,0
1653297775978,DSC 180A,A11,088134,Fraenkel; Aaron Mcmillan,0,0,0,0
1653297775978,DSC 180A,A12,088135,Fraenkel; Aaron Mcmillan,0,0,0,0
1653297775978,DSC 180A,A13,088136,Fraenkel; Aaron Mcmillan,0,0,0,0
1653297775978,DSC 180A,A14,088137,Fraenkel; Aaron Mcmillan,0,0,0,0
1653297775978,DSC 180A,A15,088138,Fraenkel; Aaron Mcmillan,0,0,0,0
1653297775978,DSC 180A,B01,088141,Fraenkel; Aaron Mcmillan,0,0,0,0
1653297775978,DSC 180A,B02,088142,Fraenkel; Aaron Mcmillan,0,0,0,0
1653297775978,DSC 180A,B03,088143,Fraenkel; Aaron Mcmillan,0,0,0,0
1653297775978,DSC 180A,B04,088144,Fraenkel; Aaron Mcmillan,0,0,0,0
1653297775978,DSC 180A,B05,088145,Fraenkel; Aaron Mcmillan,0,0,0,0
1653297775978,DSC 180A,B06,088146,Fraenkel; Aaron Mcmillan,0,0,0,0
1653297775978,DSC 180A,B07,088147,Fraenkel; Aaron Mcmillan,0,0,0,0
1653297775978,DSC 180A,B08,088148,Fraenkel; Aaron Mcmillan,0,0,0,0
1653297775978,DSC 180A,B09,088149,Fraenkel; Aaron Mcmillan,0,0,0,0
1653297775978,DSC 180A,B10,088150,Fraenkel; Aaron Mcmillan,0,0,0,0
1653297775978,DSC 180A,B11,088151,Fraenkel; Aaron Mcmillan,0,0,0,0
1653297775978,DSC 180A,B12,088152,Fraenkel; Aaron Mcmillan,0,0,0,0
1653297775978,DSC 180A,B13,088153,Fraenkel; Aaron Mcmillan,0,0,0,0
1653297775978,DSC 180A,B14,088154,Fraenkel; Aaron Mcmillan,0,0,0,0
1653297775978,DSC 180A,B15,088155,Fraenkel; Aaron Mcmillan,0,0,0,0
1653297776506,DSC 190,A01,088158,Mishne; Gal,48,0,50,2
1653297776506,DSC 190,B01,088160,Silberman; Jack,16,0,21,5
1653297777032,DSC 197,001,088161,Eldridge; Justin Matthew,9999,0,9999,0
1653297777557,DSGN 1,A01,087888,Meyer; Michael Wayne,49,0,53,4
1653297777557,DSGN 1,A02,087889,Meyer; Michael Wayne,47,0,53,6
1653297777557,DSGN 1,A03,087890,Meyer; Michael Wayne,43,0,53,10
1653297778081,DSGN 100,A01,087983,Dow; Steven P,39,0,40,1
1653297778081,DSGN 100,A02,087984,Dow; Steven P,40,0,40,0
1653297778081,DSGN 100,A03,087985,Dow; Steven P,34,0,40,6
1653297778610,DSGN 118,A01,087987,Xia; Haijun,55,0,60,5
1653297778610,DSGN 118,A02,087988,Xia; Haijun,56,0,60,4
1653297779141,DSGN 119,A00,087989,Staff,51,0,70,19
1653297779670,ECE 5,A01,090699,Morris; Karcher William,0,0,0,0
1653297779670,ECE 5,A02,090700,Morris; Karcher William,0,0,0,0
1653297779670,ECE 5,A03,090701,Morris; Karcher William,0,0,0,0
1653297779670,ECE 5,A04,090702,Morris; Karcher William,0,0,0,0
1653297779670,ECE 5,A05,090703,Morris; Karcher William,0,0,0,0
1653297779670,ECE 5,A06,090704,Morris; Karcher William,0,0,0,0
1653297780201,ECE 15,A01,090706,Schurgers; Curt,0,0,0,0
1653297780201,ECE 15,A02,090707,Schurgers; Curt,0,0,0,0
1653297780737,ECE 16,A01,090709,Khoshabeh; Ramsin,24,0,30,6
1653297781263,ECE 17,A01,090711,Gilja; Vikash,55,0,60,5
1653297781788,ECE 25,A50,090714,Liu; Zhaowei,0,0,0,0
1653297781788,ECE 25,A51,090715,Liu; Zhaowei,0,0,0,0
1653297781788,ECE 25,A52,090716,Liu; Zhaowei,0,0,0,0
1653297782319,ECE 30,A50,094300,Mir Arabbaygi; Siavash,25,0,30,5
1653297782319,ECE 30,A51,094301,Mir Arabbaygi; Siavash,29,0,30,1
1653297782319,ECE 30,A52,094302,Mir Arabbaygi; Siavash,27,0,30,3
1653297782319,ECE 30,A53,094303,Mir Arabbaygi; Siavash,29,0,30,1
1653297782319,ECE 30,A54,094304,Mir Arabbaygi; Siavash,25,0,25,0
1653297782845,ECE 35,A50,090720,Schurgers; Curt,0,0,0,0
1653297782845,ECE 35,A51,090721,Schurgers; Curt,0,0,0,0
1653297782845,ECE 35,A52,090722,Schurgers; Curt,0,0,0,0
1653297782845,ECE 35,A53,090723,Schurgers; Curt,0,0,0,0
1653297782845,ECE 35,A54,090724,Schurgers; Curt,0,0,0,0
1653297782845,ECE 35,A55,090725,Schurgers; Curt,0,0,0,0
1653297782845,ECE 35,B50,090729,Schurgers; Curt,0,0,0,0
1653297782845,ECE 35,B51,090730,Schurgers; Curt,0,0,0,0
1653297782845,ECE 35,B52,090731,Schurgers; Curt,0,0,0,0
1653297782845,ECE 35,B53,090732,Schurgers; Curt,0,0,0,0
1653297782845,ECE 35,B54,090733,Schurgers; Curt,0,0,0,0
1653297782845,ECE 35,B55,090734,Schurgers; Curt,0,0,0,0
1653297783368,ECE 45,A01,090736,Franceschetti; Massimo,56,0,57,1
1653297783368,ECE 45,A02,090737,Franceschetti; Massimo,50,0,58,8
1653297783897,ECE 65,A50,090741,Baghdadchi; Saharnaz,13,0,15,2
1653297783897,ECE 65,A51,090742,Baghdadchi; Saharnaz,5,0,10,5
1653297783897,ECE 65,A52,090743,Baghdadchi; Saharnaz,14,0,15,1
1653297783897,ECE 65,A53,090744,Baghdadchi; Saharnaz,8,0,10,2
1653297783897,ECE 65,A54,094865,Baghdadchi; Saharnaz,14,0,15,1
1653297783897,ECE 65,A55,094866,Baghdadchi; Saharnaz,9,0,10,1
1653297783897,ECE 65,A56,094867,Baghdadchi; Saharnaz,14,0,15,1
1653297783897,ECE 65,A57,094868,Baghdadchi; Saharnaz,15,0,15,0
1653297783897,ECE 65,A58,094869,Baghdadchi; Saharnaz,10,0,10,0
1653297784421,ECE 100,A01,090746,Baghdadchi; Saharnaz,16,0,20,4
1653297784421,ECE 100,A02,090747,Baghdadchi; Saharnaz,20,0,20,0
1653297784421,ECE 100,A03,090748,Baghdadchi; Saharnaz,18,0,20,2
1653297784421,ECE 100,A04,090749,Baghdadchi; Saharnaz,20,0,20,0
1653297784421,ECE 100,A05,090750,Baghdadchi; Saharnaz,18,0,20,2
1653297784421,ECE 100,A06,090751,Baghdadchi; Saharnaz,18,0,20,2
1653297784421,ECE 100,A07,090752,Baghdadchi; Saharnaz,20,0,20,0
1653297784955,ECE 101,A01,090754,Siegel; Paul H.,62,0,75,13
1653297784955,ECE 101,A02,090755,Siegel; Paul H.,71,0,75,4
1653297785479,ECE 102,A00,090756,Hsueh; Tzu-Chien,57,0,75,18
1653297786019,ECE 103,A01,090767,Lo; Yu-Hwa,45,0,50,5
1653297786543,ECE 107,A01,090769,Lomakin; Vitaliy,72,0,75,3
1653297787066,ECE 109,A01,090771,Zeger; Kenneth A.,176,0,180,4
1653297787588,ECE 111,A01,090774,Koushanfar; Farinaz,100,0,120,20
1653297788114,ECE 121A,A50,090777,Esmaili; Gholamreza,17,0,24,7
1653297788114,ECE 121A,A51,090778,Esmaili; Gholamreza,9,0,24,15
1653297788114,ECE 121A,A52,090779,Esmaili; Gholamreza,22,0,24,2
1653297788638,ECE 128A,A00,090780,Staff,40,0,70,30
1653297789166,ECE 135A,A00,090781,Kuzum; Duygu,30,0,30,0
1653297789689,ECE 143,A00,090782,Unpingco; Jose H.,0,0,0,2
1653297790212,ECE 148,A01,090784,Staff,32,0,32,0
1653297790740,ECE 155,A01,090786,Milstein; Laurence B.,16,0,20,4
1653297791264,ECE 158A,A01,090788,Franceschetti; Massimo,56,0,65,9
1653297791786,ECE 161A,A01,090790,Rao; Bhaskar D.,103,0,115,12
1653297792311,ECE 164,A00,090791,Hall; Drew A.,87,0,115,28
1653297792841,ECE 166,A50,090796,Rebeiz; Gabriel,6,0,12,6
1653297792841,ECE 166,A51,090797,Rebeiz; Gabriel,9,0,12,3
1653297792841,ECE 166,A52,090799,Rebeiz; Gabriel,1,0,12,11
1653297792841,ECE 166,A53,090800,Rebeiz; Gabriel,6,0,12,6
1653297792841,ECE 166,A54,094335,Rebeiz; Gabriel,11,0,12,1
1653297792841,ECE 166,A55,094336,Rebeiz; Gabriel,12,0,12,0
1653297792841,ECE 166,A56,094349,Rebeiz; Gabriel,13,0,15,2
1653297792841,ECE 166,A57,094350,Rebeiz; Gabriel,14,0,15,1
1653297793363,ECE 171A,A01,090802,Atanasov; Nikolay A.,45,0,60,15
1653297793889,ECE 171B,A01,090804,Shi; Yuanyuan,44,0,50,6
1653297794415,ECE 174,A01,090806,Pal; Piya,125,0,146,21
1653297794936,ECE 182,A01,090808,Lomakin; Vitaliy,23,0,23,0
1653297795460,ECE 187,A00,090809,Liu; Zhaowei,19,0,20,1
1653297795986,ECE 196,A00,090812,Morris; Karcher William,19,0,24,5
1653297795986,ECE 196,B00,094833,Morris; Karcher William,24,0,24,0
1653297796517,ECE 197,001,090813,Sievenpiper; Daniel F.,9999,0,9999,0
1653297797051,ECON 1,A01,092535,Staff,0,0,0,0
1653297797051,ECON 1,A02,092536,Staff,0,0,0,0
1653297797051,ECON 1,A03,092537,Staff,0,0,0,0
1653297797051,ECON 1,A04,092538,Staff,0,0,0,0
1653297797051,ECON 1,A05,092539,Staff,0,0,0,0
1653297797051,ECON 1,B01,092540,Ma; Alyson Chan,42,0,45,3
1653297797051,ECON 1,B02,092541,Ma; Alyson Chan,45,0,45,0
1653297797051,ECON 1,B03,092542,Ma; Alyson Chan,45,0,45,0
1653297797051,ECON 1,B04,092543,Ma; Alyson Chan,40,0,40,0
1653297797051,ECON 1,B05,092544,Ma; Alyson Chan,40,0,40,0
1653297797051,ECON 1,C01,092545,Tocoian; Oana,0,0,0,0
1653297797051,ECON 1,C02,092546,Tocoian; Oana,0,0,0,0
1653297797051,ECON 1,C03,092547,Tocoian; Oana,0,0,0,0
1653297797051,ECON 1,C04,092548,Tocoian; Oana,0,0,0,0
1653297797051,ECON 1,D01,094253,Levkoff; Steven B.,41,0,45,4
1653297797051,ECON 1,D02,094254,Levkoff; Steven B.,44,0,45,1
1653297797051,ECON 1,D03,094255,Levkoff; Steven B.,45,0,45,0
1653297797051,ECON 1,D04,094256,Levkoff; Steven B.,36,0,40,4
1653297797051,ECON 1,D05,094257,Levkoff; Steven B.,40,0,40,0
1653297797578,ECON 2,A01,092549,Staff,0,0,0,0
1653297797578,ECON 2,A02,092550,Staff,0,0,0,0
1653297797578,ECON 2,A03,092551,Staff,0,0,0,0
1653297798106,ECON 4,A01,092554,Levkoff; Steven B.,29,0,30,1
1653297798106,ECON 4,A02,092555,Levkoff; Steven B.,27,0,30,3
1653297798106,ECON 4,A03,092556,Levkoff; Steven B.,30,0,30,0
1653297798631,ECON 100A,A01,092557,Newhouse; Herbert S,23,0,30,7
1653297798631,ECON 100A,A02,092558,Newhouse; Herbert S,28,0,30,2
1653297798631,ECON 100A,A03,092559,Newhouse; Herbert S,29,0,30,1
1653297798631,ECON 100A,A04,092560,Newhouse; Herbert S,35,0,35,0
1653297798631,ECON 100A,B01,092561,Newhouse; Herbert S,20,0,30,10
1653297798631,ECON 100A,B02,092562,Newhouse; Herbert S,28,0,30,2
1653297798631,ECON 100A,B03,092563,Newhouse; Herbert S,15,0,30,15
1653297798631,ECON 100A,B04,092564,Newhouse; Herbert S,35,0,35,0
1653297799159,ECON 100B,A01,092565,Galperti; Simone,27,0,30,3
1653297799159,ECON 100B,A02,092566,Galperti; Simone,18,0,20,2
1653297799159,ECON 100B,A03,094496,Staff,27,0,30,3
1653297799159,ECON 100B,A04,094497,Staff,16,0,20,4
1653297799159,ECON 100B,B01,092567,Galperti; Simone,16,0,25,9
1653297799693,ECON 100C,A01,092569,Du; Songzi,62,0,75,13
1653297799693,ECON 100C,B01,092570,Du; Songzi,70,0,75,5
1653297799693,ECON 100C,B02,094258,Du; Songzi,75,0,75,0
1653297800217,ECON 100CH,A00,088284,Andreoni; James,20,0,20,0
1653297800743,ECON 109,A01,092572,Watson; Joel Christopher,68,0,75,7
1653297800743,ECON 109,B01,092573,Watson; Joel Christopher,68,0,75,7
1653297801266,ECON 110A,A01,092574,Alon; Titan Michael,12,0,25,13
1653297801266,ECON 110A,A02,092575,Alon; Titan Michael,24,0,25,1
1653297801266,ECON 110A,B01,092576,Alon; Titan Michael,24,0,25,1
1653297801266,ECON 110A,B02,092577,Alon; Titan Michael,25,0,25,0
1653297801791,ECON 110B,A01,092578,Trottner; Fabian Gunter We,16,0,25,9
1653297801791,ECON 110B,A02,094054,Trottner; Fabian Gunter We,23,0,25,2
1653297801791,ECON 110B,B01,092579,Trottner; Fabian Gunter We,7,0,25,18
1653297801791,ECON 110B,B02,094055,Trottner; Fabian Gunter We,24,0,25,1
1653297802316,ECON 116,A00,088291,Lowes; Sara Rachel,58,0,70,12
1653297802842,ECON 120A,A01,092580,Elliott; Graham,18,0,25,7
1653297802842,ECON 120A,A02,092581,Elliott; Graham,22,0,25,3
1653297802842,ECON 120A,B01,092582,Elliott; Graham,18,0,25,7
1653297802842,ECON 120A,B02,092583,Elliott; Graham,20,0,25,5
1653297802842,ECON 120A,C01,092584,Tocoian; Oana,27,0,30,3
1653297802842,ECON 120A,C02,092585,Tocoian; Oana,28,0,30,2
1653297802842,ECON 120A,C03,092586,Tocoian; Oana,40,0,40,0
1653297803370,ECON 120B,A01,092587,Candido; Maria Teresa,58,0,70,12
1653297803370,ECON 120B,A02,092588,Candido; Maria Teresa,51,0,60,9
1653297803370,ECON 120B,A03,092589,Candido; Maria Teresa,56,0,60,4
1653297803893,ECON 120C,A01,092590,Candido; Maria Teresa,48,0,60,12
1653297803893,ECON 120C,A02,092591,Candido; Maria Teresa,59,0,60,1
1653297803893,ECON 120C,A03,094310,Candido; Maria Teresa,73,0,75,2
1653297804418,ECON 121,A00,088298,Vogl; Tom Saul,36,0,50,14
1653297804940,ECON 130,A00,088299,Staff,59,0,75,16
1653297805468,ECON 131,A00,088300,Jacobsen; Mark,129,0,150,21
1653297805468,ECON 131,B00,088301,Jacobsen; Mark,15,0,30,15
1653297805992,ECON 152,A00,088302,Fadlon; Yizhak,34,0,50,16
1653297805992,ECON 152,B00,088303,Fadlon; Yizhak,49,0,50,1
1653297806514,ECON 168,A00,088304,Staff,54,0,60,6
1653297807040,ECON 191B,A00,088312,Galperti; Simone,20,0,20,0
1653297807564,EDS 25,A01,087581,Staff,9,0,10,1
1653297807564,EDS 25,A02,087582,Staff,10,0,10,0
1653297807564,EDS 25,A03,087583,Staff,7,0,10,3
1653297807564,EDS 25,A04,087584,Staff,10,0,10,0
1653297808089,EDS 31,A00,087585,Bussey; Thomas J,9,0,10,1
1653297808611,EDS 110R,A01,087597,Cohen; Shana R,43,0,50,7
1653297808611,EDS 110R,B01,093579,Cohen; Shana R,10,0,10,0
1653297809135,EDS 113,A00,087598,Staff,45,0,50,5
1653297809659,EDS 114,A01,088091,Eguchi; Emi,17,0,20,3
1653297809659,EDS 114,A02,087600,Eguchi; Emi,19,0,20,1
1653297810185,EDS 117,A01,087603,Chung; Luz Marina,25,0,35,10
1653297810185,EDS 117,A02,087604,Chung; Luz Marina,34,0,35,1
1653297810710,EDS 124AR,A01,087606,Simon; Elizabeth A,0,0,19,19
1653297810710,EDS 124AR,A02,087607,Simon; Elizabeth A,13,0,19,6
1653297810710,EDS 124AR,A03,087608,Simon; Elizabeth A,15,0,19,4
1653297810710,EDS 124AR,A04,087609,Simon; Elizabeth A,4,0,19,15
1653297810710,EDS 124AR,B01,087611,Simon; Elizabeth A,14,0,19,5
1653297810710,EDS 124AR,B02,087612,Simon; Elizabeth A,18,0,19,1
1653297810710,EDS 124AR,B03,087613,Simon; Elizabeth A,18,0,19,1
1653297810710,EDS 124AR,B04,087614,Simon; Elizabeth A,19,0,19,0
1653297810710,EDS 124AR,C01,094210,Simon; Elizabeth A,6,0,6,0
1653297810710,EDS 124AR,C02,094211,Simon; Elizabeth A,6,0,6,0
1653297810710,EDS 124AR,C03,094212,Simon; Elizabeth A,6,0,6,0
1653297810710,EDS 124AR,C04,094213,Simon; Elizabeth A,6,0,6,0
1653297810710,EDS 124AR,D01,094215,Simon; Elizabeth A,6,0,6,0
1653297810710,EDS 124AR,D02,094216,Simon; Elizabeth A,6,0,6,0
1653297810710,EDS 124AR,D03,094217,Simon; Elizabeth A,6,0,6,0
1653297810710,EDS 124AR,D04,094218,Simon; Elizabeth A,6,0,6,0
1653297811233,EDS 124BR,A00,087615,Eguchi; Emi,65,0,75,10
1653297811233,EDS 124BR,B00,093580,Eguchi; Emi,25,0,25,0
1653297811760,EDS 125,A00,087616,Jones; Gabrielle Anastasia,51,0,60,9
1653297812283,EDS 129A,A01,087618,Heinzman; Erica M.,43,0,50,7
1653297812806,EDS 130,A01,087620,Holtzman; Caren Lynn,17,0,20,3
1653297812806,EDS 130,A02,087621,Holtzman; Caren Lynn,20,0,20,0
1653297812806,EDS 130,A03,087622,Holtzman; Caren Lynn,20,0,20,0
1653297813335,EDS 131,A01,087624,Wishard Guerra; Alison G.,37,0,40,3
1653297813858,EDS 133,A01,087627,Bintliff; Amy S.V.,17,0,20,3
1653297813858,EDS 133,A02,087628,Bintliff; Amy S.V.,19,0,20,1
1653297814387,EDS 139,A00,087629,Holtzman; Caren Lynn,55,0,60,5
1653297814387,EDS 139,B00,087630,Heinzman; Erica M.,51,0,60,9
1653297814387,EDS 139,C00,087631,Bintliff; Amy S.V.,57,0,60,3
1653297814387,EDS 139,D00,087632,Wishard Guerra; Alison G.,58,0,60,2
1653297814387,EDS 139,E00,087633,Holtzman; Caren Lynn,30,0,30,0
1653297814387,EDS 139,F00,094886,Staff,25,0,25,0
1653297815001,EDS 146,A01,094220,Staff,25,0,25,0
1653297815525,EDS 164R,A01,087644,Wishard Guerra; Alison G.,37,0,40,3
1653297815525,EDS 164R,B01,093582,Wishard Guerra; Alison G.,20,0,20,0
1653297816048,EDS 190,A00,087645,Bresser; Bernard George,20,0,20,0
1653297816048,EDS 190,B00,087646,Pappas; Elizabeth,20,0,20,0
1653297816048,EDS 190,C00,087647,Scharton; Susan Michelle,20,0,20,0
1653297816048,EDS 190,E00,087648,Staff,20,0,20,0
1653297816571,ENG 10,A00,086288,Staff,30,0,30,0
1653297816571,ENG 10,B00,086289,Staff,30,0,30,0
1653297817095,ENG 15,A01,086291,Staff,35,0,35,0
1653297817620,ENG 20,A00,086292,Evdokimenko; Ekaterina,33,0,35,2
1653297818143,ENG 100D,A00,086293,Ngo; Anh-Thu T.,45,0,50,5
1653297818143,ENG 100D,B00,094309,Staff,46,0,50,4
1653297818667,ENG 100L,A00,086295,Kleissl; Jan,6,0,6,0
1653297818667,ENG 100L,B00,086296,Bratton; Maryann,8,0,8,0
1653297818667,ENG 100L,C00,086297,Nguyen; Truong Quang,10,0,10,0
1653297818667,ENG 100L,E00,086299,de Oliveira; Mauricio,8,0,8,0
1653297818667,ENG 100L,F00,086300,Goldberg; Charles G.,6,0,6,0
1653297818667,ENG 100L,G00,086301,Bratton; Maryann,6,0,6,0
1653297818667,ENG 100L,H00,086302,Staff,6,0,6,0
1653297819192,ENVR 30,A01,093565,Staff,29,0,30,1
1653297819192,ENVR 30,A02,093567,Staff,28,0,30,2
1653297819192,ENVR 30,A03,093568,Staff,25,0,30,5
1653297819192,ENVR 30,A04,093569,Staff,30,0,30,0
1653297819192,ENVR 30,A05,093570,Staff,29,0,30,1
1653297819192,ENVR 30,A06,093566,Staff,29,0,30,1
1653297819720,ENVR 102,A00,093571,Daly; Heather Marie,25,0,30,5
1653297820775,ERC 1,A01,092328,Herbst; Matthew,20,0,20,0
1653297820775,ERC 1,A02,092330,Herbst; Matthew,20,0,20,0
1653297820775,ERC 1,A03,092331,Herbst; Matthew,20,0,20,0
1653297820775,ERC 1,A04,092332,Herbst; Matthew,20,0,20,0
1653297820775,ERC 1,A05,092333,Herbst; Matthew,20,0,20,0
1653297820775,ERC 1,A06,092334,Herbst; Matthew,20,0,20,0
1653297821298,ERC 2,A01,092336,Rahimi; Babak,20,0,20,0
1653297821298,ERC 2,A02,092337,Rahimi; Babak,20,0,20,0
1653297821298,ERC 2,A03,092338,Rahimi; Babak,20,0,20,0
1653297821298,ERC 2,A04,092339,Rahimi; Babak,20,0,20,0
1653297821824,ERC 20,A00,092340,Evans; Ivan T,30,0,30,0
1653297821824,ERC 20,B00,092341,Evans; Ivan T,30,0,30,0
1653297822346,ERC 87,A00,093850,Herbst; Matthew,20,0,20,0
1653297822868,ERC 92,A00,092342,Staff,1,0,1,0
1653297822868,ERC 92,B00,092343,Staff,1,0,1,0
1653297822868,ERC 92,C00,092344,Staff,1,0,1,0
1653297822868,ERC 92,D00,092345,Staff,1,0,1,0
1653297822868,ERC 92,E00,092346,Staff,1,0,1,0
1653297822868,ERC 92,F00,092347,Staff,1,0,1,0
1653297823396,ESYS 90,A00,086303,Teranes; Jane,12,0,12,0
1653297823934,ESYS 101,A01,086305,Taylor; Jennifer Rebecca & Diaz; Julia Michelle,25,0,27,2
1653297823934,ESYS 101,A02,086306,Taylor; Jennifer Rebecca & Diaz; Julia Michelle,15,0,27,12
1653297823934,ESYS 101,A03,086307,Taylor; Jennifer Rebecca & Diaz; Julia Michelle,21,0,27,6
1653297823934,ESYS 101,A04,086308,Taylor; Jennifer Rebecca & Diaz; Julia Michelle,27,0,27,0
1653297824458,ESYS 187A,A01,086310,Teranes; Jane,38,0,40,2
1653297824458,ESYS 187A,B01,086312,Teranes; Jane,30,0,40,10
1653297824989,ETHN 1,A01,086314,Frank; Ross H.,15,0,15,0
1653297824989,ETHN 1,A02,086315,Frank; Ross H.,15,0,15,0
1653297824989,ETHN 1,A03,086316,Frank; Ross H.,14,0,15,1
1653297824989,ETHN 1,A04,086317,Frank; Ross H.,15,0,15,0
1653297824989,ETHN 1,A05,086318,Frank; Ross H.,15,0,15,0
1653297824989,ETHN 1,A06,086319,Frank; Ross H.,13,0,15,2
1653297824989,ETHN 1,A07,086320,Frank; Ross H.,15,0,15,0
1653297824989,ETHN 1,A08,086321,Frank; Ross H.,14,0,15,1
1653297824989,ETHN 1,A09,086322,Frank; Ross H.,15,0,15,0
1653297824989,ETHN 1,A10,086323,Frank; Ross H.,15,0,15,0
1653297824989,ETHN 1,A11,086324,Frank; Ross H.,15,0,15,0
1653297824989,ETHN 1,A12,086325,Frank; Ross H.,15,0,15,0
1653297824989,ETHN 1,A13,086326,Frank; Ross H.,15,0,15,0
1653297824989,ETHN 1,A14,086327,Frank; Ross H.,15,0,15,0
1653297824989,ETHN 1,A15,086328,Frank; Ross H.,15,0,15,0
1653297824989,ETHN 1,A16,086329,Frank; Ross H.,15,0,15,0
1653297825516,ETHN 100A,A00,086330,Patel; Shaista,41,0,48,7
1653297826040,ETHN 103,A00,086331,Perreira; Christopher Michael,63,0,70,7
1653297826565,ETHN 104,A00,086332,Staff,0,0,0,0
1653297827092,ETHN 106,A00,086333,Staff,0,0,0,0
1653297827615,ETHN 121,A00,086341,Sasaki; Christen T,20,0,28,8
1653297828139,ETHN 139,A00,086342,Ruiz; Ariana,16,0,20,4
1653297828668,ETHN 144M,A00,086343,Jolivette; Andrew J,66,0,70,4
1653297829195,ETHN 159,A00,088427,Graham; Jessica Lynn,0,0,0,0
1653297829717,ETHN 163E,A00,086344,Patel; Shaista,37,0,40,3
1653297830245,ETHN 178R,A00,090798,Borgo; David Garcia,15,0,20,5
1653297830771,ETHN 187,A00,086345,Perez; Roy,14,0,16,2
1653297831297,EXPR 100,A00,085686,Staff,9999,0,9999,0
1653297831824,FMPH 40,A00,086370,Emory; Kristen,70,0,75,5
1653297831824,FMPH 40,B00,086371,Romero; Sally Ann Dominick,71,0,75,4
1653297832348,FMPH 101,A00,086372,Brouwer; Kimberly,43,0,55,12
1653297832872,FMPH 102,A50,094498,Rana; Brinda Kanti,42,0,55,13
1653297833396,FMPH 110,A00,086374,Zoumas-Morse; Christine E.,61,0,65,4
1653297833919,FMPH 120,A00,086375,Nguyen-Grozavu; France T.,45,0,65,20
1653297833919,FMPH 120,B00,086376,Nguyen-Grozavu; France T.,60,0,65,5
1653297834444,FMPH 130,A00,086377,Staff,48,0,65,17
1653297835489,FMPH 161,A00,086379,Zoumas-Morse; Christine E.,58,0,65,7
1653297836018,FMPH 191,A00,086380,Harrell; Maralee Mae,58,0,60,2
1653297836541,FMPH 196A,A00,086381,Binkin; Nancy Jeanne,0,0,0,0
1653297837069,GLBH 20,A00,086407,Walkover; Lillian B,85,0,90,5
1653297837596,GLBH 100,A00,086408,Staff,55,0,56,1
1653297837596,GLBH 100,B00,086409,Wu; Hua,52,0,56,4
1653297837596,GLBH 100,D00,086411,Staff,38,0,40,2
1653297838120,GLBH 103,A00,086412,Hannah; Seth Donal,48,0,50,2
1653297838645,GLBH 105,A00,086413,Olivas Hernandez; Olga Lid,36,0,38,2
1653297839172,GLBH 106,A00,086414,Kayser; Georgia Lyn,40,0,40,0
1653297839695,GLBH 111,A01,094330,Burgos; Jose L.,0,0,0,0
1653297839695,GLBH 111,B01,094332,Burgos; Jose L.,0,0,0,0
1653297840218,GLBH 148,A00,086415,Staff,69,0,73,4
1653297840744,GLBH 181,A00,086417,Burgos; Jose L.,144,0,146,2
1653297841272,GSS 20,A00,094269,Staff,73,0,75,2
1653297841801,HDS 1,A01,086423,Staff,24,0,25,1
1653297841801,HDS 1,A02,086424,Staff,24,0,25,1
1653297841801,HDS 1,A03,086425,Staff,23,0,25,2
1653297841801,HDS 1,A04,086426,Staff,25,0,25,0
1653297841801,HDS 1,A05,086427,Staff,24,0,25,1
1653297841801,HDS 1,A06,086428,Staff,25,0,25,0
1653297841801,HDS 1,A07,086429,Staff,30,0,30,0
1653297842327,HDS 60,A01,086431,Staff,23,0,25,2
1653297842851,HDS 111,A00,086432,Staff,73,0,80,7
1653297843374,HDS 121,A01,086434,Deak; Gedeon O.,11,0,15,4
1653297843374,HDS 121,A02,086435,Deak; Gedeon O.,13,0,15,2
1653297843896,HDS 150,A00,086436,Staff,25,0,25,0
1653297843896,HDS 150,B00,086437,Staff,25,0,25,0
1653297844424,HDS 173,A00,086439,Staff,27,0,30,3
1653297844947,HDS 181,A01,086441,Staff,30,0,30,0
1653297845473,HDS 191,A01,086443,Staff,25,0,25,0
1653297845996,HIEA 129,A00,088057,Schneewind; Sarah,0,0,0,0
1653297846521,HIEA 137,A00,088058,Lu; Weijing,53,0,55,2
1653297847044,HIEA 144,A00,088059,Henry; Todd A.,44,0,45,1
1653297847568,HIEA 171,A00,088060,Lu; Weijing,15,0,15,0
1653297848095,HIEU 102,A00,088061,Watts; Edward J.,0,0,0,0
1653297848620,HIEU 107,A00,088062,Caciola; Nancy A,0,0,0,0
1653297849144,HIEU 108,A00,088063,Balberg; Mira,53,0,60,7
1653297849668,HIEU 128,A00,088064,Neuheiser; Joerg,0,0,0,0
1653297850190,HIEU 144,A00,094327,Staff,48,0,50,2
1653297850714,HIEU 149,A00,088065,Devereux; Andrew W,38,0,45,7
1653297851244,HIEU 154,A00,088066,Biess; Frank Peter,58,0,65,7
1653297851771,HIGL 114,A00,088067,Edington; Claire Ellen,53,0,55,2
1653297852294,HILA 119,A00,088068,Vitz; Matthew,49,0,51,2
1653297852817,HILA 122,A00,088069,Widener; Daniel,61,0,65,4
1653297853346,HILD 2A,A01,088024,Hanna; Mark G.,28,0,28,0
1653297853346,HILD 2A,A02,088025,Hanna; Mark G.,25,0,25,0
1653297853346,HILD 2A,A03,088026,Hanna; Mark G.,27,0,28,1
1653297853346,HILD 2A,A04,088027,Hanna; Mark G.,28,0,28,0
1653297853346,HILD 2A,A05,088028,Hanna; Mark G.,28,0,28,0
1653297853346,HILD 2A,A06,088029,Hanna; Mark G.,28,0,28,0
1653297853869,HILD 7A,A01,088031,Graham; Jessica Lynn,28,0,28,0
1653297853869,HILD 7A,A02,088032,Graham; Jessica Lynn,27,0,28,1
1653297853869,HILD 7A,A03,088033,Graham; Jessica Lynn,27,0,28,1
1653297853869,HILD 7A,A04,088034,Graham; Jessica Lynn,26,0,28,2
1653297853869,HILD 7A,A05,088035,Graham; Jessica Lynn,26,0,28,2
1653297853869,HILD 7A,A06,088037,Graham; Jessica Lynn,22,0,28,6
1653297853869,HILD 7A,A07,088038,Graham; Jessica Lynn,28,0,28,0
1653297853869,HILD 7A,A08,088039,Graham; Jessica Lynn,28,0,28,0
1653297853869,HILD 7A,A09,088040,Graham; Jessica Lynn,27,0,28,1
1653297853869,HILD 7A,A10,088041,Graham; Jessica Lynn,28,0,28,0
1653297853869,HILD 7A,A11,088042,Graham; Jessica Lynn,28,0,28,0
1653297853869,HILD 7A,A12,088043,Graham; Jessica Lynn,28,0,28,0
1653297854394,HILD 10,A01,088045,Muscolino; Micah S,27,0,28,1
1653297854394,HILD 10,A02,088046,Muscolino; Micah S,27,0,28,1
1653297854394,HILD 10,A03,088047,Muscolino; Micah S,28,0,28,0
1653297854394,HILD 10,A04,088048,Muscolino; Micah S,27,0,28,1
1653297854394,HILD 10,A05,088049,Muscolino; Micah S,28,0,28,0
1653297854394,HILD 10,A06,088050,Muscolino; Micah S,27,0,28,1
1653297854917,HILD 30,A01,088052,Edington; Claire Ellen,24,0,28,4
1653297854917,HILD 30,A02,088053,Edington; Claire Ellen,28,0,28,0
1653297855440,HILD 41,A01,088055,Devereux; Andrew W,28,0,28,0
1653297855440,HILD 41,A02,088056,Devereux; Andrew W,28,0,28,0
1653297855967,HINE 116,A00,088070,Kayali; Hasan,47,0,50,3
1653297856489,HINE 144,A00,088071,Provence; Michael,40,0,45,5
1653297857016,HISC 106,A00,088072,Pineda De Avila; Nydia,47,0,50,3
1653297857540,HISC 115,A00,088073,Gere; Catherina M.,103,0,110,7
1653297858063,HITO 87,A00,094352,Patterson; Patrick H.,20,0,20,0
1653297858063,HITO 87,C00,094354,Patterson; Patrick H.,20,0,20,0
1653297858063,HITO 87,B00,094353,Hanna; Mark G.,20,0,20,0
1653297858589,HITO 100,A00,088074,Hanna; Mark G.,8,0,12,4
1653297859115,HITO 193,A00,091603,Hill; Seth J,9999,0,9999,0
1653297859643,HITO 196,A00,088075,Hendrickson; Gerald M.,20,0,20,0
1653297860171,HIUS 108B,A00,088076,Klann; Mary Cameron,48,0,51,3
1653297860696,HIUS 112,A00,088077,Plant; Rebecca Jo,144,0,148,4
1653297861219,HIUS 152A,A00,088078,Vandevelde; Kenneth Joseph,40,0,45,5
1653297861745,HIUS 155,A00,088079,Alvarez; Luis A,37,0,45,8
1653297862274,HIUS 183,A00,088080,Graham; Jessica Lynn,19,0,20,1
1653297862805,HUM 3,A01,087224,West; Geoffrey Scott,27,0,28,1
1653297862805,HUM 3,A02,087225,West; Geoffrey Scott,28,0,28,0
1653297862805,HUM 3,A03,087226,West; Geoffrey Scott,26,0,28,2
1653297862805,HUM 3,A04,087227,West; Geoffrey Scott,27,0,28,1
1653297862805,HUM 3,A05,087228,West; Geoffrey Scott,27,0,28,1
1653297862805,HUM 3,A06,087229,West; Geoffrey Scott,24,0,28,4
1653297862805,HUM 3,A07,087230,West; Geoffrey Scott,27,0,28,1
1653297862805,HUM 3,A08,087231,West; Geoffrey Scott,28,0,28,0
1653297862805,HUM 3,B01,087233,Staff,28,0,28,0
1653297862805,HUM 3,B02,087234,Staff,28,0,28,0
1653297862805,HUM 3,B03,087235,Staff,28,0,28,0
1653297862805,HUM 3,B04,087236,Staff,28,0,28,0
1653297862805,HUM 3,B05,087237,Staff,28,0,28,0
1653297862805,HUM 3,B06,087238,Staff,28,0,28,0
1653297862805,HUM 3,B07,087239,Staff,0,0,0,0
1653297862805,HUM 3,B08,087240,Staff,0,0,0,0
1653297862805,HUM 3,B09,087241,Staff,30,0,30,0
1653297862805,HUM 3,B10,087242,Staff,28,0,30,2
1653297862805,HUM 3,C01,087244,Patterson; Patrick H.,0,0,0,0
1653297862805,HUM 3,C02,087245,Patterson; Patrick H.,0,0,0,0
1653297862805,HUM 3,C03,087246,Patterson; Patrick H.,23,0,28,5
1653297862805,HUM 3,C04,087247,Patterson; Patrick H.,28,0,28,0
1653297862805,HUM 3,C05,087248,Patterson; Patrick H.,27,0,28,1
1653297862805,HUM 3,C06,087249,Patterson; Patrick H.,25,0,28,3
1653297862805,HUM 3,C07,087250,Patterson; Patrick H.,27,0,28,1
1653297862805,HUM 3,C08,087251,Patterson; Patrick H.,28,0,28,0
1653297862805,HUM 3,C09,087252,Patterson; Patrick H.,28,0,28,0
1653297862805,HUM 3,C10,087253,Patterson; Patrick H.,27,0,28,1
1653297862805,HUM 3,D01,087255,Lyon; Antony J.,24,0,28,4
1653297862805,HUM 3,D02,087256,Lyon; Antony J.,28,0,28,0
1653297862805,HUM 3,D03,087257,Lyon; Antony J.,0,0,0,0
1653297862805,HUM 3,D04,087258,Lyon; Antony J.,0,0,0,0
1653297862805,HUM 3,D05,087259,Lyon; Antony J.,27,0,28,1
1653297862805,HUM 3,D06,087260,Lyon; Antony J.,28,0,28,0
1653297862805,HUM 3,D07,087261,Lyon; Antony J.,21,0,28,7
1653297862805,HUM 3,D08,087262,Lyon; Antony J.,20,0,28,8
1653297862805,HUM 3,D09,087263,Lyon; Antony J.,28,0,28,0
1653297862805,HUM 3,D10,087264,Lyon; Antony J.,27,0,28,1
1653297862805,HUM 3,D11,087265,Lyon; Antony J.,30,0,30,0
1653297862805,HUM 3,D12,087266,Lyon; Antony J.,30,0,30,0
1653297862805,HUM 3,D13,087267,Lyon; Antony J.,26,0,28,2
1653297862805,HUM 3,D14,087268,Lyon; Antony J.,25,0,28,3
1653297863328,INTL 101,A01,088176,Day; Joel Keith,19,0,20,1
1653297863328,INTL 101,A02,088177,Day; Joel Keith,20,0,20,0
1653297863328,INTL 101,A03,088178,Day; Joel Keith,17,0,20,3
1653297863328,INTL 101,A04,088179,Day; Joel Keith,19,0,20,1
1653297863328,INTL 101,A05,088180,Day; Joel Keith,19,0,20,1
1653297863328,INTL 101,A06,088181,Day; Joel Keith,18,0,20,2
1653297863855,INTL 102,A01,088183,Walter; Barbara Florence,19,0,20,1
1653297863855,INTL 102,A02,088184,Walter; Barbara Florence,19,0,20,1
1653297863855,INTL 102,A03,088185,Walter; Barbara Florence,18,0,20,2
1653297863855,INTL 102,A04,088186,Walter; Barbara Florence,16,0,20,4
1653297863855,INTL 102,A05,088187,Walter; Barbara Florence,19,0,20,1
1653297863855,INTL 102,A06,088188,Walter; Barbara Florence,19,0,20,1
1653297864381,INTL 190,A00,088189,Auerbach; Bradford C,0,0,0,0
1653297864381,INTL 190,B00,088190,Auerbach; Bradford C,0,0,0,0
1653297864381,INTL 190,C00,088191,Fortier; Jana,0,0,0,0
1653297864381,INTL 190,D00,088192,Kshatriya; Krista C,0,0,0,0
1653297864381,INTL 190,E00,088193,Nadkarni; Vidya,0,0,0,0
1653297864381,INTL 190,F00,088194,Scott; Jeffrey F,0,0,0,0
1653297864381,INTL 190,G00,088195,Segui; Alan S,0,0,0,0
1653297864381,INTL 190,H00,088196,Segui; Alan S,0,0,0,0
1653297864906,INTL 190H,A00,088197,Gibson; Clark C,0,0,0,0
1653297865458,JAPN 10A,A01,086851,Maruyama; Rie,15,0,15,0
1653297865458,JAPN 10A,A02,086852,Maruyama; Rie,15,0,15,0
1653297865458,JAPN 10A,B01,086854,Staff,13,0,13,0
1653297865458,JAPN 10A,B02,086855,Staff,13,0,13,0
1653297865458,JAPN 10A,C01,086857,McKee; Mayumi Mochizuki,13,0,13,0
1653297865458,JAPN 10A,C02,086858,McKee; Mayumi Mochizuki,11,0,13,2
1653297865458,JAPN 10A,D01,086860,Sato; Kyoko,13,0,13,0
1653297865458,JAPN 10A,D02,086861,Sato; Kyoko,13,0,13,0
1653297865458,JAPN 10A,E01,086863,Kamioka; Sachiko,12,0,13,1
1653297865458,JAPN 10A,E02,086864,Kamioka; Sachiko,12,0,13,1
1653297865458,JAPN 10A,F01,086866,Sato; Kyoko,13,0,13,0
1653297865458,JAPN 10A,F02,086867,Sato; Kyoko,13,0,13,0
1653297865458,JAPN 10A,G01,086869,Maruyama; Rie,8,0,13,5
1653297865458,JAPN 10A,G02,086870,Maruyama; Rie,13,0,13,0
1653297865458,JAPN 10A,H01,086872,Kamioka; Sachiko,12,0,13,1
1653297865458,JAPN 10A,H02,086873,Kamioka; Sachiko,11,0,13,2
1653297865458,JAPN 10A,I01,086875,Staff,12,0,13,1
1653297865458,JAPN 10A,I02,086876,Staff,13,0,13,0
1653297865458,JAPN 10A,J01,086878,McKee; Mayumi Mochizuki,12,0,13,1
1653297865458,JAPN 10A,J02,086879,McKee; Mayumi Mochizuki,13,0,13,0
1653297865458,JAPN 10A,K01,086881,Inada; Minori,13,0,13,0
1653297865458,JAPN 10A,K02,086882,Inada; Minori,12,0,13,1
1653297865458,JAPN 10A,L01,086884,Tipton; Yuko,13,0,13,0
1653297865458,JAPN 10A,L02,086885,Tipton; Yuko,13,0,13,0
1653297865458,JAPN 10A,M01,086887,Inada; Minori,12,0,13,1
1653297865458,JAPN 10A,M02,086888,Inada; Minori,13,0,13,0
1653297865458,JAPN 10A,N01,086890,McKee; Mayumi Mochizuki,13,0,13,0
1653297865458,JAPN 10A,N02,086891,McKee; Mayumi Mochizuki,11,0,13,2
1653297865458,JAPN 10A,O01,086893,Staff,13,0,13,0
1653297865458,JAPN 10A,O02,086894,Staff,12,0,13,1
1653297865458,JAPN 10A,P01,086896,Tipton; Yuko,15,0,15,0
1653297865458,JAPN 10A,P02,086897,Tipton; Yuko,15,0,15,0
1653297865991,JAPN 20A,A01,086899,Simpson; Junko Tokuda,11,0,13,2
1653297865991,JAPN 20A,A02,086900,Simpson; Junko Tokuda,12,0,13,1
1653297865991,JAPN 20A,B01,086902,Takeda; Izumi,11,0,13,2
1653297865991,JAPN 20A,B02,086903,Takeda; Izumi,12,0,13,1
1653297865991,JAPN 20A,C01,086905,Ross; Kayoko F,12,0,13,1
1653297865991,JAPN 20A,C02,086906,Ross; Kayoko F,12,0,13,1
1653297865991,JAPN 20A,D01,086908,Takeda; Izumi,10,0,13,3
1653297865991,JAPN 20A,D02,086909,Takeda; Izumi,13,0,13,0
1653297865991,JAPN 20A,E01,086911,Maruyama; Rie,11,0,13,2
1653297865991,JAPN 20A,E02,086912,Maruyama; Rie,11,0,13,2
1653297865991,JAPN 20A,F01,086914,Kamioka; Sachiko,7,0,13,6
1653297865991,JAPN 20A,F02,086915,Kamioka; Sachiko,9,0,13,4
1653297865991,JAPN 20A,G01,086917,Ross; Kayoko F,13,0,13,0
1653297865991,JAPN 20A,G02,086918,Ross; Kayoko F,12,0,13,1
1653297866521,JAPN 130A,A01,086920,Simpson; Junko Tokuda,6,0,10,4
1653297866521,JAPN 130A,A02,086921,Simpson; Junko Tokuda,5,0,10,5
1653297866521,JAPN 130A,B01,086923,Ross; Kayoko F,9,0,10,1
1653297866521,JAPN 130A,B02,086924,Ross; Kayoko F,9,0,10,1
1653297867048,JAPN 135A,A00,086925,Inada; Minori,14,0,15,1
1653297867048,JAPN 135A,B00,086926,Takeda; Izumi,15,0,15,0
1653297867574,JAPN 140A,A00,086927,Sato; Kyoko,19,0,20,1
1653297868184,JWSP 1,A01,086445,Shuster; Alana,15,0,15,0
1653297868184,JWSP 1,A02,086446,Shuster; Alana,15,0,15,0
1653297868709,JWSP 104,A01,086448,Shuster; Alana,15,0,15,0
1653297869236,LATI 10,A01,093588,Kennemore; Amy Michelle,31,0,32,1
1653297869236,LATI 10,A02,093589,Kennemore; Amy Michelle,32,0,32,0
1653297869236,LATI 10,A03,093590,Kennemore; Amy Michelle,32,0,32,0
1653297869761,LATI 50,A01,093592,Kokinis; Troy Andreas,32,0,32,0
1653297869761,LATI 50,A02,093593,Kokinis; Troy Andreas,31,0,32,1
1653297869761,LATI 50,A03,093595,Kokinis; Troy Andreas,32,0,32,0
1653297870290,LATI 122A,A00,093649,Andrews; Abigail Leslie,0,0,0,0
1653297870815,LATI 180,A00,093597,Staff,36,0,40,4
1653297871346,LIAB 1A,A00,087085,Saab; Dima,13,0,14,1
1653297871346,LIAB 1A,B00,087086,Saab; Dima,13,0,14,1
1653297871346,LIAB 1A,C00,087087,Saab; Dima,14,0,14,0
1653297871346,LIAB 1A,D00,087088,El Cheddadi; Youniss,14,0,14,0
1653297871884,LIAB 1AX,A00,087089,Akjeje; Abdelhak,28,0,28,0
1653297871884,LIAB 1AX,B00,087091,Akjeje; Abdelhak,28,0,28,0
1653297872411,LIAB 1D,A00,087093,El Cheddadi; Youniss,13,0,14,1
1653297872411,LIAB 1D,B00,087094,El Cheddadi; Youniss,12,0,14,2
1653297872936,LIAB 1DX,A00,087095,Akjeje; Abdelhak,27,0,28,1
1653297873464,LIDS 19,001,095098,Goodall; Grant Todd,9999,0,9999,0
1653297873464,LIDS 19,002,095099,Goodall; Grant Todd,9999,0,9999,0
1653297873464,LIDS 19,003,095100,Goodall; Grant Todd,9999,0,9999,0
1653297873464,LIDS 19,004,095101,Goodall; Grant Todd,9999,0,9999,0
1653297873464,LIDS 19,005,095102,Goodall; Grant Todd,9999,0,9999,0
1653297873464,LIDS 19,006,095103,Goodall; Grant Todd,9999,0,9999,0
1653297873464,LIDS 19,007,095104,Goodall; Grant Todd,9999,0,9999,0
1653297873464,LIDS 19,008,095105,Goodall; Grant Todd,9999,0,9999,0
1653297873464,LIDS 19,009,095106,Goodall; Grant Todd,9999,0,9999,0
1653297873464,LIDS 19,010,095107,Goodall; Grant Todd,9999,0,9999,0
1653297873464,LIDS 19,011,095108,Goodall; Grant Todd,9999,0,9999,0
1653297873464,LIDS 19,012,095109,Goodall; Grant Todd,9999,0,9999,0
1653297873988,LIFR 1A,A00,087097,Goodall; Grant Todd,13,0,14,1
1653297873988,LIFR 1A,B00,087098,Goodall; Grant Todd,13,0,14,1
1653297873988,LIFR 1A,C00,087099,Goodall; Grant Todd,12,0,14,2
1653297873988,LIFR 1A,D00,087100,Goodall; Grant Todd,12,0,14,2
1653297873988,LIFR 1A,E00,087101,Goodall; Grant Todd,14,0,14,0
1653297873988,LIFR 1A,F00,087102,Goodall; Grant Todd,13,0,14,1
1653297874511,LIFR 1AX,A00,087103,Goodall; Grant Todd,27,0,28,1
1653297874511,LIFR 1AX,B00,087104,Goodall; Grant Todd,27,0,28,1
1653297874511,LIFR 1AX,C00,087105,Goodall; Grant Todd,25,0,28,3
1653297875047,LIFR 1B,A00,087106,Goodall; Grant Todd,14,0,14,0
1653297875047,LIFR 1B,B00,087107,Goodall; Grant Todd,13,0,14,1
1653297875047,LIFR 1B,C00,087108,Goodall; Grant Todd,13,0,14,1
1653297875047,LIFR 1B,D00,087109,Goodall; Grant Todd,13,0,14,1
1653297875572,LIFR 1BX,A00,087110,Goodall; Grant Todd,26,0,28,2
1653297875572,LIFR 1BX,B00,087111,Goodall; Grant Todd,26,0,28,2
1653297876097,LIFR 1D,A00,087112,Goodall; Grant Todd,14,0,14,0
1653297876097,LIFR 1D,B00,087113,Goodall; Grant Todd,12,0,14,2
1653297876097,LIFR 1D,C00,087114,Goodall; Grant Todd,11,0,14,3
1653297876097,LIFR 1D,D00,087115,Goodall; Grant Todd,10,0,14,4
1653297876624,LIFR 1DX,A00,087116,Goodall; Grant Todd,26,0,28,2
1653297876624,LIFR 1DX,B00,087117,Goodall; Grant Todd,23,0,28,5
1653297877150,LIFR 11,A00,087118,Goodall; Grant Todd,10,0,10,0
1653297877675,LIGM 1A,A00,087119,Riebeling; Elke,14,0,14,0
1653297877675,LIGM 1A,B00,087120,Riebeling; Elke,14,0,14,0
1653297877675,LIGM 1A,C00,087121,Riebeling; Elke,12,0,14,2
1653297877675,LIGM 1A,D00,087122,Riebeling; Elke,14,0,14,0
1653297877675,LIGM 1A,E00,087123,Riebeling; Elke,14,0,14,0
1653297878198,LIGM 1AX,A00,087124,Riebeling; Elke,28,0,28,0
1653297878198,LIGM 1AX,B00,087125,Riebeling; Elke,28,0,28,0
1653297878198,LIGM 1AX,C00,087126,Riebeling; Elke,27,0,28,1
1653297878724,LIGM 1D,A00,087127,Riebeling; Elke,14,0,14,0
1653297878724,LIGM 1D,B00,087128,Riebeling; Elke,12,0,14,2
1653297879250,LIGM 1DX,A00,087129,Riebeling; Elke,26,0,28,2
1653297879777,LIGM 11,A00,087130,Goodall; Grant Todd,10,0,10,0
1653297880301,LIGN 5,A00,087005,Goodall; Grant Todd,74,0,75,1
1653297880824,LIGN 7,A00,087006,Mayberry; Rachel,139,0,146,7
1653297881346,LIGN 8,A00,087007,McIntosh; Justin Daniel,244,0,250,6
1653297881875,LIGN 17,A00,087008,Kehler; Andrew Scott,218,0,220,2
1653297882403,LIGN 101,A01,087010,Styler; William Francis,29,0,30,1
1653297882403,LIGN 101,A02,087011,Styler; William Francis,29,0,30,1
1653297882403,LIGN 101,A03,087012,Styler; William Francis,29,0,30,1
1653297882403,LIGN 101,A04,087013,Styler; William Francis,29,0,30,1
1653297882927,LIGN 110,A01,087015,Garellek; Marc,29,0,30,1
1653297882927,LIGN 110,A02,087016,Garellek; Marc,26,0,30,4
1653297882927,LIGN 110,A03,087017,Garellek; Marc,26,0,30,4
1653297882927,LIGN 110,A04,087018,Garellek; Marc,28,0,30,2
1653297883452,LIGN 121,A01,087020,Drake; Emily C,23,0,25,2
1653297883452,LIGN 121,A02,087021,Drake; Emily C,24,0,25,1
1653297883975,LIGN 150,A00,093702,Staff,71,0,75,4
1653297884499,LIGN 152,A00,087023,Caballero; Gabriela Hernandez,16,0,20,4
1653297885031,LIGN 154,A00,087024,Kluender; Robert,70,0,70,0
1653297885554,LIGN 167,A00,087025,Bergen; Leon,70,0,100,30
1653297886076,LIGN 187,A00,087026,McIntosh; Justin Daniel,20,0,20,0
1653297886600,LIHL 112F,A00,086505,Alicio; Atilio,25,0,28,3
1653297887122,LIHL 114F,A00,086506,Staff,21,0,28,7
1653297887650,LIHL 117F,A00,086508,Sadegholvad; Elham,20,0,20,0
1653297888173,LIHL 118,A00,086509,Staff,25,0,28,3
1653297888696,LIHL 119F,A00,086510,Staff,26,0,28,2
1653297889221,LIHL 124F,A00,086511,Staff,27,0,28,1
1653297889744,LIHL 132F,A00,086512,Alicio; Atilio,28,0,28,0
1653297890268,LIIT 1A,A00,087131,Riebeling; Elke,14,0,14,0
1653297890268,LIIT 1A,B00,087132,Riebeling; Elke,14,0,14,0
1653297890268,LIIT 1A,C00,087133,Riebeling; Elke,12,0,14,2
1653297890268,LIIT 1A,D00,087134,Riebeling; Elke,14,0,14,0
1653297890795,LIIT 1AX,A00,087135,Riebeling; Elke,28,0,28,0
1653297890795,LIIT 1AX,B00,087136,Riebeling; Elke,26,0,28,2
1653297891318,LIPO 1A,A00,087137,Paladini; Denise,14,0,14,0
1653297891318,LIPO 1A,B00,087138,Paladini; Denise,10,0,14,4
1653297891844,LIPO 1AX,A00,087139,De Abreu; Cassia,18,0,22,4
1653297891844,LIPO 1AX,B00,087140,De Abreu; Cassia,22,0,22,0
1653297892368,LIPO 1D,A00,087141,Paladini; Denise,10,0,14,4
1653297892892,LIPO 1DX,A00,087143,De Abreu; Cassia,10,0,14,4
1653297893420,LISL 1A,A00,087145,Lott; Margaret S.,10,0,14,4
1653297893420,LISL 1A,B00,087146,Lott; Margaret S.,14,0,14,0
1653297893420,LISL 1A,C00,087147,Lott; Margaret S.,10,0,14,4
1653297893420,LISL 1A,D00,087148,Lott; Margaret S.,11,0,14,3
1653297893420,LISL 1A,E00,087149,Lott; Margaret S.,13,0,14,1
1653297893420,LISL 1A,F00,087150,Lott; Margaret S.,12,0,14,2
1653297893420,LISL 1A,G00,087151,Lott; Margaret S.,13,0,14,1
1653297893420,LISL 1A,H00,087152,Lott; Margaret S.,13,0,14,1
1653297893944,LISL 1AX,A00,087153,Lott; Margaret S.,28,0,28,0
1653297893944,LISL 1AX,B00,087154,Lott; Margaret S.,25,0,28,3
1653297893944,LISL 1AX,C00,087155,Lott; Margaret S.,25,0,28,3
1653297893944,LISL 1AX,D00,087156,Lott; Margaret S.,24,0,28,4
1653297894471,LISL 1B,A00,087157,Lott; Margaret S.,13,0,14,1
1653297894471,LISL 1B,B00,087158,Lott; Margaret S.,12,0,14,2
1653297894471,LISL 1B,C00,087159,Lott; Margaret S.,11,0,14,3
1653297894471,LISL 1B,D00,087160,Lott; Margaret S.,13,0,14,1
1653297894471,LISL 1B,E00,087161,Lott; Margaret S.,13,0,14,1
1653297894471,LISL 1B,F00,087162,Lott; Margaret S.,13,0,14,1
1653297894996,LISL 1BX,A00,087163,Lott; Margaret S.,23,0,28,5
1653297894996,LISL 1BX,B00,087164,Lott; Margaret S.,26,0,28,2
1653297894996,LISL 1BX,C00,087165,Lott; Margaret S.,28,0,28,0
1653297895532,LISL 1D,A00,087166,Lott; Margaret S.,14,0,14,0
1653297895532,LISL 1D,B00,087167,Lott; Margaret S.,14,0,14,0
1653297895532,LISL 1D,C00,087168,Lott; Margaret S.,8,0,14,6
1653297895532,LISL 1D,D00,087169,Lott; Margaret S.,13,0,14,1
1653297896060,LISL 1DX,A00,087170,Lott; Margaret S.,23,0,28,5
1653297896060,LISL 1DX,B00,087171,Lott; Margaret S.,26,0,28,2
1653297896584,LISP 1A,001,087172,Munoz Sanchez; Alicia,13,0,14,1
1653297896584,LISP 1A,002,087173,Munoz Sanchez; Alicia,12,0,14,2
1653297896584,LISP 1A,003,087174,Munoz Sanchez; Alicia,13,0,14,1
1653297896584,LISP 1A,004,087175,Munoz Sanchez; Alicia,12,0,14,2
1653297896584,LISP 1A,005,087176,Munoz Sanchez; Alicia,10,0,14,4
1653297896584,LISP 1A,006,087177,Munoz Sanchez; Alicia,12,0,14,2
1653297896584,LISP 1A,007,087178,Munoz Sanchez; Alicia,12,0,14,2
1653297896584,LISP 1A,008,087179,Munoz Sanchez; Alicia,14,0,14,0
1653297897109,LISP 1AX,A00,087180,Munoz Sanchez; Alicia,27,0,28,1
1653297897109,LISP 1AX,B00,087181,Munoz Sanchez; Alicia,24,0,28,4
1653297897109,LISP 1AX,C00,087182,Munoz Sanchez; Alicia,25,0,28,3
1653297897109,LISP 1AX,D00,087183,Munoz Sanchez; Alicia,25,0,28,3
1653297897635,LISP 1B,001,087184,Munoz Sanchez; Alicia,14,0,14,0
1653297897635,LISP 1B,002,087185,Munoz Sanchez; Alicia,14,0,14,0
1653297897635,LISP 1B,003,087186,Munoz Sanchez; Alicia,11,0,14,3
1653297897635,LISP 1B,004,087187,Munoz Sanchez; Alicia,12,0,14,2
1653297897635,LISP 1B,005,087188,Munoz Sanchez; Alicia,13,0,14,1
1653297897635,LISP 1B,006,087189,Munoz Sanchez; Alicia,13,0,14,1
1653297897635,LISP 1B,007,087190,Munoz Sanchez; Alicia,14,0,14,0
1653297897635,LISP 1B,008,087191,Munoz Sanchez; Alicia,13,0,14,1
1653297897635,LISP 1B,009,087192,Munoz Sanchez; Alicia,14,0,14,0
1653297897635,LISP 1B,010,087193,Munoz Sanchez; Alicia,13,0,14,1
1653297897635,LISP 1B,011,087194,Munoz Sanchez; Alicia,14,0,14,0
1653297898163,LISP 1BX,A00,087195,Munoz Sanchez; Alicia,28,0,28,0
1653297898163,LISP 1BX,B00,087196,Munoz Sanchez; Alicia,26,0,28,2
1653297898163,LISP 1BX,C00,087197,Munoz Sanchez; Alicia,26,0,28,2
1653297898163,LISP 1BX,D00,087198,Munoz Sanchez; Alicia,26,0,28,2
1653297898163,LISP 1BX,E00,087199,Munoz Sanchez; Alicia,28,0,28,0
1653297898690,LISP 1D,001,087200,Munoz Sanchez; Alicia,13,0,14,1
1653297898690,LISP 1D,002,087201,Munoz Sanchez; Alicia,14,0,14,0
1653297898690,LISP 1D,003,087202,Munoz Sanchez; Alicia,8,0,14,6
1653297898690,LISP 1D,004,087203,Munoz Sanchez; Alicia,5,0,14,9
1653297898690,LISP 1D,005,087204,Munoz Sanchez; Alicia,11,0,14,3
1653297898690,LISP 1D,006,087205,Munoz Sanchez; Alicia,13,0,14,1
1653297898690,LISP 1D,007,087206,Munoz Sanchez; Alicia,13,0,14,1
1653297898690,LISP 1D,008,087207,Munoz Sanchez; Alicia,13,0,14,1
1653297898690,LISP 1D,009,087208,Munoz Sanchez; Alicia,14,0,14,0
1653297898690,LISP 1D,010,087209,Munoz Sanchez; Alicia,12,0,14,2
1653297898690,LISP 1D,011,087210,Munoz Sanchez; Alicia,13,0,14,1
1653297898690,LISP 1D,012,087211,Munoz Sanchez; Alicia,14,0,14,0
1653297898690,LISP 1D,013,087212,Munoz Sanchez; Alicia,14,0,14,0
1653297898690,LISP 1D,014,087213,Munoz Sanchez; Alicia,14,0,14,0
1653297899215,LISP 1DX,A00,087214,Munoz Sanchez; Alicia,27,0,28,1
1653297899215,LISP 1DX,B00,087215,Munoz Sanchez; Alicia,23,0,28,5
1653297899215,LISP 1DX,C00,087216,Munoz Sanchez; Alicia,23,0,28,5
1653297899215,LISP 1DX,D00,087217,Munoz Sanchez; Alicia,25,0,28,3
1653297899215,LISP 1DX,E00,087218,Munoz Sanchez; Alicia,27,0,28,1
1653297899215,LISP 1DX,F00,087219,Munoz Sanchez; Alicia,25,0,28,3
1653297899215,LISP 1DX,G00,087220,Munoz Sanchez; Alicia,28,0,28,0
1653297899738,LISP 15,A00,087221,Munoz Sanchez; Alicia,19,0,20,1
1653297900269,LISP 18,A00,087222,Munoz Sanchez; Alicia,15,0,20,5
1653297900792,LTAM 110,A00,087352,Chacon; Gloria Elizabeth,35,0,40,5
1653297901316,LTCS 87,A00,094011,Nguyen; Hoang Tan,19,0,20,1
1653297901845,LTCS 111,A00,087353,Vitkus; Daniel J.,40,0,40,0
1653297902369,LTCS 119,A00,087354,Nguyen; Hoang Tan,29,0,30,1
1653297902894,LTCS 130,A00,087355,Kim; Joo Ok,37,0,40,3
1653297903419,LTCS 165,A00,087356,Kim; Joo Ok,38,0,40,2
1653297903944,LTEA 120A,A00,087357,Fiss; Geraldine Anna,291,0,300,9
1653297904469,LTEA 140,A00,094009,Lee; Jin-Kyung,28,0,32,4
1653297904993,LTEA 142,A00,087358,Lee; Jin-Kyung,103,0,120,17
1653297905522,LTEN 21,A01,087275,Lampert-Weissig; Lisa,25,0,25,0
1653297905522,LTEN 21,A02,087276,Lampert-Weissig; Lisa,25,0,25,0
1653297905522,LTEN 21,A03,087277,Lampert-Weissig; Lisa,25,0,25,0
1653297905522,LTEN 21,A04,087278,Lampert-Weissig; Lisa,25,0,25,0
1653297906049,LTEN 25,A01,087280,Johnson; Sara E.,25,0,25,0
1653297906049,LTEN 25,A02,087281,Johnson; Sara E.,25,0,25,0
1653297906049,LTEN 25,A03,087282,Johnson; Sara E.,23,0,25,2
1653297906049,LTEN 25,A04,087283,Johnson; Sara E.,25,0,25,0
1653297906572,LTEN 29,A01,087285,Ruiz; Ariana,24,0,25,1
1653297906572,LTEN 29,A02,087286,Ruiz; Ariana,25,0,25,0
1653297906572,LTEN 29,A03,087287,Ruiz; Ariana,24,0,25,1
1653297906572,LTEN 29,A04,087288,Ruiz; Ariana,24,0,25,1
1653297907110,LTEN 107,A00,087359,Lampert-Weissig; Lisa,39,0,40,1
1653297907636,LTEN 117,A00,087360,Vitkus; Daniel J.,40,0,40,0
1653297908164,LTEN 127,A00,087361,Loose; Margaret,38,0,40,2
1653297908687,LTEN 142,A00,094010,Loose; Margaret,38,0,40,2
1653297909210,LTEN 148,A00,087363,Walkiewicz; Kathryn A,40,0,40,0
1653297909733,LTEN 152,A00,087364,Walkiewicz; Kathryn A,37,0,40,3
1653297910259,LTEN 180,A00,087365,Ruiz; Ariana,18,0,20,2
1653297910787,LTFR 2A,A01,087290,Ploye; Catherine,23,0,25,2
1653297911314,LTFR 2B,A01,087292,Ploye; Catherine,25,0,25,0
1653297911839,LTFR 104,A00,087366,Ploye; Catherine,25,0,25,0
1653297912362,LTFR 116,A00,087367,Zhiri; Oumelbanine,13,0,15,2
1653297912887,LTGK 1,A00,087293,Myerston Santana; Jacobo,27,0,30,3
1653297913412,LTGK 103,A00,087368,duBois; Page Ann,14,0,15,1
1653297913941,LTGM 2A,A01,087295,Fischer-Grunski; Eva K,24,0,25,1
1653297914466,LTIT 2A,A01,087297,De Marchi Gherini; Adriana,24,0,25,1
1653297914998,LTKO 1A,A01,087299,Staff,24,0,25,1
1653297914998,LTKO 1A,B01,087301,Staff,25,0,25,0
1653297914998,LTKO 1A,C01,087303,Staff,25,0,25,0
1653297914998,LTKO 1A,D01,087305,Staff,25,0,25,0
1653297914998,LTKO 1A,E01,087307,Staff,24,0,25,1
1653297914998,LTKO 1A,F01,087309,Staff,25,0,25,0
1653297914998,LTKO 1A,G01,087311,Staff,25,0,25,0
1653297914998,LTKO 1A,H01,087313,Staff,24,0,25,1
1653297914998,LTKO 1A,I01,087315,Staff,25,0,25,0
1653297915523,LTKO 2A,A01,087317,Staff,24,0,25,1
1653297915523,LTKO 2A,B01,087319,Staff,22,0,25,3
1653297915523,LTKO 2A,C01,087321,Lee; Jeyseon,24,0,25,1
1653297916047,LTKO 130,A00,087369,Lee; Jeyseon,25,0,25,0
1653297916575,LTLA 1,A00,087322,Murray; Kourtney Kristine,38,0,40,2
1653297917103,LTLA 100,A00,087371,Kelting; Edward William,23,0,25,2
1653297917636,LTRU 1A,A01,087324,Wells; Patricia Rebecca,23,0,25,2
1653297918159,LTRU 2A,A01,087326,Wells; Patricia Rebecca,20,0,20,0
1653297918686,LTRU 104B,A01,087373,Wells; Patricia Rebecca,14,0,15,1
1653297919217,LTSP 2A,A01,087328,Staff,25,0,25,0
1653297919217,LTSP 2A,B01,087330,Staff,22,0,25,3
1653297919217,LTSP 2A,C01,087332,Staff,22,0,25,3
1653297919741,LTSP 2B,A01,087334,Staff,22,0,25,3
1653297919741,LTSP 2B,B01,087336,Staff,19,0,25,6
1653297920269,LTSP 2D,A00,087337,Staff,25,0,25,0
1653297920269,LTSP 2D,B00,087338,Staff,25,0,25,0
1653297920269,LTSP 2D,C00,087339,Staff,25,0,25,0
1653297920794,LTSP 100A,A00,087374,Arcos Herrera; Carol,23,0,25,2
1653297921411,LTSP 116,A00,087375,Blanco; John D,29,0,30,1
1653297921941,LTSP 140,A00,087376,Chacon; Gloria Elizabeth,30,0,30,0
1653297922469,LTSP 175,A00,087377,Arcos Herrera; Carol,30,0,30,0
1653297922994,LTTH 150,A00,087379,Cohen; Alain J. J.,40,0,40,0
1653297923518,LTWL 19A,A00,087340,Myerston Santana; Jacobo,39,0,40,1
1653297924040,LTWL 87,A00,094012,Lampert-Weissig; Lisa,20,0,20,0
1653297924566,LTWL 116,A00,087380,Nguyen; Hoang Tan,60,0,60,0
1653297925094,LTWL 120,A00,087381,Fiss; Geraldine Anna,37,0,40,3
1653297925624,LTWL 172,A00,087382,De Marchi Gherini; Adriana,40,0,40,0
1653297926149,LTWL 180,A00,087383,Kontje; Todd Curtis,39,0,40,1
1653297926674,LTWL 194,A00,087384,Suzuki; Erin M.,31,0,32,1
1653297927202,LTWR 8A,A01,087342,Jemc; Jaclyn,24,0,25,1
1653297927202,LTWR 8A,A02,087343,Jemc; Jaclyn,25,0,25,0
1653297927202,LTWR 8A,A03,087344,Jemc; Jaclyn,24,0,25,1
1653297927202,LTWR 8A,A04,087345,Jemc; Jaclyn,24,0,25,1
1653297927730,LTWR 8C,A01,087348,Forbes; Camille,25,0,25,0
1653297927730,LTWR 8C,A02,087349,Forbes; Camille,25,0,25,0
1653297927730,LTWR 8C,A03,087350,Forbes; Camille,25,0,25,0
1653297927730,LTWR 8C,A04,087351,Forbes; Camille,23,0,25,2
1653297928252,LTWR 100,A00,087385,Staff,12,0,15,3
1653297928778,LTWR 102,A00,087386,Staff,14,0,15,1
1653297929303,LTWR 115,A00,087387,Carroll; Amy Sara,24,0,30,6
1653297929838,LTWR 119,A00,087388,Staff,22,0,30,8
1653297930362,LTWR 140,A00,087389,Carroll; Amy Sara,37,0,40,3
1653297930889,LTWR 194,A00,087390,Som; Brandon D,35,0,40,5
1653297931415,MAE 2,A01,090334,Anderson; Mark Ronald,8,0,8,0
1653297931415,MAE 2,A02,090335,Anderson; Mark Ronald,8,0,8,0
1653297931415,MAE 2,A03,090336,Anderson; Mark Ronald,8,0,8,0
1653297931415,MAE 2,A04,090337,Anderson; Mark Ronald,8,0,8,0
1653297931415,MAE 2,A05,090338,Anderson; Mark Ronald,8,0,8,0
1653297931415,MAE 2,A06,090339,Anderson; Mark Ronald,8,0,8,0
1653297931415,MAE 2,A07,090340,Anderson; Mark Ronald,8,0,8,0
1653297931415,MAE 2,A08,090341,Anderson; Mark Ronald,7,0,8,1
1653297931415,MAE 2,A09,090342,Anderson; Mark Ronald,8,0,8,0
1653297931944,MAE 3,A01,090344,Delson; Nathan Joseph,21,0,22,1
1653297931944,MAE 3,A02,090345,Delson; Nathan Joseph,20,0,22,2
1653297931944,MAE 3,A03,090346,Delson; Nathan Joseph,21,0,22,1
1653297931944,MAE 3,A04,090347,Delson; Nathan Joseph,22,0,22,0
1653297931944,MAE 3,B01,090349,Qi; Huihui,18,0,22,4
1653297931944,MAE 3,B02,090350,Qi; Huihui,17,0,22,5
1653297931944,MAE 3,B03,090351,Qi; Huihui,20,0,22,2
1653297931944,MAE 3,B04,090352,Qi; Huihui,19,0,22,3
1653297932468,MAE 8,A01,090354,Pham; Hieu Tan,182,0,185,3
1653297932991,MAE 11,A00,090355,Nomura; Keiko K.,155,0,165,10
1653297933515,MAE 20,A00,090356,Bandaru; Prabhakar,160,0,160,0
1653297933515,MAE 20,B00,090357,Evdokimenko; Ekaterina,145,0,160,15
1653297934038,MAE 21,A01,090359,Cai; Shengqiang,8,0,9,1
1653297934038,MAE 21,A02,090360,Cai; Shengqiang,9,0,9,0
1653297934038,MAE 21,A03,090361,Cai; Shengqiang,6,0,9,3
1653297934038,MAE 21,A04,090362,Cai; Shengqiang,7,0,9,2
1653297934038,MAE 21,A05,090363,Cai; Shengqiang,0,0,0,0
1653297934038,MAE 21,A06,090364,Cai; Shengqiang,9,0,9,0
1653297934038,MAE 21,A07,090365,Cai; Shengqiang,9,0,9,0
1653297934038,MAE 21,A08,090366,Cai; Shengqiang,8,0,9,1
1653297934038,MAE 21,A09,090367,Cai; Shengqiang,8,0,9,1
1653297934038,MAE 21,A10,090368,Cai; Shengqiang,0,0,0,0
1653297934038,MAE 21,A11,090369,Cai; Shengqiang,9,0,9,0
1653297934038,MAE 21,A12,090370,Cai; Shengqiang,8,0,9,1
1653297934562,MAE 30A,A00,090371,Lal; Ratnesh,72,0,75,3
1653297935086,MAE 40,A00,090372,Bitmead; Robert R.,167,0,175,8
1653297935614,MAE 101A,A00,090373,Bahadori; Mohammad Yousef,105,0,115,10
1653297936138,MAE 101C,A00,090374,Poulikakos; Lisa Voula,41,0,110,69
1653297936138,MAE 101C,B00,090375,Chen; Renkun,96,0,110,14
1653297936667,MAE 104,A00,090376,Sanchez; Antonio Luis,78,0,120,42
1653297937193,MAE 105,A00,090377,Saintillan; David,154,0,170,16
1653297937720,MAE 107,A00,090378,Lindsey; Stephanie,104,0,110,6
1653297937720,MAE 107,B00,090379,Tolley; Michael Thomas,85,0,110,25
1653297938244,MAE 118,A00,090380,Krasheninnikov; Sergei,27,0,45,18
1653297938770,MAE 131A,A00,090381,Ghazinejad; Maziar,70,0,75,5
1653297939292,MAE 133,A00,090382,Frazier; Michael,26,0,33,7
1653297939817,MAE 143A,A00,090383,de Oliveira; Mauricio,74,0,100,26
1653297940344,MAE 144,A00,090384,Bewley; Thomas R,50,0,70,20
1653297940868,MAE 148,A01,091597,Staff,32,0,32,0
1653297941391,MAE 150,A00,090385,Friend; James Robert,69,0,90,21
1653297941391,MAE 150,B00,090386,Ghazinejad; Maziar,4,0,90,86
1653297941914,MAE 152,A00,090387,Tynan; George Robert,0,0,16,16
1653297941914,MAE 152,B00,090388,Tynan; George Robert,0,0,16,16
1653297941914,MAE 152,C00,090389,Tynan; George Robert,0,0,16,16
1653297941914,MAE 152,D00,090390,Tynan; George Robert,0,0,16,16
1653297942444,MAE 156A,A01,090392,Delson; Nathan Joseph,2,0,12,10
1653297942444,MAE 156A,A02,090393,Delson; Nathan Joseph,1,0,12,11
1653297942444,MAE 156A,A03,090394,Delson; Nathan Joseph,4,0,12,8
1653297942969,MAE 170,A01,090396,Lubarda; Marko,14,0,30,16
1653297942969,MAE 170,A02,090397,Lubarda; Marko,19,0,30,11
1653297942969,MAE 170,A03,090398,Lubarda; Marko,28,0,30,2
1653297942969,MAE 170,A04,090399,Lubarda; Marko,20,0,30,10
1653297942969,MAE 170,B01,090401,Diagne; Mamadou Lamine,30,0,30,0
1653297942969,MAE 170,B02,090402,Diagne; Mamadou Lamine,27,0,30,3
1653297942969,MAE 170,B03,090403,Diagne; Mamadou Lamine,28,0,30,2
1653297942969,MAE 170,B04,090404,Diagne; Mamadou Lamine,28,0,30,2
1653297943493,MAE 180A,A00,090405,McEneaney; William Michael,110,0,125,15
1653297944017,MAE 181,A00,090406,Bahadori; Mohammad Yousef,46,0,60,14
1653297944545,MAE 190,A00,090407,Anderson; Mark Ronald,27,0,45,18
1653297945074,MAE 191,A01,090409,Qi; Huihui,25,0,32,7
1653297945609,MATH 2,A01,089123,Hammock; Frances H,0,0,0,0
1653297945609,MATH 2,B01,089126,Hammock; Frances H,0,0,0,0
1653297945609,MATH 2,C01,089129,Hammock; Frances H,0,0,0,0
1653297945609,MATH 2,D01,094201,Harel; Guershon,0,0,0,0
1653297946148,MATH 3C,A01,089132,Bowers; Adam R.,0,0,0,0
1653297946148,MATH 3C,A02,089133,Bowers; Adam R.,0,0,0,0
1653297946148,MATH 3C,A03,089134,Bowers; Adam R.,0,0,0,0
1653297946148,MATH 3C,A04,089135,Bowers; Adam R.,0,0,0,0
1653297946148,MATH 3C,A05,089136,Bowers; Adam R.,0,0,0,0
1653297946148,MATH 3C,A06,089137,Bowers; Adam R.,0,0,0,0
1653297946148,MATH 3C,A07,089138,Bowers; Adam R.,0,0,0,0
1653297946148,MATH 3C,A08,089139,Bowers; Adam R.,0,0,0,0
1653297946148,MATH 3C,A09,089140,Bowers; Adam R.,0,0,0,0
1653297946148,MATH 3C,A10,089141,Bowers; Adam R.,0,0,0,0
1653297946148,MATH 3C,A11,089142,Bowers; Adam R.,0,0,0,0
1653297946148,MATH 3C,A12,089143,Bowers; Adam R.,0,0,0,0
1653297946148,MATH 3C,A13,089144,Bowers; Adam R.,0,0,0,0
1653297946148,MATH 3C,A14,089145,Bowers; Adam R.,0,0,0,0
1653297946148,MATH 3C,A15,089146,Bowers; Adam R.,0,0,0,0
1653297946148,MATH 3C,A16,089147,Bowers; Adam R.,0,0,0,0
1653297946148,MATH 3C,A17,089148,Bowers; Adam R.,0,0,0,0
1653297946148,MATH 3C,A18,089149,Bowers; Adam R.,0,0,0,0
1653297946148,MATH 3C,A19,089150,Bowers; Adam R.,0,0,0,0
1653297946148,MATH 3C,A20,089151,Bowers; Adam R.,0,0,0,0
1653297946148,MATH 3C,A21,089152,Bowers; Adam R.,0,0,0,0
1653297946148,MATH 3C,A22,089153,Bowers; Adam R.,0,0,0,0
1653297946148,MATH 3C,A23,089154,Bowers; Adam R.,0,0,0,0
1653297946148,MATH 3C,A24,089155,Bowers; Adam R.,0,0,0,0
1653297946148,MATH 3C,B01,089158,Staff,0,0,0,0
1653297946148,MATH 3C,B02,089159,Staff,0,0,0,0
1653297946148,MATH 3C,B03,089160,Staff,0,0,0,0
1653297946148,MATH 3C,B04,089161,Staff,0,0,0,0
1653297946148,MATH 3C,C01,094244,Staff,0,0,0,0
1653297946148,MATH 3C,C02,094245,Staff,0,0,0,0
1653297946148,MATH 3C,C03,094246,Staff,0,0,0,0
1653297946148,MATH 3C,C04,094247,Staff,0,0,0,0
1653297946676,MATH 4C,A01,089164,Staff,0,0,0,0
1653297946676,MATH 4C,A02,089165,Staff,0,0,0,0
1653297946676,MATH 4C,A03,089166,Staff,0,0,0,0
1653297946676,MATH 4C,B01,089169,Ganzberger; Geoffrey Michael,0,0,0,0
1653297946676,MATH 4C,B02,089170,Ganzberger; Geoffrey Michael,0,0,0,0
1653297946676,MATH 4C,B03,089171,Ganzberger; Geoffrey Michael,0,0,0,0
1653297946676,MATH 4C,C01,089174,Ganzberger; Geoffrey Michael,0,0,0,0
1653297946676,MATH 4C,C02,089175,Ganzberger; Geoffrey Michael,0,0,0,0
1653297946676,MATH 4C,C03,089176,Ganzberger; Geoffrey Michael,0,0,0,0
1653297946676,MATH 4C,D01,094249,Ganzberger; Geoffrey Michael,0,0,0,0
1653297946676,MATH 4C,D02,094250,Ganzberger; Geoffrey Michael,0,0,0,0
1653297946676,MATH 4C,D03,094251,Ganzberger; Geoffrey Michael,0,0,0,0
1653297947205,MATH 10A,A01,089179,Jin; Muzhi,5,0,5,0
1653297947205,MATH 10A,A02,089180,Jin; Muzhi,5,0,5,0
1653297947205,MATH 10A,A03,089181,Jin; Muzhi,4,0,5,1
1653297947205,MATH 10A,A04,089182,Jin; Muzhi,4,0,5,1
1653297947205,MATH 10A,A05,089183,Jin; Muzhi,5,0,5,0
1653297947205,MATH 10A,A06,089184,Jin; Muzhi,5,0,5,0
1653297947205,MATH 10A,A07,089185,Jin; Muzhi,5,0,5,0
1653297947205,MATH 10A,A08,089186,Jin; Muzhi,5,0,5,0
1653297947205,MATH 10A,B01,089188,Stevens; Laura Jeanne,1,0,5,4
1653297947205,MATH 10A,B02,089189,Stevens; Laura Jeanne,4,0,5,1
1653297947205,MATH 10A,B03,089190,Stevens; Laura Jeanne,4,0,5,1
1653297947205,MATH 10A,B04,089191,Stevens; Laura Jeanne,5,0,5,0
1653297947205,MATH 10A,B05,089192,Stevens; Laura Jeanne,4,0,5,1
1653297947205,MATH 10A,B06,089193,Stevens; Laura Jeanne,5,0,5,0
1653297947205,MATH 10A,B07,089194,Stevens; Laura Jeanne,5,0,5,0
1653297947205,MATH 10A,B08,089195,Stevens; Laura Jeanne,4,0,5,1
1653297947205,MATH 10A,C01,089197,Jin; Muzhi,1,0,5,4
1653297947205,MATH 10A,C02,089198,Jin; Muzhi,5,0,5,0
1653297947205,MATH 10A,C03,089199,Jin; Muzhi,5,0,5,0
1653297947205,MATH 10A,C04,089200,Jin; Muzhi,5,0,5,0
1653297947205,MATH 10A,C05,089201,Jin; Muzhi,5,0,5,0
1653297947205,MATH 10A,C06,089202,Jin; Muzhi,5,0,5,0
1653297947205,MATH 10A,D01,089204,Upton; James Thomas,4,0,5,1
1653297947205,MATH 10A,D02,089205,Upton; James Thomas,5,0,5,0
1653297947205,MATH 10A,D03,089206,Upton; James Thomas,5,0,5,0
1653297947205,MATH 10A,D04,089207,Upton; James Thomas,5,0,5,0
1653297947205,MATH 10A,E01,089211,Greenfeld; Be'Eri,5,0,5,0
1653297947205,MATH 10A,E02,089212,Greenfeld; Be'Eri,3,0,5,2
1653297947205,MATH 10A,E03,089213,Greenfeld; Be'Eri,4,0,5,1
1653297947205,MATH 10A,E04,089214,Greenfeld; Be'Eri,5,0,5,0
1653297947205,MATH 10A,E05,089215,Greenfeld; Be'Eri,5,0,5,0
1653297947205,MATH 10A,E06,089216,Greenfeld; Be'Eri,5,0,5,0
1653297947740,MATH 10B,A01,089218,Stevens; Laura Jeanne,7,0,8,1
1653297947740,MATH 10B,A02,089219,Stevens; Laura Jeanne,7,0,8,1
1653297947740,MATH 10B,A03,089220,Stevens; Laura Jeanne,8,0,8,0
1653297947740,MATH 10B,A04,089221,Stevens; Laura Jeanne,6,0,8,2
1653297947740,MATH 10B,A05,089222,Stevens; Laura Jeanne,2,0,8,6
1653297947740,MATH 10B,A06,089223,Stevens; Laura Jeanne,0,0,8,8
1653297947740,MATH 10B,A07,089224,Stevens; Laura Jeanne,6,0,8,2
1653297947740,MATH 10B,A08,089225,Stevens; Laura Jeanne,4,0,8,4
1653297947740,MATH 10B,B01,089227,Staff,8,0,8,0
1653297947740,MATH 10B,B02,089228,Staff,8,0,8,0
1653297947740,MATH 10B,B03,089229,Staff,7,0,8,1
1653297947740,MATH 10B,B04,089230,Staff,8,0,8,0
1653297947740,MATH 10B,B05,089231,Staff,8,0,8,0
1653297947740,MATH 10B,B06,089232,Staff,8,0,8,0
1653297947740,MATH 10B,B07,089233,Staff,8,0,8,0
1653297947740,MATH 10B,B08,089234,Staff,8,0,8,0
1653297947740,MATH 10B,C01,089236,McKinley; Gweneth Anne,4,0,8,4
1653297947740,MATH 10B,C02,089237,McKinley; Gweneth Anne,8,0,8,0
1653297947740,MATH 10B,C03,089238,McKinley; Gweneth Anne,8,0,8,0
1653297947740,MATH 10B,C04,089239,McKinley; Gweneth Anne,8,0,8,0
1653297947740,MATH 10B,C05,089240,McKinley; Gweneth Anne,8,0,8,0
1653297947740,MATH 10B,C06,089241,McKinley; Gweneth Anne,8,0,8,0
1653297948265,MATH 10C,A01,089243,Staff,13,0,20,7
1653297948265,MATH 10C,A02,089244,Staff,20,0,20,0
1653297948265,MATH 10C,A03,089245,Staff,18,0,20,2
1653297948265,MATH 10C,A04,089246,Staff,20,0,20,0
1653297948265,MATH 10C,A05,089247,Staff,19,0,20,1
1653297948265,MATH 10C,A06,089248,Staff,20,0,20,0
1653297948265,MATH 10C,A07,094505,Staff,20,0,20,0
1653297948265,MATH 10C,A08,094506,Staff,20,0,20,0
1653297948265,MATH 10C,B01,089250,Staff,19,0,20,1
1653297948265,MATH 10C,B02,089251,Staff,19,0,20,1
1653297948265,MATH 10C,B03,089252,Staff,14,0,20,6
1653297948265,MATH 10C,B04,089253,Staff,20,0,20,0
1653297948265,MATH 10C,B05,089254,Staff,20,0,20,0
1653297948265,MATH 10C,B06,089255,Staff,18,0,20,2
1653297948793,MATH 11,A01,089258,Rava; Denise,1,0,15,14
1653297948793,MATH 11,A02,089260,Rava; Denise,9,0,15,6
1653297948793,MATH 11,A03,089263,Rava; Denise,10,0,15,5
1653297948793,MATH 11,A04,089265,Rava; Denise,13,0,15,2
1653297948793,MATH 11,A05,089267,Rava; Denise,10,0,15,5
1653297948793,MATH 11,A06,089269,Rava; Denise,14,0,15,1
1653297948793,MATH 11,A07,089271,Rava; Denise,14,0,15,1
1653297948793,MATH 11,A08,089273,Rava; Denise,13,0,15,2
1653297948793,MATH 11,B01,089279,Staff,4,0,15,11
1653297948793,MATH 11,B02,089281,Staff,14,0,15,1
1653297948793,MATH 11,B03,089283,Staff,14,0,15,1
1653297948793,MATH 11,B04,089284,Staff,15,0,15,0
1653297948793,MATH 11,B05,089286,Staff,14,0,15,1
1653297948793,MATH 11,B06,089288,Staff,15,0,15,0
1653297948793,MATH 11,B07,089289,Staff,14,0,15,1
1653297948793,MATH 11,B08,089290,Staff,14,0,15,1
1653297949321,MATH 18,A01,089303,Anzaldo; Leesa B,5,0,10,5
1653297949321,MATH 18,A02,089304,Anzaldo; Leesa B,6,0,10,4
1653297949321,MATH 18,A03,089305,Anzaldo; Leesa B,10,0,10,0
1653297949321,MATH 18,A04,089306,Anzaldo; Leesa B,8,0,10,2
1653297949321,MATH 18,A05,089307,Anzaldo; Leesa B,10,0,10,0
1653297949321,MATH 18,A06,089308,Anzaldo; Leesa B,9,0,10,1
1653297949321,MATH 18,A07,089309,Anzaldo; Leesa B,10,0,10,0
1653297949321,MATH 18,A08,089310,Anzaldo; Leesa B,10,0,10,0
1653297949321,MATH 18,A09,089311,Anzaldo; Leesa B,10,0,10,0
1653297949321,MATH 18,A10,089312,Anzaldo; Leesa B,10,0,10,0
1653297949321,MATH 18,A11,089313,Anzaldo; Leesa B,9,0,10,1
1653297949321,MATH 18,A12,089314,Anzaldo; Leesa B,10,0,10,0
1653297949321,MATH 18,A13,089315,Anzaldo; Leesa B,9,0,10,1
1653297949321,MATH 18,A14,089316,Anzaldo; Leesa B,10,0,10,0
1653297949321,MATH 18,A15,089317,Anzaldo; Leesa B,9,0,10,1
1653297949321,MATH 18,A16,089318,Anzaldo; Leesa B,10,0,10,0
1653297949321,MATH 18,A17,089319,Anzaldo; Leesa B,9,0,10,1
1653297949321,MATH 18,A18,089320,Anzaldo; Leesa B,10,0,10,0
1653297949321,MATH 18,A19,089321,Anzaldo; Leesa B,0,0,0,0
1653297949321,MATH 18,A20,089322,Anzaldo; Leesa B,0,0,0,0
1653297949321,MATH 18,A21,089323,Anzaldo; Leesa B,9,0,10,1
1653297949321,MATH 18,A22,089324,Anzaldo; Leesa B,7,0,10,3
1653297949321,MATH 18,A23,089325,Anzaldo; Leesa B,10,0,10,0
1653297949321,MATH 18,A24,089326,Anzaldo; Leesa B,9,0,10,1
1653297949321,MATH 18,B01,089329,Staff,13,0,13,0
1653297949321,MATH 18,B02,089330,Staff,12,0,13,1
1653297949321,MATH 18,B03,089331,Staff,12,0,13,1
1653297949321,MATH 18,B04,089332,Staff,13,0,13,0
1653297949321,MATH 18,B05,089333,Staff,12,0,13,1
1653297949321,MATH 18,C01,089336,Staff,13,0,13,0
1653297949321,MATH 18,C02,089337,Staff,11,0,13,2
1653297949321,MATH 18,C03,089338,Staff,0,0,0,0
1653297949321,MATH 18,C04,089339,Staff,0,0,0,0
1653297949321,MATH 18,C05,089340,Staff,0,0,0,1
1653297949321,MATH 18,D01,094194,Staff,0,0,0,0
1653297949321,MATH 18,D02,094195,Staff,0,0,0,0
1653297949321,MATH 18,D03,094196,Staff,0,0,0,0
1653297949321,MATH 18,D04,094197,Staff,0,0,0,0
1653297949321,MATH 18,D05,094198,Staff,0,0,0,0
1653297949850,MATH 20A,A01,089343,Staff,5,0,5,0
1653297949850,MATH 20A,A02,089344,Staff,5,0,5,0
1653297949850,MATH 20A,A03,089345,Staff,5,0,5,0
1653297949850,MATH 20A,B01,089347,Suk; Andrew Hoon,2,0,3,1
1653297949850,MATH 20A,B02,089348,Suk; Andrew Hoon,3,0,3,0
1653297949850,MATH 20A,B03,089349,Suk; Andrew Hoon,3,0,3,0
1653297949850,MATH 20A,B04,089350,Suk; Andrew Hoon,3,0,3,0
1653297949850,MATH 20A,B05,089351,Suk; Andrew Hoon,3,0,3,0
1653297949850,MATH 20A,B06,089352,Suk; Andrew Hoon,2,0,3,1
1653297949850,MATH 20A,B07,089353,Suk; Andrew Hoon,3,0,3,0
1653297949850,MATH 20A,B08,089354,Suk; Andrew Hoon,3,0,3,0
1653297949850,MATH 20A,B09,089355,Suk; Andrew Hoon,3,0,3,0
1653297949850,MATH 20A,B10,089356,Suk; Andrew Hoon,3,0,3,0
1653297949850,MATH 20A,B11,089357,Suk; Andrew Hoon,3,0,3,0
1653297949850,MATH 20A,B12,089358,Suk; Andrew Hoon,3,0,3,0
1653297949850,MATH 20A,B13,089359,Suk; Andrew Hoon,2,0,3,1
1653297949850,MATH 20A,B14,089360,Suk; Andrew Hoon,3,0,3,0
1653297949850,MATH 20A,B15,089361,Suk; Andrew Hoon,3,0,3,0
1653297949850,MATH 20A,B16,089362,Suk; Andrew Hoon,3,0,3,0
1653297949850,MATH 20A,B17,089363,Suk; Andrew Hoon,3,0,3,0
1653297949850,MATH 20A,B18,089364,Suk; Andrew Hoon,0,0,0,0
1653297949850,MATH 20A,B19,089365,Suk; Andrew Hoon,3,0,3,0
1653297949850,MATH 20A,B20,089366,Suk; Andrew Hoon,3,0,3,0
1653297949850,MATH 20A,B21,089367,Suk; Andrew Hoon,3,0,3,0
1653297949850,MATH 20A,B22,089368,Suk; Andrew Hoon,3,0,3,0
1653297949850,MATH 20A,B23,089369,Suk; Andrew Hoon,3,0,3,0
1653297949850,MATH 20A,B24,089370,Suk; Andrew Hoon,3,0,3,0
1653297950390,MATH 20B,A01,089372,Quarfoot; David James,8,0,8,0
1653297950390,MATH 20B,A02,089373,Quarfoot; David James,8,0,8,0
1653297950390,MATH 20B,A03,089374,Quarfoot; David James,7,0,8,1
1653297950390,MATH 20B,A04,089375,Quarfoot; David James,7,0,8,1
1653297950390,MATH 20B,A05,089376,Quarfoot; David James,0,0,0,0
1653297950390,MATH 20B,A06,089377,Quarfoot; David James,0,0,0,0
1653297950390,MATH 20B,A07,089378,Quarfoot; David James,0,0,0,0
1653297950390,MATH 20B,A08,089379,Quarfoot; David James,0,0,0,0
1653297950390,MATH 20B,A09,089380,Quarfoot; David James,0,0,0,0
1653297950390,MATH 20B,A10,089381,Quarfoot; David James,0,0,0,0
1653297950390,MATH 20B,A11,089382,Quarfoot; David James,0,0,0,0
1653297950390,MATH 20B,A12,089383,Quarfoot; David James,0,0,0,0
1653297950390,MATH 20B,A13,089384,Quarfoot; David James,0,0,0,0
1653297950390,MATH 20B,A14,089385,Quarfoot; David James,0,0,0,0
1653297950390,MATH 20B,A15,089386,Quarfoot; David James,0,0,0,0
1653297950390,MATH 20B,A16,089387,Quarfoot; David James,0,0,0,0
1653297950390,MATH 20B,A17,089388,Quarfoot; David James,8,0,8,0
1653297950390,MATH 20B,A18,089389,Quarfoot; David James,8,0,8,0
1653297950390,MATH 20B,A19,089390,Quarfoot; David James,8,0,8,0
1653297950390,MATH 20B,A20,089391,Quarfoot; David James,8,0,8,0
1653297950390,MATH 20B,A21,089392,Quarfoot; David James,8,0,8,0
1653297950390,MATH 20B,A22,089393,Quarfoot; David James,7,0,8,1
1653297950390,MATH 20B,A23,089394,Quarfoot; David James,7,0,8,1
1653297950390,MATH 20B,A24,089395,Quarfoot; David James,8,0,8,0
1653297950390,MATH 20B,B01,089397,Lahiri; Aranya,7,0,10,3
1653297950390,MATH 20B,B02,089398,Lahiri; Aranya,10,0,10,0
1653297950390,MATH 20B,B03,089399,Lahiri; Aranya,10,0,10,0
1653297950390,MATH 20B,B04,089400,Lahiri; Aranya,10,0,10,0
1653297950390,MATH 20B,B05,089401,Lahiri; Aranya,10,0,10,0
1653297950390,MATH 20B,C01,089403,Lahiri; Aranya,0,0,0,0
1653297950390,MATH 20B,C02,089404,Lahiri; Aranya,8,0,10,2
1653297950390,MATH 20B,C03,089405,Lahiri; Aranya,10,0,10,0
1653297950390,MATH 20B,C04,089406,Lahiri; Aranya,9,0,10,1
1653297950390,MATH 20B,C05,089407,Lahiri; Aranya,9,0,10,1
1653297950916,MATH 20C,A01,089409,Um; Ko Woon,10,0,10,0
1653297950916,MATH 20C,A02,089410,Um; Ko Woon,10,0,10,0
1653297950916,MATH 20C,A03,089411,Um; Ko Woon,9,0,10,1
1653297950916,MATH 20C,A04,089412,Um; Ko Woon,9,0,10,1
1653297950916,MATH 20C,A05,089413,Um; Ko Woon,10,0,10,0
1653297950916,MATH 20C,A06,089414,Um; Ko Woon,9,0,10,1
1653297950916,MATH 20C,A07,094270,Um; Ko Woon,10,0,10,0
1653297950916,MATH 20C,A08,094271,Um; Ko Woon,10,0,10,0
1653297950916,MATH 20C,A09,094272,Um; Ko Woon,7,0,10,3
1653297950916,MATH 20C,A10,094273,Um; Ko Woon,10,0,10,0
1653297950916,MATH 20C,A11,094274,Um; Ko Woon,10,0,10,0
1653297950916,MATH 20C,A12,094275,Um; Ko Woon,8,0,10,2
1653297950916,MATH 20C,A13,094276,Um; Ko Woon,10,0,10,0
1653297950916,MATH 20C,A14,094277,Um; Ko Woon,10,0,10,0
1653297950916,MATH 20C,A15,094278,Um; Ko Woon,10,0,10,0
1653297950916,MATH 20C,A16,094279,Um; Ko Woon,10,0,10,0
1653297950916,MATH 20C,B03,089418,Zhang; Ming,7,0,15,8
1653297950916,MATH 20C,B04,089419,Zhang; Ming,13,0,15,2
1653297950916,MATH 20C,B05,089420,Zhang; Ming,13,0,15,2
1653297950916,MATH 20C,C01,089423,Staff,15,0,15,0
1653297950916,MATH 20C,C02,089424,Staff,15,0,15,0
1653297950916,MATH 20C,C03,089425,Staff,15,0,15,0
1653297950916,MATH 20C,C04,089426,Staff,15,0,15,0
1653297950916,MATH 20C,C05,089427,Staff,15,0,15,0
1653297950916,MATH 20C,D04,089433,Zhang; Ming,13,0,15,2
1653297950916,MATH 20C,D05,089434,Zhang; Ming,15,0,15,0
1653297950916,MATH 20C,E01,089439,Staff,15,0,15,0
1653297950916,MATH 20C,E02,089440,Staff,15,0,15,0
1653297950916,MATH 20C,E03,089441,Staff,15,0,15,0
1653297950916,MATH 20C,E04,089442,Staff,15,0,15,0
1653297950916,MATH 20C,E05,089443,Staff,15,0,15,0
1653297950916,MATH 20C,E06,089444,Staff,15,0,15,0
1653297950916,MATH 20C,A17,094280,Um; Ko Woon,0,0,0,0
1653297950916,MATH 20C,A18,094281,Um; Ko Woon,0,0,0,0
1653297950916,MATH 20C,A19,094282,Um; Ko Woon,0,0,0,0
1653297950916,MATH 20C,A20,094283,Um; Ko Woon,0,0,0,0
1653297950916,MATH 20C,A21,094284,Um; Ko Woon,0,0,0,0
1653297950916,MATH 20C,A22,094285,Um; Ko Woon,0,0,0,0
1653297950916,MATH 20C,A23,094286,Um; Ko Woon,0,0,0,0
1653297950916,MATH 20C,A24,094287,Um; Ko Woon,0,0,0,0
1653297950916,MATH 20C,B01,089416,Zhang; Ming,0,0,0,0
1653297950916,MATH 20C,B02,089417,Zhang; Ming,0,0,0,0
1653297950916,MATH 20C,D01,089430,Zhang; Ming,0,0,0,0
1653297950916,MATH 20C,D02,089431,Zhang; Ming,0,0,0,0
1653297950916,MATH 20C,D03,089432,Zhang; Ming,0,0,0,0
1653297951443,MATH 20D,A01,089455,Lee; Kisun,11,0,25,14
1653297951443,MATH 20D,A02,089456,Lee; Kisun,24,0,25,1
1653297951443,MATH 20D,A03,089457,Lee; Kisun,24,0,25,1
1653297951443,MATH 20D,A04,089458,Lee; Kisun,25,0,25,0
1653297951443,MATH 20D,A05,089459,Lee; Kisun,25,0,25,0
1653297951443,MATH 20D,A06,089460,Lee; Kisun,25,0,25,0
1653297951443,MATH 20D,B01,089463,Lee; Kisun,20,0,25,5
1653297951443,MATH 20D,B02,089464,Lee; Kisun,25,0,25,0
1653297951443,MATH 20D,B03,089465,Lee; Kisun,24,0,25,1
1653297951443,MATH 20D,B04,089466,Lee; Kisun,25,0,25,0
1653297951443,MATH 20D,B05,089467,Lee; Kisun,23,0,25,2
1653297951443,MATH 20D,B06,089468,Lee; Kisun,24,0,25,1
1653297951443,MATH 20D,C01,089471,Staff,23,0,25,2
1653297951443,MATH 20D,C02,089472,Staff,25,0,25,0
1653297951443,MATH 20D,C03,089473,Staff,25,0,25,0
1653297951443,MATH 20D,C04,089474,Staff,25,0,25,0
1653297951443,MATH 20D,C05,089475,Staff,25,0,25,0
1653297951443,MATH 20D,C06,089476,Staff,25,0,25,0
1653297951968,MATH 20E,A01,089479,Eggers; John Dietrich,17,0,24,7
1653297951968,MATH 20E,A02,089480,Eggers; John Dietrich,24,0,25,1
1653297951968,MATH 20E,A03,089481,Eggers; John Dietrich,25,0,25,0
1653297951968,MATH 20E,A04,089482,Eggers; John Dietrich,25,0,25,0
1653297951968,MATH 20E,A05,089483,Eggers; John Dietrich,19,0,25,6
1653297951968,MATH 20E,A06,089484,Eggers; John Dietrich,25,0,25,0
1653297951968,MATH 20E,A07,089485,Eggers; John Dietrich,24,0,25,1
1653297951968,MATH 20E,A08,089486,Eggers; John Dietrich,24,0,25,1
1653297951968,MATH 20E,B01,089488,Staff,15,0,25,10
1653297951968,MATH 20E,B02,089489,Staff,21,0,25,4
1653297951968,MATH 20E,B03,089490,Staff,25,0,25,0
1653297951968,MATH 20E,B04,089491,Staff,25,0,25,0
1653297951968,MATH 20E,B05,089492,Staff,24,0,25,1
1653297951968,MATH 20E,B06,089493,Staff,24,0,25,1
1653297951968,MATH 20E,B07,089494,Staff,25,0,25,0
1653297951968,MATH 20E,B08,089495,Staff,25,0,25,0
1653297951968,MATH 20E,C01,089497,Staff,23,0,25,2
1653297951968,MATH 20E,C02,089498,Staff,25,0,25,0
1653297951968,MATH 20E,C03,089499,Staff,25,0,25,0
1653297951968,MATH 20E,C04,089500,Staff,25,0,25,0
1653297951968,MATH 20E,C05,089501,Staff,25,0,25,0
1653297951968,MATH 20E,C06,089502,Staff,25,0,25,0
1653297951968,MATH 20E,C07,089503,Staff,25,0,25,0
1653297951968,MATH 20E,C08,089504,Staff,25,0,25,0
1653297952498,MATH 31AH,A01,089506,Rabin; Jeffrey Mark,35,0,35,0
1653297952498,MATH 31AH,A02,089507,Rabin; Jeffrey Mark,35,0,35,0
1653297953023,MATH 87,A00,094827,Meyer; David A.,20,0,20,0
1653297953549,MATH 96,A00,094836,Kane; Daniel Mertz,11,0,30,19
1653297954073,MATH 100A,A01,089509,Kedlaya; Kiran S.,23,0,30,7
1653297954073,MATH 100A,A02,089510,Kedlaya; Kiran S.,28,0,30,2
1653297954073,MATH 100A,B01,089512,Greenfeld; Be'Eri,24,0,30,6
1653297954073,MATH 100A,B02,089513,Greenfeld; Be'Eri,30,0,30,0
1653297954598,MATH 102,A01,089515,Hodges; Reuven Moses,25,0,30,5
1653297954598,MATH 102,A02,089516,Hodges; Reuven Moses,30,0,30,0
1653297954598,MATH 102,A03,089517,Hodges; Reuven Moses,30,0,30,0
1653297954598,MATH 102,A04,089518,Hodges; Reuven Moses,29,0,30,1
1653297954598,MATH 102,B01,089520,Hodges; Reuven Moses,29,0,30,1
1653297954598,MATH 102,B02,089521,Hodges; Reuven Moses,29,0,30,1
1653297954598,MATH 102,B03,089522,Hodges; Reuven Moses,29,0,30,1
1653297954598,MATH 102,B04,089523,Hodges; Reuven Moses,30,0,30,0
1653297955124,MATH 103A,A01,089525,Staff,27,0,30,3
1653297955124,MATH 103A,A02,089526,Staff,30,0,30,0
1653297955124,MATH 103A,B01,089528,Seward; Brandon M.,9,0,30,21
1653297955124,MATH 103A,B02,089529,Seward; Brandon M.,22,0,30,8
1653297955124,MATH 103A,C01,089531,Staff,27,0,30,3
1653297955124,MATH 103A,C02,089532,Staff,28,0,30,2
1653297955124,MATH 103A,D01,089534,Staff,28,0,30,2
1653297955124,MATH 103A,D02,089535,Staff,28,0,30,2
1653297955649,MATH 109,A01,089537,Chung; Kwun,9,0,10,1
1653297955649,MATH 109,A02,089538,Chung; Kwun,10,0,10,0
1653297955649,MATH 109,B01,089540,Belmont; Eva Kinoshita,9,0,10,1
1653297955649,MATH 109,B02,089541,Belmont; Eva Kinoshita,6,0,10,4
1653297955649,MATH 109,C01,089543,Chow; Bennett,8,0,10,2
1653297955649,MATH 109,C02,089544,Chow; Bennett,10,0,10,0
1653297955649,MATH 109,D01,089546,Chung; Kwun,9,0,10,1
1653297955649,MATH 109,D02,089547,Chung; Kwun,9,0,10,1
1653297955649,MATH 109,E01,089549,Schweinsberg; Jason,6,0,10,4
1653297955649,MATH 109,E02,089550,Schweinsberg; Jason,10,0,10,0
1653297956177,MATH 110,A01,089552,Wenzl; Hans G,27,0,35,8
1653297956177,MATH 110,A02,089553,Wenzl; Hans G,33,0,35,2
1653297956702,MATH 111A,A01,089555,Meyer; David A.,0,0,0,1
1653297957224,MATH 120A,A01,089557,Manners; Frederick,30,0,35,5
1653297957224,MATH 120A,A02,089558,Manners; Frederick,33,0,35,2
1653297957749,MATH 140A,A01,089560,Seward; Brandon M.,25,0,30,5
1653297957749,MATH 140A,A02,089561,Seward; Brandon M.,29,0,30,1
1653297957749,MATH 140A,B01,089563,Chan; Pak Yeung,30,0,30,0
1653297957749,MATH 140A,B02,089564,Chan; Pak Yeung,22,0,30,8
1653297958274,MATH 142A,A01,089566,Staff,29,0,30,1
1653297958274,MATH 142A,A02,089567,Staff,29,0,30,1
1653297958274,MATH 142A,B01,089569,Staff,30,0,30,0
1653297958274,MATH 142A,B02,089570,Staff,29,0,30,1
1653297958274,MATH 142A,C01,089572,Staff,26,0,30,4
1653297958274,MATH 142A,C02,089573,Staff,29,0,30,1
1653297958274,MATH 142A,D01,089575,Eggers; John Dietrich,15,0,30,15
1653297958274,MATH 142A,D02,089576,Eggers; John Dietrich,27,0,30,3
1653297958798,MATH 144,A01,089578,Bejenaru; Ioan,29,0,30,1
1653297959324,MATH 150A,A01,089580,Chow; Bennett,29,0,35,6
1653297959324,MATH 150A,A02,089581,Chow; Bennett,34,0,35,1
1653297960371,MATH 153,A01,094204,Harel; Guershon,33,0,35,2
1653297960894,MATH 154,A01,089590,Verstraete; Jacques Allan,3,0,30,27
1653297960894,MATH 154,A02,089591,Verstraete; Jacques Allan,23,0,30,7
1653297960894,MATH 154,A03,089592,Verstraete; Jacques Allan,28,0,30,2
1653297960894,MATH 154,A04,089593,Verstraete; Jacques Allan,26,0,30,4
1653297961419,MATH 155A,A01,089595,Buss; Samuel R,22,0,35,13
1653297961419,MATH 155A,A02,089596,Buss; Samuel R,32,0,35,3
1653297961950,MATH 160A,A01,089598,Manners; Frederick,28,0,35,7
1653297961950,MATH 160A,A02,094207,Manners; Frederick,34,0,35,1
1653297962476,MATH 170A,A01,089600,Liu; Shuang,24,0,25,1
1653297962476,MATH 170A,A02,089601,Liu; Shuang,24,0,25,1
1653297962476,MATH 170A,A03,089602,Liu; Shuang,24,0,25,1
1653297962476,MATH 170A,A04,089603,Liu; Shuang,23,0,25,2
1653297962476,MATH 170A,B01,089605,Dumitriu; Ioana,8,0,25,17
1653297962476,MATH 170A,B02,089606,Dumitriu; Ioana,20,0,25,5
1653297962476,MATH 170A,B03,089607,Dumitriu; Ioana,21,0,25,4
1653297962476,MATH 170A,B04,089608,Dumitriu; Ioana,25,0,25,0
1653297962999,MATH 173A,A01,089610,Cloninger; Alexander,0,0,35,35
1653297962999,MATH 173A,A02,089611,Cloninger; Alexander,2,0,35,33
1653297962999,MATH 173A,A03,089612,Cloninger; Alexander,20,0,35,15
1653297963524,MATH 174,A01,089614,Cheng; Li-Tien,23,0,25,2
1653297963524,MATH 174,A02,089615,Cheng; Li-Tien,25,0,25,0
1653297964048,MATH 180A,A01,089617,Jekel; David Andrew,0,0,25,25
1653297964048,MATH 180A,A02,089618,Jekel; David Andrew,23,0,25,2
1653297964048,MATH 180A,A03,089619,Jekel; David Andrew,22,0,25,3
1653297964048,MATH 180A,A04,089620,Jekel; David Andrew,22,0,25,3
1653297964048,MATH 180A,A05,089621,Jekel; David Andrew,24,0,25,1
1653297964048,MATH 180A,A06,089622,Jekel; David Andrew,23,0,25,2
1653297964048,MATH 180A,B01,089624,Agarwal; Pooja,23,0,25,2
1653297964048,MATH 180A,B02,089625,Agarwal; Pooja,24,0,25,1
1653297964048,MATH 180A,B03,089626,Agarwal; Pooja,22,0,25,3
1653297964048,MATH 180A,B04,089627,Agarwal; Pooja,25,0,25,0
1653297964048,MATH 180A,B05,089628,Agarwal; Pooja,24,0,25,1
1653297964048,MATH 180A,B06,089629,Agarwal; Pooja,25,0,25,0
1653297964048,MATH 180A,C01,089631,Staff,22,0,25,3
1653297964048,MATH 180A,C02,089632,Staff,25,0,25,0
1653297964048,MATH 180A,C03,089633,Staff,25,0,25,0
1653297964048,MATH 180A,C04,089634,Staff,25,0,25,0
1653297964573,MATH 180C,A01,089636,Fitzsimmons; Patrick J,4,0,25,21
1653297964573,MATH 180C,A02,089637,Fitzsimmons; Patrick J,21,0,25,4
1653297965098,MATH 181B,A01,089639,Rava; Denise,31,0,35,4
1653297965098,MATH 181B,A02,089640,Rava; Denise,34,0,35,1
1653297965098,MATH 181B,A03,089641,Rava; Denise,31,0,35,4
1653297965098,MATH 181B,A04,089642,Rava; Denise,35,0,35,0
1653297965625,MATH 183,A01,089644,Staff,10,0,25,15
1653297965625,MATH 183,A02,089645,Staff,23,0,25,2
1653297965625,MATH 183,A03,089646,Staff,23,0,25,2
1653297965625,MATH 183,A04,089647,Staff,25,0,25,0
1653297965625,MATH 183,A05,089648,Staff,19,0,25,6
1653297965625,MATH 183,A06,089649,Staff,22,0,25,3
1653297965625,MATH 183,A07,089650,Staff,25,0,25,0
1653297965625,MATH 183,A08,089651,Staff,25,0,25,0
1653297966149,MATH 184,A01,089653,Kane; Daniel Mertz,24,0,30,6
1653297966149,MATH 184,A02,089654,Kane; Daniel Mertz,30,0,30,0
1653297966149,MATH 184,A03,089655,Kane; Daniel Mertz,30,0,30,0
1653297966149,MATH 184,A04,089656,Kane; Daniel Mertz,30,0,30,0
1653297966677,MATH 187A,A01,089658,Bucur; Alina Ioana,0,0,25,25
1653297966677,MATH 187A,A02,089659,Bucur; Alina Ioana,12,0,25,13
1653297966677,MATH 187A,A03,089660,Bucur; Alina Ioana,1,0,25,24
1653297966677,MATH 187A,A04,089661,Bucur; Alina Ioana,17,0,25,8
1653297967201,MATH 187B,A01,089663,Bucur; Alina Ioana,28,0,35,7
1653297967201,MATH 187B,A02,089664,Bucur; Alina Ioana,34,0,35,1
1653297967724,MATH 188,A01,094817,Sam; Steven V,33,0,35,2
1653297968250,MATH 190A,A01,089666,Sam; Steven V,21,0,35,14
1653297968778,MATH 196,A00,089667,Spolaor; Luca,33,0,45,12
1653297969305,MCWP 40,004,093486,Wastal; Carrie King,0,0,3,3
1653297969305,MCWP 40,005,093487,Wastal; Carrie King,0,0,3,3
1653297969305,MCWP 40,006,093488,Wastal; Carrie King,3,0,3,0
1653297969305,MCWP 40,007,093489,Wastal; Carrie King,3,0,3,0
1653297969305,MCWP 40,008,093490,Wastal; Carrie King,2,0,3,1
1653297969305,MCWP 40,009,093491,Wastal; Carrie King,2,0,3,1
1653297969305,MCWP 40,013,093495,Wastal; Carrie King,3,0,3,0
1653297969305,MCWP 40,014,093496,Wastal; Carrie King,0,0,3,3
1653297969305,MCWP 40,015,093497,Wastal; Carrie King,3,0,3,0
1653297969305,MCWP 40,016,093498,Wastal; Carrie King,3,0,3,0
1653297969305,MCWP 40,017,093499,Wastal; Carrie King,3,0,3,0
1653297969305,MCWP 40,018,093500,Wastal; Carrie King,1,0,3,2
1653297969305,MCWP 40,020,093502,Wastal; Carrie King,0,0,0,0
1653297969305,MCWP 40,021,093503,Wastal; Carrie King,3,0,3,0
1653297969305,MCWP 40,022,093504,Wastal; Carrie King,2,0,3,1
1653297969305,MCWP 40,023,093505,Wastal; Carrie King,2,0,3,1
1653297969305,MCWP 40,024,093506,Wastal; Carrie King,2,0,3,1
1653297969305,MCWP 40,026,093508,Wastal; Carrie King,3,0,3,0
1653297969305,MCWP 40,027,093509,Wastal; Carrie King,3,0,3,0
1653297969305,MCWP 40,028,093510,Wastal; Carrie King,3,0,3,0
1653297969305,MCWP 40,029,093511,Wastal; Carrie King,3,0,3,0
1653297969305,MCWP 40,030,093512,Wastal; Carrie King,2,0,3,1
1653297969305,MCWP 40,032,093514,Wastal; Carrie King,2,0,3,1
1653297969305,MCWP 40,033,093515,Wastal; Carrie King,3,0,3,0
1653297969305,MCWP 40,034,093516,Wastal; Carrie King,3,0,3,0
1653297969305,MCWP 40,035,093517,Wastal; Carrie King,3,0,3,0
1653297969305,MCWP 40,038,093520,Wastal; Carrie King,2,0,3,1
1653297969305,MCWP 40,039,093521,Wastal; Carrie King,3,0,3,0
1653297969305,MCWP 40,041,093523,Wastal; Carrie King,2,0,3,1
1653297969305,MCWP 40,042,093524,Wastal; Carrie King,3,0,3,0
1653297969305,MCWP 40,043,093525,Wastal; Carrie King,0,0,0,0
1653297969305,MCWP 40,049,093531,Wastal; Carrie King,2,0,3,1
1653297969305,MCWP 40,050,093532,Wastal; Carrie King,3,0,3,0
1653297969305,MCWP 40,051,093533,Wastal; Carrie King,3,0,3,0
1653297969836,MCWP 50,001,093534,Wastal; Carrie King,0,0,0,0
1653297969836,MCWP 50,002,093535,Wastal; Carrie King,0,0,3,3
1653297969836,MCWP 50,003,093536,Wastal; Carrie King,0,0,3,3
1653297969836,MCWP 50,004,093537,Wastal; Carrie King,0,0,3,3
1653297969836,MCWP 50,005,093538,Wastal; Carrie King,0,0,3,3
1653297969836,MCWP 50,006,093539,Wastal; Carrie King,2,0,3,1
1653297969836,MCWP 50,007,093540,Wastal; Carrie King,0,0,3,3
1653297969836,MCWP 50,008,093541,Wastal; Carrie King,0,0,3,3
1653297969836,MCWP 50,009,093542,Wastal; Carrie King,0,0,3,3
1653297969836,MCWP 50,010,093543,Wastal; Carrie King,0,0,3,3
1653297969836,MCWP 50,013,093546,Wastal; Carrie King,1,0,3,2
1653297969836,MCWP 50,014,093547,Wastal; Carrie King,0,0,3,3
1653297969836,MCWP 50,015,093548,Wastal; Carrie King,0,0,3,3
1653297969836,MCWP 50,016,093549,Wastal; Carrie King,0,0,0,0
1653297970368,MCWP 125,A00,093550,Wilson; Marion E.,3,0,3,0
1653297970368,MCWP 125,B00,093551,Guillen; Melinda,3,0,3,0
1653297970368,MCWP 125,C00,093552,Guillen; Melinda,3,0,3,0
1653297970368,MCWP 125,D00,093553,Guillen; Melinda,3,0,3,0
1653297970368,MCWP 125,E00,093554,Miller; Elizabeth Deen,3,0,3,0
1653297970368,MCWP 125,F00,093555,Miller; Elizabeth Deen,3,0,3,0
1653297970368,MCWP 125,G00,093556,Miller; Elizabeth Deen,3,0,3,0
1653297970891,MGT 3,A00,087704,Wagner; Timothy Ryan,90,0,90,0
1653297971417,MGT 4,A01,087706,Levkoff; Steven B.,2,0,3,1
1653297971417,MGT 4,A02,087707,Levkoff; Steven B.,3,0,3,0
1653297971417,MGT 4,A03,092659,Levkoff; Steven B.,1,0,4,3
1653297971943,MGT 5,A00,087708,Houskeeper; Robert,194,0,196,2
1653297972467,MGT 12,A00,087709,Pecore; Joseph P.,91,0,100,9
1653297972467,MGT 12,B00,087710,Lindenberger; Wade Douglas,91,0,100,9
1653297972995,MGT 16,A00,087711,Campbell; Robert Harold,108,0,110,2
1653297972995,MGT 16,B00,087712,Campbell; Robert Harold,110,0,110,0
1653297972995,MGT 16,C00,087713,Lindenberger; Wade Douglas,100,0,110,10
1653297972995,MGT 16,D00,087714,Lindenberger; Wade Douglas,107,0,110,3
1653297972995,MGT 16,E00,094819,Buchanan; Harold G,99,0,100,1
1653297973523,MGT 18,A00,087715,McKay; Michael J,88,0,90,2
1653297973523,MGT 18,B00,087716,McKay; Michael J,90,0,90,0
1653297973523,MGT 18,C00,087717,McKay; Michael J,88,0,90,2
1653297973523,MGT 18,D00,087718,McKay; Mary A,90,0,90,0
1653297973523,MGT 18,E00,087719,McKay; Mary A,87,0,90,3
1653297974045,MGT 45,A00,087720,Pecore; Joseph P.,136,0,150,14
1653297974045,MGT 45,B00,087721,Pecore; Joseph P.,140,0,150,10
1653297974651,MGT 52,A00,087722,Deal; Jennifer Jean,83,0,90,7
1653297975175,MGT 71,A00,087723,August; Terrence,60,0,90,30
1653297976228,MGT 103,A00,087726,Ehrich; Kristine R,86,0,90,4
1653297976228,MGT 103,B00,087727,Ehrich; Kristine R,89,0,90,1
1653297976228,MGT 103,C00,087728,Eberhard; Craig A,89,0,90,1
1653297976228,MGT 103,D00,087729,Eberhard; Craig A,88,0,90,2
1653297976228,MGT 103,E00,087730,Demill; Burritt,75,0,90,15
1653297976228,MGT 103,F00,087731,Bates; Kenneth Walter,81,0,90,9
1653297976228,MGT 103,G00,087732,Bates; Kenneth Walter,88,0,90,2
1653297976752,MGT 105,A00,087733,Campbell; Robert Harold,102,0,120,18
1653297977278,MGT 106,A00,087734,Eberhard; Craig A,81,0,90,9
1653297977805,MGT 108R,A00,087735,Amir; On,84,0,90,6
1653297978332,MGT 109,A00,087736,Staff,77,0,90,13
1653297978857,MGT 112,A00,087737,Somasundaram; Tyagarajan,89,0,90,1
1653297978857,MGT 112,B00,087738,Somasundaram; Tyagarajan,86,0,90,4
1653297978857,MGT 112,C00,087739,Ehrich; Kristine R,86,0,90,4
1653297978857,MGT 112,D00,087740,Zimmermann; Carsten,65,0,90,25
1653297979386,MGT 121A,A00,087741,Wang; Helen Shan,65,0,70,5
1653297979386,MGT 121A,B00,087742,Wang; Helen Shan,64,0,70,6
1653297979910,MGT 131A,A00,087743,Houskeeper; Robert,146,0,150,4
1653297980434,MGT 132,A00,087744,Blakley; Bruce,88,0,90,2
1653297980957,MGT 134,A00,087745,Houskeeper; Robert,84,0,90,6
1653297981480,MGT 135,A00,087746,Anderson; John Charles,83,0,90,7
1653297982005,MGT 139,A00,087747,Perols; Johan Lars,88,0,90,2
1653297982535,MGT 153,A00,087748,Perols; Johan Lars,82,0,90,8
1653297982535,MGT 153,B00,087749,Phiroz; Zal Navroze,76,0,90,14
1653297982535,MGT 153,C00,087750,Phiroz; Zal Navroze,87,0,90,3
1653297983064,MGT 162R,A00,087751,Gneezy; Uri,64,0,90,26
1653297983591,MGT 164,A00,087752,McKay; Mary A,90,0,90,0
1653297983591,MGT 164,B00,087753,Meyer; Alison Bloomfield,0,0,0,0
1653297983591,MGT 164,C00,087754,Smith; Pamela Karen,82,0,90,8
1653297984118,MGT 166,A00,087755,Moran; Cathleen L.,89,0,90,1
1653297984118,MGT 166,B00,087756,Moran; Cathleen L.,90,0,90,0
1653297984118,MGT 166,C00,087757,Moran; Cathleen L.,90,0,90,0
1653297984118,MGT 166,D00,087758,Demill; Burritt,56,0,90,34
1653297984642,MGT 167,A00,087759,Klaas; Jeffrey David,88,0,90,2
1653297984642,MGT 167,B00,087760,Jacob; Jo Dee C,83,0,90,7
1653297985166,MGT 171,A00,087761,Phiroz; Zal Navroze,85,0,90,5
1653297985693,MGT 172,A00,087762,Hedges; Kathleen & Royal; Rebecca,96,0,100,4
1653297985693,MGT 172,B00,087763,Hedges; Kathleen,79,0,90,11
1653297985693,MGT 172,C00,087764,Zimmermann; Carsten,90,0,90,0
1653297986216,MGT 172R,A00,094888,Erat; Sanjiv,90,0,90,0
1653297986744,MGT 173,A00,087765,Hayes; Sherry Lorine,80,0,100,20
1653297987271,MGT 175,A00,087766,Gopal; Christopher S.,84,0,90,6
1653297987794,MGT 181,A00,087767,Buchanan; Harold G,114,0,120,6
1653297987794,MGT 181,B00,087768,Buchanan; Harold G,110,0,120,10
1653297987794,MGT 181,C00,087769,Bliss; Barbara Ann,109,0,120,11
1653297988846,MGT 185,A00,087771,Dunn; Louis Jean,84,0,90,6
1653297989369,MGT 187,A00,087772,Dunn; Louis Jean,138,0,146,8
1653297989896,MMW 11,A01,086931,duBois; Page Ann,4,0,4,0
1653297989896,MMW 11,A02,086932,duBois; Page Ann,4,0,4,0
1653297989896,MMW 11,A03,086933,duBois; Page Ann,3,0,4,1
1653297989896,MMW 11,A04,086934,duBois; Page Ann,3,0,4,1
1653297989896,MMW 11,A05,086935,duBois; Page Ann,4,0,4,0
1653297989896,MMW 11,A06,086936,duBois; Page Ann,3,0,4,1
1653297989896,MMW 11,A07,086937,duBois; Page Ann,4,0,4,0
1653297989896,MMW 11,A08,086938,duBois; Page Ann,4,0,4,0
1653297989896,MMW 11,A09,086939,duBois; Page Ann,4,0,4,0
1653297989896,MMW 11,A10,086940,duBois; Page Ann,4,0,4,0
1653297989896,MMW 11,A11,086941,duBois; Page Ann,4,0,4,0
1653297989896,MMW 11,A12,093877,duBois; Page Ann,3,0,4,1
1653297990420,MMW 11R,A01,093852,Herbst; Matthew,4,0,4,0
1653297990420,MMW 11R,A02,093853,Herbst; Matthew,4,0,4,0
1653297990420,MMW 11R,A03,093854,Herbst; Matthew,4,0,4,0
1653297990420,MMW 11R,A04,093855,Herbst; Matthew,4,0,4,0
1653297990420,MMW 11R,A05,093856,Herbst; Matthew,4,0,4,0
1653297990420,MMW 11R,A06,093857,Herbst; Matthew,4,0,4,0
1653297990420,MMW 11R,A07,093858,Herbst; Matthew,4,0,4,0
1653297990420,MMW 11R,A08,093859,Herbst; Matthew,4,0,4,0
1653297990420,MMW 11R,A09,093860,Herbst; Matthew,4,0,4,0
1653297990420,MMW 11R,A10,093861,Herbst; Matthew,4,0,4,0
1653297990420,MMW 11R,A11,093862,Herbst; Matthew,4,0,4,0
1653297990420,MMW 11R,A12,093863,Herbst; Matthew,4,0,4,0
1653297990420,MMW 11R,B01,093865,Herbst; Matthew,4,0,4,0
1653297990420,MMW 11R,B02,093866,Herbst; Matthew,4,0,4,0
1653297990420,MMW 11R,B03,093867,Herbst; Matthew,4,0,4,0
1653297990420,MMW 11R,B04,093868,Herbst; Matthew,4,0,4,0
1653297990420,MMW 11R,B05,093869,Herbst; Matthew,4,0,4,0
1653297990420,MMW 11R,B06,093870,Herbst; Matthew,4,0,4,0
1653297990420,MMW 11R,B07,093871,Herbst; Matthew,4,0,4,0
1653297990420,MMW 11R,B08,093872,Herbst; Matthew,4,0,4,0
1653297990420,MMW 11R,B09,093873,Herbst; Matthew,4,0,4,0
1653297990420,MMW 11R,B10,093874,Herbst; Matthew,4,0,4,0
1653297990420,MMW 11R,B11,093875,Herbst; Matthew,4,0,4,0
1653297990420,MMW 11R,B12,093876,Herbst; Matthew,4,0,4,0
1653297990946,MMW 14,A01,086968,Chang; Edmond Yi-Teh,28,0,28,0
1653297990946,MMW 14,A02,086969,Chang; Edmond Yi-Teh,27,0,28,1
1653297990946,MMW 14,A03,086970,Chang; Edmond Yi-Teh,21,0,28,7
1653297990946,MMW 14,A04,086971,Chang; Edmond Yi-Teh,27,0,28,1
1653297990946,MMW 14,A05,086972,Chang; Edmond Yi-Teh,26,0,28,2
1653297990946,MMW 14,A06,086973,Chang; Edmond Yi-Teh,28,0,28,0
1653297990946,MMW 14,A07,086974,Chang; Edmond Yi-Teh,27,0,28,1
1653297990946,MMW 14,A08,086975,Chang; Edmond Yi-Teh,25,0,28,3
1653297990946,MMW 14,A09,086976,Chang; Edmond Yi-Teh,0,0,0,0
1653297990946,MMW 14,A10,086977,Chang; Edmond Yi-Teh,27,0,28,1
1653297990946,MMW 14,A11,086978,Chang; Edmond Yi-Teh,26,0,28,2
1653297990946,MMW 14,A12,086979,Chang; Edmond Yi-Teh,27,0,28,1
1653297990946,MMW 14,A13,086980,Chang; Edmond Yi-Teh,28,0,28,0
1653297991477,MMW 121,A01,086982,Chang; Edmond Yi-Teh,0,0,0,0
1653297991477,MMW 121,A02,086983,Chang; Edmond Yi-Teh,0,0,0,0
1653297991477,MMW 121,A03,086984,Chang; Edmond Yi-Teh,2,0,4,2
1653297991477,MMW 121,A04,086985,Chang; Edmond Yi-Teh,4,0,4,0
1653297991477,MMW 121,A05,086986,Chang; Edmond Yi-Teh,4,0,4,0
1653297991477,MMW 121,A06,086987,Chang; Edmond Yi-Teh,4,0,4,0
1653297991477,MMW 121,A07,086988,Chang; Edmond Yi-Teh,4,0,4,0
1653297991477,MMW 121,A08,086989,Chang; Edmond Yi-Teh,4,0,4,0
1653297991477,MMW 121,B01,086991,Patterson; Patrick H.,4,0,4,0
1653297991477,MMW 121,B02,086992,Patterson; Patrick H.,4,0,4,0
1653297991477,MMW 121,B03,086993,Patterson; Patrick H.,4,0,4,0
1653297991477,MMW 121,B04,086994,Patterson; Patrick H.,3,0,4,1
1653297991477,MMW 121,B05,086995,Patterson; Patrick H.,4,0,4,0
1653297991477,MMW 121,B06,086996,Patterson; Patrick H.,4,0,4,0
1653297991477,MMW 121,B07,086997,Patterson; Patrick H.,4,0,4,0
1653297991477,MMW 121,B08,086998,Patterson; Patrick H.,4,0,4,0
1653297991477,MMW 121,B09,086999,Patterson; Patrick H.,4,0,4,0
1653297991477,MMW 121,B10,087000,Patterson; Patrick H.,4,0,4,0
1653297991477,MMW 121,B11,087001,Patterson; Patrick H.,0,0,0,0
1653297991477,MMW 121,B12,087002,Patterson; Patrick H.,0,0,0,0
1653297992008,MUS 1A,A01,090497,Staff,19,0,20,1
1653297992008,MUS 1A,A02,090498,Staff,13,0,20,7
1653297992008,MUS 1A,A03,090499,Staff,18,0,20,2
1653297992008,MUS 1A,A04,090500,Staff,19,0,20,1
1653297992008,MUS 1A,A05,090501,Staff,20,0,20,0
1653297992008,MUS 1A,A06,090502,Staff,20,0,20,0
1653297992008,MUS 1A,B01,090504,Staff,18,0,20,2
1653297992008,MUS 1A,B02,090505,Staff,20,0,20,0
1653297992008,MUS 1A,B03,090506,Staff,18,0,20,2
1653297992008,MUS 1A,B04,090507,Staff,18,0,20,2
1653297992008,MUS 1A,B05,090508,Staff,16,0,20,4
1653297992008,MUS 1A,B06,090509,Staff,20,0,20,0
1653297992534,MUS 2A,A01,090511,Carlson; Erik Norman,19,0,20,1
1653297993059,MUS 2AK,A00,090512,Ohnishi; Takae,24,0,25,1
1653297993059,MUS 2AK,B00,090513,Ohnishi; Takae,15,0,15,0
1653297993582,MUS 4,A01,090515,Staff,24,0,25,1
1653297993582,MUS 4,A02,090516,Staff,24,0,25,1
1653297993582,MUS 4,A03,090517,Staff,22,0,25,3
1653297993582,MUS 4,A04,090518,Staff,24,0,25,1
1653297993582,MUS 4,A05,090519,Staff,25,0,25,0
1653297993582,MUS 4,A06,090520,Staff,25,0,25,0
1653297993582,MUS 4,A07,090521,Staff,24,0,25,1
1653297993582,MUS 4,A08,090522,Staff,24,0,25,1
1653297994112,MUS 5,A01,090524,Staff,20,0,20,0
1653297994112,MUS 5,A02,090525,Staff,18,0,20,2
1653297994112,MUS 5,A03,090526,Staff,20,0,20,0
1653297994112,MUS 5,A04,090527,Staff,20,0,20,0
1653297994112,MUS 5,A05,090528,Staff,19,0,20,1
1653297994647,MUS 6,A01,090530,Staff,22,0,25,3
1653297994647,MUS 6,A02,090531,Staff,25,0,25,0
1653297994647,MUS 6,A03,090532,Staff,25,0,25,0
1653297994647,MUS 6,A04,090533,Staff,23,0,25,2
1653297995174,MUS 8,A01,090535,Kenyatta; Kamau,17,0,25,8
1653297995174,MUS 8,A02,090536,Kenyatta; Kamau,19,0,25,6
1653297995174,MUS 8,A03,090537,Kenyatta; Kamau,17,0,25,8
1653297995174,MUS 8,A04,090538,Kenyatta; Kamau,21,0,25,4
1653297995701,MUS 12,A01,090540,Narucki; Susan M,20,0,20,0
1653297995701,MUS 12,A02,090541,Narucki; Susan M,20,0,20,0
1653297995701,MUS 12,A03,090542,Narucki; Susan M,17,0,20,3
1653297996225,MUS 15,A01,090544,Staff,21,0,25,4
1653297996225,MUS 15,A02,090545,Staff,23,0,25,2
1653297996225,MUS 15,A03,090546,Staff,24,0,25,1
1653297996225,MUS 15,A04,090547,Staff,22,0,25,3
1653297996225,MUS 15,A05,090548,Staff,25,0,25,0
1653297996225,MUS 15,A06,090549,Staff,24,0,25,1
1653297996757,MUS 19R,A01,090551,Britt; King James,17,0,20,3
1653297996757,MUS 19R,A02,090552,Britt; King James,19,0,20,1
1653297996757,MUS 19R,A03,090553,Britt; King James,20,0,20,0
1653297996757,MUS 19R,A04,090554,Britt; King James,19,0,20,1
1653297996757,MUS 19R,A05,090555,Britt; King James,20,0,20,0
1653297996757,MUS 19R,A06,090556,Britt; King James,18,0,20,2
1653297996757,MUS 19R,A07,090557,Britt; King James,19,0,20,1
1653297996757,MUS 19R,A08,090558,Britt; King James,19,0,20,1
1653297996757,MUS 19R,A09,090559,Britt; King James,20,0,20,0
1653297996757,MUS 19R,A10,090560,Britt; King James,20,0,20,0
1653297996757,MUS 19R,B01,090562,Britt; King James,10,0,10,0
1653297996757,MUS 19R,B02,090563,Britt; King James,10,0,10,0
1653297996757,MUS 19R,B03,090564,Britt; King James,10,0,10,0
1653297996757,MUS 19R,B04,090565,Britt; King James,10,0,10,0
1653297996757,MUS 19R,B05,090566,Britt; King James,10,0,10,0
1653297996757,MUS 19R,B06,090567,Britt; King James,10,0,10,0
1653297996757,MUS 19R,B07,090568,Britt; King James,10,0,10,0
1653297996757,MUS 19R,B08,090569,Britt; King James,10,0,10,0
1653297996757,MUS 19R,B09,090570,Britt; King James,10,0,10,0
1653297996757,MUS 19R,B10,090571,Britt; King James,10,0,10,0
1653297997280,MUS 20,A01,090573,Borgo; David Garcia,12,0,15,3
1653297997280,MUS 20,A02,090574,Borgo; David Garcia,14,0,15,1
1653297997280,MUS 20,A03,090575,Borgo; David Garcia,13,0,15,2
1653297997807,MUS 32,001,094074,Staff,10,0,10,0
1653297997807,MUS 32,002,094075,Kenyatta; Kamau,10,0,10,0
1653297997807,MUS 32,003,094076,Curtis; Charles Rector,10,0,10,0
1653297997807,MUS 32,005,094078,Terrazas Perez; Wilfrido D,10,0,10,0
1653297997807,MUS 32,006,094079,Ohnishi; Takae,10,0,10,0
1653297997807,MUS 32,007,094080,Burr; Anthony I,10,0,10,0
1653297997807,MUS 32,008,094081,Carlson; Erik Norman,10,0,10,0
1653297997807,MUS 32,009,094082,Dresser; Mark Stuart,10,0,10,0
1653297997807,MUS 32,011,094084,Richards; Stephanie F,10,0,10,0
1653297997807,MUS 32,012,094085,Borgo; David Garcia,10,0,10,0
1653297997807,MUS 32,013,094086,Paganos Koukakis; Dimitrios,10,0,10,0
1653297997807,MUS 32,014,094087,Jones; Michael David,10,0,10,0
1653297998334,MUS 32V,A00,094355,Zazueta Cervera; Miguel Angel,10,0,10,0
1653297998334,MUS 32V,B00,094089,Flores; Mariana,10,0,10,0
1653297998859,MUS 32VM,A00,094090,Zazueta Cervera; Miguel Angel,15,0,15,0
1653297999387,MUS 33A,A00,090576,Liang; Lei,24,0,25,1
1653297999910,MUS 43,A00,090577,Burr; Anthony I,92,0,100,8
1653298000433,MUS 95C,B00,094829,Staff,28,0,30,2
1653298000955,MUS 95D,A00,090579,Staff,30,0,30,0
1653298001479,MUS 95E,A00,090580,Staff,30,0,30,0
1653298002003,MUS 95G,A00,090581,Anderson; Kenneth,384,0,395,11
1653298002003,MUS 95G,B00,090582,Anderson; Kenneth,393,0,395,2
1653298002526,MUS 95JC,A00,090583,Kenyatta; Kamau,35,0,35,0
1653298003049,MUS 95L,A00,090584,Staff,30,0,30,0
1653298003574,MUS 95W,A00,090585,Seshadri; Kartik,60,0,60,0
1653298003574,MUS 95W,B00,090586,Seshadri; Kartik,30,0,30,0
1653298004102,MUS 101A,A01,090588,Staff,29,0,30,1
1653298004629,MUS 103A,A00,090589,Ung; Chinary,15,0,15,0
1653298005176,MUS 107,A00,090590,Terrazas Perez; Wilfrido D,30,0,30,0
1653298005699,MUS 111,A00,090591,Yadegari; Shahrokh D,124,0,130,6
1653298006223,MUS 114,A00,090592,Curtis; Charles Rector,117,0,125,8
1653298006749,MUS 120A,A01,090594,Cimini; Amy Marie,29,0,30,1
1653298007275,MUS 126R,A00,090595,Borgo; David Garcia,106,0,115,9
1653298007799,MUS 130,A00,090596,Ohnishi; Takae,30,0,30,0
1653298008332,MUS 132,001,094091,Nourai; Keyarash,10,0,10,0
1653298008332,MUS 132,002,094093,Kenyatta; Kamau,10,0,10,0
1653298008332,MUS 132,003,094094,Curtis; Charles Rector,10,0,10,0
1653298008332,MUS 132,005,094096,Terrazas Perez; Wilfrido D,10,0,10,0
1653298008332,MUS 132,006,094097,Ohnishi; Takae,10,0,10,0
1653298008332,MUS 132,007,094098,Burr; Anthony I,10,0,10,0
1653298008332,MUS 132,008,094099,Carlson; Erik Norman,10,0,10,0
1653298008332,MUS 132,009,094100,Dresser; Mark Stuart,10,0,10,0
1653298008332,MUS 132,011,094102,Richards; Stephanie F,10,0,10,0
1653298008332,MUS 132,012,094103,Borgo; David Garcia,10,0,10,0
1653298008332,MUS 132,013,094104,Jones; Michael David,10,0,10,0
1653298008332,MUS 132,014,094105,Staff,10,0,10,0
1653298008857,MUS 132V,A00,094106,Narucki; Susan M,15,0,15,0
1653298009379,MUS 134,A00,090597,Staff,30,0,30,0
1653298009906,MUS 137A,A00,090598,Kenyatta; Kamau,30,0,30,0
1653298010429,MUS 143,A00,090599,Staff,26,0,30,4
1653298011482,MUS 173,A00,090600,Britt; King James,19,0,30,11
1653298012006,MUS 174A,A00,090601,Staff,8,0,15,7
1653298013056,NANO 4,A01,088199,Vazquez Mena; Oscar,20,0,20,0
1653298013056,NANO 4,B01,088201,Vazquez Mena; Oscar,20,0,20,0
1653298013056,NANO 4,C01,088203,Vazquez Mena; Oscar,20,0,20,0
1653298013580,NANO 15,A01,088205,Lubarda; Vlado,50,0,50,0
1653298013580,NANO 15,B01,088207,Lubarda; Vlado,50,0,50,0
1653298014103,NANO 20L,A00,088208,Sirbuly; Donald,27,0,30,3
1653298014103,NANO 20L,B00,088209,Sirbuly; Donald,29,0,30,1
1653298014627,NANO 100L,A00,088210,Vecchio; Kenneth S,24,0,30,6
1653298015151,NANO 102,A00,088211,Tao; Andrea Rae,94,0,100,6
1653298015682,NANO 110,A00,088212,Pascal; Tod A,99,0,100,1
1653298016209,NANO 111,A00,088213,Fenning; David,45,0,50,5
1653298016733,NANO 117,A00,088214,Cubukcu; Ertugrul,71,0,75,4
1653298017260,NANO 119,A00,088215,Vazquez Mena; Oscar,50,0,50,0
1653298017786,NANO 159,A00,088216,Wang; Joseph,33,0,40,7
1653298018308,NANO 181,A01,088218,Ong; Shyue Ping,22,0,25,3
1653298018833,PHIL 1,A00,090815,Sher; Gila,57,0,60,3
1653298019358,PHIL 10,A01,090817,Grush; Rick Scott,37,0,40,3
1653298019358,PHIL 10,A02,090818,Grush; Rick Scott,37,0,40,3
1653298019358,PHIL 10,A03,090819,Grush; Rick Scott,38,0,40,2
1653298019358,PHIL 10,A04,090820,Grush; Rick Scott,40,0,40,0
1653298019358,PHIL 10,A05,090821,Grush; Rick Scott,38,0,40,2
1653298019358,PHIL 10,A06,090822,Grush; Rick Scott,39,0,40,1
1653298019885,PHIL 12,A01,090824,Bechtel; William,20,0,25,5
1653298019885,PHIL 12,A02,090825,Bechtel; William,24,0,25,1
1653298019885,PHIL 12,A03,090826,Bechtel; William,25,0,25,0
1653298019885,PHIL 12,A04,090827,Bechtel; William,25,0,25,0
1653298020408,PHIL 13,A01,090829,Wonderly; Monique L.,25,0,25,0
1653298020408,PHIL 13,A02,090830,Wonderly; Monique L.,24,0,25,1
1653298020408,PHIL 13,A03,090831,Wonderly; Monique L.,24,0,25,1
1653298020408,PHIL 13,A04,090832,Wonderly; Monique L.,25,0,25,0
1653298020933,PHIL 27,A01,090834,Harrell; Maralee Mae,23,0,35,12
1653298020933,PHIL 27,A02,090835,Harrell; Maralee Mae,35,0,35,0
1653298020933,PHIL 27,A03,090836,Harrell; Maralee Mae,33,0,35,2
1653298020933,PHIL 27,A04,090837,Harrell; Maralee Mae,33,0,35,2
1653298020933,PHIL 27,A05,090838,Harrell; Maralee Mae,35,0,35,0
1653298020933,PHIL 27,A06,090839,Harrell; Maralee Mae,35,0,35,0
1653298021463,PHIL 28,A01,090841,Bazargan-Forward; Saba,31,0,35,4
1653298021463,PHIL 28,A02,090842,Bazargan-Forward; Saba,31,0,35,4
1653298021463,PHIL 28,A03,090843,Bazargan-Forward; Saba,35,0,35,0
1653298021463,PHIL 28,A04,090844,Bazargan-Forward; Saba,30,0,35,5
1653298021463,PHIL 28,A05,090845,Bazargan-Forward; Saba,33,0,35,2
1653298021463,PHIL 28,A06,090846,Bazargan-Forward; Saba,34,0,35,1
1653298021463,PHIL 28,A07,090847,Bazargan-Forward; Saba,32,0,35,3
1653298021463,PHIL 28,A08,090848,Bazargan-Forward; Saba,33,0,35,2
1653298021994,PHIL 31,A00,090849,Johnson; Monte,59,0,60,1
1653298022518,PHIL 100,A00,090852,Nelkin; Dana Kay,28,0,35,7
1653298023045,PHIL 110,A00,090853,Johnson; Monte,29,0,30,1
1653298023571,PHIL 120,A00,090854,Rickless; Samuel Charles,23,0,35,12
1653298024096,PHIL 123,A00,090855,Sher; Gila,38,0,40,2
1653298024624,PHIL 131,A00,090856,Cohen; Jonathan David,34,0,35,1
1653298025150,PHIL 132,A00,090857,Carr; Jennifer Rose,33,0,35,2
1653298025677,PHIL 138,A00,090858,Brink; David O.,34,0,40,6
1653298026205,PHIL 147,A00,090860,Fulkerson; Matthew Todd,33,0,35,2
1653298026743,PHIL 150,A00,090861,Bechtel; William,36,0,40,4
1653298027267,PHIL 155,A00,090862,Vargas; Manuel Rogelio,38,0,40,2
1653298027862,PHIL 165,A00,090863,Rickless; Samuel Charles,58,0,70,12
1653298028385,PHIL 172,A00,090864,Bazargan-Forward; Saba,37,0,40,3
1653298028910,PHIL 173,A00,090865,Wonderly; Monique L.,33,0,40,7
1653298029436,PHYS 1A,A00,088555,Koslover; Elena F,354,0,362,8
1653298029436,PHYS 1A,B00,088556,Koslover; Elena F,343,0,362,19
1653298029436,PHYS 1A,C00,088557,Shpyrko; Oleg,326,0,362,36
1653298029968,PHYS 1AL,001,088558,Tsai; Philbert S,30,0,30,0
1653298029968,PHYS 1AL,002,088559,Tsai; Philbert S,30,0,30,0
1653298029968,PHYS 1AL,003,088560,Tsai; Philbert S,23,0,30,7
1653298029968,PHYS 1AL,004,088561,Tsai; Philbert S,26,0,30,4
1653298029968,PHYS 1AL,005,088562,Tsai; Philbert S,24,0,30,6
1653298029968,PHYS 1AL,006,088563,Tsai; Philbert S,30,0,30,0
1653298029968,PHYS 1AL,007,088564,Tsai; Philbert S,26,0,30,4
1653298029968,PHYS 1AL,008,088565,Tsai; Philbert S,29,0,30,1
1653298029968,PHYS 1AL,009,088566,Tsai; Philbert S,28,0,30,2
1653298029968,PHYS 1AL,010,088567,Tsai; Philbert S,30,0,30,0
1653298029968,PHYS 1AL,011,088568,Tsai; Philbert S,29,0,30,1
1653298029968,PHYS 1AL,012,088569,Tsai; Philbert S,29,0,30,1
1653298029968,PHYS 1AL,013,088570,Tsai; Philbert S,30,0,30,0
1653298029968,PHYS 1AL,014,088571,Tsai; Philbert S,29,0,30,1
1653298029968,PHYS 1AL,015,088572,Tsai; Philbert S,23,0,30,7
1653298029968,PHYS 1AL,016,088573,Tsai; Philbert S,28,0,30,2
1653298029968,PHYS 1AL,017,088574,Tsai; Philbert S,29,0,30,1
1653298029968,PHYS 1AL,018,088575,Tsai; Philbert S,28,0,30,2
1653298029968,PHYS 1AL,019,088576,Tsai; Philbert S,26,0,30,4
1653298029968,PHYS 1AL,020,088577,Tsai; Philbert S,29,0,30,1
1653298029968,PHYS 1AL,021,088578,Tsai; Philbert S,30,0,30,0
1653298029968,PHYS 1AL,022,088579,Tsai; Philbert S,30,0,30,0
1653298029968,PHYS 1AL,023,088580,Tsai; Philbert S,30,0,30,0
1653298029968,PHYS 1AL,024,088581,Tsai; Philbert S,30,0,30,0
1653298029968,PHYS 1AL,025,088582,Tsai; Philbert S,26,0,30,4
1653298029968,PHYS 1AL,026,088583,Tsai; Philbert S,29,0,30,1
1653298029968,PHYS 1AL,027,088584,Tsai; Philbert S,28,0,30,2
1653298029968,PHYS 1AL,028,088585,Tsai; Philbert S,30,0,30,0
1653298029968,PHYS 1AL,029,088586,Tsai; Philbert S,27,0,30,3
1653298029968,PHYS 1AL,030,088587,Tsai; Philbert S,29,0,30,1
1653298029968,PHYS 1AL,031,088588,Tsai; Philbert S,30,0,30,0
1653298029968,PHYS 1AL,032,088589,Tsai; Philbert S,30,0,30,0
1653298029968,PHYS 1AL,033,088590,Tsai; Philbert S,30,0,30,0
1653298029968,PHYS 1AL,034,088591,Tsai; Philbert S,30,0,30,0
1653298029968,PHYS 1AL,035,088592,Tsai; Philbert S,29,0,30,1
1653298029968,PHYS 1AL,036,088593,Tsai; Philbert S,30,0,30,0
1653298030493,PHYS 1B,A00,088594,Groisman; Alexander,351,0,360,9
1653298031022,PHYS 1BL,001,088595,Tsai; Philbert S,30,0,30,0
1653298031022,PHYS 1BL,002,088596,Tsai; Philbert S,25,0,30,5
1653298031022,PHYS 1BL,003,088597,Tsai; Philbert S,27,0,30,3
1653298031022,PHYS 1BL,004,088598,Tsai; Philbert S,30,0,30,0
1653298031022,PHYS 1BL,005,088599,Tsai; Philbert S,29,0,30,1
1653298031022,PHYS 1BL,006,088600,Tsai; Philbert S,25,0,30,5
1653298031022,PHYS 1BL,007,088601,Tsai; Philbert S,30,0,30,0
1653298031022,PHYS 1BL,008,088602,Tsai; Philbert S,29,0,30,1
1653298031022,PHYS 1BL,009,088603,Tsai; Philbert S,30,0,30,0
1653298031022,PHYS 1BL,010,088604,Tsai; Philbert S,30,0,30,0
1653298031022,PHYS 1BL,011,088605,Tsai; Philbert S,28,0,30,2
1653298031022,PHYS 1BL,012,088606,Tsai; Philbert S,26,0,30,4
1653298031548,PHYS 1C,A00,088607,Tsai; Philbert S,334,0,360,26
1653298032072,PHYS 1CL,001,088608,Tsai; Philbert S,30,0,30,0
1653298032072,PHYS 1CL,002,088609,Tsai; Philbert S,24,0,30,6
1653298032072,PHYS 1CL,003,088610,Tsai; Philbert S,24,0,30,6
1653298032072,PHYS 1CL,004,088611,Tsai; Philbert S,29,0,30,1
1653298032072,PHYS 1CL,005,088612,Tsai; Philbert S,17,0,30,13
1653298032072,PHYS 1CL,006,088613,Tsai; Philbert S,19,0,30,11
1653298032072,PHYS 1CL,007,088614,Tsai; Philbert S,30,0,30,0
1653298032072,PHYS 1CL,008,088615,Tsai; Philbert S,26,0,30,4
1653298032072,PHYS 1CL,009,088616,Tsai; Philbert S,27,0,30,3
1653298032072,PHYS 1CL,010,088617,Tsai; Philbert S,29,0,30,1
1653298032072,PHYS 1CL,011,088618,Tsai; Philbert S,27,0,30,3
1653298032072,PHYS 1CL,012,088619,Tsai; Philbert S,24,0,30,6
1653298032604,PHYS 2A,A01,092602,Meyertholen; Andrew D.,26,0,30,4
1653298032604,PHYS 2A,A02,092603,Meyertholen; Andrew D.,28,0,30,2
1653298032604,PHYS 2A,A03,092604,Meyertholen; Andrew D.,29,0,30,1
1653298032604,PHYS 2A,A04,092605,Meyertholen; Andrew D.,30,0,30,0
1653298032604,PHYS 2A,A05,092606,Meyertholen; Andrew D.,29,0,30,1
1653298032604,PHYS 2A,A06,092607,Meyertholen; Andrew D.,29,0,30,1
1653298032604,PHYS 2A,A07,092608,Meyertholen; Andrew D.,30,0,30,0
1653298032604,PHYS 2A,A08,092609,Meyertholen; Andrew D.,30,0,30,0
1653298032604,PHYS 2A,A09,092610,Meyertholen; Andrew D.,27,0,30,3
1653298032604,PHYS 2A,A10,092611,Meyertholen; Andrew D.,30,0,30,0
1653298032604,PHYS 2A,A11,092612,Meyertholen; Andrew D.,30,0,30,0
1653298032604,PHYS 2A,A12,094499,Meyertholen; Andrew D.,27,0,30,3
1653298033130,PHYS 2B,A01,092613,Branson; James G,28,0,30,2
1653298033130,PHYS 2B,A02,092614,Branson; James G,29,0,30,1
1653298033130,PHYS 2B,A03,092615,Branson; James G,30,0,30,0
1653298033130,PHYS 2B,A04,092616,Branson; James G,30,0,30,0
1653298033130,PHYS 2B,A05,092617,Branson; James G,29,0,30,1
1653298033130,PHYS 2B,A06,092618,Branson; James G,29,0,30,1
1653298033130,PHYS 2B,A07,092619,Branson; James G,29,0,30,1
1653298033130,PHYS 2B,A08,092620,Branson; James G,0,0,0,0
1653298033130,PHYS 2B,A09,092621,Branson; James G,0,0,0,0
1653298033130,PHYS 2B,A10,092622,Branson; James G,0,0,0,0
1653298033130,PHYS 2B,A11,092623,Branson; James G,0,0,0,0
1653298033130,PHYS 2B,A12,092624,Branson; James G,30,0,30,0
1653298033657,PHYS 2C,A01,092625,Barreiro Guerrero; Julio,27,0,30,3
1653298033657,PHYS 2C,A02,092626,Barreiro Guerrero; Julio,28,0,30,2
1653298033657,PHYS 2C,A03,092627,Barreiro Guerrero; Julio,29,0,30,1
1653298033657,PHYS 2C,A04,092628,Barreiro Guerrero; Julio,29,0,30,1
1653298033657,PHYS 2C,A05,092629,Barreiro Guerrero; Julio,30,0,30,0
1653298033657,PHYS 2C,A06,092630,Barreiro Guerrero; Julio,30,0,30,0
1653298033657,PHYS 2C,A07,092631,Barreiro Guerrero; Julio,30,0,30,0
1653298033657,PHYS 2C,A08,092632,Barreiro Guerrero; Julio,30,0,30,0
1653298033657,PHYS 2C,A09,092633,Barreiro Guerrero; Julio,29,0,30,1
1653298033657,PHYS 2C,A10,092634,Barreiro Guerrero; Julio,29,0,30,1
1653298033657,PHYS 2C,A11,092635,Barreiro Guerrero; Julio,27,0,30,3
1653298033657,PHYS 2C,A12,092636,Barreiro Guerrero; Julio,29,0,30,1
1653298033657,PHYS 2C,B01,092637,Barreiro Guerrero; Julio,29,0,30,1
1653298033657,PHYS 2C,B02,092638,Barreiro Guerrero; Julio,30,0,30,0
1653298033657,PHYS 2C,B03,092639,Barreiro Guerrero; Julio,28,0,30,2
1653298033657,PHYS 2C,B04,092640,Barreiro Guerrero; Julio,29,0,30,1
1653298033657,PHYS 2C,B05,092641,Barreiro Guerrero; Julio,26,0,30,4
1653298033657,PHYS 2C,B06,092642,Barreiro Guerrero; Julio,28,0,30,2
1653298033657,PHYS 2C,B07,092643,Barreiro Guerrero; Julio,29,0,30,1
1653298033657,PHYS 2C,B08,092644,Barreiro Guerrero; Julio,30,0,30,0
1653298033657,PHYS 2C,B09,092645,Barreiro Guerrero; Julio,29,0,30,1
1653298033657,PHYS 2C,B10,092646,Barreiro Guerrero; Julio,29,0,30,1
1653298033657,PHYS 2C,B11,092647,Barreiro Guerrero; Julio,30,0,30,0
1653298033657,PHYS 2C,B12,092648,Barreiro Guerrero; Julio,30,0,30,0
1653298034180,PHYS 2CL,A01,088625,Du; Chunhui,26,0,30,4
1653298034180,PHYS 2CL,A02,088626,Du; Chunhui,29,0,30,1
1653298034180,PHYS 2CL,A03,088627,Du; Chunhui,21,0,30,9
1653298034180,PHYS 2CL,A04,088628,Du; Chunhui,30,0,30,0
1653298034180,PHYS 2CL,A05,088629,Du; Chunhui,29,0,30,1
1653298034180,PHYS 2CL,A06,088630,Du; Chunhui,24,0,30,6
1653298034180,PHYS 2CL,A07,088631,Du; Chunhui,28,0,30,2
1653298034180,PHYS 2CL,A08,088632,Du; Chunhui,28,0,30,2
1653298034180,PHYS 2CL,A09,088633,Du; Chunhui,24,0,30,6
1653298034180,PHYS 2CL,A10,088634,Du; Chunhui,29,0,30,1
1653298034180,PHYS 2CL,A11,088635,Du; Chunhui,27,0,30,3
1653298034180,PHYS 2CL,A12,088636,Du; Chunhui,30,0,30,0
1653298034711,PHYS 2D,A01,092649,Hirsch; Jorge Eduardo,30,0,30,0
1653298034711,PHYS 2D,A02,092650,Hirsch; Jorge Eduardo,28,0,30,2
1653298034711,PHYS 2D,A03,092651,Hirsch; Jorge Eduardo,30,0,30,0
1653298034711,PHYS 2D,A04,092652,Hirsch; Jorge Eduardo,30,0,30,0
1653298034711,PHYS 2D,A05,092653,Hirsch; Jorge Eduardo,30,0,30,0
1653298034711,PHYS 2D,A06,092654,Hirsch; Jorge Eduardo,30,0,30,0
1653298035240,PHYS 2DL,A01,088639,Butov; Leonid,7,0,16,9
1653298035240,PHYS 2DL,A02,088640,Butov; Leonid,13,0,16,3
1653298035240,PHYS 2DL,A03,094501,Butov; Leonid,13,0,16,3
1653298035240,PHYS 2DL,A04,094502,Butov; Leonid,16,0,16,0
1653298035771,PHYS 4C,A01,092655,Averitt; Richard Douglas,28,0,30,2
1653298035771,PHYS 4C,A02,092656,Averitt; Richard Douglas,30,0,30,0
1653298035771,PHYS 4C,A03,092657,Averitt; Richard Douglas,30,0,30,0
1653298035771,PHYS 4C,A04,092658,Staff,30,0,30,0
1653298036297,PHYS 5,A01,092662,Konopacky; Quinn Morgan,197,0,200,3
1653298036827,PHYS 10,A01,092663,Tytler; David Robert,191,0,192,1
1653298037350,PHYS 100A,A01,092660,Shpyrko; Oleg,114,0,120,6
1653298037879,PHYS 110A,A01,092664,Arovas; Daniel P,116,0,120,4
1653298038402,PHYS 122,A01,088647,Yang; Liang,30,0,40,10
1653298038930,PHYS 130B,A01,092661,Grover; Tarun,106,0,120,14
1653298039461,PHYS 139,A00,088649,Kuti; Julius,19,0,20,1
1653298039988,PHYS 140A,A01,092665,Shotwell; Brian,105,0,120,15
1653298040513,PHYS 161,A01,092666,Fuller; George Michael,46,0,65,19
1653298041038,PHYS 163,A01,092667,Keres; Dusan,48,0,50,2
1653298041564,PHYS 175,A00,088653,Dudko; Olga,18,0,20,2
1653298042088,PHYS 191,A00,088654,Shpyrko; Oleg,26,0,30,4
1653298042614,POLI 11D,A01,090896,Ferree; Karen E,29,0,30,1
1653298042614,POLI 11D,A02,090897,Ferree; Karen E,28,0,30,2
1653298042614,POLI 11D,A03,090899,Ferree; Karen E,28,0,30,2
1653298042614,POLI 11D,A04,090900,Ferree; Karen E,29,0,30,1
1653298043142,POLI 12D,A01,090902,Roeder; Philip G,26,0,30,4
1653298043142,POLI 12D,A02,090903,Roeder; Philip G,27,0,30,3
1653298043142,POLI 12D,A05,090906,Roeder; Philip G,28,0,30,2
1653298043142,POLI 12D,A06,090907,Roeder; Philip G,30,0,30,0
1653298043682,POLI 13DR,A01,090909,Forman; Fonna,26,0,30,4
1653298043682,POLI 13DR,A02,090910,Forman; Fonna,30,0,30,0
1653298043682,POLI 13DR,A03,090911,Forman; Fonna,28,0,30,2
1653298043682,POLI 13DR,A04,090912,Forman; Fonna,30,0,30,0
1653298043682,POLI 13DR,A05,090913,Forman; Fonna,28,0,30,2
1653298043682,POLI 13DR,A06,090914,Forman; Fonna,34,0,34,0
1653298044205,POLI 27,A01,090916,Elgin; Samuel Zincke,23,0,30,7
1653298044205,POLI 27,A02,090917,Elgin; Samuel Zincke,26,0,30,4
1653298044205,POLI 27,A03,090918,Elgin; Samuel Zincke,30,0,30,0
1653298044205,POLI 27,A04,090919,Elgin; Samuel Zincke,28,0,30,2
1653298044205,POLI 27,A05,090920,Elgin; Samuel Zincke,24,0,30,6
1653298044205,POLI 27,A06,090921,Elgin; Samuel Zincke,29,0,30,1
1653298044730,POLI 28,A01,090923,Elgin; Samuel Zincke,23,0,30,7
1653298044730,POLI 28,A02,090924,Elgin; Samuel Zincke,26,0,30,4
1653298044730,POLI 28,A05,090927,Elgin; Samuel Zincke,23,0,30,7
1653298044730,POLI 28,A06,090928,Elgin; Samuel Zincke,23,0,30,7
1653298045259,POLI 30D,A01,090930,Desposato; Scott,22,0,24,2
1653298045259,POLI 30D,A02,090931,Desposato; Scott,22,0,24,2
1653298045259,POLI 30D,A03,090932,Desposato; Scott,23,0,24,1
1653298045259,POLI 30D,A04,090933,Desposato; Scott,24,0,24,0
1653298045259,POLI 30D,A05,090934,Desposato; Scott,23,0,24,1
1653298045259,POLI 30D,A06,090935,Desposato; Scott,24,0,24,0
1653298045795,POLI 100G,A00,090936,Fletcher; Nathan,199,0,208,9
1653298046322,POLI 100V,A00,090937,Gause; LaGina,111,0,115,4
1653298046868,POLI 100W,A00,090938,Paglayan; Agustina,161,0,165,4
1653298047393,POLI 104A,A00,090940,Smith; Glenn Chatmas,186,0,195,9
1653298047916,POLI 104F,A00,090941,Smith; Glenn Chatmas,11,0,19,8
1653298048438,POLI 104M,A00,090942,Stephens; Mattheus E,156,0,165,9
1653298048962,POLI 110A,A00,090943,Wiens; David,39,0,44,5
1653298049486,POLI 110F,A00,090944,Elgin; Samuel Zincke,50,0,50,0
1653298050013,POLI 113A,A00,090945,Magagna; Victor Valentine,469,0,475,6
1653298050013,POLI 113A,B00,090946,Magagna; Victor Valentine,467,0,475,8
1653298050540,POLI 117R,A00,090947,Forman; Fonna,16,0,40,24
1653298051068,POLI 120E,A00,090948,Strom; Kaare,47,0,50,3
1653298051598,POLI 120G,A00,090949,Fisk; David Lee,110,0,115,5
1653298052123,POLI 120H,A00,090950,Fisk; David Lee,111,0,115,4
1653298052654,POLI 133A,A00,090951,Naoi; Megumi,156,0,165,9
1653298053179,POLI 135,A00,090952,Fisk; David Lee,111,0,115,4
1653298053706,POLI 142J,A00,090953,Slantchev; Branislav,45,0,50,5
1653298054232,POLI 143,A00,090954,Gartzke; Erik,111,0,115,4
1653298054757,POLI 149,A00,090955,Joseph; Michael F,152,0,165,13
1653298055282,POLI 151,A00,090956,Schneider; Christina,92,0,100,8
1653298055809,POLI 165,A00,090957,Warren; Scott,45,0,50,5
1653298056336,POLI 178,A00,090958,Joseph; Michael F,34,0,50,16
1653298056859,POLI 191A,A00,090959,Forman; Fonna & Hoston; Germaine,25,0,25,0
1653298057385,POLI 194,A00,090960,Hill; Seth J,9999,0,9999,0
1653298057910,POLI 194SD,A00,090961,Nichter; Maysa,9999,0,9999,0
1653298058434,POLI 197SD,001,090962,Nichter; Maysa,9999,0,9999,0
1653298058958,PSYC 1,A00,088391,Ferreira; Victor,194,0,200,6
1653298059486,PSYC 2,A00,093916,Moranton; Nirelia Melbina-,192,0,195,3
1653298060014,PSYC 3,A00,088392,Pilegard; Celeste Cristine,221,0,225,4
1653298060539,PSYC 6,A00,088393,McCullough; Michael E,198,0,200,2
1653298061063,PSYC 7,A00,088394,Powell; Lindsey Jane,196,0,200,4
1653298061598,PSYC 60,A01,088397,Lowe; Angela Beth,12,0,25,13
1653298061598,PSYC 60,A02,088398,Lowe; Angela Beth,25,0,25,0
1653298061598,PSYC 60,A03,088399,Lowe; Angela Beth,24,0,25,1
1653298061598,PSYC 60,A04,088400,Lowe; Angela Beth,23,0,25,2
1653298061598,PSYC 60,A05,088401,Lowe; Angela Beth,24,0,25,1
1653298061598,PSYC 60,A06,088402,Lowe; Angela Beth,25,0,25,0
1653298061598,PSYC 60,A07,088403,Lowe; Angela Beth,24,0,25,1
1653298061598,PSYC 60,B01,088405,Rickard; Timothy C.,25,0,25,0
1653298061598,PSYC 60,B02,088406,Rickard; Timothy C.,25,0,25,0
1653298061598,PSYC 60,B03,088407,Rickard; Timothy C.,25,0,25,0
1653298061598,PSYC 60,B04,088408,Rickard; Timothy C.,23,0,25,2
1653298061598,PSYC 60,B05,088410,Rickard; Timothy C.,24,0,25,1
1653298061598,PSYC 60,B06,088411,Rickard; Timothy C.,24,0,25,1
1653298061598,PSYC 60,B07,088412,Rickard; Timothy C.,24,0,25,1
1653298062122,PSYC 70,A01,088414,Pilegard; Celeste Cristine,17,0,25,8
1653298062122,PSYC 70,A02,088415,Pilegard; Celeste Cristine,24,0,25,1
1653298062122,PSYC 70,A03,088416,Pilegard; Celeste Cristine,25,0,25,0
1653298062122,PSYC 70,A04,088417,Pilegard; Celeste Cristine,25,0,25,0
1653298062122,PSYC 70,A05,088418,Pilegard; Celeste Cristine,22,0,25,3
1653298062122,PSYC 70,A06,088419,Pilegard; Celeste Cristine,19,0,25,6
1653298062652,PSYC 71,A01,088421,Lowe; Angela Beth,15,0,25,10
1653298062652,PSYC 71,A02,088422,Lowe; Angela Beth,21,0,25,4
1653298062652,PSYC 71,B01,088424,Steiner; Eric Tomas,20,0,25,5
1653298062652,PSYC 71,B02,088425,Steiner; Eric Tomas,23,0,25,2
1653298063176,PSYC 87,A00,093915,Gorman; Michael R.,20,0,20,0
1653298063702,PSYC 88,A00,088426,Dobkins; Karen R.,61,0,65,4
1653298064225,PSYC 100,A00,088428,Chapman; Eddie Nathaniel,125,0,170,45
1653298064747,PSYC 101,A00,088429,Heyman; Gail D.,148,0,170,22
1653298065270,PSYC 102,A00,093917,Moranton; Nirelia Melbina-,162,0,170,8
1653298065793,PSYC 104,A00,088430,Fine; Rachel,163,0,175,12
1653298066321,PSYC 116A,A01,088433,Lang; Ariel,25,0,25,0
1653298066855,PSYC 122,A00,088434,Miller; Cory T.,103,0,115,12
1653298067381,PSYC 125,A00,088436,Rose; Fred E.,90,0,120,30
1653298067908,PSYC 134,A00,088437,Kaye; Walter H.,235,0,250,15
1653298068430,PSYC 137,A00,088438,Fine; Rachel,210,0,216,6
1653298068957,PSYC 145,A00,093918,Staff,73,0,90,17
1653298069483,PSYC 147,A00,088441,Wong; Lauren Hitomi,120,0,146,26
1653298070008,PSYC 154,A00,093919,Lacefield; Katharine I,270,0,295,25
1653298070532,PSYC 158,A00,088443,Willis; Jarryd Thomas,250,0,295,45
1653298071058,PSYC 162,A00,088444,Wixted; John T,210,0,225,15
1653298071582,PSYC 167,A00,088445,Walker; Caren Michelle,0,0,30,30
1653298072107,PSYC 168,A00,088446,Chapman; Eddie Nathaniel,222,0,250,28
1653298072634,PSYC 171,A00,088447,Mukku; Dhananjaya,66,0,75,9
1653298073170,PSYC 178,A00,088448,Glaser; Dale,105,0,120,15
1653298073693,PSYC 179,A00,088449,Lacefield; Katharine I,193,0,250,57
1653298074219,PSYC 181,A00,088450,Anagnostaras; Stephan,284,0,300,16
1653298074745,PSYC 189,A00,088451,Gentner; Tim,19,0,31,12
1653298075272,PSYC 193,A00,088452,Gremel; Christina M,19,0,20,1
1653298075272,PSYC 193,B00,088453,Staff,19,0,20,1
1653298075798,PSYC 193L,A01,088455,Staff,33,0,35,2
1653298076332,PSYC 194A,A01,088461,Heyman; Gail D.,35,0,35,0
1653298076862,RELI 1,A01,086478,Kalleres; Dayna,20,0,20,0
1653298076862,RELI 1,A02,086479,Kalleres; Dayna,19,0,20,1
1653298077387,RELI 147,A00,088409,Caciola; Nancy A,0,0,0,0
1653298077914,REV 1,A01,092308,Leigh; Brian,24,0,24,0
1653298077914,REV 1,A02,092310,Leigh; Brian,24,0,24,0
1653298077914,REV 1,A03,092312,Leigh; Brian,24,0,24,0
1653298077914,REV 1,A04,092314,Leigh; Brian,24,0,24,0
1653298077914,REV 1,A05,092316,Leigh; Brian,24,0,24,0
1653298078437,REV 2,A01,092318,Staff,28,0,28,0
1653298078437,REV 2,A02,092319,Staff,28,0,28,0
1653298078961,REV 20,A00,092320,Staff,40,0,40,0
1653298079486,REV 87,A00,092321,Lyon; Antony J.,20,0,20,0
1653298080011,SE 1,A01,088674,Van Den Einde; Yael Dahlia,48,0,48,0
1653298080011,SE 1,A02,088675,Van Den Einde; Yael Dahlia,47,0,48,1
1653298080011,SE 1,A03,088676,Van Den Einde; Yael Dahlia,46,0,48,2
1653298080547,SE 101A,A00,088677,Morrison; Machel Leigh,191,0,200,9
1653298081149,SE 101C,A00,088678,Zhu; Qiang,137,0,145,8
1653298081681,SE 125,A00,088679,Conte; Joel P,143,0,145,2
1653298082206,SE 130A,A00,088680,Loh; Kenneth J. H.,110,0,115,5
1653298082729,SE 131B,A00,088681,Krysl; Petr,84,0,115,31
1653298083253,SE 142,A01,088683,Staff,11,0,18,7
1653298083253,SE 142,A02,088684,Staff,13,0,18,5
1653298083776,SE 164,A01,088686,Loh; Kenneth J. H.,14,0,16,2
1653298084304,SE 180,A00,088687,Elgamal; Ahmed,66,0,75,9
1653298084829,SE 181,A01,088689,McCartney; John Scott,25,0,30,5
1653298084829,SE 181,A02,088690,McCartney; John Scott,14,0,30,16
1653298084829,SE 181,A03,088691,McCartney; John Scott,25,0,25,0
1653298084829,SE 181,A04,088692,McCartney; John Scott,25,0,25,0
1653298085353,SIO 12,A00,088342,Staff,141,0,146,5
1653298085882,SIO 15,A00,088343,Laske; Gabi,333,0,340,7
1653298086404,SIO 30,A01,092382,Castillo; Paterno R.,28,0,35,7
1653298086404,SIO 30,A02,092383,Castillo; Paterno R.,32,0,35,3
1653298086404,SIO 30,A03,092384,Castillo; Paterno R.,35,0,35,0
1653298086404,SIO 30,A04,092385,Castillo; Paterno R.,35,0,35,0
1653298086933,SIO 40,A00,088345,Barbeau; Katherine,144,0,146,2
1653298087464,SIO 50,A01,088347,Cook; Geoffrey W,11,0,14,3
1653298087464,SIO 50,A02,088348,Cook; Geoffrey W,11,0,14,3
1653298087994,SIO 87,A00,088350,Cook; Geoffrey W,20,0,20,0
1653298087994,SIO 87,B00,088351,Cook; Geoffrey W,20,0,20,0
1653298087994,SIO 87,C00,094017,Gilbert; Jack Anthony,20,0,20,0
1653298087994,SIO 87,D00,094018,Gerwick; William Henry,20,0,20,0
1653298088528,SIO 90,A00,088352,Staff,56,0,60,4
1653298089058,SIO 100,A00,088354,Norris; Richard D. & Gee; Jeffrey S,10,0,20,10
1653298089582,SIO 101,A01,088356,Aluwihare; Lihini & Decima; Moira R.,1,0,30,29
1653298089582,SIO 101,A02,088357,Aluwihare; Lihini & Decima; Moira R.,15,0,30,15
1653298090107,SIO 103,A01,088359,Parnell-Turner; Ross Ernes,21,0,25,4
1653298090636,SIO 105,A00,088360,Driscoll; Neal W.,18,0,20,2
1653298091160,SIO 108,A01,088363,Teranes; Jane,15,0,20,5
1653298091683,SIO 109R,A00,088364,Forman; Fonna,27,0,40,13
1653298092205,SIO 110,A01,088366,Staff,8,0,29,21
1653298092735,SIO 117,A01,088368,Keeling; Ralph F.,31,0,36,5
1653298093263,SIO 123,A00,088369,Allen; Andrew Ellis,61,0,70,9
1653298093790,SIO 132,A01,092386,Hechinger; Ryan F. & Kacev; David,17,0,28,11
1653298093790,SIO 132,A02,092387,Hechinger; Ryan F. & Kacev; David,26,0,28,2
1653298093790,SIO 132,A03,092388,Hechinger; Ryan F. & Kacev; David,28,0,28,0
1653298093790,SIO 132,A04,092389,Hechinger; Ryan F. & Kacev; David,23,0,28,5
1653298093790,SIO 132,A05,092390,Hechinger; Ryan F. & Kacev; David,27,0,28,1
1653298093790,SIO 132,A06,092391,Hechinger; Ryan F. & Kacev; David,27,0,28,1
1653298094321,SIO 136,A01,088373,Kacev; David & Bowman; Jeff Shovlowsky,0,0,5,7
1653298094321,SIO 136,B01,088376,Kacev; David & Bowman; Jeff Shovlowsky,0,0,5,5
1653298094849,SIO 155,A01,088379,Day; James M.D.,1,0,5,4
1653298095373,SIO 170,A00,088380,Cook; Geoffrey W,29,0,30,1
1653298095896,SIO 171,A01,088382,Rudnick; Daniel Lars,37,0,40,3
1653298096422,SIO 175,A01,088384,Merrifield; Mark A,22,0,25,3
1653298096948,SIO 177,A00,088385,Becker; Janet Maria,15,0,20,5
1653298097475,SIO 179,A01,088387,Martz; Todd R.,7,0,15,8
1653298098528,SIO 189,A00,088390,Hamdoun; Amr,35,0,60,25
1653298099054,SIO 194,A00,091602,Hill; Seth J,9999,0,9999,0
1653298099577,SOCE 194,A00,091601,Hill; Seth J,9999,0,9999,0
1653298100102,SOCI 1,A01,093704,Skrentny; John David,19,0,20,1
1653298100102,SOCI 1,A02,093705,Skrentny; John David,20,0,20,0
1653298100102,SOCI 1,A03,093706,Skrentny; John David,18,0,20,2
1653298100102,SOCI 1,A04,093707,Skrentny; John David,19,0,20,1
1653298100102,SOCI 1,A05,093708,Skrentny; John David,17,0,20,3
1653298100102,SOCI 1,A06,093709,Skrentny; John David,20,0,20,0
1653298100102,SOCI 1,A07,093710,Skrentny; John David,20,0,20,0
1653298100102,SOCI 1,A08,093711,Skrentny; John David,20,0,20,0
1653298100102,SOCI 1,A09,093712,Skrentny; John David,20,0,20,0
1653298100102,SOCI 1,A10,093713,Skrentny; John David,20,0,20,0
1653298100102,SOCI 1,A11,093714,Skrentny; John David,20,0,20,0
1653298100632,SOCI 30,A01,093716,Staff,30,0,30,0
1653298100632,SOCI 30,A02,093717,Staff,30,0,30,0
1653298101161,SOCI 60,A01,093719,Staff,17,0,20,3
1653298101161,SOCI 60,A02,093720,Staff,18,0,20,2
1653298101161,SOCI 60,A03,093721,Staff,20,0,20,0
1653298101161,SOCI 60,A04,093722,Staff,20,0,20,0
1653298101688,SOCI 87,A00,093819,Blair-Loy; Mary,20,0,20,0
1653298102212,SOCI 100,A01,093724,Estefan; Michel,15,0,20,5
1653298102212,SOCI 100,A02,093725,Estefan; Michel,5,0,20,15
1653298102738,SOCI 104,A00,093728,Gong; Neil M,22,0,25,3
1653298103266,SOCI 104Q,A00,093729,Staff,23,0,25,2
1653298103790,SOCI 106,A00,093730,Staff,25,0,25,0
1653298104317,SOCI 109,A00,093731,Staff,21,0,25,4
1653298104841,SOCI 110,A00,093732,Binder; Amy,24,0,25,1
1653298106415,SOCI 117,A01,091568,Chung; Luz Marina,29,0,35,6
1653298106415,SOCI 117,A02,091569,Chung; Luz Marina,35,0,35,0
1653298106940,SOCI 118,A00,093735,Staff,0,0,0,0
1653298107468,SOCI 120T,A00,093736,Lampland; Martha,50,0,50,0
1653298107468,SOCI 120T,B00,094832,Staff,69,0,70,1
1653298107998,SOCI 122,A00,093737,Lewis; Kevin Michael,62,0,70,8
1653298108524,SOCI 123,A00,094831,Staff,57,0,65,8
1653298109051,SOCI 125,A00,093738,Staff,115,0,120,5
1653298109576,SOCI 127,A00,094894,Staff,54,0,56,2
1653298110100,SOCI 132,A00,093739,Blair-Loy; Mary,51,0,60,9
1653298111153,SOCI 136F,A00,094830,Staff,45,0,56,11
1653298111677,SOCI 138,A00,093741,Navon; Daniel,117,0,120,3
1653298112201,SOCI 140A,A00,093743,Gong; Neil M,53,0,60,7
1653298112726,SOCI 141,A00,093744,Summers; Valerie R.,111,0,120,9
1653298113775,SOCI 144,A00,093746,Staff,0,0,0,0
1653298115884,SOCI 159,A00,094902,Staff,49,0,50,1
1653298116408,SOCI 160,A00,093750,Staff,0,0,0,0
1653298116932,SOCI 165,A00,093751,Rona-Tas; Akos,43,0,48,5
1653298117459,SOCI 165A,A00,094206,Hallin; Daniel C,3,0,4,1
1653298117982,SOCI 166,A00,093752,Lampland; Martha,52,0,56,4
1653298118511,SOCI 176,A00,093753,Turner; Christena L.,44,0,48,4
1653298119034,SOCI 180,A00,094901,Staff,56,0,56,0
1653298119561,SOCI 185,A00,094903,Staff,55,0,56,1
1653298120090,SOCI 196A,A00,093754,Shafir; Gershon,20,0,20,0
1653298120614,SXTH 1,A01,092351,Bronstein; Phoebe Malan,18,0,18,0
1653298120614,SXTH 1,A02,092352,Bronstein; Phoebe Malan,18,0,18,0
1653298120614,SXTH 1,A03,092353,Bronstein; Phoebe Malan,18,0,18,0
1653298121138,SXTH 20A,A00,092355,Chilukuri; Lakshmi N,56,0,56,0
1653298121675,SYN 2,001,091487,Gladstein; Jill M,13,0,15,2
1653298121675,SYN 2,002,091488,Gladstein; Jill M,14,0,15,1
1653298121675,SYN 2,003,091490,Gladstein; Jill M,12,0,15,3
1653298121675,SYN 2,004,091491,Gladstein; Jill M,15,0,15,0
1653298121675,SYN 2,005,091493,Gladstein; Jill M,15,0,15,0
1653298121675,SYN 2,006,091495,Gladstein; Jill M,15,0,15,0
1653298121675,SYN 2,007,091496,Gladstein; Jill M,15,0,15,0
1653298121675,SYN 2,008,091497,Gladstein; Jill M,14,0,15,1
1653298121675,SYN 2,009,091499,Gladstein; Jill M,13,0,15,2
1653298121675,SYN 2,010,091501,Gladstein; Jill M,13,0,15,2
1653298121675,SYN 2,011,091502,Gladstein; Jill M,13,0,15,2
1653298121675,SYN 2,012,091503,Gladstein; Jill M,15,0,15,0
1653298121675,SYN 2,013,091505,Gladstein; Jill M,13,0,15,2
1653298121675,SYN 2,014,091506,Gladstein; Jill M,12,0,15,3
1653298121675,SYN 2,015,091508,Gladstein; Jill M,14,0,15,1
1653298121675,SYN 2,016,091509,Gladstein; Jill M,12,0,15,3
1653298121675,SYN 2,017,091510,Gladstein; Jill M,14,0,15,1
1653298121675,SYN 2,018,091512,Gladstein; Jill M,15,0,15,0
1653298121675,SYN 2,019,091513,Gladstein; Jill M,15,0,15,0
1653298121675,SYN 2,020,091514,Gladstein; Jill M,15,0,15,0
1653298121675,SYN 2,021,091516,Gladstein; Jill M,12,0,15,3
1653298121675,SYN 2,022,091517,Gladstein; Jill M,13,0,15,2
1653298121675,SYN 2,023,091518,Gladstein; Jill M,15,0,15,0
1653298121675,SYN 2,024,091519,Gladstein; Jill M,15,0,15,0
1653298121675,SYN 2,025,091520,Gladstein; Jill M,11,0,15,4
1653298121675,SYN 2,026,091521,Gladstein; Jill M,15,0,15,0
1653298121675,SYN 2,027,091522,Gladstein; Jill M,0,0,0,0
1653298121675,SYN 2,028,091523,Gladstein; Jill M,0,0,0,0
1653298121675,SYN 2,029,091524,Gladstein; Jill M,0,0,0,0
1653298121675,SYN 2,030,091525,Gladstein; Jill M,0,0,0,0
1653298121675,SYN 2,031,091526,Gladstein; Jill M,14,0,15,1
1653298121675,SYN 2,032,091527,Gladstein; Jill M,15,0,15,0
1653298121675,SYN 2,033,091528,Gladstein; Jill M,0,0,0,0
1653298121675,SYN 2,034,091529,Gladstein; Jill M,15,0,15,0
1653298121675,SYN 2,035,091530,Gladstein; Jill M,15,0,15,0
1653298121675,SYN 2,036,091531,Gladstein; Jill M,15,0,15,0
1653298121675,SYN 2,037,091532,Gladstein; Jill M,15,0,15,0
1653298121675,SYN 2,038,091533,Gladstein; Jill M,15,0,15,0
1653298121675,SYN 2,039,091534,Gladstein; Jill M,15,0,15,0
1653298121675,SYN 2,040,091535,Gladstein; Jill M,15,0,15,0
1653298122198,SYN 100,A01,091537,Gladstein; Jill M,26,0,30,4
1653298122198,SYN 100,B01,091539,Gladstein; Jill M,26,0,30,4
1653298122198,SYN 100,C01,091541,Gladstein; Jill M,26,0,30,4
1653298122198,SYN 100,D01,091543,Gladstein; Jill M,25,0,30,5
1653298122198,SYN 100,E01,091545,Gladstein; Jill M,28,0,30,2
1653298122728,TDAC 1,A00,088922,Walsh; Kim C.,10,0,10,0
1653298122728,TDAC 1,B00,088923,Walsh; Kim C.,8,0,10,2
1653298122728,TDAC 1,C00,088924,Walsh; Kim C.,0,0,10,10
1653298122728,TDAC 1,D00,088925,Walsh; Kim C.,7,0,10,3
1653298122728,TDAC 1,E00,088926,Walsh; Kim C.,2,0,10,8
1653298122728,TDAC 1,F00,088927,Walsh; Kim C.,9,0,10,1
1653298123272,TDAC 101,A00,088972,Harting; Carla Kelso,9,0,10,1
1653298123272,TDAC 101,B00,088973,Salovey; Todd,8,0,10,2
1653298123272,TDAC 101,C00,088974,Walsh; Kim C.,6,0,10,4
1653298123796,TDAC 102,A00,088975,Basso; Beatrice,9,0,10,1
1653298123796,TDAC 102,B00,088976,Basso; Beatrice,7,0,10,3
1653298124320,TDAC 103A,A00,094044,Castro; Robert Jess,32,0,35,3
1653298124848,TDAC 108,A00,088977,Staff,20,0,20,0
1653298125374,TDAC 109,A00,088978,Blair; Kyle Adam,20,0,20,0
1653298125897,TDAC 115,A00,088979,Newcomb; James,20,0,20,0
1653298126421,TDAC 122,A00,088981,Staff,30,0,30,0
1653298126948,TDAC 123,A00,088982,Staff,30,0,30,0
1653298127484,TDDE 1,A01,088929,Benzoni; Elisa,9,0,11,2
1653298127484,TDDE 1,A02,088930,Benzoni; Elisa,11,0,11,0
1653298127484,TDDE 1,A03,088931,Benzoni; Elisa,11,0,11,0
1653298127484,TDDE 1,A04,088932,Benzoni; Elisa,10,0,11,1
1653298127484,TDDE 1,A05,088933,Benzoni; Elisa,11,0,11,0
1653298128012,TDDE 130,A00,088983,Staff,20,0,20,0
1653298128540,TDDE 132,A00,094263,Staff,20,0,20,0
1653298129073,TDDE 169A,A00,094046,Petrovich; Victoria A.,18,0,20,2
1653298129602,TDDM 1,A00,088934,Snaith; Yolande,6,0,10,4
1653298130130,TDDM 5,A00,088935,Smith; Alison D,30,0,30,0
1653298130654,TDDR 101,A00,088986,Powell; Lora,34,0,35,1
1653298131178,TDDR 111,A00,088987,Stalling; Vanessa,24,0,30,6
1653298131178,TDDR 111,B00,094045,Castro; Robert Jess,14,0,16,2
1653298131705,TDDR 190,A00,088988,Stalling; Vanessa,10,0,10,0
1653298132234,TDGE 1,A01,088937,Salovey; Todd,12,0,12,0
1653298132234,TDGE 1,A02,088938,Salovey; Todd,10,0,12,2
1653298132234,TDGE 1,A03,088939,Salovey; Todd,8,0,12,4
1653298132234,TDGE 1,A04,088940,Salovey; Todd,12,0,12,0
1653298132234,TDGE 1,A05,088941,Salovey; Todd,11,0,12,1
1653298132234,TDGE 1,A06,088942,Salovey; Todd,12,0,12,0
1653298132761,TDGE 10,A00,088943,Havis; Allan,191,0,200,9
1653298133287,TDGE 11,A00,088944,Staff,200,0,200,0
1653298133818,TDGE 25,A00,088945,Harting; Carla Kelso,19,0,20,1
1653298133818,TDGE 25,B00,088946,Harting; Carla Kelso,19,0,20,1
1653298133818,TDGE 25,C00,088947,Harting; Carla Kelso,20,0,20,0
1653298133818,TDGE 25,D00,088948,Harting; Carla Kelso,19,0,20,1
1653298133818,TDGE 25,E00,088949,Harting; Carla Kelso,20,0,20,0
1653298133818,TDGE 25,F00,088950,Harting; Carla Kelso,19,0,20,1
1653298133818,TDGE 25,G00,088951,Harting; Carla Kelso,19,0,20,1
1653298134425,TDGE 127,A00,088990,Havis; Allan,188,0,200,12
1653298134955,TDHD 21,A00,088952,Jun; Grace Shin Hae,20,0,20,0
1653298135483,TDHT 10,A00,088953,Power; Jade Yukana,14,0,14,0
1653298135483,TDHT 10,B00,088954,Power; Jade Yukana,13,0,14,1
1653298136007,TDHT 21,A01,088956,Power; Jade Yukana,17,0,18,1
1653298136007,TDHT 21,A02,088957,Power; Jade Yukana,7,0,11,4
1653298136007,TDHT 21,A03,088958,Power; Jade Yukana,11,0,11,0
1653298136537,TDHT 101,A00,088994,Burelle; Julie Sara Veronique,21,0,25,4
1653298137067,TDHT 114,A00,094208,Williams; Madison Mae,47,0,50,3
1653298137593,TDHT 119,A00,094299,Burelle; Julie Sara Veronique,25,0,25,0
1653298138118,TDMV 1,A00,088959,Weinberg; Sadie,23,0,30,7
1653298138643,TDMV 2,A00,088960,Sammartano; Tonnie,27,0,30,3
1653298138643,TDMV 2,B00,094043,Duran; Marcos Antonio,29,0,30,1
1653298139167,TDMV 3,A00,088961,Arcidiacono; Kristin,27,0,30,3
1653298139693,TDMV 110,A00,088995,Wilson; Terry A.,0,0,0,0
1653298140217,TDMV 120,A00,088996,Smith; Alison D,17,0,20,3
1653298140747,TDMV 122,A00,088997,Chaleff; Rebecca,28,0,30,2
1653298141271,TDMV 130,A00,094042,Rincon; Alicia,30,0,30,0
1653298141796,TDMV 138,A00,088998,Jun; Grace Shin Hae,12,0,40,28
1653298142320,TDMV 142,A00,088999,Caligagan; Tony,28,0,40,12
1653298142858,TDMV 143,A00,094041,Foster-King; Sandra,37,0,40,3
1653298143385,TDMV 146,A00,089000,Caligagan; Tony,39,0,40,1
1653298143914,TDPF 160,A00,094264,Snaith; Yolande,30,0,30,0
1653298143914,TDPF 160,B00,094265,Smith; Alison D,30,0,30,0
1653298143914,TDPF 160,C00,094266,Weinberg; Sadie,30,0,30,0
1653298144437,TDPR 6,A01,088963,Benzoni; Elisa,25,0,25,0
1653298144437,TDPR 6,A02,088964,Benzoni; Elisa,25,0,25,0
1653298144966,TDPR 102,A00,089003,Staff,15,0,15,0
1653298145490,TDPR 104,A00,089004,Powell; Lora,15,0,15,0
1653298146014,TDPW 1,A00,088965,Staff,10,0,10,0
1653298146014,TDPW 1,B00,088966,Staff,10,0,10,0
1653298146014,TDPW 1,C00,088967,Staff,9,0,10,1
1653298146014,TDPW 1,D00,088968,Staff,9,0,10,1
1653298146014,TDPW 1,E00,088969,Staff,10,0,10,0
1653298146014,TDPW 1,F00,088970,Staff,9,0,10,1
1653298146537,TDTR 10,A00,088971,Wilson; Terry A.,22,0,25,3
1653298147062,TMC 2,A01,092358,Carver; Leslie J.,20,0,20,0
1653298147062,TMC 2,A02,092359,Carver; Leslie J.,20,0,20,0
1653298147062,TMC 2,A03,092360,Carver; Leslie J.,20,0,20,0
1653298147062,TMC 2,A04,092361,Carver; Leslie J.,20,0,20,0
1653298147062,TMC 2,A05,092362,Carver; Leslie J.,20,0,20,0
1653298147062,TMC 2,A06,092363,Carver; Leslie J.,20,0,20,0
1653298147592,TMC 15,A00,092364,Atkinson; Arthur Laird,20,0,20,0
1653298148115,TMC 20,A00,092365,Carver; Leslie J.,20,0,20,0
1653298148640,TMC 90,A00,092366,Mell; Loren K.,20,0,20,0
1653298149163,TMC 120,A01,092368,Staff,20,0,20,0
1653298149687,USP 1,A01,087520,Kwak; Nancy,19,0,20,1
1653298149687,USP 1,A02,087521,Kwak; Nancy,17,0,20,3
1653298149687,USP 1,A03,087522,Kwak; Nancy,16,0,20,4
1653298149687,USP 1,A04,087523,Kwak; Nancy,19,0,20,1
1653298150212,USP 2,A01,087525,Lerner; Amy M,29,0,30,1
1653298150212,USP 2,A02,087526,Lerner; Amy M,29,0,30,1
1653298150737,USP 4,A00,094267,Polat; Soydan Alihan,16,0,20,4
1653298150737,USP 4,B00,094268,Staff,20,0,20,0
1653298151260,USP 5,A01,087532,Staff,26,0,30,4
1653298151260,USP 5,A02,087533,Staff,27,0,30,3
1653298151788,USP 6,A01,094322,Shvartzberg Carrio; Manuel,20,0,20,0
1653298151788,USP 6,A02,094323,Shvartzberg Carrio; Manuel,20,0,20,0
1653298152313,USP 15,A01,087535,Anderson; William Raymond,20,0,25,5
1653298152313,USP 15,A02,087536,Anderson; William Raymond,23,0,25,2
1653298152840,USP 25,A00,087537,Staff,0,0,7,7
1653298153364,USP 50,A00,087538,Martin; Isaac,38,0,40,2
1653298153894,USP 124,A00,087539,Bussell; Mirle Rabinowitz,26,0,35,9
1653298154421,USP 125,A00,087540,Staff,17,0,23,6
1653298154944,USP 136,A00,087541,Staff,23,0,25,2
1653298155466,USP 144,A00,087542,Staff,136,0,146,10
1653298155992,USP 151,A00,087543,Boomhower; Matthew Charles,18,0,20,2
1653298156521,USP 152,A01,087545,Moeder; Nathan L,17,0,20,3
1653298156521,USP 152,A02,087546,Moeder; Nathan L,20,0,20,0
1653298157050,USP 153,A00,087547,Moden; Kelly Kjestine,27,0,30,3
1653298157575,USP 161,A00,094854,Wartell; Julie Dara,25,0,25,0
1653298158103,USP 169,A00,087548,Bajaj; Ravi Siddharth,30,0,35,5
1653298158627,USP 170,A00,087549,Hinds; Juli Beth,30,0,35,5
1653298159151,USP 171,A00,087550,Lerner; Amy M,38,0,50,12
1653298159675,USP 176,A00,094853,Staff,24,0,25,1
1653298160202,USP 177A,A00,087551,Peerson; Susan,20,0,22,2
1653298160730,USP 184,A00,094324,Shvartzberg Carrio; Manuel,24,0,25,1
1653298161259,USP 185A,A01,087553,Norr; Alex Vaughn,28,0,30,2
1653298161259,USP 185A,B01,087555,Boomhower; Matthew Charles,26,0,30,4
1653298161788,USP 186,A01,087557,Pezzoli; Keith,22,0,25,3
1653298161788,USP 186,A02,087558,Pezzoli; Keith,20,0,25,5
1653298162840,USP 191A,A00,087561,Rothberg; Scott Jacob,18,0,20,2
1653298163363,USP 194,A00,091599,Hill; Seth J,9999,0,9999,0
1653298163894,VIS 1,A01,088809,Tonies; Joshua Vanjaymes,10,0,10,0
1653298163894,VIS 1,A02,088810,Tonies; Joshua Vanjaymes,10,0,10,0
1653298163894,VIS 1,A03,088811,Tonies; Joshua Vanjaymes,3,0,10,7
1653298163894,VIS 1,A04,088812,Tonies; Joshua Vanjaymes,8,0,10,2
1653298163894,VIS 1,A05,088813,Tonies; Joshua Vanjaymes,4,0,10,6
1653298163894,VIS 1,A06,088814,Tonies; Joshua Vanjaymes,6,0,10,4
1653298163894,VIS 1,A07,088815,Tonies; Joshua Vanjaymes,6,0,10,4
1653298163894,VIS 1,A08,088816,Tonies; Joshua Vanjaymes,9,0,10,1
1653298163894,VIS 1,A09,088817,Tonies; Joshua Vanjaymes,8,0,10,2
1653298163894,VIS 1,A10,088818,Tonies; Joshua Vanjaymes,8,0,10,2
1653298163894,VIS 1,A11,088819,Tonies; Joshua Vanjaymes,3,0,10,7
1653298163894,VIS 1,A12,088820,Tonies; Joshua Vanjaymes,6,0,10,4
1653298163894,VIS 1,A13,088821,Tonies; Joshua Vanjaymes,6,0,10,4
1653298163894,VIS 1,A14,088822,Tonies; Joshua Vanjaymes,7,0,10,3
1653298163894,VIS 1,A15,088823,Tonies; Joshua Vanjaymes,7,0,10,3
1653298163894,VIS 1,A16,088824,Tonies; Joshua Vanjaymes,8,0,10,2
1653298164427,VIS 20,A01,088826,Woods; Ann,19,0,20,1
1653298164427,VIS 20,A02,088827,Woods; Ann,20,0,20,0
1653298164427,VIS 20,A03,088828,Woods; Ann,18,0,20,2
1653298164427,VIS 20,A04,088829,Woods; Ann,17,0,20,3
1653298164427,VIS 20,A05,088830,Woods; Ann,20,0,20,0
1653298164427,VIS 20,A06,088831,Woods; Ann,20,0,20,0
1653298164427,VIS 20,A07,088832,Woods; Ann,20,0,20,0
1653298164427,VIS 20,A08,088833,Woods; Ann,20,0,20,0
1653298164427,VIS 20,A09,088834,Woods; Ann,18,0,20,2
1653298164427,VIS 20,A10,088835,Woods; Ann,19,0,20,1
1653298164427,VIS 20,A11,088836,Woods; Ann,20,0,20,0
1653298164427,VIS 20,A12,088837,Woods; Ann,20,0,20,0
1653298164951,VIS 23,A00,088838,Rose; Jordan M,3,0,3,0
1653298165482,VIS 30,A01,088840,Stone; Patricia,11,0,11,0
1653298165482,VIS 30,A02,088841,Stone; Patricia,7,0,11,4
1653298165482,VIS 30,A03,094821,Stone; Patricia,8,0,11,3
1653298165482,VIS 30,A04,094822,Stone; Patricia,11,0,11,0
1653298166007,VIS 41,A01,088844,D'Elena-Tweed; Jessica Erin,9,0,10,1
1653298166007,VIS 41,A02,088845,D'Elena-Tweed; Jessica Erin,9,0,10,1
1653298166007,VIS 41,A03,088846,D'Elena-Tweed; Jessica Erin,9,0,10,1
1653298166007,VIS 41,A04,088847,D'Elena-Tweed; Jessica Erin,9,0,10,1
1653298166007,VIS 41,A05,088848,D'Elena-Tweed; Jessica Erin,10,0,10,0
1653298166007,VIS 41,A06,088849,D'Elena-Tweed; Jessica Erin,10,0,10,0
1653298166007,VIS 41,A07,088850,D'Elena-Tweed; Jessica Erin,10,0,10,0
1653298166007,VIS 41,A08,088851,D'Elena-Tweed; Jessica Erin,10,0,10,0
1653298166533,VIS 60,A01,088853,Sepuya; Paul Mpagi,9,0,10,1
1653298166533,VIS 60,A02,088854,Sepuya; Paul Mpagi,10,0,10,0
1653298166533,VIS 60,A03,088855,Sepuya; Paul Mpagi,10,0,10,0
1653298166533,VIS 60,A04,088856,Sepuya; Paul Mpagi,10,0,10,0
1653298166533,VIS 60,A05,088857,Sepuya; Paul Mpagi,10,0,10,0
1653298166533,VIS 60,A06,088858,Sepuya; Paul Mpagi,10,0,10,0
1653298166533,VIS 60,A07,088859,Sepuya; Paul Mpagi,9,0,10,1
1653298166533,VIS 60,A08,093932,Sepuya; Paul Mpagi,10,0,10,0
1653298167057,VIS 70N,A01,088861,Segade; Alexandro Abraham,8,0,8,0
1653298167057,VIS 70N,A02,088862,Segade; Alexandro Abraham,8,0,8,0
1653298167057,VIS 70N,A03,088863,Segade; Alexandro Abraham,8,0,8,0
1653298167057,VIS 70N,A04,088864,Segade; Alexandro Abraham,8,0,8,0
1653298167057,VIS 70N,A05,088865,Segade; Alexandro Abraham,7,0,8,1
1653298167057,VIS 70N,A06,088866,Segade; Alexandro Abraham,8,0,8,0
1653298167586,VIS 80,A01,088868,Adler; Amy,9,0,10,1
1653298167586,VIS 80,A02,088869,Adler; Amy,8,0,10,2
1653298167586,VIS 80,A03,088870,Adler; Amy,9,0,10,1
1653298167586,VIS 80,A04,088871,Adler; Amy,8,0,10,2
1653298167586,VIS 80,A05,088872,Adler; Amy,10,0,10,0
1653298167586,VIS 80,A06,088873,Adler; Amy,7,0,10,3
1653298168112,VIS 100,A00,088874,Cruz; Edwin Teddy,65,0,75,10
1653298168636,VIS 105A,A00,088875,Tonies; Joshua Vanjaymes,26,0,30,4
1653298169161,VIS 105B,A00,088876,Staff,25,0,30,5
1653298169691,VIS 106A,A00,088877,Tobe; Geoffroy,21,0,25,4
1653298170217,VIS 106B,A00,088878,Staff,21,0,25,4
1653298170744,VIS 106C,A00,088879,Staff,9,0,15,6
1653298171272,VIS 107B,A00,088880,Gallaccio; Anya,24,0,25,1
1653298171796,VIS 108,A00,093894,Gallaccio; Anya,5,0,15,10
1653298172321,VIS 110A,A00,093895,Dean; Danielle Adobi,15,0,15,0
1653298172844,VIS 110B,A00,088881,Adler; Amy,14,0,15,1
1653298173369,VIS 125E,A00,093896,Welchman; John C.,75,0,75,0
1653298173899,VIS 126HN,A00,088882,Newsome; Elizabeth Ann,74,0,75,1
1653298174428,VIS 126P,A00,088883,Wardwell; Mariana Razo,72,0,75,3
1653298174951,VIS 128E,A00,088884,Staff,68,0,75,7
1653298175481,VIS 132,A00,088885,Miller; Nicole L,15,0,15,0
1653298176006,VIS 133,A01,094348,D'Elena-Tweed; Jessica Erin,34,0,34,0
1653298176006,VIS 133,A02,094492,D'Elena-Tweed; Jessica Erin,33,0,34,1
1653298176531,VIS 142,A01,088887,Stalbaum; Brett,14,0,15,1
1653298176531,VIS 142,A02,088888,Stalbaum; Brett,10,0,15,5
1653298176531,VIS 142,A03,088889,Stalbaum; Brett,15,0,15,0
1653298176531,VIS 142,A04,088890,Stalbaum; Brett,8,0,15,7
1653298176531,VIS 142,A05,088891,Stalbaum; Brett,14,0,15,1
1653298176531,VIS 142,A06,094828,Stalbaum; Brett,15,0,15,0
1653298177054,VIS 143,A00,088892,Akten; Mehmet,11,0,22,11
1653298177577,VIS 147A,A01,088894,Stalbaum; Brett,20,0,22,2
1653298177577,VIS 147A,A02,088895,Stalbaum; Brett,17,0,22,5
1653298178106,VIS 149,A00,088896,Akten; Mehmet,11,0,15,4
1653298178634,VIS 150,A00,093893,Tufenkian; Armand Yervant,24,0,30,6
1653298179158,VIS 151A,A00,088897,Williams; Alena J,13,0,15,2
1653298179682,VIS 163,A00,088901,Bratton; Benjamin H.,75,0,75,0
1653298180207,VIS 164,A00,088902,Nakayama; Yue,22,0,22,0
1653298180735,VIS 165A,A00,093892,Cross; Brian R,19,0,22,3
1653298181264,VIS 167,A00,088903,Ortiz-Torres; Ruben,19,0,22,3
1653298181788,VIS 174,A00,088905,Staff,21,0,22,1
1653298181788,VIS 174,B00,088906,Kauffmann; Casey,22,0,22,0
1653298182312,VIS 175,A00,093891,Staff,18,0,22,4
1653298182835,VIS 177,A00,088907,Segade; Alexandro Abraham,20,0,22,2
1653298183358,VIS 178,A00,093890,Staff,17,0,22,5
1653298183883,VIS 179,A00,093889,Kauffmann; Casey,21,0,22,1
1653298184409,VIS 180A,A00,093888,Nakayama; Yue,16,0,22,6
1653298184934,VIS 180B,A00,088908,Miller; Nicole L,21,0,22,1
1653298185457,VIS 183A,A00,088909,Sepuya; Paul Mpagi,20,0,22,2
1653298186005,WCWP 10A,001,086588,Gagnon; Jeffrey C,15,0,15,0
1653298186005,WCWP 10A,002,086589,Gagnon; Jeffrey C,14,0,15,1
1653298186005,WCWP 10A,003,086590,Gagnon; Jeffrey C,15,0,15,0
1653298186005,WCWP 10A,004,086591,Gagnon; Jeffrey C,15,0,15,0
1653298186005,WCWP 10A,005,086592,Gagnon; Jeffrey C,15,0,15,0
1653298186005,WCWP 10A,006,086593,Gagnon; Jeffrey C,15,0,15,0
1653298186005,WCWP 10A,007,086594,Gagnon; Jeffrey C,15,0,15,0
1653298186005,WCWP 10A,008,086595,Gagnon; Jeffrey C,15,0,15,0
1653298186005,WCWP 10A,009,086596,Gagnon; Jeffrey C,15,0,15,0
1653298186005,WCWP 10A,010,086597,Gagnon; Jeffrey C,15,0,15,0
1653298186005,WCWP 10A,011,086598,Gagnon; Jeffrey C,20,0,20,0
1653298186005,WCWP 10A,012,086599,Gagnon; Jeffrey C,20,0,20,0
1653298186005,WCWP 10A,013,086600,Gagnon; Jeffrey C,20,0,20,0
1653298186005,WCWP 10A,014,086601,Gagnon; Jeffrey C,20,0,20,0
1653298186005,WCWP 10A,015,086602,Gagnon; Jeffrey C,20,0,20,0
1653298186005,WCWP 10A,016,086603,Gagnon; Jeffrey C,20,0,20,0
1653298186005,WCWP 10A,017,086604,Gagnon; Jeffrey C,20,0,20,0
1653298186005,WCWP 10A,018,086605,Gagnon; Jeffrey C,19,0,20,1
1653298186005,WCWP 10A,019,086606,Gagnon; Jeffrey C,19,0,20,1
1653298186005,WCWP 10A,020,086607,Gagnon; Jeffrey C,20,0,20,0
1653298186005,WCWP 10A,021,086608,Gagnon; Jeffrey C,20,0,20,0
1653298186005,WCWP 10A,022,086609,Gagnon; Jeffrey C,20,0,20,0
1653298186005,WCWP 10A,023,086610,Gagnon; Jeffrey C,19,0,20,1
1653298186005,WCWP 10A,024,086611,Gagnon; Jeffrey C,20,0,20,0
1653298186005,WCWP 10A,025,086612,Gagnon; Jeffrey C,0,0,0,0
1653298186005,WCWP 10A,026,086613,Gagnon; Jeffrey C,0,0,0,0
1653298186005,WCWP 10A,027,086614,Gagnon; Jeffrey C,0,0,0,0
1653298186005,WCWP 10A,028,086615,Gagnon; Jeffrey C,0,0,0,0
1653298186005,WCWP 10A,029,086616,Gagnon; Jeffrey C,0,0,0,0
1653298186005,WCWP 10A,030,086617,Gagnon; Jeffrey C,15,0,15,0
1653298186005,WCWP 10A,031,086618,Gagnon; Jeffrey C,15,0,15,0
1653298186005,WCWP 10A,032,093687,Gagnon; Jeffrey C,15,0,15,0
1653298186005,WCWP 10A,033,093688,Gagnon; Jeffrey C,15,0,15,0
1653298186005,WCWP 10A,034,093689,Gagnon; Jeffrey C,0,0,0,0
1653298186005,WCWP 10A,035,093690,Gagnon; Jeffrey C,0,0,0,0
1653298186536,WCWP 10B,003,086621,Gagnon; Jeffrey C,0,0,0,0
1653298186536,WCWP 10B,004,086622,Gagnon; Jeffrey C,16,0,20,4
1653298186536,WCWP 10B,005,086623,Gagnon; Jeffrey C,18,0,20,2
1653298186536,WCWP 10B,006,086624,Gagnon; Jeffrey C,20,0,20,0
1653298186536,WCWP 10B,007,086625,Gagnon; Jeffrey C,0,0,0,0
1653298187065,WCWP 100,A00,086626,McCleary; Keith Long,20,0,20,0
1653298187065,WCWP 100,B00,086627,McCleary; Keith Long,20,0,20,0
1653298187065,WCWP 100,C00,086628,McCleary; Keith Long,18,0,20,2
1653298187065,WCWP 100,D00,086629,Twohig; Niall Ivan,17,0,20,3
1653298187065,WCWP 100,E00,086630,Twohig; Niall Ivan,17,0,20,3
1653298187065,WCWP 100,F00,086631,Twohig; Niall Ivan,18,0,20,2
1653298187065,WCWP 100,G00,086632,Young; Mark T,20,0,20,0
1653298187065,WCWP 100,H00,086633,Young; Mark T,20,0,20,0
1653298245495,AAS 10,A01,085689,Butler; Elizabeth Annette,28,0,34,6
1653298245495,AAS 10,A02,085690,Butler; Elizabeth Annette,34,0,34,0
1653298246019,AAS 170,A00,085691,Butler; Elizabeth Annette,30,0,32,2
1653298246547,AIP 197,001,085683,Staff,100,0,100,0
1653298246547,AIP 197,002,085684,Rao; Ramesh R,50,0,50,0
1653298247072,AIP 197DC,001,085696,Anderson; Patrick W.,27,0,27,0
1653298247597,AIP 197T,A00,085685,Anderson; Patrick W.,15,0,15,0
1653298248130,ANAR 100,A00,094326,Fortier; Jana,22,0,25,3
1653298248654,ANAR 104,A01,085846,Staff,13,0,15,2
1653298249178,ANAR 120,A00,085847,Staff,15,0,15,0
1653298249703,ANAR 143,A00,094288,Staff,31,0,32,1
1653298250226,ANBI 100,A00,085849,Marchetto; Maria Carolina,31,0,34,3
1653298250750,ANBI 112,A00,085850,Marchetto; Maria Carolina,21,0,28,7
1653298251273,ANBI 118,A00,085851,Fox; Patrick Keolu Ozer,32,0,32,0
1653298251797,ANBI 136,A00,085852,Semendeferi; Ekaterini,20,0,22,2
1653298252328,ANBI 141,A00,085854,Gagneux; Pascal,186,0,192,6
1653298252854,ANBI 145,A00,085855,Staff,30,0,32,2
1653298253381,ANBI 175,A00,085857,Staff,30,0,32,2
1653298253911,ANSC 104,A00,094290,Yeh; Rihan Wen Xin,40,0,46,6
1653298254434,ANSC 105,A00,085859,Olivas Hernandez; Olga Lid,36,0,37,1
1653298254958,ANSC 120,A00,085860,Jassal; Aftab,51,0,56,5
1653298255482,ANSC 121,A00,085861,Staff,29,0,32,3
1653298256531,ANSC 148,A00,085866,Staff,71,0,73,2
1653298257057,ANSC 169,A00,085869,Fortier; Jana,23,0,25,2
1653298257589,ANSC 175,A00,085871,Pedersen; David,28,0,32,4
1653298258113,ANTH 1,A00,085803,Varma; Saiba,146,0,146,0
1653298258646,ANTH 2,A01,085805,Staff,43,0,44,1
1653298258646,ANTH 2,A02,085806,Staff,42,0,44,2
1653298258646,ANTH 2,A03,085807,Staff,44,0,44,0
1653298258646,ANTH 2,A04,085808,Staff,44,0,44,0
1653298258646,ANTH 2,A05,085809,Staff,40,0,40,0
1653298259171,ANTH 4,A01,085811,Yeh; Rihan Wen Xin,32,0,32,0
1653298259171,ANTH 4,A02,095113,Yeh; Rihan Wen Xin,32,0,32,0
1653298259171,ANTH 4,A03,095114,Yeh; Rihan Wen Xin,32,0,32,0
1653298259171,ANTH 4,A04,095115,Yeh; Rihan Wen Xin,34,0,34,0
1653298259701,ANTH 10,A00,085814,Stewart; Alexander B,215,0,216,1
1653298260226,ANTH 21,A01,085816,Kang; Byung Chu,35,0,35,0
1653298260226,ANTH 21,A02,085817,Kang; Byung Chu,35,0,35,0
1653298260226,ANTH 21,A03,085818,Kang; Byung Chu,35,0,35,0
1653298260226,ANTH 21,A04,085819,Kang; Byung Chu,35,0,35,0
1653298260226,ANTH 21,A05,085820,Kang; Byung Chu,33,0,35,2
1653298260226,ANTH 21,A06,085821,Kang; Byung Chu,33,0,35,2
1653298260226,ANTH 21,A07,085822,Kang; Byung Chu,35,0,35,0
1653298260226,ANTH 21,A08,085823,Kang; Byung Chu,35,0,35,0
1653298260226,ANTH 21,A09,085824,Kang; Byung Chu,0,0,0,0
1653298260226,ANTH 21,A10,085825,Kang; Byung Chu,0,0,0,0
1653298260226,ANTH 21,A11,095111,Kang; Byung Chu,30,0,30,0
1653298260226,ANTH 21,A12,095112,Kang; Byung Chu,30,0,30,0
1653298260226,ANTH 21,B01,085827,Staff,36,0,36,0
1653298260226,ANTH 21,B02,085828,Staff,36,0,36,0
1653298260226,ANTH 21,B03,085829,Staff,36,0,36,0
1653298260226,ANTH 21,B04,085830,Staff,38,0,38,0
1653298260791,ANTH 23,A01,085832,Stewart; Alexander B,31,0,31,0
1653298260791,ANTH 23,A02,085833,Stewart; Alexander B,31,0,31,0
1653298260791,ANTH 23,A03,085834,Stewart; Alexander B,31,0,31,0
1653298260791,ANTH 23,A04,085835,Stewart; Alexander B,31,0,31,0
1653298260791,ANTH 23,A05,085836,Stewart; Alexander B,31,0,31,0
1653298260791,ANTH 23,A06,085837,Stewart; Alexander B,0,0,0,0
1653298260791,ANTH 23,A07,085838,Stewart; Alexander B,0,0,0,0
1653298261316,ANTH 87,A00,085842,Staff,20,0,20,0
1653298261316,ANTH 87,B00,085843,Staff,20,0,20,0
1653298261841,ANTH 101,A01,085873,Goldstein; Paul S,33,0,36,3
1653298261841,ANTH 101,A02,085874,Goldstein; Paul S,33,0,36,3
1653298261841,ANTH 101,A03,085875,Goldstein; Paul S,36,0,36,0
1653298261841,ANTH 101,A04,085876,Goldstein; Paul S,36,0,38,2
1653298262362,ANTH 105,A00,085877,Staff,39,0,40,1
1653298262885,ANTH 108,A00,085878,Staff,31,0,32,1
1653298263414,ANTH 192,A00,094234,Kaiser; Bronwyn Nicole & Non; Amy L,20,0,20,0
1653298263937,ANTH 196A,A00,085879,Varma; Saiba,20,0,20,0
1653298264490,AWP 3,001,085697,Staff,13,0,13,0
1653298264490,AWP 3,002,085698,Staff,13,0,13,0
1653298264490,AWP 3,003,085699,Staff,13,0,13,0
1653298264490,AWP 3,004,085700,Staff,0,0,0,0
1653298264490,AWP 3,005,085701,Staff,0,0,0,0
1653298264490,AWP 3,006,085703,Staff,0,0,0,0
1653298264490,AWP 3,007,085704,Staff,13,0,13,0
1653298264490,AWP 3,008,085707,Staff,0,0,0,0
1653298264490,AWP 3,009,085709,Staff,13,0,13,0
1653298264490,AWP 3,010,085710,Staff,13,0,13,0
1653298264490,AWP 3,011,085711,Staff,0,0,0,0
1653298264490,AWP 3,012,085712,Staff,0,0,0,0
1653298264490,AWP 3,013,085713,Staff,13,0,13,0
1653298264490,AWP 3,014,085715,Staff,13,0,13,0
1653298264490,AWP 3,015,085717,Staff,13,0,13,0
1653298264490,AWP 3,016,085719,Staff,13,0,13,0
1653298264490,AWP 3,017,085720,Staff,13,0,13,0
1653298264490,AWP 3,018,085721,Staff,13,0,13,0
1653298264490,AWP 3,019,085722,Staff,13,0,13,0
1653298264490,AWP 3,020,085723,Staff,13,0,13,0
1653298264490,AWP 3,021,085724,Staff,13,0,13,0
1653298264490,AWP 3,022,085725,Staff,13,0,13,0
1653298264490,AWP 3,023,085726,Staff,13,0,13,0
1653298264490,AWP 3,024,085727,Staff,13,0,13,0
1653298264490,AWP 3,025,085728,Staff,13,0,13,0
1653298264490,AWP 3,026,085729,Staff,13,0,13,0
1653298264490,AWP 3,027,085730,Staff,13,0,13,0
1653298264490,AWP 3,028,085731,Staff,13,0,13,0
1653298264490,AWP 3,029,085732,Staff,13,0,13,0
1653298264490,AWP 3,030,085733,Staff,13,0,13,0
1653298264490,AWP 3,031,085734,Staff,13,0,13,0
1653298264490,AWP 3,032,085735,Staff,13,0,13,0
1653298264490,AWP 3,033,085736,Staff,13,0,13,0
1653298264490,AWP 3,034,085737,Staff,13,0,13,0
1653298264490,AWP 3,035,085738,Staff,13,0,13,0
1653298264490,AWP 3,036,085739,Staff,13,0,13,0
1653298264490,AWP 3,037,085740,Staff,13,0,13,0
1653298264490,AWP 3,038,085741,Staff,13,0,13,0
1653298264490,AWP 3,039,085742,Staff,13,0,13,0
1653298264490,AWP 3,040,085743,Staff,13,0,13,0
1653298264490,AWP 3,041,085744,Staff,13,0,13,0
1653298264490,AWP 3,042,085745,Staff,13,0,13,0
1653298264490,AWP 3,043,085746,Staff,13,0,13,0
1653298264490,AWP 3,044,085747,Staff,13,0,13,0
1653298264490,AWP 3,045,085748,Staff,13,0,13,0
1653298264490,AWP 3,046,085749,Staff,13,0,13,0
1653298264490,AWP 3,047,085750,Staff,13,0,13,0
1653298264490,AWP 3,048,085751,Staff,13,0,13,0
1653298264490,AWP 3,049,085752,Staff,13,0,13,0
1653298264490,AWP 3,050,085753,Staff,13,0,13,0
1653298264490,AWP 3,051,085754,Staff,13,0,13,0
1653298264490,AWP 3,052,085755,Staff,0,0,0,0
1653298264490,AWP 3,053,085756,Staff,13,0,13,0
1653298264490,AWP 3,054,085757,Staff,0,0,0,0
1653298264490,AWP 3,055,085758,Staff,13,0,13,0
1653298264490,AWP 3,056,085759,Staff,13,0,13,0
1653298264490,AWP 3,057,085760,Staff,13,0,13,0
1653298264490,AWP 3,058,085761,Staff,13,0,13,0
1653298264490,AWP 3,059,085762,Staff,13,0,13,0
1653298264490,AWP 3,060,085763,Staff,13,0,13,0
1653298264490,AWP 3,061,085764,Staff,13,0,13,0
1653298264490,AWP 3,062,085765,Staff,13,0,13,0
1653298264490,AWP 3,063,085766,Staff,13,0,13,0
1653298264490,AWP 3,064,085767,Staff,13,0,13,0
1653298264490,AWP 3,065,085768,Staff,13,0,13,0
1653298264490,AWP 3,066,085769,Staff,0,0,0,0
1653298265026,AWP 4A,001,085770,Staff,0,0,0,0
1653298265026,AWP 4A,002,085771,Staff,13,0,13,0
1653298265026,AWP 4A,003,085772,Staff,13,0,13,0
1653298265026,AWP 4A,004,085773,Staff,13,0,13,0
1653298265026,AWP 4A,005,085774,Staff,0,0,0,0
1653298265026,AWP 4A,006,085775,Staff,13,0,13,0
1653298265026,AWP 4A,007,085776,Staff,0,0,0,0
1653298265026,AWP 4A,008,085777,Staff,0,0,0,0
1653298265026,AWP 4A,009,085778,Staff,0,0,0,0
1653298265026,AWP 4A,010,085779,Staff,13,0,13,0
1653298265026,AWP 4A,011,085780,Staff,13,0,13,0
1653298265026,AWP 4A,012,085781,Staff,0,0,0,0
1653298265026,AWP 4A,013,085782,Staff,13,0,13,0
1653298265026,AWP 4A,014,085783,Staff,13,0,13,0
1653298265026,AWP 4A,015,085784,Staff,13,0,13,0
1653298265026,AWP 4A,016,085785,Staff,13,0,13,0
1653298265026,AWP 4A,017,085786,Staff,13,0,13,0
1653298265026,AWP 4A,018,085787,Staff,0,0,0,0
1653298265026,AWP 4A,019,085788,Staff,13,0,13,0
1653298265026,AWP 4A,020,085789,Staff,13,0,13,0
1653298265026,AWP 4A,021,085790,Staff,0,0,0,0
1653298265026,AWP 4A,022,085791,Staff,13,0,13,0
1653298265026,AWP 4A,023,085792,Staff,0,0,0,0
1653298265026,AWP 4A,024,085793,Staff,0,0,0,0
1653298265026,AWP 4A,025,085794,Staff,13,0,13,0
1653298265026,AWP 4A,026,085795,Staff,13,0,13,0
1653298265026,AWP 4A,027,085796,Staff,13,0,13,0
1653298265026,AWP 4A,028,085797,Staff,13,0,13,0
1653298265026,AWP 4A,029,085798,Staff,0,0,0,0
1653298265026,AWP 4A,030,085799,Staff,0,0,0,0
1653298265026,AWP 4A,031,093835,Staff,0,0,0,0
1653298265551,AWP 4B,001,085800,Staff,0,0,0,0
1653298265551,AWP 4B,002,085801,Staff,0,0,0,0
1653298266081,BENG 2,A00,085936,Wheeler; Bruce Christopher,28,0,30,2
1653298266612,BENG 110,A01,085939,Mc Culloch; Andrew Douglas,20,0,30,10
1653298266612,BENG 110,A02,085940,Mc Culloch; Andrew Douglas,18,0,30,12
1653298266612,BENG 110,A03,085941,Mc Culloch; Andrew Douglas,27,0,30,3
1653298267141,BENG 119A,A01,085943,Wheeler; Bruce Christopher,29,0,30,1
1653298267670,BENG 122A,A01,085945,Cauwenberghs; Gert,18,0,25,7
1653298267670,BENG 122A,A02,085946,Cauwenberghs; Gert,22,0,25,3
1653298267670,BENG 122A,A03,085947,Cauwenberghs; Gert,22,0,25,3
1653298268195,BENG 126A,A01,085949,Wheeler; Bruce Christopher,30,0,30,0
1653298268722,BENG 127A,A01,085951,Wheeler; Bruce Christopher,28,0,30,2
1653298269251,BENG 128A,A01,085953,Wheeler; Bruce Christopher,29,0,30,1
1653298269780,BENG 134,A01,085955,Smarr; Benjamin,0,0,0,0
1653298270304,BENG 135,A00,085956,Wheeler; Bruce Christopher,23,0,30,7
1653298270828,BENG 141,A00,085958,Lal; Ratnesh,20,0,30,10
1653298271351,BENG 147A,A01,085963,Wheeler; Bruce Christopher,30,0,30,0
1653298271876,BENG 148A,A01,085967,Wheeler; Bruce Christopher,30,0,30,0
1653298272403,BENG 149A,A01,085969,Wheeler; Bruce Christopher,30,0,30,0
1653298272932,BENG 161A,A01,085971,Fraley; Stephanie I.,20,0,25,5
1653298272932,BENG 161A,A02,085972,Fraley; Stephanie I.,13,0,25,12
1653298272932,BENG 161A,A03,085973,Fraley; Stephanie I.,9,0,25,16
1653298273456,BENG 162,A01,085975,Mali; Prashant Gulab Ram,0,0,35,35
1653298273456,BENG 162,A02,085976,Mali; Prashant Gulab Ram,26,0,35,9
1653298273986,BENG 166A,A00,085977,Sah; Robert Lie-Yuan,0,0,0,0
1653298274510,BENG 169A,A01,085982,Wheeler; Bruce Christopher,28,0,30,2
1653298275032,BENG 179A,A01,085984,Wheeler; Bruce Christopher,30,0,30,0
1653298275565,BENG 183,A01,085986,Zhong; Sheng,13,0,30,17
1653298275565,BENG 183,A02,085987,Zhong; Sheng,15,0,30,15
1653298275565,BENG 183,A03,085988,Zhong; Sheng,20,0,30,10
1653298276089,BENG 187B,A00,085989,Wheeler; Bruce Christopher,105,0,170,65
1653298276617,BENG 196,001,094047,Engler; Adam J.,9999,0,9999,0
1653298277149,BIBC 100,A01,092918,Huffaker; Alisa,0,0,19,19
1653298277149,BIBC 100,A02,092919,Huffaker; Alisa,19,0,19,0
1653298277149,BIBC 100,A03,092920,Huffaker; Alisa,18,0,19,1
1653298277149,BIBC 100,A04,092921,Huffaker; Alisa,18,0,19,1
1653298277149,BIBC 100,A05,092922,Huffaker; Alisa,19,0,19,0
1653298277149,BIBC 100,A06,092923,Huffaker; Alisa,18,0,19,1
1653298277149,BIBC 100,A07,092924,Huffaker; Alisa,10,0,19,9
1653298277149,BIBC 100,A08,092925,Huffaker; Alisa,17,0,19,2
1653298277149,BIBC 100,A09,092926,Huffaker; Alisa,19,0,19,0
1653298277149,BIBC 100,A10,092927,Huffaker; Alisa,11,0,19,8
1653298277685,BIBC 102,A01,092997,Schmelz; Eric Alexander,16,0,19,3
1653298277685,BIBC 102,A02,092998,Schmelz; Eric Alexander,5,0,19,14
1653298277685,BIBC 102,A03,092999,Schmelz; Eric Alexander,1,0,19,18
1653298277685,BIBC 102,A04,093000,Schmelz; Eric Alexander,17,0,19,2
1653298277685,BIBC 102,A05,093001,Schmelz; Eric Alexander,9,0,19,10
1653298277685,BIBC 102,A06,093002,Schmelz; Eric Alexander,16,0,19,3
1653298277685,BIBC 102,A07,093003,Schmelz; Eric Alexander,19,0,19,0
1653298277685,BIBC 102,A08,093004,Schmelz; Eric Alexander,19,0,19,0
1653298277685,BIBC 102,A09,093005,Schmelz; Eric Alexander,14,0,19,5
1653298277685,BIBC 102,B01,093064,Coleman; Aaron B.,19,0,19,0
1653298277685,BIBC 102,B02,093065,Coleman; Aaron B.,17,0,19,2
1653298277685,BIBC 102,B03,093066,Coleman; Aaron B.,16,0,19,3
1653298277685,BIBC 102,B04,093067,Coleman; Aaron B.,11,0,19,8
1653298277685,BIBC 102,B05,093068,Coleman; Aaron B.,18,0,19,1
1653298277685,BIBC 102,B06,093069,Coleman; Aaron B.,16,0,19,3
1653298277685,BIBC 102,B07,093070,Coleman; Aaron B.,19,0,19,0
1653298277685,BIBC 102,B08,093071,Coleman; Aaron B.,15,0,19,4
1653298277685,BIBC 102,B09,093072,Coleman; Aaron B.,17,0,19,2
1653298278216,BIBC 103,A01,089887,Bozinovic; Goran,19,0,24,5
1653298278216,BIBC 103,A02,089888,Bozinovic; Goran,23,0,24,1
1653298278216,BIBC 103,B01,089890,Burg; Michael,2,0,24,22
1653298278216,BIBC 103,B02,089891,Burg; Michael,20,0,24,4
1653298278216,BIBC 103,C01,089893,Beyhan; Sinem,14,0,24,10
1653298278216,BIBC 103,C02,089894,Beyhan; Sinem,22,0,24,2
1653298278216,BIBC 103,D01,089896,Coleman; Aaron B.,10,0,24,14
1653298278216,BIBC 103,D02,089897,Coleman; Aaron B.,22,0,24,2
1653298278740,BIBC 194,A00,089898,Hui; Enfu,16,0,27,11
1653298279269,BICD 100,A01,092396,Smith; Laurie,21,0,22,1
1653298279269,BICD 100,A02,092397,Smith; Laurie,22,0,22,0
1653298279269,BICD 100,A03,092398,Smith; Laurie,21,0,22,1
1653298279269,BICD 100,A04,092399,Smith; Laurie,22,0,22,0
1653298279269,BICD 100,A05,092400,Smith; Laurie,21,0,22,1
1653298279269,BICD 100,A06,092401,Smith; Laurie,22,0,22,0
1653298279269,BICD 100,A07,092402,Smith; Laurie,22,0,22,0
1653298279269,BICD 100,A08,092403,Smith; Laurie,22,0,22,0
1653298279269,BICD 100,B01,093073,Mueller; Liam O'Connor,21,0,22,1
1653298279269,BICD 100,B02,093074,Mueller; Liam O'Connor,22,0,22,0
1653298279269,BICD 100,B03,093075,Mueller; Liam O'Connor,22,0,22,0
1653298279269,BICD 100,B04,093076,Mueller; Liam O'Connor,22,0,22,0
1653298279269,BICD 100,B05,093077,Mueller; Liam O'Connor,22,0,22,0
1653298279269,BICD 100,B06,093078,Mueller; Liam O'Connor,22,0,22,0
1653298279269,BICD 100,B07,093079,Mueller; Liam O'Connor,21,0,22,1
1653298279269,BICD 100,B08,093080,Mueller; Liam O'Connor,22,0,22,0
1653298279269,BICD 100,C01,093021,McDonnell; Lisa Marie,21,0,22,1
1653298279269,BICD 100,C02,093022,McDonnell; Lisa Marie,20,0,22,2
1653298279269,BICD 100,C03,093023,McDonnell; Lisa Marie,22,0,22,0
1653298279269,BICD 100,C04,093024,McDonnell; Lisa Marie,22,0,22,0
1653298279269,BICD 100,C05,093025,McDonnell; Lisa Marie,22,0,22,0
1653298279269,BICD 100,C06,093026,McDonnell; Lisa Marie,22,0,22,0
1653298279269,BICD 100,C07,093027,McDonnell; Lisa Marie,20,0,22,2
1653298279269,BICD 100,C08,093028,McDonnell; Lisa Marie,22,0,22,0
1653298279269,BICD 100,D01,093081,Day; Christopher D,22,0,22,0
1653298279269,BICD 100,D02,093082,Day; Christopher D,17,0,22,5
1653298279269,BICD 100,D03,093083,Day; Christopher D,21,0,22,1
1653298279269,BICD 100,D04,093084,Day; Christopher D,19,0,22,3
1653298279269,BICD 100,D05,093085,Day; Christopher D,22,0,22,0
1653298279269,BICD 100,D06,093086,Day; Christopher D,20,0,22,2
1653298279269,BICD 100,D07,093087,Day; Christopher D,19,0,22,3
1653298279269,BICD 100,D08,093088,Day; Christopher D,20,0,22,2
1653298279805,BICD 110,A01,093089,Kiger; Amy,29,0,32,3
1653298279805,BICD 110,A02,093091,Kiger; Amy,32,0,32,0
1653298279805,BICD 110,A03,093092,Kiger; Amy,31,0,32,1
1653298279805,BICD 110,A04,093093,Kiger; Amy,31,0,32,1
1653298279805,BICD 110,A05,093094,Kiger; Amy,26,0,32,6
1653298279805,BICD 110,A06,093095,Kiger; Amy,31,0,32,1
1653298279805,BICD 110,A07,093096,Kiger; Amy,31,0,32,1
1653298279805,BICD 110,B01,093029,Grossman; Emily N,21,0,32,11
1653298279805,BICD 110,B02,093030,Grossman; Emily N,28,0,32,4
1653298279805,BICD 110,B03,093031,Grossman; Emily N,32,0,32,0
1653298279805,BICD 110,B04,093032,Grossman; Emily N,28,0,32,4
1653298279805,BICD 110,B05,093033,Grossman; Emily N,26,0,32,6
1653298279805,BICD 110,B06,093034,Grossman; Emily N,19,0,32,13
1653298279805,BICD 110,B07,093035,Grossman; Emily N,20,0,32,12
1653298280329,BICD 140,A01,093097,Zuniga; Elina I,19,0,32,13
1653298280329,BICD 140,A02,093098,Zuniga; Elina I,17,0,32,15
1653298280329,BICD 140,A03,093099,Zuniga; Elina I,30,0,32,2
1653298280329,BICD 140,A04,093100,Zuniga; Elina I,32,0,32,0
1653298280329,BICD 140,A05,093101,Zuniga; Elina I,29,0,32,3
1653298280329,BICD 140,A06,093102,Zuniga; Elina I,27,0,32,5
1653298280855,BIEB 102,A01,092528,Butler; Shannon Rhey,22,0,27,5
1653298280855,BIEB 102,A02,092529,Butler; Shannon Rhey,17,0,27,10
1653298280855,BIEB 102,A03,092530,Butler; Shannon Rhey,24,0,27,3
1653298280855,BIEB 102,A04,092531,Butler; Shannon Rhey,26,0,27,1
1653298280855,BIEB 102,A05,092532,Butler; Shannon Rhey,25,0,27,2
1653298280855,BIEB 102,A06,092533,Butler; Shannon Rhey,24,0,27,3
1653298280855,BIEB 102,A07,092534,Butler; Shannon Rhey,23,0,27,4
1653298281377,BIEB 121,A00,089907,Holway; David A.,0,0,32,32
1653298281901,BIEB 126,A01,092974,Kohn; Joshua R,24,0,27,3
1653298281901,BIEB 126,A02,092975,Kohn; Joshua R,26,0,27,1
1653298281901,BIEB 126,A03,092976,Kohn; Joshua R,23,0,27,4
1653298281901,BIEB 126,A04,092977,Kohn; Joshua R,25,0,27,2
1653298281901,BIEB 126,A05,092978,Kohn; Joshua R,27,0,27,0
1653298282428,BIEB 146,A01,093054,Petrie; Katherine Lynn,1,0,27,26
1653298282428,BIEB 146,A02,093055,Petrie; Katherine Lynn,4,0,27,23
1653298282428,BIEB 146,A03,093056,Petrie; Katherine Lynn,0,0,27,27
1653298282428,BIEB 146,A04,093057,Petrie; Katherine Lynn,0,0,27,27
1653298282428,BIEB 146,A05,093058,Petrie; Katherine Lynn,20,0,27,7
1653298282428,BIEB 146,A06,093059,Petrie; Katherine Lynn,26,0,27,1
1653298282428,BIEB 146,A07,093060,Petrie; Katherine Lynn,16,0,27,11
1653298282428,BIEB 146,A08,093061,Petrie; Katherine Lynn,25,0,27,2
1653298282428,BIEB 146,A09,093062,Petrie; Katherine Lynn,17,0,27,10
1653298282951,BIEB 150,A01,093103,Rennison; Diana,16,0,27,11
1653298282951,BIEB 150,A02,093104,Rennison; Diana,21,0,27,6
1653298282951,BIEB 150,A03,093105,Rennison; Diana,26,0,27,1
1653298282951,BIEB 150,A04,093106,Rennison; Diana,24,0,27,3
1653298282951,BIEB 150,A05,093107,Rennison; Diana,25,0,27,2
1653298282951,BIEB 150,A06,093108,Rennison; Diana,27,0,27,0
1653298283476,BIEB 158,A01,094057,Reese; Aspen Taylor & Jackrel; Sara,31,0,32,1
1653298283476,BIEB 158,A02,094058,Reese; Aspen Taylor & Jackrel; Sara,28,0,32,4
1653298283476,BIEB 158,A03,094059,Reese; Aspen Taylor & Jackrel; Sara,31,0,32,1
1653298283476,BIEB 158,A04,094060,Reese; Aspen Taylor & Jackrel; Sara,32,0,32,0
1653298284003,BIEB 174,A01,092465,Cleland; Elsa Eleanor & Barton; Andrew David,27,0,27,0
1653298284003,BIEB 174,A02,092466,Cleland; Elsa Eleanor & Barton; Andrew David,27,0,27,0
1653298284003,BIEB 174,A03,092467,Cleland; Elsa Eleanor & Barton; Andrew David,23,0,27,4
1653298284003,BIEB 174,A04,092468,Cleland; Elsa Eleanor & Barton; Andrew David,20,0,27,7
1653298284003,BIEB 174,A05,092469,Cleland; Elsa Eleanor & Barton; Andrew David,25,0,27,2
1653298284003,BIEB 174,A06,092470,Cleland; Elsa Eleanor & Barton; Andrew David,27,0,27,0
1653298284003,BIEB 174,A07,092471,Cleland; Elsa Eleanor & Barton; Andrew David,25,0,27,2
1653298284535,BILD 1,A01,092884,Pickett; Brooke Elizabeth,16,0,19,3
1653298284535,BILD 1,A02,092885,Pickett; Brooke Elizabeth,19,0,19,0
1653298284535,BILD 1,A03,092886,Pickett; Brooke Elizabeth,19,0,19,0
1653298284535,BILD 1,A04,092887,Pickett; Brooke Elizabeth,18,0,19,1
1653298284535,BILD 1,A05,092888,Pickett; Brooke Elizabeth,19,0,19,0
1653298284535,BILD 1,A06,092889,Pickett; Brooke Elizabeth,19,0,19,0
1653298284535,BILD 1,A07,092890,Pickett; Brooke Elizabeth,17,0,19,2
1653298284535,BILD 1,B01,092891,Pekkurnaz Banghart; Gulcin,19,0,19,0
1653298284535,BILD 1,B02,092892,Pekkurnaz Banghart; Gulcin,16,0,19,3
1653298284535,BILD 1,B03,092893,Pekkurnaz Banghart; Gulcin,19,0,19,0
1653298284535,BILD 1,B04,092894,Pekkurnaz Banghart; Gulcin,19,0,19,0
1653298284535,BILD 1,B05,092895,Pekkurnaz Banghart; Gulcin,17,0,19,2
1653298284535,BILD 1,B06,092896,Pekkurnaz Banghart; Gulcin,19,0,19,0
1653298284535,BILD 1,B07,092897,Pekkurnaz Banghart; Gulcin,19,0,19,0
1653298284535,BILD 1,C01,092421,Meaders; Clara Leigh,18,0,19,1
1653298284535,BILD 1,C02,092422,Meaders; Clara Leigh,18,0,19,1
1653298284535,BILD 1,C03,092423,Meaders; Clara Leigh,17,0,19,2
1653298284535,BILD 1,C04,092424,Meaders; Clara Leigh,16,0,19,3
1653298284535,BILD 1,C05,092425,Meaders; Clara Leigh,19,0,19,0
1653298284535,BILD 1,C06,092426,Meaders; Clara Leigh,19,0,19,0
1653298284535,BILD 1,C07,092427,Meaders; Clara Leigh,19,0,19,0
1653298284535,BILD 1,D01,092428,Meaders; Clara Leigh,14,0,19,5
1653298284535,BILD 1,D02,092429,Meaders; Clara Leigh,19,0,19,0
1653298284535,BILD 1,D03,092430,Meaders; Clara Leigh,19,0,19,0
1653298284535,BILD 1,D04,092431,Meaders; Clara Leigh,19,0,19,0
1653298284535,BILD 1,D05,092432,Meaders; Clara Leigh,19,0,19,0
1653298284535,BILD 1,D06,092433,Meaders; Clara Leigh,19,0,19,0
1653298284535,BILD 1,D07,092434,Meaders; Clara Leigh,19,0,19,0
1653298284535,BILD 1,E01,092445,Cooper; Andrew Michael,19,0,19,0
1653298284535,BILD 1,E02,092446,Cooper; Andrew Michael,19,0,19,0
1653298284535,BILD 1,E03,092447,Cooper; Andrew Michael,19,0,19,0
1653298284535,BILD 1,E04,092448,Cooper; Andrew Michael,19,0,19,0
1653298284535,BILD 1,E05,092449,Cooper; Andrew Michael,17,0,19,2
1653298284535,BILD 1,E06,092450,Cooper; Andrew Michael,19,0,19,0
1653298284535,BILD 1,E07,092451,Cooper; Andrew Michael,19,0,19,0
1653298285064,BILD 2,A01,092822,Glasgow; Stacey Marie,25,0,25,0
1653298285064,BILD 2,A02,092823,Glasgow; Stacey Marie,24,0,25,1
1653298285064,BILD 2,A03,092824,Glasgow; Stacey Marie,24,0,25,1
1653298285064,BILD 2,A04,092825,Glasgow; Stacey Marie,25,0,25,0
1653298285064,BILD 2,A05,092826,Glasgow; Stacey Marie,25,0,25,0
1653298285064,BILD 2,A06,092827,Glasgow; Stacey Marie,25,0,25,0
1653298285064,BILD 2,A07,092828,Glasgow; Stacey Marie,25,0,25,0
1653298285064,BILD 2,B01,092830,Owens; Melinda Tsao-Ying,25,0,25,0
1653298285064,BILD 2,B02,092831,Owens; Melinda Tsao-Ying,21,0,25,4
1653298285064,BILD 2,B03,092832,Owens; Melinda Tsao-Ying,23,0,25,2
1653298285064,BILD 2,B04,092833,Owens; Melinda Tsao-Ying,25,0,25,0
1653298285064,BILD 2,B05,092834,Owens; Melinda Tsao-Ying,24,0,25,1
1653298285064,BILD 2,B06,092835,Owens; Melinda Tsao-Ying,21,0,25,4
1653298285064,BILD 2,B07,092836,Owens; Melinda Tsao-Ying,25,0,25,0
1653298285064,BILD 2,C01,092668,Owens; Melinda Tsao-Ying,24,0,25,1
1653298285064,BILD 2,C02,092669,Owens; Melinda Tsao-Ying,23,0,25,2
1653298285064,BILD 2,C03,092670,Owens; Melinda Tsao-Ying,22,0,25,3
1653298285064,BILD 2,C04,092671,Owens; Melinda Tsao-Ying,25,0,25,0
1653298285064,BILD 2,C05,092672,Owens; Melinda Tsao-Ying,25,0,25,0
1653298285064,BILD 2,C06,092673,Owens; Melinda Tsao-Ying,24,0,25,1
1653298285064,BILD 2,C07,092674,Owens; Melinda Tsao-Ying,25,0,25,0
1653298285608,BILD 3,A01,092454,Stockwell; Sarah R,17,0,19,2
1653298285608,BILD 3,A02,092455,Stockwell; Sarah R,17,0,19,2
1653298285608,BILD 3,A03,092456,Stockwell; Sarah R,18,0,19,1
1653298285608,BILD 3,A04,092457,Stockwell; Sarah R,19,0,19,0
1653298285608,BILD 3,A05,092458,Stockwell; Sarah R,19,0,19,0
1653298285608,BILD 3,A06,092459,Stockwell; Sarah R,18,0,19,1
1653298285608,BILD 3,A07,092460,Stockwell; Sarah R,18,0,19,1
1653298285608,BILD 3,A08,092461,Stockwell; Sarah R,19,0,19,0
1653298285608,BILD 3,A09,092462,Stockwell; Sarah R,19,0,19,0
1653298285608,BILD 3,B01,092479,Stockwell; Sarah R,19,0,19,0
1653298285608,BILD 3,B02,092480,Stockwell; Sarah R,18,0,19,1
1653298285608,BILD 3,B03,092481,Stockwell; Sarah R,18,0,19,1
1653298285608,BILD 3,B04,092482,Stockwell; Sarah R,19,0,19,0
1653298285608,BILD 3,B05,092483,Stockwell; Sarah R,19,0,19,0
1653298285608,BILD 3,B06,092484,Stockwell; Sarah R,19,0,19,0
1653298285608,BILD 3,B07,092485,Stockwell; Sarah R,19,0,19,0
1653298285608,BILD 3,B08,092486,Stockwell; Sarah R,18,0,19,1
1653298285608,BILD 3,B09,092487,Stockwell; Sarah R,18,0,19,1
1653298285608,BILD 3,C01,092412,Butler; Shannon Rhey,18,0,19,1
1653298285608,BILD 3,C02,092413,Butler; Shannon Rhey,15,0,19,4
1653298285608,BILD 3,C03,092414,Butler; Shannon Rhey,19,0,19,0
1653298285608,BILD 3,C04,092415,Butler; Shannon Rhey,19,0,19,0
1653298285608,BILD 3,C05,092416,Butler; Shannon Rhey,19,0,19,0
1653298285608,BILD 3,C06,092417,Butler; Shannon Rhey,19,0,19,0
1653298285608,BILD 3,C07,092418,Butler; Shannon Rhey,19,0,19,0
1653298285608,BILD 3,C08,092419,Butler; Shannon Rhey,19,0,19,0
1653298285608,BILD 3,C09,092420,Butler; Shannon Rhey,19,0,19,0
1653298285608,BILD 3,D01,092898,Reuther; Keefe,18,0,19,1
1653298285608,BILD 3,D02,092899,Reuther; Keefe,19,0,19,0
1653298285608,BILD 3,D03,092900,Reuther; Keefe,19,0,19,0
1653298285608,BILD 3,D04,092901,Reuther; Keefe,19,0,19,0
1653298285608,BILD 3,D05,092902,Reuther; Keefe,19,0,19,0
1653298285608,BILD 3,D06,092903,Reuther; Keefe,19,0,19,0
1653298285608,BILD 3,D07,092904,Reuther; Keefe,18,0,19,1
1653298285608,BILD 3,D08,092905,Reuther; Keefe,19,0,19,0
1653298285608,BILD 3,D09,092906,Reuther; Keefe,19,0,19,0
1653298286134,BILD 4,A01,089840,Mel; Stephanie,0,0,0,0
1653298286134,BILD 4,A02,089841,Mel; Stephanie,0,0,0,0
1653298286134,BILD 4,A03,089842,Mel; Stephanie,0,0,0,0
1653298286134,BILD 4,A04,089843,Mel; Stephanie,0,0,0,0
1653298286134,BILD 4,A05,089844,Mel; Stephanie,0,0,0,0
1653298286134,BILD 4,A06,089845,Mel; Stephanie,0,0,0,0
1653298286134,BILD 4,A07,089846,Mel; Stephanie,0,0,0,0
1653298286134,BILD 4,A08,089847,Mel; Stephanie,0,0,0,0
1653298286134,BILD 4,A09,089848,Mel; Stephanie,0,0,0,0
1653298286134,BILD 4,A10,089849,Mel; Stephanie,0,0,0,0
1653298286134,BILD 4,A11,089850,Mel; Stephanie,0,0,0,0
1653298286134,BILD 4,A12,089851,Mel; Stephanie,0,0,0,0
1653298286134,BILD 4,A13,089852,Mel; Stephanie,0,0,0,0
1653298286134,BILD 4,A14,089853,Mel; Stephanie,0,0,0,0
1653298286134,BILD 4,A15,089854,Mel; Stephanie,0,0,0,0
1653298286134,BILD 4,A16,089855,Mel; Stephanie,0,0,0,0
1653298286134,BILD 4,B01,089857,Lo; Stanley M.,0,0,0,0
1653298286134,BILD 4,B02,089858,Lo; Stanley M.,0,0,0,0
1653298286134,BILD 4,B03,089859,Lo; Stanley M.,0,0,0,0
1653298286134,BILD 4,B04,089860,Lo; Stanley M.,0,0,0,0
1653298286134,BILD 4,B05,089861,Lo; Stanley M.,0,0,0,0
1653298286134,BILD 4,B06,089862,Lo; Stanley M.,0,0,0,0
1653298286134,BILD 4,B07,089863,Lo; Stanley M.,0,0,0,0
1653298286134,BILD 4,B08,089864,Lo; Stanley M.,0,0,0,0
1653298286134,BILD 4,B09,089865,Lo; Stanley M.,0,0,0,0
1653298286134,BILD 4,B10,089866,Lo; Stanley M.,0,0,0,0
1653298286134,BILD 4,B11,089867,Lo; Stanley M.,0,0,0,0
1653298286134,BILD 4,B12,089868,Lo; Stanley M.,0,0,0,0
1653298286134,BILD 4,B13,089869,Lo; Stanley M.,0,0,0,0
1653298286134,BILD 4,B14,089870,Lo; Stanley M.,0,0,0,0
1653298286134,BILD 4,B15,089871,Lo; Stanley M.,0,0,0,0
1653298286134,BILD 4,B16,089872,Lo; Stanley M.,0,0,0,0
1653298286660,BILD 5,A01,092907,Reuther; Keefe,31,0,32,1
1653298286660,BILD 5,A02,092908,Reuther; Keefe,30,0,32,2
1653298287184,BILD 10,A01,092909,Gustafson-Brown; Cindy,27,0,27,0
1653298287184,BILD 10,A02,092910,Gustafson-Brown; Cindy,27,0,27,0
1653298287184,BILD 10,A03,092911,Gustafson-Brown; Cindy,27,0,27,0
1653298287184,BILD 10,A04,092912,Gustafson-Brown; Cindy,27,0,27,0
1653298287184,BILD 10,A05,092913,Gustafson-Brown; Cindy,25,0,27,2
1653298287184,BILD 10,A06,092914,Gustafson-Brown; Cindy,26,0,27,1
1653298287184,BILD 10,A07,092915,Gustafson-Brown; Cindy,27,0,27,0
1653298287184,BILD 10,A08,092916,Gustafson-Brown; Cindy,27,0,27,0
1653298287184,BILD 10,A09,092917,Gustafson-Brown; Cindy,27,0,27,0
1653298287709,BILD 20,A01,092956,Rana; Brinda Kanti,24,0,27,3
1653298287709,BILD 20,A02,092957,Rana; Brinda Kanti,24,0,27,3
1653298287709,BILD 20,A03,092958,Rana; Brinda Kanti,27,0,27,0
1653298287709,BILD 20,A04,092959,Rana; Brinda Kanti,27,0,27,0
1653298288232,BILD 32,A01,092990,Burg; Michael,27,0,27,0
1653298288232,BILD 32,A02,092991,Burg; Michael,26,0,27,1
1653298288232,BILD 32,A03,092992,Burg; Michael,27,0,27,0
1653298288232,BILD 32,A04,092993,Burg; Michael,26,0,27,1
1653298288232,BILD 32,A05,092994,Burg; Michael,27,0,27,0
1653298288232,BILD 32,A06,092995,Burg; Michael,27,0,27,0
1653298288232,BILD 32,A07,092996,Burg; Michael,27,0,27,0
1653298288764,BILD 60,A01,092392,Hammond; LaTisha Marie,24,0,24,0
1653298288764,BILD 60,A02,092393,Hammond; LaTisha Marie,24,0,24,0
1653298288764,BILD 60,B01,092394,Macagno; Eduardo R.,23,0,24,1
1653298288764,BILD 60,B02,092395,Macagno; Eduardo R.,24,0,24,0
1653298289288,BILD 62,A01,092949,Aljadeff; Johnatan,31,0,32,1
1653298289288,BILD 62,A02,092950,Aljadeff; Johnatan,32,0,32,0
1653298289288,BILD 62,A03,092951,Aljadeff; Johnatan,32,0,32,0
1653298289814,BILD 80,A00,089880,Pogliano; Joseph,27,0,30,3
1653298290351,BIMM 100,A01,092435,Pasquinelli; Amy,32,0,32,0
1653298290351,BIMM 100,A02,092436,Pasquinelli; Amy,30,0,32,2
1653298290351,BIMM 100,A03,092437,Pasquinelli; Amy,32,0,32,0
1653298290351,BIMM 100,A04,092438,Pasquinelli; Amy,31,0,32,1
1653298290351,BIMM 100,A05,092439,Pasquinelli; Amy,32,0,32,0
1653298290351,BIMM 100,A06,092440,Pasquinelli; Amy,32,0,32,0
1653298290351,BIMM 100,A07,092441,Pasquinelli; Amy,32,0,32,0
1653298290351,BIMM 100,A08,092442,Pasquinelli; Amy,32,0,32,0
1653298290351,BIMM 100,A09,092443,Pasquinelli; Amy,32,0,32,0
1653298290351,BIMM 100,A10,092444,Pasquinelli; Amy,32,0,32,0
1653298290351,BIMM 100,B01,092518,Pruneda-Paz; Jose L.,26,0,32,6
1653298290351,BIMM 100,B02,092519,Pruneda-Paz; Jose L.,19,0,32,13
1653298290351,BIMM 100,B03,092520,Pruneda-Paz; Jose L.,20,0,32,12
1653298290351,BIMM 100,B04,092521,Pruneda-Paz; Jose L.,24,0,32,8
1653298290351,BIMM 100,B05,092522,Pruneda-Paz; Jose L.,23,0,32,9
1653298290351,BIMM 100,B06,092523,Pruneda-Paz; Jose L.,24,0,32,8
1653298290351,BIMM 100,B07,092524,Pruneda-Paz; Jose L.,28,0,32,4
1653298290351,BIMM 100,B08,092525,Pruneda-Paz; Jose L.,25,0,32,7
1653298290351,BIMM 100,B09,092526,Pruneda-Paz; Jose L.,26,0,32,6
1653298290351,BIMM 100,B10,092527,Pruneda-Paz; Jose L.,24,0,32,8
1653298290877,BIMM 101,A01,089915,Rusert; Jessica Marie,22,0,24,2
1653298290877,BIMM 101,A02,089916,Rusert; Jessica Marie,21,0,24,3
1653298290877,BIMM 101,A03,089917,Rusert; Jessica Marie,21,0,24,3
1653298290877,BIMM 101,A04,089918,Rusert; Jessica Marie,20,0,24,4
1653298290877,BIMM 101,B01,089920,Grossman; Emily N,0,0,24,24
1653298290877,BIMM 101,B02,089921,Grossman; Emily N,1,0,24,23
1653298290877,BIMM 101,C01,089923,Day; Christopher D,0,0,24,24
1653298290877,BIMM 101,C02,089924,Day; Christopher D,0,0,24,24
1653298290877,BIMM 101,D01,089926,Cooper; Andrew Michael,18,0,24,6
1653298290877,BIMM 101,D02,089927,Cooper; Andrew Michael,24,0,24,0
1653298290877,BIMM 101,E01,089929,McDonnell; Lisa Marie,1,0,24,23
1653298290877,BIMM 101,E02,089930,McDonnell; Lisa Marie,12,0,24,12
1653298291401,BIMM 110,A01,092472,Tour; Ella,26,0,32,6
1653298291401,BIMM 110,A02,092473,Tour; Ella,23,0,32,9
1653298291401,BIMM 110,A03,092474,Tour; Ella,29,0,32,3
1653298291401,BIMM 110,A04,092475,Tour; Ella,27,0,32,5
1653298291401,BIMM 110,A05,092476,Tour; Ella,32,0,32,0
1653298291401,BIMM 110,A06,092477,Tour; Ella,30,0,32,2
1653298291401,BIMM 110,A07,092478,Tour; Ella,29,0,32,3
1653298291926,BIMM 120,A01,092979,Allen; Eric,28,0,32,4
1653298291926,BIMM 120,A02,092980,Allen; Eric,1,0,32,31
1653298291926,BIMM 120,A03,092981,Allen; Eric,14,0,32,18
1653298291926,BIMM 120,A04,092982,Allen; Eric,27,0,32,5
1653298291926,BIMM 120,A05,092983,Allen; Eric,30,0,32,2
1653298291926,BIMM 120,A06,092984,Allen; Eric,29,0,32,3
1653298291926,BIMM 120,A07,092985,Allen; Eric,20,0,32,12
1653298291926,BIMM 120,A08,092986,Allen; Eric,30,0,32,2
1653298291926,BIMM 120,A09,092987,Allen; Eric,30,0,32,2
1653298291926,BIMM 120,A10,092988,Allen; Eric,30,0,32,2
1653298291926,BIMM 120,A11,092989,Allen; Eric,32,0,32,0
1653298292450,BIMM 121,A01,089934,Petrie; Katherine Lynn,0,0,24,24
1653298292450,BIMM 121,A02,089935,Petrie; Katherine Lynn,0,0,24,24
1653298292450,BIMM 121,B01,089937,Pickett; Brooke Elizabeth,0,0,24,24
1653298292450,BIMM 121,B02,089938,Pickett; Brooke Elizabeth,0,0,24,24
1653298292450,BIMM 121,C01,089940,Pirino; Giorgia,0,0,24,24
1653298292450,BIMM 121,C02,089941,Pirino; Giorgia,0,0,24,24
1653298292450,BIMM 121,C03,089942,Pirino; Giorgia,0,0,24,24
1653298292450,BIMM 121,C04,089943,Pirino; Giorgia,0,0,24,24
1653298292978,BIMM 122,A01,093006,Russell; Alistair B,18,0,32,14
1653298292978,BIMM 122,A02,093007,Russell; Alistair B,16,0,32,16
1653298292978,BIMM 122,A03,093008,Russell; Alistair B,26,0,32,6
1653298292978,BIMM 122,A04,093009,Russell; Alistair B,32,0,32,0
1653298292978,BIMM 122,A05,093010,Russell; Alistair B,30,0,32,2
1653298293502,BIMM 124,A01,092404,Gustafson-Brown; Cindy,26,0,32,6
1653298293502,BIMM 124,A02,092405,Gustafson-Brown; Cindy,29,0,32,3
1653298293502,BIMM 124,A03,092406,Gustafson-Brown; Cindy,30,0,32,2
1653298293502,BIMM 124,A04,092407,Gustafson-Brown; Cindy,32,0,32,0
1653298293502,BIMM 124,A05,092408,Gustafson-Brown; Cindy,28,0,32,4
1653298293502,BIMM 124,A06,092409,Gustafson-Brown; Cindy,31,0,32,1
1653298293502,BIMM 124,A07,092410,Gustafson-Brown; Cindy,32,0,32,0
1653298294031,BIMM 140,A01,089947,Suel; Gurol Mehmet & Hao; Nan,16,0,27,11
1653298294031,BIMM 140,A02,089948,Suel; Gurol Mehmet & Hao; Nan,24,0,27,3
1653298294031,BIMM 140,A03,089949,Suel; Gurol Mehmet & Hao; Nan,21,0,27,6
1653298294031,BIMM 140,A04,089950,Suel; Gurol Mehmet & Hao; Nan,25,0,27,2
1653298294031,BIMM 140,A05,089951,Suel; Gurol Mehmet & Hao; Nan,24,0,27,3
1653298294559,BIMM 143,A01,089953,Grant; Barry J,0,0,40,40
1653298294559,BIMM 143,B01,089955,Fan; Chun Chieh,39,0,40,1
1653298294559,BIMM 143,C01,089957,Bozinovic; Goran,29,0,40,11
1653298295094,BIMM 194,A00,089958,Hasty; Jeff M,15,0,27,12
1653298295094,BIMM 194,B00,089959,Golden; James W,19,0,27,8
1653298295094,BIMM 194,C00,089960,Lykke-Andersen; Jens,2,0,27,25
1653298295094,BIMM 194,D00,094317,Golden; Susan S.,25,0,27,2
1653298295713,BIPN 100,A01,093011,Cooke; James Edward,7,0,19,12
1653298295713,BIPN 100,A02,093012,Cooke; James Edward,10,0,19,9
1653298295713,BIPN 100,A03,093013,Cooke; James Edward,8,0,19,11
1653298295713,BIPN 100,A04,093014,Cooke; James Edward,12,0,19,7
1653298295713,BIPN 100,A05,093015,Cooke; James Edward,17,0,19,2
1653298295713,BIPN 100,A06,093016,Cooke; James Edward,12,0,19,7
1653298295713,BIPN 100,A07,093017,Cooke; James Edward,12,0,19,7
1653298295713,BIPN 100,A08,093018,Cooke; James Edward,18,0,19,1
1653298295713,BIPN 100,A09,093019,Cooke; James Edward,17,0,19,2
1653298295713,BIPN 100,A10,093020,Cooke; James Edward,18,0,19,1
1653298295713,BIPN 100,B01,093036,Reyes Gonzalez; Catalina,17,0,19,2
1653298295713,BIPN 100,B02,093037,Reyes Gonzalez; Catalina,14,0,19,5
1653298295713,BIPN 100,B03,093038,Reyes Gonzalez; Catalina,16,0,19,3
1653298295713,BIPN 100,B04,093039,Reyes Gonzalez; Catalina,19,0,19,0
1653298295713,BIPN 100,B05,093040,Reyes Gonzalez; Catalina,19,0,19,0
1653298295713,BIPN 100,B06,093041,Reyes Gonzalez; Catalina,19,0,19,0
1653298295713,BIPN 100,B07,093042,Reyes Gonzalez; Catalina,14,0,19,5
1653298295713,BIPN 100,B08,093043,Reyes Gonzalez; Catalina,16,0,19,3
1653298295713,BIPN 100,B09,093044,Reyes Gonzalez; Catalina,19,0,19,0
1653298295713,BIPN 100,B10,093045,Reyes Gonzalez; Catalina,19,0,19,0
1653298296236,BIPN 102,A01,093046,Reyes Gonzalez; Catalina,28,0,32,4
1653298296236,BIPN 102,A02,093047,Reyes Gonzalez; Catalina,17,0,32,15
1653298296236,BIPN 102,A05,093050,Reyes Gonzalez; Catalina,29,0,32,3
1653298296236,BIPN 102,A06,093051,Reyes Gonzalez; Catalina,15,0,32,17
1653298296236,BIPN 102,A07,093052,Reyes Gonzalez; Catalina,29,0,32,3
1653298296236,BIPN 102,A08,093053,Reyes Gonzalez; Catalina,31,0,32,1
1653298296766,BIPN 105,A01,089966,Armour; Jon Christopher,0,0,21,21
1653298296766,BIPN 105,A02,089967,Armour; Jon Christopher,0,0,21,21
1653298296766,BIPN 105,A03,089968,Armour; Jon Christopher,3,0,21,18
1653298296766,BIPN 105,A04,089969,Armour; Jon Christopher,10,0,21,11
1653298297300,BIPN 140,A01,092514,Spitzer; Nicholas & Su; Chih-Ying,9,0,19,10
1653298297300,BIPN 140,A02,092515,Spitzer; Nicholas & Su; Chih-Ying,12,0,19,7
1653298297300,BIPN 140,A03,092516,Spitzer; Nicholas & Su; Chih-Ying,11,0,19,8
1653298297300,BIPN 140,A04,092517,Spitzer; Nicholas & Su; Chih-Ying,15,0,19,4
1653298297300,BIPN 140,B01,092952,Banghart; Matthew Ryan,12,0,19,7
1653298297300,BIPN 140,B02,092953,Banghart; Matthew Ryan,19,0,19,0
1653298297300,BIPN 140,B03,092954,Banghart; Matthew Ryan,19,0,19,0
1653298297300,BIPN 140,B04,092955,Banghart; Matthew Ryan,19,0,19,0
1653298297828,BIPN 145,A01,089973,Marino; Marc J,35,0,42,7
1653298297828,BIPN 145,A02,089974,Marino; Marc J,36,0,42,6
1653298297828,BIPN 145,B01,089976,Juavinett; Ashley Lauren,0,0,42,42
1653298298351,BIPN 148,A01,092960,Leutgeb; Jill K.,31,0,32,1
1653298298351,BIPN 148,A02,092961,Leutgeb; Jill K.,25,0,32,7
1653298298351,BIPN 148,A03,092962,Leutgeb; Jill K.,29,0,31,2
1653298298351,BIPN 148,A04,092963,Leutgeb; Jill K.,31,0,31,0
1653298298351,BIPN 148,A05,092964,Leutgeb; Jill K.,31,0,31,0
1653298298351,BIPN 148,A06,094351,Leutgeb; Jill K.,26,0,31,5
1653298298351,BIPN 148,A07,092966,Leutgeb; Jill K.,26,0,31,5
1653298298351,BIPN 148,A08,092967,Leutgeb; Jill K.,26,0,31,5
1653298298875,BIPN 189,A00,090665,Gentner; Tim,0,0,25,25
1653298299402,BIPN 194,A00,089978,Pekkurnaz Banghart; Gulcin,17,0,27,10
1653298299402,BIPN 194,B00,089979,Leutgeb; Stefan,24,0,27,3
1653298299930,BISP 194,A00,089980,Wertheim; Joel Okrent,8,0,27,19
1653298300477,CAT 1,A01,086671,Bronstein; Phoebe Malan,17,0,17,0
1653298300477,CAT 1,A02,086672,Bronstein; Phoebe Malan,13,0,17,4
1653298300477,CAT 1,A03,086673,Bronstein; Phoebe Malan,17,0,17,0
1653298300477,CAT 1,A04,086674,Bronstein; Phoebe Malan,15,0,17,2
1653298300477,CAT 1,A05,086675,Bronstein; Phoebe Malan,17,0,17,0
1653298300477,CAT 1,A06,086676,Bronstein; Phoebe Malan,17,0,17,0
1653298300477,CAT 1,A07,086677,Bronstein; Phoebe Malan,16,0,17,1
1653298300477,CAT 1,A08,086678,Bronstein; Phoebe Malan,17,0,17,0
1653298300477,CAT 1,A09,086679,Bronstein; Phoebe Malan,16,0,17,1
1653298300477,CAT 1,A10,086680,Bronstein; Phoebe Malan,17,0,17,0
1653298300477,CAT 1,A11,086681,Bronstein; Phoebe Malan,16,0,17,1
1653298300477,CAT 1,A12,086682,Bronstein; Phoebe Malan,17,0,17,0
1653298300477,CAT 1,A13,086683,Bronstein; Phoebe Malan,17,0,17,0
1653298300477,CAT 1,A14,086684,Bronstein; Phoebe Malan,17,0,17,0
1653298300477,CAT 1,A15,086685,Bronstein; Phoebe Malan,17,0,17,0
1653298300477,CAT 1,A16,086686,Bronstein; Phoebe Malan,17,0,17,0
1653298300477,CAT 1,B01,086688,Bigham; David Joseph,17,0,17,0
1653298300477,CAT 1,B02,086689,Bigham; David Joseph,16,0,17,1
1653298300477,CAT 1,B03,086690,Bigham; David Joseph,17,0,17,0
1653298300477,CAT 1,B04,086691,Bigham; David Joseph,17,0,17,0
1653298300477,CAT 1,B05,086692,Bigham; David Joseph,16,0,17,1
1653298300477,CAT 1,B06,086693,Bigham; David Joseph,17,0,17,0
1653298300477,CAT 1,B07,086694,Bigham; David Joseph,17,0,17,0
1653298300477,CAT 1,B08,086695,Bigham; David Joseph,17,0,17,0
1653298300477,CAT 1,B09,086696,Bigham; David Joseph,17,0,17,0
1653298300477,CAT 1,B10,086697,Bigham; David Joseph,17,0,17,0
1653298300477,CAT 1,B11,086698,Bigham; David Joseph,17,0,17,0
1653298300477,CAT 1,B12,086699,Bigham; David Joseph,17,0,17,0
1653298300477,CAT 1,B13,086700,Bigham; David Joseph,15,0,17,2
1653298300477,CAT 1,B14,086701,Bigham; David Joseph,17,0,17,0
1653298300477,CAT 1,C01,086703,Algaze; Guillermo,17,0,17,0
1653298300477,CAT 1,C02,086704,Algaze; Guillermo,17,0,17,0
1653298300477,CAT 1,C03,086705,Algaze; Guillermo,17,0,17,0
1653298300477,CAT 1,C04,086706,Algaze; Guillermo,17,0,17,0
1653298300477,CAT 1,C05,086707,Algaze; Guillermo,17,0,17,0
1653298300477,CAT 1,C06,086708,Algaze; Guillermo,17,0,17,0
1653298300477,CAT 1,C07,086709,Algaze; Guillermo,17,0,17,0
1653298300477,CAT 1,C08,086710,Algaze; Guillermo,17,0,17,0
1653298300477,CAT 1,C09,086711,Algaze; Guillermo,17,0,17,0
1653298300477,CAT 1,C10,086712,Algaze; Guillermo,17,0,17,0
1653298300477,CAT 1,C11,086713,Algaze; Guillermo,17,0,17,0
1653298300477,CAT 1,C12,086714,Algaze; Guillermo,17,0,17,0
1653298300477,CAT 1,C13,086715,Algaze; Guillermo,17,0,17,0
1653298300477,CAT 1,C14,086716,Algaze; Guillermo,16,0,17,1
1653298300477,CAT 1,C15,086717,Algaze; Guillermo,17,0,17,0
1653298300477,CAT 1,C16,086718,Algaze; Guillermo,16,0,17,1
1653298300477,CAT 1,D01,086720,Staff,17,0,17,0
1653298300477,CAT 1,D02,086721,Staff,17,0,17,0
1653298300477,CAT 1,D03,086722,Staff,17,0,17,0
1653298300477,CAT 1,D04,086723,Staff,17,0,17,0
1653298300477,CAT 1,D05,086724,Staff,16,0,17,1
1653298300477,CAT 1,D06,086725,Staff,16,0,17,1
1653298300477,CAT 1,D07,086726,Staff,17,0,17,0
1653298300477,CAT 1,D08,086727,Staff,17,0,17,0
1653298300477,CAT 1,D09,086728,Staff,16,0,17,1
1653298300477,CAT 1,D10,086729,Staff,17,0,17,0
1653298300477,CAT 1,D11,086730,Staff,17,0,17,0
1653298300477,CAT 1,D12,086731,Staff,17,0,17,0
1653298300477,CAT 1,D13,086732,Staff,17,0,17,0
1653298300477,CAT 1,D14,086733,Staff,17,0,17,0
1653298301002,CAT 3,A01,086735,Gumm; Elizabeth Ashley,14,0,15,1
1653298301002,CAT 3,A02,086736,Gumm; Elizabeth Ashley,14,0,15,1
1653298301002,CAT 3,A03,086737,Gumm; Elizabeth Ashley,15,0,15,0
1653298301002,CAT 3,A04,086738,Gumm; Elizabeth Ashley,15,0,15,0
1653298301002,CAT 3,A05,086739,Gumm; Elizabeth Ashley,15,0,15,0
1653298301002,CAT 3,A06,086740,Gumm; Elizabeth Ashley,15,0,15,0
1653298301532,CAT 124,A01,086742,Staff,15,0,15,0
1653298302061,CAT 125R,A01,094882,Staff,14,0,16,2
1653298302061,CAT 125R,A02,086745,Staff,16,0,16,0
1653298302061,CAT 125R,A03,086746,Staff,14,0,16,2
1653298302061,CAT 125R,A04,086747,Staff,13,0,16,3
1653298302061,CAT 125R,A05,086748,Staff,15,0,16,1
1653298302061,CAT 125R,A06,086749,Staff,12,0,16,4
1653298302061,CAT 125R,A07,086750,Staff,14,0,16,2
1653298302061,CAT 125R,A08,094883,Staff,14,0,16,2
1653298302061,CAT 125R,A09,094884,Staff,16,0,16,0
1653298302061,CAT 125R,A10,094885,Staff,15,0,16,1
1653298302061,CAT 125R,A14,086761,Staff,15,0,16,1
1653298302061,CAT 125R,A15,086762,Staff,16,0,16,0
1653298302061,CAT 125R,A16,086763,Staff,13,0,16,3
1653298302061,CAT 125R,A17,086764,Staff,14,0,16,2
1653298302061,CAT 125R,A18,086765,Staff,14,0,16,2
1653298302061,CAT 125R,A19,086766,Staff,14,0,16,2
1653298302585,CCS 101,A00,088353,Staff,29,0,35,6
1653298303119,CENG 4,A01,086204,Bae; Jinhye,30,0,30,0
1653298303119,CENG 4,A02,086205,Bae; Jinhye,30,0,30,0
1653298303119,CENG 4,B01,086207,Drews; Aaron,30,0,30,0
1653298303119,CENG 4,B02,086208,Drews; Aaron,30,0,30,0
1653298303643,CENG 15,A01,086210,Lubarda; Vlado,63,0,65,2
1653298303643,CENG 15,B01,086212,Lubarda; Vlado,65,0,65,0
1653298304178,CENG 100,A00,086213,Chen; Zheng,147,0,150,3
1653298304702,CENG 101A,A00,086214,Bae; Jinhye,142,0,150,8
1653298305226,CENG 120,A00,086215,Opatkiewicz; Justin Paul,125,0,150,25
1653298305750,CENG 122,A00,086216,Opatkiewicz; Justin Paul,137,0,150,13
1653298306274,CGS 2A,A01,086271,Shelby; Karen Lee,12,0,15,3
1653298306274,CGS 2A,A02,086272,Shelby; Karen Lee,13,0,15,2
1653298306274,CGS 2A,A03,086273,Shelby; Karen Lee,14,0,15,1
1653298306274,CGS 2A,A04,086274,Shelby; Karen Lee,15,0,15,0
1653298306798,CGS 100A,A00,086275,Perez; Roy,26,0,32,6
1653298307322,CGS 101,A00,086276,Shelby; Karen Lee,30,0,30,0
1653298307845,CGS 106,A00,086277,Shelby; Karen Lee,24,0,30,6
1653298308369,CGS 119,A00,086279,Nguyen; Hoang Tan,27,0,30,3
1653298308898,CGS 121,A00,086280,Martin Sandino; Amanda Maria Yoland,19,0,20,1
1653298309426,CGS 122,A00,086281,Whitley; Leila Marie,20,0,20,0
1653298309951,CGS 123,A00,086282,Staff,0,0,0,0
1653298310478,CGS 127,A00,086283,Whitley; Leila Marie,15,0,15,0
1653298311004,CGS 130,A00,086284,Martin Sandino; Amanda Maria Yoland,15,0,15,0
1653298311528,CGS 187,A00,086285,Perez; Roy,15,0,16,1
1653298312067,CGS 190,A00,086286,Staff,5,0,5,0
1653298312597,CHEM 4,A01,089669,Bussey; Thomas J,40,0,40,0
1653298312597,CHEM 4,A02,089670,Bussey; Thomas J,42,0,42,0
1653298312597,CHEM 4,A03,089671,Bussey; Thomas J,40,0,42,2
1653298312597,CHEM 4,A04,089672,Bussey; Thomas J,42,0,42,0
1653298312597,CHEM 4,A05,089673,Bussey; Thomas J,40,0,42,2
1653298312597,CHEM 4,A06,089674,Bussey; Thomas J,40,0,42,2
1653298312597,CHEM 4,A07,089675,Bussey; Thomas J,42,0,42,0
1653298312597,CHEM 4,A08,089676,Bussey; Thomas J,42,0,42,0
1653298312597,CHEM 4,A09,089677,Bussey; Thomas J,41,0,41,0
1653298312597,CHEM 4,A10,089678,Bussey; Thomas J,40,0,40,0
1653298313133,CHEM 6A,A01,092734,Pomeroy; Robert S.,4,0,4,0
1653298313133,CHEM 6A,A02,092735,Pomeroy; Robert S.,4,0,4,0
1653298313133,CHEM 6A,A03,092736,Pomeroy; Robert S.,4,0,4,0
1653298313133,CHEM 6A,A04,092737,Pomeroy; Robert S.,4,0,4,0
1653298313133,CHEM 6A,A05,092738,Pomeroy; Robert S.,4,0,4,0
1653298313133,CHEM 6A,A06,092739,Pomeroy; Robert S.,4,0,4,0
1653298313133,CHEM 6A,A07,092740,Pomeroy; Robert S.,4,0,4,0
1653298313133,CHEM 6A,A08,092741,Pomeroy; Robert S.,4,0,4,0
1653298313133,CHEM 6A,A09,092742,Pomeroy; Robert S.,0,0,0,0
1653298313133,CHEM 6A,B01,092744,Schurmeier; Kimberly,4,0,4,0
1653298313133,CHEM 6A,B02,092746,Schurmeier; Kimberly,4,0,4,0
1653298313133,CHEM 6A,B03,092749,Schurmeier; Kimberly,4,0,4,0
1653298313133,CHEM 6A,B04,092751,Schurmeier; Kimberly,4,0,4,0
1653298313133,CHEM 6A,B05,092753,Schurmeier; Kimberly,4,0,4,0
1653298313133,CHEM 6A,B06,092755,Schurmeier; Kimberly,3,0,4,1
1653298313133,CHEM 6A,B07,092756,Schurmeier; Kimberly,4,0,4,0
1653298313133,CHEM 6A,B08,092757,Schurmeier; Kimberly,4,0,4,0
1653298313133,CHEM 6A,B09,092758,Schurmeier; Kimberly,0,0,0,0
1653298313133,CHEM 6A,C01,092805,Schurmeier; Kimberly,4,0,4,0
1653298313133,CHEM 6A,C02,092806,Schurmeier; Kimberly,4,0,4,0
1653298313133,CHEM 6A,C03,092807,Schurmeier; Kimberly,4,0,4,0
1653298313133,CHEM 6A,C04,092808,Schurmeier; Kimberly,4,0,4,0
1653298313133,CHEM 6A,C05,092809,Schurmeier; Kimberly,4,0,4,0
1653298313133,CHEM 6A,C06,092810,Schurmeier; Kimberly,4,0,4,0
1653298313133,CHEM 6A,C07,092811,Schurmeier; Kimberly,4,0,4,0
1653298313133,CHEM 6A,C08,092812,Schurmeier; Kimberly,4,0,4,0
1653298313133,CHEM 6A,C09,092813,Schurmeier; Kimberly,0,0,0,0
1653298313133,CHEM 6A,D01,092837,Stallings; Dontarie M,4,0,4,0
1653298313133,CHEM 6A,D02,092838,Stallings; Dontarie M,4,0,4,0
1653298313133,CHEM 6A,D03,092839,Stallings; Dontarie M,4,0,4,0
1653298313133,CHEM 6A,D04,092840,Stallings; Dontarie M,4,0,4,0
1653298313133,CHEM 6A,D05,092841,Stallings; Dontarie M,4,0,4,0
1653298313133,CHEM 6A,D06,092842,Stallings; Dontarie M,4,0,4,0
1653298313133,CHEM 6A,D07,092843,Stallings; Dontarie M,4,0,4,0
1653298313133,CHEM 6A,D08,092844,Stallings; Dontarie M,4,0,4,0
1653298313133,CHEM 6A,D09,092845,Stallings; Dontarie M,0,0,0,0
1653298313133,CHEM 6A,E01,092796,Brydges; Stacey,4,0,4,0
1653298313133,CHEM 6A,E02,092797,Brydges; Stacey,3,0,4,1
1653298313133,CHEM 6A,E03,092798,Brydges; Stacey,4,0,4,0
1653298313133,CHEM 6A,E04,092799,Brydges; Stacey,3,0,4,1
1653298313133,CHEM 6A,E05,092800,Brydges; Stacey,4,0,4,0
1653298313133,CHEM 6A,E06,092801,Brydges; Stacey,4,0,4,0
1653298313133,CHEM 6A,E07,092802,Brydges; Stacey,4,0,4,0
1653298313133,CHEM 6A,E08,092803,Brydges; Stacey,4,0,4,0
1653298313133,CHEM 6A,E09,092804,Brydges; Stacey,0,0,0,0
1653298313133,CHEM 6A,F01,092759,Brydges; Stacey,4,0,4,0
1653298313133,CHEM 6A,F02,092760,Brydges; Stacey,4,0,4,0
1653298313133,CHEM 6A,F03,092761,Brydges; Stacey,3,0,4,1
1653298313133,CHEM 6A,F04,092762,Brydges; Stacey,4,0,4,0
1653298313133,CHEM 6A,F05,092763,Brydges; Stacey,4,0,4,0
1653298313133,CHEM 6A,F06,092764,Brydges; Stacey,4,0,4,0
1653298313133,CHEM 6A,F07,092765,Brydges; Stacey,4,0,4,0
1653298313133,CHEM 6A,F08,092766,Brydges; Stacey,4,0,4,0
1653298313133,CHEM 6A,F09,092767,Brydges; Stacey,0,0,0,0
1653298313133,CHEM 6A,G01,092774,Zid; Brian M,0,0,4,4
1653298313133,CHEM 6A,G02,092775,Zid; Brian M,2,0,4,2
1653298313133,CHEM 6A,G03,092776,Zid; Brian M,2,0,4,2
1653298313133,CHEM 6A,G04,092777,Zid; Brian M,2,0,4,2
1653298313133,CHEM 6A,G05,092778,Zid; Brian M,4,0,4,0
1653298313133,CHEM 6A,G06,092779,Zid; Brian M,4,0,4,0
1653298313133,CHEM 6A,G07,092780,Zid; Brian M,3,0,4,1
1653298313133,CHEM 6A,G08,092781,Zid; Brian M,3,0,4,1
1653298313133,CHEM 6A,G09,092782,Zid; Brian M,0,0,0,0
1653298313133,CHEM 6A,H01,092846,Stallings; Dontarie M,4,0,4,0
1653298313133,CHEM 6A,H02,092847,Stallings; Dontarie M,3,0,4,1
1653298313133,CHEM 6A,H03,092848,Stallings; Dontarie M,4,0,4,0
1653298313133,CHEM 6A,H04,092849,Stallings; Dontarie M,4,0,4,0
1653298313133,CHEM 6A,H05,092850,Stallings; Dontarie M,4,0,4,0
1653298313133,CHEM 6A,H06,092851,Stallings; Dontarie M,3,0,4,1
1653298313133,CHEM 6A,H07,092852,Stallings; Dontarie M,4,0,4,0
1653298313133,CHEM 6A,H08,092853,Stallings; Dontarie M,3,0,4,1
1653298313133,CHEM 6A,H09,092854,Stallings; Dontarie M,0,0,0,0
1653298313133,CHEM 6A,I01,092814,Staff,0,0,0,0
1653298313133,CHEM 6A,I02,092815,Staff,0,0,0,0
1653298313133,CHEM 6A,I04,092816,Staff,0,0,0,0
1653298313133,CHEM 6A,I05,092817,Staff,0,0,0,0
1653298313133,CHEM 6A,I06,092818,Staff,0,0,0,0
1653298313133,CHEM 6A,I07,092819,Staff,0,0,0,0
1653298313133,CHEM 6A,I08,092820,Staff,0,0,0,0
1653298313133,CHEM 6A,I09,092821,Staff,0,0,0,0
1653298313656,CHEM 6AH,A01,092793,Paesani; Francesco,15,0,16,1
1653298313656,CHEM 6AH,A02,092794,Paesani; Francesco,16,0,16,0
1653298313656,CHEM 6AH,A03,092795,Paesani; Francesco,16,0,16,0
1653298314180,CHEM 6B,A01,092691,Hopkins; Patrycja Anna,21,0,25,4
1653298314180,CHEM 6B,A02,092692,Hopkins; Patrycja Anna,23,0,25,2
1653298314180,CHEM 6B,A03,092693,Hopkins; Patrycja Anna,25,0,25,0
1653298314180,CHEM 6B,A04,092694,Hopkins; Patrycja Anna,0,0,0,0
1653298314180,CHEM 6B,A05,092695,Hopkins; Patrycja Anna,24,0,25,1
1653298314180,CHEM 6B,A06,092696,Hopkins; Patrycja Anna,22,0,25,3
1653298314180,CHEM 6B,A07,092697,Hopkins; Patrycja Anna,24,0,25,1
1653298314710,CHEM 6C,A01,092708,Albizati; Kim F.,31,0,38,7
1653298314710,CHEM 6C,A02,092709,Albizati; Kim F.,32,0,38,6
1653298314710,CHEM 6C,A03,092710,Albizati; Kim F.,37,0,38,1
1653298314710,CHEM 6C,A04,092711,Albizati; Kim F.,36,0,38,2
1653298314710,CHEM 6C,A05,092712,Albizati; Kim F.,0,0,0,0
1653298314710,CHEM 6C,A06,092714,Albizati; Kim F.,33,0,38,5
1653298314710,CHEM 6C,A07,092715,Albizati; Kim F.,32,0,38,6
1653298314710,CHEM 6C,A08,092716,Albizati; Kim F.,37,0,38,1
1653298314710,CHEM 6C,A09,092717,Albizati; Kim F.,38,0,38,0
1653298315239,CHEM 7L,A01,089692,Leigh; Brian,11,0,19,8
1653298315239,CHEM 7L,A02,089693,Leigh; Brian,23,0,24,1
1653298315239,CHEM 7L,A03,089694,Leigh; Brian,24,0,24,0
1653298315239,CHEM 7L,A04,089695,Leigh; Brian,24,0,24,0
1653298315239,CHEM 7L,A05,089696,Leigh; Brian,23,0,24,1
1653298315239,CHEM 7L,A06,089697,Leigh; Brian,22,0,24,2
1653298315239,CHEM 7L,A07,089698,Leigh; Brian,21,0,21,0
1653298315239,CHEM 7L,A08,089699,Leigh; Brian,17,0,24,7
1653298315239,CHEM 7L,A09,089700,Leigh; Brian,23,0,24,1
1653298315239,CHEM 7L,A10,089701,Leigh; Brian,0,0,0,0
1653298315239,CHEM 7L,B01,089703,Leigh; Brian,18,0,24,6
1653298315239,CHEM 7L,B02,089704,Leigh; Brian,18,0,24,6
1653298315239,CHEM 7L,B03,089705,Leigh; Brian,23,0,24,1
1653298315239,CHEM 7L,B04,089706,Leigh; Brian,20,0,21,1
1653298315239,CHEM 7L,B05,089707,Leigh; Brian,17,0,24,7
1653298315239,CHEM 7L,B06,089708,Leigh; Brian,17,0,24,7
1653298315239,CHEM 7L,B07,089709,Leigh; Brian,17,0,24,7
1653298315239,CHEM 7L,B08,089710,Leigh; Brian,21,0,24,3
1653298315239,CHEM 7L,B09,089711,Leigh; Brian,21,0,24,3
1653298315239,CHEM 7L,B10,089712,Leigh; Brian,0,0,0,0
1653298315239,CHEM 7L,C01,089714,Staff,23,0,24,1
1653298315239,CHEM 7L,C02,089715,Staff,22,0,24,2
1653298315239,CHEM 7L,C03,089716,Staff,23,0,24,1
1653298315239,CHEM 7L,C04,089717,Staff,24,0,24,0
1653298315239,CHEM 7L,C05,089718,Staff,21,0,24,3
1653298315239,CHEM 7L,C06,089719,Staff,22,0,24,2
1653298315239,CHEM 7L,C07,089720,Staff,23,0,24,1
1653298315239,CHEM 7L,C08,089721,Staff,24,0,24,0
1653298315239,CHEM 7L,C09,089722,Staff,24,0,24,0
1653298315239,CHEM 7L,C10,089723,Staff,0,0,0,0
1653298315773,CHEM 40A,A01,092871,Schmidt; Valerie A,31,0,31,0
1653298315773,CHEM 40A,A02,092872,Schmidt; Valerie A,31,0,31,0
1653298315773,CHEM 40A,A03,092873,Schmidt; Valerie A,31,0,31,0
1653298315773,CHEM 40A,A04,092874,Schmidt; Valerie A,0,0,0,0
1653298315773,CHEM 40A,A05,092875,Schmidt; Valerie A,31,0,31,0
1653298315773,CHEM 40A,A06,092876,Schmidt; Valerie A,29,0,31,2
1653298315773,CHEM 40A,A07,092877,Schmidt; Valerie A,31,0,31,0
1653298315773,CHEM 40A,A08,092878,Schmidt; Valerie A,28,0,28,0
1653298315773,CHEM 40A,B01,089726,Lam; Tin Yiu,31,0,31,0
1653298315773,CHEM 40A,B02,089727,Lam; Tin Yiu,31,0,31,0
1653298315773,CHEM 40A,B03,089728,Lam; Tin Yiu,31,0,31,0
1653298315773,CHEM 40A,B04,089729,Lam; Tin Yiu,30,0,31,1
1653298315773,CHEM 40A,B05,089730,Lam; Tin Yiu,31,0,31,0
1653298315773,CHEM 40A,B06,089731,Lam; Tin Yiu,30,0,31,1
1653298315773,CHEM 40A,B07,089732,Lam; Tin Yiu,29,0,31,2
1653298315773,CHEM 40A,B08,089733,Lam; Tin Yiu,0,0,0,0
1653298315773,CHEM 40A,C01,092718,Albizati; Kim F.,17,0,31,14
1653298315773,CHEM 40A,C02,092719,Albizati; Kim F.,24,0,31,7
1653298315773,CHEM 40A,C03,092720,Albizati; Kim F.,12,0,31,19
1653298315773,CHEM 40A,C04,092721,Albizati; Kim F.,24,0,31,7
1653298315773,CHEM 40A,C05,092722,Albizati; Kim F.,21,0,31,10
1653298315773,CHEM 40A,C06,092723,Albizati; Kim F.,24,0,31,7
1653298315773,CHEM 40A,C07,092724,Albizati; Kim F.,30,0,31,1
1653298315773,CHEM 40A,C08,092725,Albizati; Kim F.,0,0,0,0
1653298315773,CHEM 40A,D01,092863,Yang; Jerry,28,0,31,3
1653298315773,CHEM 40A,D02,092864,Yang; Jerry,28,0,31,3
1653298315773,CHEM 40A,D03,092865,Yang; Jerry,31,0,31,0
1653298315773,CHEM 40A,D04,092866,Yang; Jerry,31,0,31,0
1653298315773,CHEM 40A,D05,092867,Yang; Jerry,0,0,0,0
1653298315773,CHEM 40A,D06,092868,Yang; Jerry,31,0,31,0
1653298315773,CHEM 40A,D07,092869,Yang; Jerry,31,0,31,0
1653298315773,CHEM 40A,D08,092870,Yang; Jerry,31,0,31,0
1653298316298,CHEM 40B,A01,092698,Oconnor; Joseph M.,24,0,34,10
1653298316298,CHEM 40B,A02,092699,Oconnor; Joseph M.,34,0,34,0
1653298316298,CHEM 40B,A03,092700,Oconnor; Joseph M.,0,0,0,0
1653298316298,CHEM 40B,A04,092701,Oconnor; Joseph M.,30,0,34,4
1653298316298,CHEM 40B,A05,092702,Oconnor; Joseph M.,33,0,34,1
1653298316298,CHEM 40B,A06,092703,Oconnor; Joseph M.,34,0,34,0
1653298316298,CHEM 40B,A07,092704,Oconnor; Joseph M.,32,0,34,2
1653298316298,CHEM 40B,A08,092705,Oconnor; Joseph M.,33,0,34,1
1653298316298,CHEM 40B,A09,092706,Oconnor; Joseph M.,34,0,34,0
1653298316822,CHEM 40C,A01,089739,Lam; Tin Yiu,0,0,0,0
1653298316822,CHEM 40C,A02,089740,Lam; Tin Yiu,0,0,0,0
1653298316822,CHEM 40C,A03,089741,Lam; Tin Yiu,0,0,0,0
1653298316822,CHEM 40C,A04,089742,Lam; Tin Yiu,13,0,34,21
1653298316822,CHEM 40C,A05,089743,Lam; Tin Yiu,32,0,34,2
1653298316822,CHEM 40C,A06,089744,Lam; Tin Yiu,31,0,34,3
1653298317351,CHEM 41A,A01,093840,Ternansky; Robert J.,29,0,33,4
1653298317351,CHEM 41A,A02,093841,Ternansky; Robert J.,32,0,33,1
1653298317351,CHEM 41A,A03,093842,Ternansky; Robert J.,33,0,33,0
1653298317351,CHEM 41A,A04,093843,Ternansky; Robert J.,30,0,33,3
1653298317351,CHEM 41A,A05,093844,Ternansky; Robert J.,31,0,33,2
1653298317351,CHEM 41A,A06,093845,Ternansky; Robert J.,27,0,27,0
1653298317351,CHEM 41A,A07,093846,Ternansky; Robert J.,32,0,33,1
1653298317351,CHEM 41A,A08,093847,Ternansky; Robert J.,33,0,33,0
1653298317892,CHEM 43A,A01,089746,Klosterman; Jeremy K,11,0,24,13
1653298317892,CHEM 43A,A02,089747,Klosterman; Jeremy K,16,0,24,8
1653298317892,CHEM 43A,A03,089748,Klosterman; Jeremy K,21,0,24,3
1653298317892,CHEM 43A,A04,089749,Klosterman; Jeremy K,22,0,24,2
1653298317892,CHEM 43A,A05,089750,Klosterman; Jeremy K,23,0,24,1
1653298317892,CHEM 43A,A06,089751,Klosterman; Jeremy K,9,0,24,15
1653298317892,CHEM 43A,A07,089752,Klosterman; Jeremy K,17,0,24,7
1653298317892,CHEM 43A,A08,089753,Klosterman; Jeremy K,16,0,24,8
1653298317892,CHEM 43A,A09,089754,Klosterman; Jeremy K,21,0,24,3
1653298317892,CHEM 43A,A10,089755,Klosterman; Jeremy K,21,0,24,3
1653298317892,CHEM 43A,A11,089756,Klosterman; Jeremy K,0,0,0,0
1653298317892,CHEM 43A,A12,089757,Klosterman; Jeremy K,0,0,0,0
1653298317892,CHEM 43A,A13,089758,Klosterman; Jeremy K,0,0,0,0
1653298317892,CHEM 43A,B01,089760,Klosterman; Jeremy K,0,0,0,0
1653298317892,CHEM 43A,B02,089761,Klosterman; Jeremy K,0,0,0,0
1653298317892,CHEM 43A,B03,089762,Klosterman; Jeremy K,16,0,24,8
1653298317892,CHEM 43A,B04,089763,Klosterman; Jeremy K,22,0,24,2
1653298317892,CHEM 43A,B05,089764,Klosterman; Jeremy K,23,0,24,1
1653298317892,CHEM 43A,B06,089765,Klosterman; Jeremy K,23,0,24,1
1653298317892,CHEM 43A,B07,089766,Klosterman; Jeremy K,17,0,24,7
1653298317892,CHEM 43A,B08,089767,Klosterman; Jeremy K,23,0,24,1
1653298317892,CHEM 43A,B09,089768,Klosterman; Jeremy K,24,0,24,0
1653298317892,CHEM 43A,B10,089769,Klosterman; Jeremy K,23,0,24,1
1653298317892,CHEM 43A,B11,089770,Klosterman; Jeremy K,22,0,24,2
1653298317892,CHEM 43A,B12,089771,Klosterman; Jeremy K,21,0,24,3
1653298318420,CHEM 87,A00,089772,Bussey; Thomas J,20,0,20,0
1653298318948,CHEM 96,A00,089773,Bussey; Thomas J,20,0,25,5
1653298319471,CHEM 100A,A01,089775,Pomeroy; Robert S.,22,0,24,2
1653298319471,CHEM 100A,A02,089776,Pomeroy; Robert S.,19,0,24,5
1653298319471,CHEM 100A,A03,089777,Pomeroy; Robert S.,13,0,24,11
1653298319471,CHEM 100A,A04,089778,Pomeroy; Robert S.,18,0,24,6
1653298319471,CHEM 100A,A05,089779,Pomeroy; Robert S.,19,0,24,5
1653298319471,CHEM 100A,A06,089780,Pomeroy; Robert S.,24,0,24,0
1653298319471,CHEM 100A,A07,089781,Pomeroy; Robert S.,0,0,0,0
1653298319996,CHEM 105A,A01,089783,Young; Mark,0,0,39,39
1653298319996,CHEM 105A,B01,089785,Young; Mark,26,0,39,13
1653298320527,CHEM 108,A01,089787,Ghosh; Gourisankar,1,0,22,21
1653298320527,CHEM 108,A02,089788,Ghosh; Gourisankar,6,0,22,16
1653298320527,CHEM 108,B01,089790,Ghosh; Gourisankar,13,0,22,9
1653298320527,CHEM 108,B02,089791,Ghosh; Gourisankar,20,0,22,2
1653298321059,CHEM 109,A01,089793,Hamaoka; Brent Y,4,0,22,18
1653298321059,CHEM 109,A02,089794,Hamaoka; Brent Y,10,0,22,12
1653298321059,CHEM 109,B01,089796,Hamaoka; Brent Y,6,0,22,16
1653298321059,CHEM 109,B02,089797,Hamaoka; Brent Y,18,0,22,4
1653298321582,CHEM 114A,A01,092855,Toor; Navtej,21,0,25,4
1653298321582,CHEM 114A,A02,092856,Toor; Navtej,25,0,25,0
1653298321582,CHEM 114A,A03,092857,Toor; Navtej,19,0,25,6
1653298321582,CHEM 114A,A04,092858,Toor; Navtej,24,0,25,1
1653298321582,CHEM 114A,A05,092859,Toor; Navtej,0,0,0,0
1653298321582,CHEM 114A,A06,092860,Toor; Navtej,14,0,25,11
1653298321582,CHEM 114A,A07,092861,Toor; Navtej,24,0,25,1
1653298321582,CHEM 114A,A08,092862,Toor; Navtej,24,0,25,1
1653298322111,CHEM 116,A01,092707,Ferguson; Fleur,7,0,35,28
1653298322111,CHEM 116,A02,094887,Ferguson; Fleur,31,0,35,4
1653298322639,CHEM 120A,A01,092785,Schimpf; Alina M,16,0,28,12
1653298322639,CHEM 120A,A02,092786,Schimpf; Alina M,26,0,28,2
1653298322639,CHEM 120A,A03,092787,Schimpf; Alina M,20,0,28,8
1653298322639,CHEM 120A,A04,092788,Schimpf; Alina M,27,0,28,1
1653298322639,CHEM 120A,A05,092789,Schimpf; Alina M,27,0,28,1
1653298322639,CHEM 120A,A06,092790,Schimpf; Alina M,0,0,0,0
1653298322639,CHEM 120A,A07,092791,Schimpf; Alina M,15,0,28,13
1653298322639,CHEM 120A,A08,092792,Schimpf; Alina M,0,0,0,0
1653298323169,CHEM 126A,A01,092768,Schoeneberg; Johannes,16,0,35,19
1653298323169,CHEM 126A,A02,092769,Schoeneberg; Johannes,35,0,35,0
1653298323169,CHEM 126A,A03,092770,Schoeneberg; Johannes,29,0,35,6
1653298323169,CHEM 126A,A04,092771,Schoeneberg; Johannes,0,0,0,0
1653298323169,CHEM 126A,A05,092772,Schoeneberg; Johannes,30,0,35,5
1653298323169,CHEM 126A,A06,092773,Schoeneberg; Johannes,33,0,35,2
1653298323697,CHEM 130,A01,092685,Sinha; Amitabha,28,0,38,10
1653298323697,CHEM 130,A02,092686,Sinha; Amitabha,31,0,38,7
1653298323697,CHEM 130,A03,092687,Sinha; Amitabha,34,0,38,4
1653298324221,CHEM 142,A00,089803,Esko; Jeffrey D. & Godula; Kamil,9,0,46,37
1653298324750,CHEM 143C,A01,089805,Ternansky; Robert J.,17,0,22,5
1653298324750,CHEM 143C,A02,089806,Ternansky; Robert J.,18,0,22,4
1653298324750,CHEM 143C,A03,089807,Ternansky; Robert J.,19,0,22,3
1653298324750,CHEM 143C,A04,089808,Ternansky; Robert J.,20,0,22,2
1653298325277,CHEM 152,A00,089809,Romero; Nathan A & Schmidt; Valerie A,35,0,40,5
1653298325802,CHEM 171,A01,092688,Slade; Jonathan,35,0,45,10
1653298325802,CHEM 171,A02,092689,Slade; Jonathan,44,0,45,1
1653298325802,CHEM 171,A03,092690,Slade; Jonathan,45,0,45,0
1653298326330,CHEM 186,A00,089811,Paesani; Francesco,9,0,15,6
1653298326855,CHIN 10AD,A01,086223,Staff,13,0,13,0
1653298326855,CHIN 10AD,A02,086224,Staff,12,0,13,1
1653298326855,CHIN 10AD,B01,086227,Staff,14,0,15,1
1653298327382,CHIN 10AM,A01,086230,Chen; Pei-Chia,16,0,16,0
1653298327382,CHIN 10AM,A02,086231,Chen; Pei-Chia,16,0,16,0
1653298327914,CHIN 10AN,A01,086234,Xu; Li,14,0,14,0
1653298327914,CHIN 10AN,A02,086235,Xu; Li,14,0,14,0
1653298327914,CHIN 10AN,B01,086240,Xu; Li,14,0,14,0
1653298327914,CHIN 10AN,B02,086242,Xu; Li,0,0,0,0
1653298327914,CHIN 10AN,C01,086245,Xu; Li,14,0,14,0
1653298327914,CHIN 10AN,C02,086246,Xu; Li,14,0,14,0
1653298328439,CHIN 20AD,A01,086248,Wang; Xiao,14,0,14,0
1653298328439,CHIN 20AD,A02,086249,Wang; Xiao,14,0,14,0
1653298328439,CHIN 20AD,B01,086251,Wang; Xiao,13,0,14,1
1653298328439,CHIN 20AD,B02,086252,Wang; Xiao,14,0,14,0
1653298329499,CHIN 20AM,A01,086254,Wang; Xiao,11,0,14,3
1653298329499,CHIN 20AM,A02,086255,Wang; Xiao,13,0,14,1
1653298329499,CHIN 20AM,B01,086257,Staff,15,0,15,0
1653298330022,CHIN 20AN,A01,086259,Anderson; Qin-Hong,11,0,12,1
1653298330022,CHIN 20AN,A02,086260,Anderson; Qin-Hong,12,0,12,0
1653298330022,CHIN 20AN,A03,086261,Anderson; Qin-Hong,0,0,0,0
1653298330022,CHIN 20AN,B01,086263,Anderson; Qin-Hong,12,0,13,1
1653298330022,CHIN 20AN,B02,086264,Anderson; Qin-Hong,13,0,13,0
1653298330549,CHIN 100AM,A00,086265,Anderson; Qin-Hong,20,0,20,0
1653298331078,CHIN 100AN,A00,086266,Chen; Pei-Chia,17,0,20,3
1653298331601,CHIN 185A,A00,086268,Staff,20,0,20,0
1653298332126,COGS 1,A01,087834,Barrera; Steven James,57,0,60,3
1653298332126,COGS 1,A02,087835,Barrera; Steven James,52,0,60,8
1653298332126,COGS 1,A03,087836,Barrera; Steven James,57,0,60,3
1653298332126,COGS 1,A04,087837,Barrera; Steven James,59,0,60,1
1653298332126,COGS 1,A05,087838,Barrera; Steven James,60,0,60,0
1653298332126,COGS 1,A06,087839,Barrera; Steven James,59,0,60,1
1653298332126,COGS 1,A07,087840,Barrera; Steven James,54,0,57,3
1653298332649,COGS 2,A01,087842,Boyle; Mary E. T.,64,0,64,0
1653298332649,COGS 2,A02,087843,Boyle; Mary E. T.,61,0,64,3
1653298332649,COGS 2,A03,087844,Boyle; Mary E. T.,64,0,64,0
1653298333177,COGS 3,A01,094312,Boyle; Mary E. T.,30,0,35,5
1653298333177,COGS 3,A02,094313,Boyle; Mary E. T.,33,0,35,2
1653298333177,COGS 3,A03,094314,Boyle; Mary E. T.,35,0,35,0
1653298333177,COGS 3,A04,094315,Boyle; Mary E. T.,35,0,35,0
1653298333177,COGS 3,A05,094316,Boyle; Mary E. T.,35,0,35,0
1653298333700,COGS 8,A01,087846,Staff,35,0,35,0
1653298334228,COGS 10,A01,094357,Hollan; James D.,53,0,60,7
1653298334228,COGS 10,A02,094358,Hollan; James D.,58,0,60,2
1653298334228,COGS 10,A03,094359,Hollan; James D.,59,0,60,1
1653298334228,COGS 10,A04,094360,Hollan; James D.,60,0,60,0
1653298334228,COGS 10,A05,094361,Hollan; James D.,60,0,60,0
1653298334751,COGS 11,A01,087848,Boyle; Mary E. T.,46,0,47,1
1653298334751,COGS 11,A02,087849,Boyle; Mary E. T.,44,0,47,3
1653298334751,COGS 11,A03,087850,Boyle; Mary E. T.,46,0,46,0
1653298335274,COGS 13,A01,087852,Davis; Joshua Daniel,56,0,60,4
1653298335274,COGS 13,A02,087853,Davis; Joshua Daniel,55,0,60,5
1653298335274,COGS 13,A03,087854,Davis; Joshua Daniel,57,0,60,3
1653298335274,COGS 13,A04,087855,Davis; Joshua Daniel,58,0,60,2
1653298335802,COGS 14A,A01,087857,Creel; Sarah,58,0,65,7
1653298335802,COGS 14A,A02,087858,Creel; Sarah,62,0,65,3
1653298335802,COGS 14A,A03,087859,Creel; Sarah,63,0,65,2
1653298335802,COGS 14A,A04,087860,Creel; Sarah,63,0,65,2
1653298336325,COGS 14B,A01,087862,Hoffman; Drew Ellen,56,0,60,4
1653298336325,COGS 14B,A02,087863,Hoffman; Drew Ellen,53,0,60,7
1653298336325,COGS 14B,A03,087864,Hoffman; Drew Ellen,60,0,60,0
1653298336853,COGS 15,A01,087866,Bergen; Benjamin,60,0,60,0
1653298336853,COGS 15,A02,087867,Bergen; Benjamin,59,0,60,1
1653298337382,COGS 17,A01,087869,Johnson; Christine M.,55,0,60,5
1653298337382,COGS 17,A02,087870,Johnson; Christine M.,58,0,60,2
1653298337382,COGS 17,A03,087871,Johnson; Christine M.,55,0,60,5
1653298337382,COGS 17,A04,087872,Johnson; Christine M.,60,0,60,0
1653298337382,COGS 17,A05,087873,Johnson; Christine M.,59,0,60,1
1653298337382,COGS 17,A06,087874,Johnson; Christine M.,60,0,60,0
1653298337911,COGS 18,A01,087876,Fleischer; Jason G,22,0,35,13
1653298337911,COGS 18,A02,087877,Fleischer; Jason G,31,0,35,4
1653298337911,COGS 18,A03,087878,Fleischer; Jason G,33,0,35,2
1653298337911,COGS 18,A04,087879,Fleischer; Jason G,33,0,35,2
1653298337911,COGS 18,A05,087880,Fleischer; Jason G,28,0,35,7
1653298337911,COGS 18,A06,087881,Fleischer; Jason G,34,0,35,1
1653298337911,COGS 18,A07,087882,Fleischer; Jason G,33,0,35,2
1653298337911,COGS 18,A08,087883,Fleischer; Jason G,31,0,35,4
1653298337911,COGS 18,A09,087884,Fleischer; Jason G,33,0,35,2
1653298338442,COGS 20,A01,090761,Borgo; David Garcia,5,0,5,0
1653298338442,COGS 20,A02,090762,Borgo; David Garcia,5,0,5,0
1653298338442,COGS 20,A03,090763,Borgo; David Garcia,5,0,5,0
1653298338969,COGS 87,A00,087885,Deak; Gedeon O.,20,0,20,0
1653298338969,COGS 87,B00,087886,Fleischer; Jason G,20,0,20,0
1653298339493,COGS 100,A01,087892,Kirsh; David Joel,56,0,60,4
1653298339493,COGS 100,A02,087893,Kirsh; David Joel,54,0,60,6
1653298339493,COGS 100,A03,087894,Kirsh; David Joel,54,0,60,6
1653298339493,COGS 100,A04,087895,Kirsh; David Joel,51,0,60,9
1653298339493,COGS 100,A05,087896,Kirsh; David Joel,48,0,60,12
1653298340017,COGS 101A,A01,087898,Hoffman; Drew Ellen,48,0,60,12
1653298340017,COGS 101A,A02,087899,Hoffman; Drew Ellen,58,0,60,2
1653298340017,COGS 101A,A03,087900,Hoffman; Drew Ellen,55,0,60,5
1653298340017,COGS 101A,A04,087901,Hoffman; Drew Ellen,58,0,60,2
1653298340017,COGS 101A,A05,087902,Hoffman; Drew Ellen,59,0,60,1
1653298340017,COGS 101A,A06,087903,Hoffman; Drew Ellen,56,0,60,4
1653298340542,COGS 101B,A01,087905,Barrera; Steven James,30,0,60,30
1653298340542,COGS 101B,A02,087906,Barrera; Steven James,52,0,60,8
1653298340542,COGS 101B,A03,087907,Barrera; Steven James,54,0,60,6
1653298341066,COGS 101C,A01,094240,Cooperrider; Kensy A,70,0,75,5
1653298341066,COGS 101C,A02,094241,Cooperrider; Kensy A,73,0,75,2
1653298341590,COGS 102A,A01,087909,Scott; Taylor Jackson,58,0,60,2
1653298341590,COGS 102A,A02,087910,Scott; Taylor Jackson,51,0,60,9
1653298342115,COGS 107A,A01,087912,Rangel; Lara M,51,0,60,9
1653298342115,COGS 107A,A02,087913,Rangel; Lara M,54,0,60,6
1653298342115,COGS 107A,A03,087914,Rangel; Lara M,47,0,60,13
1653298342115,COGS 107A,A04,087915,Rangel; Lara M,53,0,60,7
1653298342115,COGS 107A,A05,087916,Rangel; Lara M,55,0,60,5
1653298342115,COGS 107A,A06,087917,Rangel; Lara M,50,0,60,10
1653298342642,COGS 108,A01,087919,Fleischer; Jason G,15,0,60,45
1653298342642,COGS 108,A02,087920,Fleischer; Jason G,25,0,60,35
1653298342642,COGS 108,A03,087921,Fleischer; Jason G,40,0,60,20
1653298342642,COGS 108,A04,087922,Fleischer; Jason G,40,0,60,20
1653298342642,COGS 108,A05,087923,Fleischer; Jason G,48,0,60,12
1653298342642,COGS 108,A06,087924,Fleischer; Jason G,55,0,60,5
1653298342642,COGS 108,A07,087925,Fleischer; Jason G,42,0,57,15
1653298343169,COGS 110,A01,087927,Deak; Gedeon O.,30,0,35,5
1653298343169,COGS 110,A02,087928,Deak; Gedeon O.,33,0,35,2
1653298343699,COGS 116,A01,094228,Greene; Deanna Jacquelyn,51,0,52,1
1653298343699,COGS 116,A02,094229,Greene; Deanna Jacquelyn,52,0,52,0
1653298343699,COGS 116,A03,094230,Greene; Deanna Jacquelyn,50,0,52,2
1653298344224,COGS 118B,A01,087930,De Sa; Virginia,24,0,35,11
1653298344224,COGS 118B,A02,087931,De Sa; Virginia,28,0,35,7
1653298344224,COGS 118B,A03,087932,De Sa; Virginia,18,0,35,17
1653298344224,COGS 118B,A04,087933,De Sa; Virginia,29,0,35,6
1653298344224,COGS 118B,A05,087934,De Sa; Virginia,27,0,35,8
1653298344224,COGS 118B,A06,087935,De Sa; Virginia,27,0,35,8
1653298344757,COGS 120,A01,087937,Xia; Haijun,38,0,50,12
1653298344757,COGS 120,A02,087938,Xia; Haijun,32,0,50,18
1653298344757,COGS 120,A03,087939,Xia; Haijun,26,0,50,24
1653298344757,COGS 120,A04,087940,Xia; Haijun,1,0,50,49
1653298345285,COGS 128,A01,087944,Scott; Taylor Jackson,11,0,56,45
1653298345809,COGS 143,A01,087947,Johnson; Christine M.,23,0,40,17
1653298346334,COGS 153,A00,087949,Davis; Joshua Daniel,46,0,75,29
1653298346864,COGS 160,A00,087950,Deak; Gedeon O.,20,0,20,0
1653298346864,COGS 160,B00,094232,Saygin; Ayse P,40,0,40,0
1653298347390,COGS 175,A01,094238,Staff,27,0,40,13
1653298347913,COGS 187A,A01,087958,Kirsh; David Joel,22,0,50,28
1653298347913,COGS 187A,A02,087959,Kirsh; David Joel,30,0,50,20
1653298347913,COGS 187A,A03,087960,Kirsh; David Joel,34,0,45,11
1653298348436,COGS 190A,A00,087961,Staff,9999,0,9999,0
1653298348964,COGS 194,A00,087962,Hill; Seth J,9999,0,9999,0
1653298349572,COMM 10,A02,090628,Schmidt; Thomas Rainer,1,0,5,4
1653298349572,COMM 10,A03,090629,Schmidt; Thomas Rainer,3,0,5,2
1653298349572,COMM 10,A04,090630,Schmidt; Thomas Rainer,4,0,5,1
1653298349572,COMM 10,A05,090631,Schmidt; Thomas Rainer,4,0,5,1
1653298349572,COMM 10,A06,090632,Schmidt; Thomas Rainer,5,0,5,0
1653298349572,COMM 10,A07,090633,Schmidt; Thomas Rainer,5,0,5,0
1653298349572,COMM 10,A08,090634,Schmidt; Thomas Rainer,5,0,5,0
1653298349572,COMM 10,A09,090635,Schmidt; Thomas Rainer,5,0,5,0
1653298349572,COMM 10,A10,090636,Schmidt; Thomas Rainer,2,0,5,3
1653298349572,COMM 10,A11,090637,Schmidt; Thomas Rainer,4,0,5,1
1653298349572,COMM 10,A12,094013,Schmidt; Thomas Rainer,2,0,5,3
1653298349572,COMM 10,A13,094014,Schmidt; Thomas Rainer,5,0,5,0
1653298349572,COMM 10,A14,094015,Schmidt; Thomas Rainer,4,0,5,1
1653298349572,COMM 10,A15,094016,Schmidt; Thomas Rainer,5,0,5,0
1653298350102,COMM 100A,A01,090639,Irani; Lilly C,5,0,5,0
1653298350102,COMM 100A,A02,090640,Irani; Lilly C,4,0,5,1
1653298350102,COMM 100A,A03,090641,Irani; Lilly C,5,0,5,0
1653298350102,COMM 100A,A04,090642,Irani; Lilly C,3,0,5,2
1653298350102,COMM 100A,A05,090643,Irani; Lilly C,3,0,5,2
1653298350102,COMM 100A,A06,090644,Irani; Lilly C,4,0,5,1
1653298350102,COMM 100A,A07,090645,Irani; Lilly C,5,0,5,0
1653298350102,COMM 100A,A08,090646,Irani; Lilly C,5,0,5,0
1653298350102,COMM 100A,A09,090647,Irani; Lilly C,5,0,5,0
1653298350102,COMM 100A,A10,090648,Irani; Lilly C,5,0,5,0
1653298350102,COMM 100A,A11,090649,Irani; Lilly C,3,0,5,2
1653298350102,COMM 100A,A12,090650,Irani; Lilly C,5,0,5,0
1653298350626,COMM 101,A01,090652,Halm; Gavin Patrick,14,0,15,1
1653298350626,COMM 101,A02,090653,Halm; Gavin Patrick,14,0,15,1
1653298350626,COMM 101,A03,090654,Halm; Gavin Patrick,12,0,15,3
1653298350626,COMM 101,A04,090655,Halm; Gavin Patrick,13,0,15,2
1653298351153,COMM 101D,A00,090656,Halm; Gavin Patrick,14,0,15,1
1653298351677,COMM 101K,A00,090657,Ahn; Patricia Jeehyun,16,0,20,4
1653298352204,COMM 101T,A00,093701,Staff,20,0,20,0
1653298352727,COMM 102C,A01,090660,Staff,4,0,6,2
1653298352727,COMM 102C,A02,090661,Staff,6,0,6,0
1653298352727,COMM 102C,A03,090662,Staff,4,0,6,2
1653298353252,COMM 103D,A00,090663,Davis; Zeinabu I.,38,0,40,2
1653298353778,COMM 106E,A00,090667,Geiger; Richard Stuart,26,0,30,4
1653298354301,COMM 106G,A00,090668,Cordoba Azcarate; Matilde,25,0,30,5
1653298354825,COMM 108G,A00,090670,Walkover; Lillian B,30,0,30,0
1653298355355,COMM 109I,A00,090671,Tanaka; Stefan A.,30,0,30,0
1653298355885,COMM 109N,A00,094205,Hallin; Daniel C,25,0,30,5
1653298356415,COMM 110G,A00,090672,Whitworth-Smith; Andrew C,45,0,50,5
1653298356938,COMM 111P,A00,090673,Conner; Thomas Hartnell,27,0,30,3
1653298357468,COMM 111T,A00,090674,Iatarola; Briana Marie,27,0,30,3
1653298357994,COMM 124A,A00,090677,Sims; Christopher O,79,0,80,1
1653298358517,COMM 131,A00,090678,Fields; Gary,22,0,25,3
1653298359040,COMM 134,A00,090679,Kidman; Shawna F,16,0,25,9
1653298359563,COMM 146,A00,090680,Staff,22,0,25,3
1653298360086,COMM 166,A00,094493,Staff,24,0,25,1
1653298360612,COMM 172,A00,094066,Staff,23,0,25,2
1653298361136,COMM 182,A00,094063,Staff,25,0,25,0
1653298361661,COMM 190,A00,090686,Kidman; Shawna F,17,0,23,6
1653298361661,COMM 190,B00,090687,Irani; Lilly C,0,0,0,0
1653298361661,COMM 190,C00,090688,Keith; Kerry,21,0,23,2
1653298361661,COMM 190,D00,090689,Zilberg; Elana,23,0,23,0
1653298362184,COMM 194,A00,091600,Hill; Seth J,9999,0,9999,0
1653298362709,COMM 196A,A00,090690,Schmidt; Thomas Rainer,0,0,0,0
1653298363240,COMM 198,001,091397,Ahn; Patricia Jeehyun,9999,0,9999,0
1653298363240,COMM 198,002,091398,Alac; Morana,9999,0,9999,0
1653298363240,COMM 198,003,091399,Anderson; Patrick W.,9999,0,9999,0
1653298363240,COMM 198,004,091400,Boateng; Boatema,9999,0,9999,0
1653298363240,COMM 198,005,091401,Booker; Angela N,9999,0,9999,0
1653298363240,COMM 198,008,091402,Cordoba Azcarate; Matilde,9999,0,9999,0
1653298363240,COMM 198,009,091403,Davis; Zeinabu I.,9999,0,9999,0
1653298363240,COMM 198,010,091404,Dewaard; Andrew Michael,9999,0,9999,0
1653298363240,COMM 198,011,091405,Dominguez Rubio; Fernando,9999,0,9999,0
1653298363240,COMM 198,012,091406,Fattal; Alexander Leor,9999,0,9999,0
1653298363240,COMM 198,013,091407,Fields; Gary,9999,0,9999,0
1653298363240,COMM 198,014,091408,Gates; Kelly,9999,0,9999,0
1653298363240,COMM 198,015,091409,Goldfarb; Brian,9999,0,9999,0
1653298363240,COMM 198,018,091410,Hill; Erin Truesdell,9999,0,9999,0
1653298363240,COMM 198,019,091411,Horwitz; Robert B,9999,0,9999,0
1653298363240,COMM 198,021,091412,Irani; Lilly C,9999,0,9999,0
1653298363240,COMM 198,022,091413,Jack; Caroline Sarah,9999,0,9999,0
1653298363240,COMM 198,023,091414,Kidman; Shawna F,9999,0,9999,0
1653298363240,COMM 198,024,091415,Martinico; Daniel J,9999,0,9999,0
1653298363240,COMM 198,026,091416,Schmidt; Thomas Rainer,9999,0,9999,0
1653298363240,COMM 198,027,091417,Serlin; David,9999,0,9999,0
1653298363240,COMM 198,028,091418,Sims; Christopher O,9999,0,9999,0
1653298363240,COMM 198,029,091419,Tanaka; Stefan A.,9999,0,9999,0
1653298363240,COMM 198,030,091420,Zilberg; Elana,9999,0,9999,0
1653298363240,COMM 198,031,091421,Walkover; Lillian B,9999,0,9999,0
1653298363240,COMM 198,032,091422,Geiger; Richard Stuart,9999,0,9999,0
1653298363776,CSE 8A,A50,089985,Soosai Raj; Adalbert Geral,7,0,10,3
1653298363776,CSE 8A,A51,089986,Soosai Raj; Adalbert Geral,1,0,10,9
1653298363776,CSE 8A,A52,089987,Soosai Raj; Adalbert Geral,5,0,10,5
1653298363776,CSE 8A,A53,089988,Soosai Raj; Adalbert Geral,9,0,10,1
1653298363776,CSE 8A,B50,089990,Soosai Raj; Adalbert Geral,0,0,10,10
1653298363776,CSE 8A,B51,089991,Soosai Raj; Adalbert Geral,5,0,10,5
1653298363776,CSE 8A,B52,089992,Soosai Raj; Adalbert Geral,5,0,10,5
1653298363776,CSE 8A,B53,089993,Soosai Raj; Adalbert Geral,9,0,10,1
1653298363776,CSE 8A,C50,089995,Lerner; Sorin,0,0,10,10
1653298363776,CSE 8A,C51,089996,Lerner; Sorin,6,0,10,4
1653298363776,CSE 8A,C52,089997,Lerner; Sorin,9,0,10,1
1653298363776,CSE 8A,C53,089998,Lerner; Sorin,8,0,10,2
1653298364300,CSE 8B,A01,090000,Ochoa; Benjamin Lawrence,94,0,100,6
1653298364832,CSE 11,A01,090002,Cao; Yingjun,39,0,49,10
1653298364832,CSE 11,B01,090004,Cao; Yingjun,45,0,49,4
1653298364832,CSE 11,C01,090006,Cao; Yingjun,35,0,49,14
1653298365356,CSE 12,A01,090008,Staff,73,0,73,0
1653298365356,CSE 12,B01,090010,Staff,67,0,73,6
1653298365356,CSE 12,C01,090012,Staff,60,0,73,13
1653298365884,CSE 15L,A01,090014,Politz; Joseph Gibbs,4,0,10,6
1653298365884,CSE 15L,A02,090015,Politz; Joseph Gibbs,7,0,10,3
1653298365884,CSE 15L,A03,090016,Politz; Joseph Gibbs,9,0,10,1
1653298365884,CSE 15L,A04,090017,Politz; Joseph Gibbs,9,0,10,1
1653298365884,CSE 15L,A05,090018,Politz; Joseph Gibbs,9,0,10,1
1653298365884,CSE 15L,B01,090020,Politz; Joseph Gibbs,8,0,10,2
1653298365884,CSE 15L,B02,090021,Politz; Joseph Gibbs,6,0,10,4
1653298365884,CSE 15L,B03,090022,Politz; Joseph Gibbs,7,0,10,3
1653298365884,CSE 15L,B04,090023,Politz; Joseph Gibbs,7,0,10,3
1653298365884,CSE 15L,B05,090024,Politz; Joseph Gibbs,7,0,10,3
1653298366412,CSE 20,A01,090026,Staff,204,0,210,6
1653298366940,CSE 21,A01,090028,Impagliazzo; Russell,0,0,0,0
1653298366940,CSE 21,A02,094488,Impagliazzo; Russell,0,0,0,0
1653298366940,CSE 21,A03,094489,Impagliazzo; Russell,0,0,0,0
1653298367465,CSE 30,A01,092463,Muller; P Keith,73,0,100,27
1653298367465,CSE 30,A02,092464,Staff,97,0,100,3
1653298367989,CSE 87,A00,094193,Moshiri; Alexander Niema,20,0,20,0
1653298368512,CSE 95,A00,090030,Minnes Kemp; Mor Mia,35,0,35,0
1653298368512,CSE 95,B00,093883,Minnes Kemp; Mor Mia,35,0,35,0
1653298368512,CSE 95,C00,093885,Minnes Kemp; Mor Mia,35,0,35,0
1653298369039,CSE 100,A01,090033,Moshiri; Alexander Niema,68,0,114,46
1653298369566,CSE 100R,A01,093837,Moshiri; Alexander Niema,334,0,350,16
1653298370095,CSE 101,A01,090035,Saha; Barna,152,0,237,85
1653298370623,CSE 103,A01,090037,Freund; Yoav,60,0,75,15
1653298371146,CSE 105,A01,090039,Lovett; Shachar,201,0,225,24
1653298371674,CSE 106,A50,090042,Paturi; Ramamohan,11,0,30,19
1653298372197,CSE 107,A01,090044,Bellare; Mihir,94,0,120,26
1653298372731,CSE 110,A50,090047,Powell; Thomas Allan,39,0,50,11
1653298372731,CSE 110,A51,090048,Powell; Thomas Allan,39,0,50,11
1653298372731,CSE 110,A52,090049,Powell; Thomas Allan,48,0,50,2
1653298372731,CSE 110,A53,090050,Powell; Thomas Allan,49,0,50,1
1653298372731,CSE 110,A54,090051,Powell; Thomas Allan,45,0,50,5
1653298372731,CSE 110,A55,090052,Powell; Thomas Allan,50,0,50,0
1653298372731,CSE 110,A56,090053,Powell; Thomas Allan,49,0,50,1
1653298372731,CSE 110,A57,090054,Powell; Thomas Allan,41,0,45,4
1653298373259,CSE 118,A00,094897,Weibel; Nadir,0,0,0,0
1653298373787,CSE 120,A01,090056,Voelker; Geoffrey M.,226,0,300,74
1653298374312,CSE 124,A01,090058,Porter; George M,123,0,189,66
1653298374839,CSE 127,A01,090060,Savage; Stefan,46,0,189,143
1653298375365,CSE 130,A01,090062,Polikarpova; Nadezhda,171,0,189,18
1653298375897,CSE 132A,A01,090064,Deutsch; Alin Bernard,47,0,189,142
1653298376421,CSE 140,A01,090068,Eldon; John,169,0,196,27
1653298376421,CSE 140,B01,090070,Orailoglu; Alex,48,0,49,1
1653298376945,CSE 140L,A01,090072,Eldon; John,161,0,192,31
1653298376945,CSE 140L,B01,090075,Orailoglu; Alex,44,0,49,5
1653298377470,CSE 142,A01,090078,Porter; Leonard Emerson,86,0,146,60
1653298377470,CSE 142,B01,090080,Porter; Leonard Emerson,107,0,146,39
1653298377995,CSE 142L,A01,090082,Swanson; Steven James,48,0,146,98
1653298377995,CSE 142L,B01,090084,Swanson; Steven James,120,0,146,26
1653298378522,CSE 151B,A01,090088,Cottrell; Garrison W,258,0,328,70
1653298379046,CSE 152A,A01,090090,Chandraker; Manmohan Krishna,153,0,189,36
1653298379570,CSE 158,A01,090092,McAuley; Julian John,84,0,197,113
1653298380091,CSE 158R,A01,090094,McAuley; Julian John,306,0,353,47
1653298380619,CSE 167,A01,090096,Chern; Albert Ren-Haur,165,0,189,24
1653298381150,CSE 170,A01,090098,Vaccaro; Kristen Marie,20,0,20,0
1653298381150,CSE 170,A02,090099,Vaccaro; Kristen Marie,14,0,20,6
1653298381150,CSE 170,A03,090100,Vaccaro; Kristen Marie,14,0,20,6
1653298381150,CSE 170,A04,090101,Vaccaro; Kristen Marie,14,0,20,6
1653298381150,CSE 170,A05,090102,Vaccaro; Kristen Marie,18,0,20,2
1653298381674,CSE 190,A00,090103,Shalev; Aaron D,40,0,40,0
1653298381674,CSE 190,B00,090104,Vaccaro; Kristen Marie,100,0,100,0
1653298381674,CSE 190,C00,090105,Pannuto; Patrick William,25,0,25,0
1653298382198,CSE 191,A00,093848,Minnes Kemp; Mor Mia,9999,0,9999,0
1653298382723,CSE 193,A01,090107,Elsherif; May Elhussein,49,0,49,0
1653298383249,CSE 194,A01,090109,Munyaka; Imani N. S.,20,0,49,29
1653298383773,CSS 1,A01,086486,Staff,22,0,24,2
1653298383773,CSS 1,A02,086487,Staff,21,0,24,3
1653298383773,CSS 1,A03,086488,Staff,20,0,24,4
1653298383773,CSS 1,A04,086489,Staff,23,0,24,1
1653298384300,DOC 1,A01,086773,Solomon; Amanda Lee Albaniel,0,0,0,0
1653298384300,DOC 1,A02,086774,Solomon; Amanda Lee Albaniel,0,0,0,0
1653298384300,DOC 1,A03,086775,Solomon; Amanda Lee Albaniel,5,0,6,1
1653298384300,DOC 1,A04,086776,Solomon; Amanda Lee Albaniel,6,0,6,0
1653298384300,DOC 1,A05,086777,Solomon; Amanda Lee Albaniel,6,0,6,0
1653298384300,DOC 1,A06,086778,Solomon; Amanda Lee Albaniel,6,0,6,0
1653298384300,DOC 1,A07,086779,Solomon; Amanda Lee Albaniel,5,0,6,1
1653298384300,DOC 1,A08,086849,Solomon; Amanda Lee Albaniel,6,0,6,0
1653298384300,DOC 1,A09,086780,Solomon; Amanda Lee Albaniel,6,0,6,0
1653298384300,DOC 1,A10,086781,Solomon; Amanda Lee Albaniel,6,0,6,0
1653298384300,DOC 1,A11,086782,Solomon; Amanda Lee Albaniel,5,0,6,1
1653298384300,DOC 1,A12,086783,Solomon; Amanda Lee Albaniel,6,0,6,0
1653298384300,DOC 1,A13,086784,Solomon; Amanda Lee Albaniel,6,0,6,0
1653298384300,DOC 1,A14,086785,Solomon; Amanda Lee Albaniel,6,0,6,0
1653298384300,DOC 1,A15,086786,Solomon; Amanda Lee Albaniel,6,0,6,0
1653298384300,DOC 1,A16,086787,Solomon; Amanda Lee Albaniel,6,0,6,0
1653298384300,DOC 1,A17,086788,Solomon; Amanda Lee Albaniel,0,0,0,0
1653298384300,DOC 1,A18,086789,Solomon; Amanda Lee Albaniel,0,0,0,0
1653298384300,DOC 1,B01,086791,Solomon; Amanda Lee Albaniel,6,0,6,0
1653298384300,DOC 1,B02,086792,Solomon; Amanda Lee Albaniel,6,0,6,0
1653298384300,DOC 1,B03,086793,Solomon; Amanda Lee Albaniel,6,0,6,0
1653298384300,DOC 1,B04,086794,Solomon; Amanda Lee Albaniel,6,0,6,0
1653298384300,DOC 1,B05,086795,Solomon; Amanda Lee Albaniel,3,0,6,3
1653298384300,DOC 1,B06,086796,Solomon; Amanda Lee Albaniel,6,0,6,0
1653298384300,DOC 1,B07,086797,Solomon; Amanda Lee Albaniel,6,0,6,0
1653298384300,DOC 1,B08,086798,Solomon; Amanda Lee Albaniel,6,0,6,0
1653298384300,DOC 1,B09,086799,Solomon; Amanda Lee Albaniel,6,0,6,0
1653298384300,DOC 1,B10,086800,Solomon; Amanda Lee Albaniel,6,0,6,0
1653298384300,DOC 1,B11,086801,Solomon; Amanda Lee Albaniel,5,0,6,1
1653298384300,DOC 1,B12,086802,Solomon; Amanda Lee Albaniel,6,0,6,0
1653298384300,DOC 1,B13,086803,Solomon; Amanda Lee Albaniel,6,0,6,0
1653298384300,DOC 1,B14,086804,Solomon; Amanda Lee Albaniel,6,0,6,0
1653298384300,DOC 1,B15,086805,Solomon; Amanda Lee Albaniel,5,0,6,1
1653298384300,DOC 1,B16,086806,Solomon; Amanda Lee Albaniel,6,0,6,0
1653298384300,DOC 1,B17,086807,Solomon; Amanda Lee Albaniel,0,0,0,0
1653298384300,DOC 1,B18,086808,Solomon; Amanda Lee Albaniel,0,0,0,0
1653298384300,DOC 1,C01,086810,Strom; Megan C.,6,0,6,0
1653298384300,DOC 1,C02,086811,Strom; Megan C.,5,0,6,1
1653298384300,DOC 1,C03,086812,Strom; Megan C.,6,0,6,0
1653298384300,DOC 1,C04,086813,Strom; Megan C.,5,0,6,1
1653298384300,DOC 1,C05,086814,Strom; Megan C.,5,0,6,1
1653298384300,DOC 1,C06,086815,Strom; Megan C.,6,0,6,0
1653298384300,DOC 1,C07,086816,Strom; Megan C.,6,0,6,0
1653298384300,DOC 1,C08,086817,Strom; Megan C.,6,0,6,0
1653298384300,DOC 1,C09,086818,Strom; Megan C.,6,0,6,0
1653298384300,DOC 1,C10,086819,Strom; Megan C.,6,0,6,0
1653298384300,DOC 1,C11,086820,Strom; Megan C.,6,0,6,0
1653298384300,DOC 1,C12,086821,Strom; Megan C.,6,0,6,0
1653298384300,DOC 1,C13,086822,Strom; Megan C.,6,0,6,0
1653298384300,DOC 1,C14,086823,Strom; Megan C.,6,0,6,0
1653298384300,DOC 1,C15,086824,Strom; Megan C.,6,0,6,0
1653298384300,DOC 1,C16,086825,Strom; Megan C.,6,0,6,0
1653298384300,DOC 1,C17,086826,Strom; Megan C.,0,0,0,0
1653298384300,DOC 1,C18,086827,Strom; Megan C.,0,0,0,0
1653298384300,DOC 1,D01,086829,Strom; Megan C.,6,0,6,0
1653298384300,DOC 1,D02,086830,Strom; Megan C.,6,0,6,0
1653298384300,DOC 1,D03,086831,Strom; Megan C.,5,0,6,1
1653298384300,DOC 1,D04,086832,Strom; Megan C.,6,0,6,0
1653298384300,DOC 1,D05,086833,Strom; Megan C.,6,0,6,0
1653298384300,DOC 1,D06,086834,Strom; Megan C.,6,0,6,0
1653298384300,DOC 1,D07,086835,Strom; Megan C.,6,0,6,0
1653298384300,DOC 1,D08,086836,Strom; Megan C.,6,0,6,0
1653298384300,DOC 1,D09,086837,Strom; Megan C.,0,0,0,0
1653298384300,DOC 1,D10,086838,Strom; Megan C.,0,0,0,0
1653298384300,DOC 1,D11,086839,Strom; Megan C.,6,0,6,0
1653298384300,DOC 1,D12,086840,Strom; Megan C.,6,0,6,0
1653298384300,DOC 1,D13,086841,Strom; Megan C.,6,0,6,0
1653298384300,DOC 1,D14,086842,Strom; Megan C.,5,0,6,1
1653298384300,DOC 1,D15,086843,Strom; Megan C.,6,0,6,0
1653298384300,DOC 1,D16,086844,Strom; Megan C.,5,0,6,1
1653298384826,DOC 100D,A00,086845,Pass; Natalye Joann,0,0,0,0
1653298384826,DOC 100D,B00,086846,Pass; Natalye Joann,21,0,25,4
1653298384826,DOC 100D,C00,086847,Pass; Natalye Joann,23,0,25,2
1653298385350,DSC 10,A01,088092,Tiefenbruck; Janine LoBue,13,0,15,2
1653298385350,DSC 10,B01,088095,Tiefenbruck; Janine LoBue,9,0,15,6
1653298385350,DSC 10,C01,088098,Rampure; Suraj,0,0,15,15
1653298385879,DSC 20,A01,088101,Langlois; Marina,148,0,150,2
1653298386406,DSC 30,A01,088105,Langlois; Marina,74,0,75,1
1653298386929,DSC 40A,A01,088107,Rampure; Suraj,97,0,100,3
1653298386929,DSC 40A,B01,088109,Rampure; Suraj,99,0,100,1
1653298387453,DSC 40B,A01,088111,Eldridge; Justin Matthew,73,0,75,2
1653298387453,DSC 40B,B01,088113,Wang; Yusu,75,0,75,0
1653298387977,DSC 80,A01,088115,Eldridge; Justin Matthew,95,0,100,5
1653298388500,DSC 95,A01,088117,Langlois; Marina,20,0,20,0
1653298389026,DSC 96,A00,088118,Liao; Soohyun Nam,50,0,50,0
1653298389553,DSC 100,A01,088120,Salimi; Babak,164,0,175,11
1653298390080,DSC 102,A01,094320,Kumar; Arun Kumar,77,0,125,48
1653298390613,DSC 180A,A01,088124,Fraenkel; Aaron Mcmillan,0,0,0,0
1653298390613,DSC 180A,A02,088125,Fraenkel; Aaron Mcmillan,0,0,0,0
1653298390613,DSC 180A,A03,088126,Fraenkel; Aaron Mcmillan,0,0,0,0
1653298390613,DSC 180A,A04,088127,Fraenkel; Aaron Mcmillan,0,0,0,0
1653298390613,DSC 180A,A05,088128,Fraenkel; Aaron Mcmillan,0,0,0,0
1653298390613,DSC 180A,A06,088129,Fraenkel; Aaron Mcmillan,0,0,0,0
1653298390613,DSC 180A,A07,088130,Fraenkel; Aaron Mcmillan,0,0,0,0
1653298390613,DSC 180A,A08,088131,Fraenkel; Aaron Mcmillan,0,0,0,0
1653298390613,DSC 180A,A09,088132,Fraenkel; Aaron Mcmillan,0,0,0,0
1653298390613,DSC 180A,A10,088133,Fraenkel; Aaron Mcmillan,0,0,0,0
1653298390613,DSC 180A,A11,088134,Fraenkel; Aaron Mcmillan,0,0,0,0
1653298390613,DSC 180A,A12,088135,Fraenkel; Aaron Mcmillan,0,0,0,0
1653298390613,DSC 180A,A13,088136,Fraenkel; Aaron Mcmillan,0,0,0,0
1653298390613,DSC 180A,A14,088137,Fraenkel; Aaron Mcmillan,0,0,0,0
1653298390613,DSC 180A,A15,088138,Fraenkel; Aaron Mcmillan,0,0,0,0
1653298390613,DSC 180A,B01,088141,Fraenkel; Aaron Mcmillan,0,0,0,0
1653298390613,DSC 180A,B02,088142,Fraenkel; Aaron Mcmillan,0,0,0,0
1653298390613,DSC 180A,B03,088143,Fraenkel; Aaron Mcmillan,0,0,0,0
1653298390613,DSC 180A,B04,088144,Fraenkel; Aaron Mcmillan,0,0,0,0
1653298390613,DSC 180A,B05,088145,Fraenkel; Aaron Mcmillan,0,0,0,0
1653298390613,DSC 180A,B06,088146,Fraenkel; Aaron Mcmillan,0,0,0,0
1653298390613,DSC 180A,B07,088147,Fraenkel; Aaron Mcmillan,0,0,0,0
1653298390613,DSC 180A,B08,088148,Fraenkel; Aaron Mcmillan,0,0,0,0
1653298390613,DSC 180A,B09,088149,Fraenkel; Aaron Mcmillan,0,0,0,0
1653298390613,DSC 180A,B10,088150,Fraenkel; Aaron Mcmillan,0,0,0,0
1653298390613,DSC 180A,B11,088151,Fraenkel; Aaron Mcmillan,0,0,0,0
1653298390613,DSC 180A,B12,088152,Fraenkel; Aaron Mcmillan,0,0,0,0
1653298390613,DSC 180A,B13,088153,Fraenkel; Aaron Mcmillan,0,0,0,0
1653298390613,DSC 180A,B14,088154,Fraenkel; Aaron Mcmillan,0,0,0,0
1653298390613,DSC 180A,B15,088155,Fraenkel; Aaron Mcmillan,0,0,0,0
1653298391137,DSC 190,A01,088158,Mishne; Gal,48,0,50,2
1653298391137,DSC 190,B01,088160,Silberman; Jack,16,0,21,5
1653298391659,DSC 197,001,088161,Eldridge; Justin Matthew,9999,0,9999,0
1653298392185,DSGN 1,A01,087888,Meyer; Michael Wayne,49,0,53,4
1653298392185,DSGN 1,A02,087889,Meyer; Michael Wayne,47,0,53,6
1653298392185,DSGN 1,A03,087890,Meyer; Michael Wayne,43,0,53,10
1653298392716,DSGN 100,A01,087983,Dow; Steven P,39,0,40,1
1653298392716,DSGN 100,A02,087984,Dow; Steven P,40,0,40,0
1653298392716,DSGN 100,A03,087985,Dow; Steven P,34,0,40,6
1653298393242,DSGN 118,A01,087987,Xia; Haijun,55,0,60,5
1653298393242,DSGN 118,A02,087988,Xia; Haijun,56,0,60,4
1653298393774,DSGN 119,A00,087989,Staff,51,0,70,19
1653298394298,ECE 5,A01,090699,Morris; Karcher William,0,0,0,0
1653298394298,ECE 5,A02,090700,Morris; Karcher William,0,0,0,0
1653298394298,ECE 5,A03,090701,Morris; Karcher William,0,0,0,0
1653298394298,ECE 5,A04,090702,Morris; Karcher William,0,0,0,0
1653298394298,ECE 5,A05,090703,Morris; Karcher William,0,0,0,0
1653298394298,ECE 5,A06,090704,Morris; Karcher William,0,0,0,0
1653298394821,ECE 15,A01,090706,Schurgers; Curt,0,0,0,0
1653298394821,ECE 15,A02,090707,Schurgers; Curt,0,0,0,0
1653298395351,ECE 16,A01,090709,Khoshabeh; Ramsin,24,0,30,6
1653298395880,ECE 17,A01,090711,Gilja; Vikash,55,0,60,5
1653298396404,ECE 25,A50,090714,Liu; Zhaowei,0,0,0,0
1653298396404,ECE 25,A51,090715,Liu; Zhaowei,0,0,0,0
1653298396404,ECE 25,A52,090716,Liu; Zhaowei,0,0,0,0
1653298396928,ECE 30,A50,094300,Mir Arabbaygi; Siavash,25,0,30,5
1653298396928,ECE 30,A51,094301,Mir Arabbaygi; Siavash,29,0,30,1
1653298396928,ECE 30,A52,094302,Mir Arabbaygi; Siavash,27,0,30,3
1653298396928,ECE 30,A53,094303,Mir Arabbaygi; Siavash,29,0,30,1
1653298396928,ECE 30,A54,094304,Mir Arabbaygi; Siavash,25,0,25,0
1653298397452,ECE 35,A50,090720,Schurgers; Curt,0,0,0,0
1653298397452,ECE 35,A51,090721,Schurgers; Curt,0,0,0,0
1653298397452,ECE 35,A52,090722,Schurgers; Curt,0,0,0,0
1653298397452,ECE 35,A53,090723,Schurgers; Curt,0,0,0,0
1653298397452,ECE 35,A54,090724,Schurgers; Curt,0,0,0,0
1653298397452,ECE 35,A55,090725,Schurgers; Curt,0,0,0,0
1653298397452,ECE 35,B50,090729,Schurgers; Curt,0,0,0,0
1653298397452,ECE 35,B51,090730,Schurgers; Curt,0,0,0,0
1653298397452,ECE 35,B52,090731,Schurgers; Curt,0,0,0,0
1653298397452,ECE 35,B53,090732,Schurgers; Curt,0,0,0,0
1653298397452,ECE 35,B54,090733,Schurgers; Curt,0,0,0,0
1653298397452,ECE 35,B55,090734,Schurgers; Curt,0,0,0,0
1653298397979,ECE 45,A01,090736,Franceschetti; Massimo,56,0,57,1
1653298397979,ECE 45,A02,090737,Franceschetti; Massimo,50,0,58,8
1653298398509,ECE 65,A50,090741,Baghdadchi; Saharnaz,13,0,15,2
1653298398509,ECE 65,A51,090742,Baghdadchi; Saharnaz,5,0,10,5
1653298398509,ECE 65,A52,090743,Baghdadchi; Saharnaz,14,0,15,1
1653298398509,ECE 65,A53,090744,Baghdadchi; Saharnaz,8,0,10,2
1653298398509,ECE 65,A54,094865,Baghdadchi; Saharnaz,14,0,15,1
1653298398509,ECE 65,A55,094866,Baghdadchi; Saharnaz,9,0,10,1
1653298398509,ECE 65,A56,094867,Baghdadchi; Saharnaz,14,0,15,1
1653298398509,ECE 65,A57,094868,Baghdadchi; Saharnaz,15,0,15,0
1653298398509,ECE 65,A58,094869,Baghdadchi; Saharnaz,10,0,10,0
1653298399035,ECE 100,A01,090746,Baghdadchi; Saharnaz,16,0,20,4
1653298399035,ECE 100,A02,090747,Baghdadchi; Saharnaz,20,0,20,0
1653298399035,ECE 100,A03,090748,Baghdadchi; Saharnaz,18,0,20,2
1653298399035,ECE 100,A04,090749,Baghdadchi; Saharnaz,20,0,20,0
1653298399035,ECE 100,A05,090750,Baghdadchi; Saharnaz,18,0,20,2
1653298399035,ECE 100,A06,090751,Baghdadchi; Saharnaz,18,0,20,2
1653298399035,ECE 100,A07,090752,Baghdadchi; Saharnaz,20,0,20,0
1653298399557,ECE 101,A01,090754,Siegel; Paul H.,62,0,75,13
1653298399557,ECE 101,A02,090755,Siegel; Paul H.,71,0,75,4
1653298400087,ECE 102,A00,090756,Hsueh; Tzu-Chien,57,0,75,18
1653298400615,ECE 103,A01,090767,Lo; Yu-Hwa,45,0,50,5
1653298401141,ECE 107,A01,090769,Lomakin; Vitaliy,72,0,75,3
1653298401667,ECE 109,A01,090771,Zeger; Kenneth A.,176,0,180,4
1653298402192,ECE 111,A01,090774,Koushanfar; Farinaz,100,0,120,20
1653298402811,ECE 121A,A50,090777,Esmaili; Gholamreza,17,0,24,7
1653298402811,ECE 121A,A51,090778,Esmaili; Gholamreza,9,0,24,15
1653298402811,ECE 121A,A52,090779,Esmaili; Gholamreza,22,0,24,2
1653298403339,ECE 128A,A00,090780,Staff,40,0,70,30
1653298403868,ECE 135A,A00,090781,Kuzum; Duygu,30,0,30,0
1653298404392,ECE 143,A00,090782,Unpingco; Jose H.,0,0,0,2
1653298404919,ECE 148,A01,090784,Staff,32,0,32,0
1653298405451,ECE 155,A01,090786,Milstein; Laurence B.,16,0,20,4
1653298405975,ECE 158A,A01,090788,Franceschetti; Massimo,56,0,65,9
1653298406506,ECE 161A,A01,090790,Rao; Bhaskar D.,103,0,115,12
1653298407033,ECE 164,A00,090791,Hall; Drew A.,87,0,115,28
1653298407564,ECE 166,A50,090796,Rebeiz; Gabriel,6,0,12,6
1653298407564,ECE 166,A51,090797,Rebeiz; Gabriel,9,0,12,3
1653298407564,ECE 166,A52,090799,Rebeiz; Gabriel,1,0,12,11
1653298407564,ECE 166,A53,090800,Rebeiz; Gabriel,6,0,12,6
1653298407564,ECE 166,A54,094335,Rebeiz; Gabriel,11,0,12,1
1653298407564,ECE 166,A55,094336,Rebeiz; Gabriel,12,0,12,0
1653298407564,ECE 166,A56,094349,Rebeiz; Gabriel,13,0,15,2
1653298407564,ECE 166,A57,094350,Rebeiz; Gabriel,14,0,15,1
1653298408088,ECE 171A,A01,090802,Atanasov; Nikolay A.,45,0,60,15
1653298408612,ECE 171B,A01,090804,Shi; Yuanyuan,44,0,50,6
1653298409139,ECE 174,A01,090806,Pal; Piya,125,0,146,21
1653298409664,ECE 182,A01,090808,Lomakin; Vitaliy,23,0,23,0
1653298410188,ECE 187,A00,090809,Liu; Zhaowei,19,0,20,1
1653298410715,ECE 196,A00,090812,Morris; Karcher William,19,0,24,5
1653298410715,ECE 196,B00,094833,Morris; Karcher William,24,0,24,0
1653298411242,ECE 197,001,090813,Sievenpiper; Daniel F.,9999,0,9999,0
1653298411777,ECON 1,A01,092535,Staff,0,0,0,0
1653298411777,ECON 1,A02,092536,Staff,0,0,0,0
1653298411777,ECON 1,A03,092537,Staff,0,0,0,0
1653298411777,ECON 1,A04,092538,Staff,0,0,0,0
1653298411777,ECON 1,A05,092539,Staff,0,0,0,0
1653298411777,ECON 1,B01,092540,Ma; Alyson Chan,42,0,45,3
1653298411777,ECON 1,B02,092541,Ma; Alyson Chan,45,0,45,0
1653298411777,ECON 1,B03,092542,Ma; Alyson Chan,45,0,45,0
1653298411777,ECON 1,B04,092543,Ma; Alyson Chan,40,0,40,0
1653298411777,ECON 1,B05,092544,Ma; Alyson Chan,40,0,40,0
1653298411777,ECON 1,C01,092545,Tocoian; Oana,0,0,0,0
1653298411777,ECON 1,C02,092546,Tocoian; Oana,0,0,0,0
1653298411777,ECON 1,C03,092547,Tocoian; Oana,0,0,0,0
1653298411777,ECON 1,C04,092548,Tocoian; Oana,0,0,0,0
1653298411777,ECON 1,D01,094253,Levkoff; Steven B.,41,0,45,4
1653298411777,ECON 1,D02,094254,Levkoff; Steven B.,44,0,45,1
1653298411777,ECON 1,D03,094255,Levkoff; Steven B.,45,0,45,0
1653298411777,ECON 1,D04,094256,Levkoff; Steven B.,36,0,40,4
1653298411777,ECON 1,D05,094257,Levkoff; Steven B.,40,0,40,0
1653298412304,ECON 2,A01,092549,Staff,0,0,0,0
1653298412304,ECON 2,A02,092550,Staff,0,0,0,0
1653298412304,ECON 2,A03,092551,Staff,0,0,0,0
1653298412827,ECON 4,A01,092554,Levkoff; Steven B.,29,0,30,1
1653298412827,ECON 4,A02,092555,Levkoff; Steven B.,27,0,30,3
1653298412827,ECON 4,A03,092556,Levkoff; Steven B.,30,0,30,0
1653298413359,ECON 100A,A01,092557,Newhouse; Herbert S,23,0,30,7
1653298413359,ECON 100A,A02,092558,Newhouse; Herbert S,28,0,30,2
1653298413359,ECON 100A,A03,092559,Newhouse; Herbert S,29,0,30,1
1653298413359,ECON 100A,A04,092560,Newhouse; Herbert S,35,0,35,0
1653298413359,ECON 100A,B01,092561,Newhouse; Herbert S,20,0,30,10
1653298413359,ECON 100A,B02,092562,Newhouse; Herbert S,28,0,30,2
1653298413359,ECON 100A,B03,092563,Newhouse; Herbert S,15,0,30,15
1653298413359,ECON 100A,B04,092564,Newhouse; Herbert S,35,0,35,0
1653298413884,ECON 100B,A01,092565,Galperti; Simone,27,0,30,3
1653298413884,ECON 100B,A02,092566,Galperti; Simone,18,0,20,2
1653298413884,ECON 100B,A03,094496,Staff,27,0,30,3
1653298413884,ECON 100B,A04,094497,Staff,16,0,20,4
1653298413884,ECON 100B,B01,092567,Galperti; Simone,16,0,25,9
1653298414409,ECON 100C,A01,092569,Du; Songzi,62,0,75,13
1653298414409,ECON 100C,B01,092570,Du; Songzi,70,0,75,5
1653298414409,ECON 100C,B02,094258,Du; Songzi,75,0,75,0
1653298414937,ECON 100CH,A00,088284,Andreoni; James,20,0,20,0
1653298415462,ECON 109,A01,092572,Watson; Joel Christopher,68,0,75,7
1653298415462,ECON 109,B01,092573,Watson; Joel Christopher,68,0,75,7
1653298415989,ECON 110A,A01,092574,Alon; Titan Michael,12,0,25,13
1653298415989,ECON 110A,A02,092575,Alon; Titan Michael,24,0,25,1
1653298415989,ECON 110A,B01,092576,Alon; Titan Michael,24,0,25,1
1653298415989,ECON 110A,B02,092577,Alon; Titan Michael,25,0,25,0
1653298416532,ECON 110B,A01,092578,Trottner; Fabian Gunter We,16,0,25,9
1653298416532,ECON 110B,A02,094054,Trottner; Fabian Gunter We,23,0,25,2
1653298416532,ECON 110B,B01,092579,Trottner; Fabian Gunter We,7,0,25,18
1653298416532,ECON 110B,B02,094055,Trottner; Fabian Gunter We,24,0,25,1
1653298417055,ECON 116,A00,088291,Lowes; Sara Rachel,58,0,70,12
1653298417579,ECON 120A,A01,092580,Elliott; Graham,18,0,25,7
1653298417579,ECON 120A,A02,092581,Elliott; Graham,22,0,25,3
1653298417579,ECON 120A,B01,092582,Elliott; Graham,18,0,25,7
1653298417579,ECON 120A,B02,092583,Elliott; Graham,20,0,25,5
1653298417579,ECON 120A,C01,092584,Tocoian; Oana,27,0,30,3
1653298417579,ECON 120A,C02,092585,Tocoian; Oana,28,0,30,2
1653298417579,ECON 120A,C03,092586,Tocoian; Oana,40,0,40,0
1653298418103,ECON 120B,A01,092587,Candido; Maria Teresa,58,0,70,12
1653298418103,ECON 120B,A02,092588,Candido; Maria Teresa,51,0,60,9
1653298418103,ECON 120B,A03,092589,Candido; Maria Teresa,56,0,60,4
1653298418628,ECON 120C,A01,092590,Candido; Maria Teresa,48,0,60,12
1653298418628,ECON 120C,A02,092591,Candido; Maria Teresa,59,0,60,1
1653298418628,ECON 120C,A03,094310,Candido; Maria Teresa,73,0,75,2
1653298419150,ECON 121,A00,088298,Vogl; Tom Saul,36,0,50,14
1653298419674,ECON 130,A00,088299,Staff,59,0,75,16
1653298420204,ECON 131,A00,088300,Jacobsen; Mark,129,0,150,21
1653298420204,ECON 131,B00,088301,Jacobsen; Mark,15,0,30,15
1653298420736,ECON 152,A00,088302,Fadlon; Yizhak,34,0,50,16
1653298420736,ECON 152,B00,088303,Fadlon; Yizhak,49,0,50,1
1653298421268,ECON 168,A00,088304,Staff,54,0,60,6
1653298421794,ECON 191B,A00,088312,Galperti; Simone,20,0,20,0
1653298422319,EDS 25,A01,087581,Staff,9,0,10,1
1653298422319,EDS 25,A02,087582,Staff,10,0,10,0
1653298422319,EDS 25,A03,087583,Staff,7,0,10,3
1653298422319,EDS 25,A04,087584,Staff,10,0,10,0
1653298422846,EDS 31,A00,087585,Bussey; Thomas J,9,0,10,1
1653298423376,EDS 110R,A01,087597,Cohen; Shana R,43,0,50,7
1653298423376,EDS 110R,B01,093579,Cohen; Shana R,10,0,10,0
1653298423899,EDS 113,A00,087598,Staff,45,0,50,5
1653298424423,EDS 114,A01,088091,Eguchi; Emi,17,0,20,3
1653298424423,EDS 114,A02,087600,Eguchi; Emi,19,0,20,1
1653298424952,EDS 117,A01,087603,Chung; Luz Marina,25,0,35,10
1653298424952,EDS 117,A02,087604,Chung; Luz Marina,34,0,35,1
1653298425479,EDS 124AR,A01,087606,Simon; Elizabeth A,0,0,19,19
1653298425479,EDS 124AR,A02,087607,Simon; Elizabeth A,13,0,19,6
1653298425479,EDS 124AR,A03,087608,Simon; Elizabeth A,15,0,19,4
1653298425479,EDS 124AR,A04,087609,Simon; Elizabeth A,4,0,19,15
1653298425479,EDS 124AR,B01,087611,Simon; Elizabeth A,14,0,19,5
1653298425479,EDS 124AR,B02,087612,Simon; Elizabeth A,18,0,19,1
1653298425479,EDS 124AR,B03,087613,Simon; Elizabeth A,18,0,19,1
1653298425479,EDS 124AR,B04,087614,Simon; Elizabeth A,19,0,19,0
1653298425479,EDS 124AR,C01,094210,Simon; Elizabeth A,6,0,6,0
1653298425479,EDS 124AR,C02,094211,Simon; Elizabeth A,6,0,6,0
1653298425479,EDS 124AR,C03,094212,Simon; Elizabeth A,6,0,6,0
1653298425479,EDS 124AR,C04,094213,Simon; Elizabeth A,6,0,6,0
1653298425479,EDS 124AR,D01,094215,Simon; Elizabeth A,6,0,6,0
1653298425479,EDS 124AR,D02,094216,Simon; Elizabeth A,6,0,6,0
1653298425479,EDS 124AR,D03,094217,Simon; Elizabeth A,6,0,6,0
1653298425479,EDS 124AR,D04,094218,Simon; Elizabeth A,6,0,6,0
1653298426003,EDS 124BR,A00,087615,Eguchi; Emi,65,0,75,10
1653298426003,EDS 124BR,B00,093580,Eguchi; Emi,25,0,25,0
1653298426530,EDS 125,A00,087616,Jones; Gabrielle Anastasia,51,0,60,9
1653298427056,EDS 129A,A01,087618,Heinzman; Erica M.,43,0,50,7
1653298427581,EDS 130,A01,087620,Holtzman; Caren Lynn,17,0,20,3
1653298427581,EDS 130,A02,087621,Holtzman; Caren Lynn,20,0,20,0
1653298427581,EDS 130,A03,087622,Holtzman; Caren Lynn,20,0,20,0
1653298428109,EDS 131,A01,087624,Wishard Guerra; Alison G.,37,0,40,3
1653298428634,EDS 133,A01,087627,Bintliff; Amy S.V.,17,0,20,3
1653298428634,EDS 133,A02,087628,Bintliff; Amy S.V.,19,0,20,1
1653298429162,EDS 139,A00,087629,Holtzman; Caren Lynn,55,0,60,5
1653298429162,EDS 139,B00,087630,Heinzman; Erica M.,51,0,60,9
1653298429162,EDS 139,C00,087631,Bintliff; Amy S.V.,57,0,60,3
1653298429162,EDS 139,D00,087632,Wishard Guerra; Alison G.,58,0,60,2
1653298429162,EDS 139,E00,087633,Holtzman; Caren Lynn,30,0,30,0
1653298429162,EDS 139,F00,094886,Staff,25,0,25,0
1653298429686,EDS 146,A01,094220,Staff,25,0,25,0
1653298430216,EDS 164R,A01,087644,Wishard Guerra; Alison G.,37,0,40,3
1653298430216,EDS 164R,B01,093582,Wishard Guerra; Alison G.,20,0,20,0
1653298430743,EDS 190,A00,087645,Bresser; Bernard George,20,0,20,0
1653298430743,EDS 190,B00,087646,Pappas; Elizabeth,20,0,20,0
1653298430743,EDS 190,C00,087647,Scharton; Susan Michelle,20,0,20,0
1653298430743,EDS 190,E00,087648,Staff,20,0,20,0
1653298431267,ENG 10,A00,086288,Staff,30,0,30,0
1653298431267,ENG 10,B00,086289,Staff,30,0,30,0
1653298431792,ENG 15,A01,086291,Staff,35,0,35,0
1653298432318,ENG 20,A00,086292,Evdokimenko; Ekaterina,33,0,35,2
1653298432845,ENG 100D,A00,086293,Ngo; Anh-Thu T.,45,0,50,5
1653298432845,ENG 100D,B00,094309,Staff,46,0,50,4
1653298433385,ENG 100L,A00,086295,Kleissl; Jan,6,0,6,0
1653298433385,ENG 100L,B00,086296,Bratton; Maryann,8,0,8,0
1653298433385,ENG 100L,C00,086297,Nguyen; Truong Quang,10,0,10,0
1653298433385,ENG 100L,E00,086299,de Oliveira; Mauricio,8,0,8,0
1653298433385,ENG 100L,F00,086300,Goldberg; Charles G.,6,0,6,0
1653298433385,ENG 100L,G00,086301,Bratton; Maryann,6,0,6,0
1653298433385,ENG 100L,H00,086302,Staff,6,0,6,0
1653298433913,ENVR 30,A01,093565,Staff,29,0,30,1
1653298433913,ENVR 30,A02,093567,Staff,28,0,30,2
1653298433913,ENVR 30,A03,093568,Staff,25,0,30,5
1653298433913,ENVR 30,A04,093569,Staff,30,0,30,0
1653298433913,ENVR 30,A05,093570,Staff,29,0,30,1
1653298433913,ENVR 30,A06,093566,Staff,29,0,30,1
1653298434450,ENVR 102,A00,093571,Daly; Heather Marie,25,0,30,5
1653298435507,ERC 1,A01,092328,Herbst; Matthew,20,0,20,0
1653298435507,ERC 1,A02,092330,Herbst; Matthew,20,0,20,0
1653298435507,ERC 1,A03,092331,Herbst; Matthew,20,0,20,0
1653298435507,ERC 1,A04,092332,Herbst; Matthew,20,0,20,0
1653298435507,ERC 1,A05,092333,Herbst; Matthew,20,0,20,0
1653298435507,ERC 1,A06,092334,Herbst; Matthew,20,0,20,0
1653298436032,ERC 2,A01,092336,Rahimi; Babak,20,0,20,0
1653298436032,ERC 2,A02,092337,Rahimi; Babak,20,0,20,0
1653298436032,ERC 2,A03,092338,Rahimi; Babak,20,0,20,0
1653298436032,ERC 2,A04,092339,Rahimi; Babak,20,0,20,0
1653298436557,ERC 20,A00,092340,Evans; Ivan T,30,0,30,0
1653298436557,ERC 20,B00,092341,Evans; Ivan T,30,0,30,0
1653298437081,ERC 87,A00,093850,Herbst; Matthew,20,0,20,0
1653298437606,ERC 92,A00,092342,Staff,1,0,1,0
1653298437606,ERC 92,B00,092343,Staff,1,0,1,0
1653298437606,ERC 92,C00,092344,Staff,1,0,1,0
1653298437606,ERC 92,D00,092345,Staff,1,0,1,0
1653298437606,ERC 92,E00,092346,Staff,1,0,1,0
1653298437606,ERC 92,F00,092347,Staff,1,0,1,0
1653298438132,ESYS 90,A00,086303,Teranes; Jane,12,0,12,0
1653298438664,ESYS 101,A01,086305,Taylor; Jennifer Rebecca & Diaz; Julia Michelle,25,0,27,2
1653298438664,ESYS 101,A02,086306,Taylor; Jennifer Rebecca & Diaz; Julia Michelle,15,0,27,12
1653298438664,ESYS 101,A03,086307,Taylor; Jennifer Rebecca & Diaz; Julia Michelle,21,0,27,6
1653298438664,ESYS 101,A04,086308,Taylor; Jennifer Rebecca & Diaz; Julia Michelle,27,0,27,0
1653298439190,ESYS 187A,A01,086310,Teranes; Jane,38,0,40,2
1653298439190,ESYS 187A,B01,086312,Teranes; Jane,30,0,40,10
1653298439716,ETHN 1,A01,086314,Frank; Ross H.,15,0,15,0
1653298439716,ETHN 1,A02,086315,Frank; Ross H.,15,0,15,0
1653298439716,ETHN 1,A03,086316,Frank; Ross H.,14,0,15,1
1653298439716,ETHN 1,A04,086317,Frank; Ross H.,15,0,15,0
1653298439716,ETHN 1,A05,086318,Frank; Ross H.,15,0,15,0
1653298439716,ETHN 1,A06,086319,Frank; Ross H.,13,0,15,2
1653298439716,ETHN 1,A07,086320,Frank; Ross H.,15,0,15,0
1653298439716,ETHN 1,A08,086321,Frank; Ross H.,14,0,15,1
1653298439716,ETHN 1,A09,086322,Frank; Ross H.,15,0,15,0
1653298439716,ETHN 1,A10,086323,Frank; Ross H.,15,0,15,0
1653298439716,ETHN 1,A11,086324,Frank; Ross H.,15,0,15,0
1653298439716,ETHN 1,A12,086325,Frank; Ross H.,15,0,15,0
1653298439716,ETHN 1,A13,086326,Frank; Ross H.,15,0,15,0
1653298439716,ETHN 1,A14,086327,Frank; Ross H.,15,0,15,0
1653298439716,ETHN 1,A15,086328,Frank; Ross H.,15,0,15,0
1653298439716,ETHN 1,A16,086329,Frank; Ross H.,15,0,15,0
1653298440240,ETHN 100A,A00,086330,Patel; Shaista,41,0,48,7
1653298440765,ETHN 103,A00,086331,Perreira; Christopher Michael,63,0,70,7
1653298441288,ETHN 104,A00,086332,Staff,0,0,0,0
1653298441811,ETHN 106,A00,086333,Staff,0,0,0,0
1653298442336,ETHN 121,A00,086341,Sasaki; Christen T,20,0,28,8
1653298442864,ETHN 139,A00,086342,Ruiz; Ariana,16,0,20,4
1653298443389,ETHN 144M,A00,086343,Jolivette; Andrew J,66,0,70,4
1653298443912,ETHN 159,A00,088427,Graham; Jessica Lynn,0,0,0,0
1653298444444,ETHN 163E,A00,086344,Patel; Shaista,37,0,40,3
1653298444967,ETHN 178R,A00,090798,Borgo; David Garcia,15,0,20,5
1653298445493,ETHN 187,A00,086345,Perez; Roy,14,0,16,2
1653298446017,EXPR 100,A00,085686,Staff,9999,0,9999,0
1653298446547,FMPH 40,A00,086370,Emory; Kristen,70,0,75,5
1653298446547,FMPH 40,B00,086371,Romero; Sally Ann Dominick,71,0,75,4
1653298447070,FMPH 101,A00,086372,Brouwer; Kimberly,43,0,55,12
1653298447605,FMPH 102,A50,094498,Rana; Brinda Kanti,42,0,55,13
1653298448131,FMPH 110,A00,086374,Zoumas-Morse; Christine E.,61,0,65,4
1653298448660,FMPH 120,A00,086375,Nguyen-Grozavu; France T.,45,0,65,20
1653298448660,FMPH 120,B00,086376,Nguyen-Grozavu; France T.,60,0,65,5
1653298449185,FMPH 130,A00,086377,Staff,48,0,65,17
1653298450229,FMPH 161,A00,086379,Zoumas-Morse; Christine E.,58,0,65,7
1653298450757,FMPH 191,A00,086380,Harrell; Maralee Mae,58,0,60,2
1653298451282,FMPH 196A,A00,086381,Binkin; Nancy Jeanne,0,0,0,0
1653298451807,GLBH 20,A00,086407,Walkover; Lillian B,85,0,90,5
1653298452345,GLBH 100,A00,086408,Staff,55,0,56,1
1653298452345,GLBH 100,B00,086409,Wu; Hua,52,0,56,4
1653298452345,GLBH 100,D00,086411,Staff,38,0,40,2
1653298452869,GLBH 103,A00,086412,Hannah; Seth Donal,48,0,50,2
1653298453403,GLBH 105,A00,086413,Olivas Hernandez; Olga Lid,36,0,38,2
1653298453926,GLBH 106,A00,086414,Kayser; Georgia Lyn,40,0,40,0
1653298454455,GLBH 111,A01,094330,Burgos; Jose L.,0,0,0,0
1653298454455,GLBH 111,B01,094332,Burgos; Jose L.,0,0,0,0
1653298454978,GLBH 148,A00,086415,Staff,69,0,73,4
1653298455502,GLBH 181,A00,086417,Burgos; Jose L.,144,0,146,2
1653298456099,GSS 20,A00,094269,Staff,73,0,75,2
1653298456623,HDS 1,A01,086423,Staff,24,0,25,1
1653298456623,HDS 1,A02,086424,Staff,24,0,25,1
1653298456623,HDS 1,A03,086425,Staff,23,0,25,2
1653298456623,HDS 1,A04,086426,Staff,25,0,25,0
1653298456623,HDS 1,A05,086427,Staff,24,0,25,1
1653298456623,HDS 1,A06,086428,Staff,25,0,25,0
1653298456623,HDS 1,A07,086429,Staff,30,0,30,0
1653298457148,HDS 60,A01,086431,Staff,23,0,25,2
1653298457676,HDS 111,A00,086432,Staff,73,0,80,7
1653298458198,HDS 121,A01,086434,Deak; Gedeon O.,11,0,15,4
1653298458198,HDS 121,A02,086435,Deak; Gedeon O.,13,0,15,2
1653298458724,HDS 150,A00,086436,Staff,25,0,25,0
1653298458724,HDS 150,B00,086437,Staff,25,0,25,0
1653298459251,HDS 173,A00,086439,Staff,27,0,30,3
1653298459776,HDS 181,A01,086441,Staff,30,0,30,0
1653298460309,HDS 191,A01,086443,Staff,25,0,25,0
1653298460837,HIEA 129,A00,088057,Schneewind; Sarah,0,0,0,0
1653298461367,HIEA 137,A00,088058,Lu; Weijing,53,0,55,2
1653298461893,HIEA 144,A00,088059,Henry; Todd A.,44,0,45,1
1653298462416,HIEA 171,A00,088060,Lu; Weijing,15,0,15,0
1653298462945,HIEU 102,A00,088061,Watts; Edward J.,0,0,0,0
1653298463470,HIEU 107,A00,088062,Caciola; Nancy A,0,0,0,0
1653298463996,HIEU 108,A00,088063,Balberg; Mira,53,0,60,7
1653298464520,HIEU 128,A00,088064,Neuheiser; Joerg,0,0,0,0
1653298465043,HIEU 144,A00,094327,Staff,48,0,50,2
1653298465571,HIEU 149,A00,088065,Devereux; Andrew W,38,0,45,7
1653298466098,HIEU 154,A00,088066,Biess; Frank Peter,58,0,65,7
1653298466626,HIGL 114,A00,088067,Edington; Claire Ellen,53,0,55,2
1653298467150,HILA 119,A00,088068,Vitz; Matthew,49,0,51,2
1653298467676,HILA 122,A00,088069,Widener; Daniel,61,0,65,4
1653298468201,HILD 2A,A01,088024,Hanna; Mark G.,28,0,28,0
1653298468201,HILD 2A,A02,088025,Hanna; Mark G.,25,0,25,0
1653298468201,HILD 2A,A03,088026,Hanna; Mark G.,27,0,28,1
1653298468201,HILD 2A,A04,088027,Hanna; Mark G.,28,0,28,0
1653298468201,HILD 2A,A05,088028,Hanna; Mark G.,28,0,28,0
1653298468201,HILD 2A,A06,088029,Hanna; Mark G.,28,0,28,0
1653298468730,HILD 7A,A01,088031,Graham; Jessica Lynn,28,0,28,0
1653298468730,HILD 7A,A02,088032,Graham; Jessica Lynn,27,0,28,1
1653298468730,HILD 7A,A03,088033,Graham; Jessica Lynn,27,0,28,1
1653298468730,HILD 7A,A04,088034,Graham; Jessica Lynn,26,0,28,2
1653298468730,HILD 7A,A05,088035,Graham; Jessica Lynn,26,0,28,2
1653298468730,HILD 7A,A06,088037,Graham; Jessica Lynn,22,0,28,6
1653298468730,HILD 7A,A07,088038,Graham; Jessica Lynn,28,0,28,0
1653298468730,HILD 7A,A08,088039,Graham; Jessica Lynn,28,0,28,0
1653298468730,HILD 7A,A09,088040,Graham; Jessica Lynn,27,0,28,1
1653298468730,HILD 7A,A10,088041,Graham; Jessica Lynn,28,0,28,0
1653298468730,HILD 7A,A11,088042,Graham; Jessica Lynn,28,0,28,0
1653298468730,HILD 7A,A12,088043,Graham; Jessica Lynn,28,0,28,0
1653298469270,HILD 10,A01,088045,Muscolino; Micah S,27,0,28,1
1653298469270,HILD 10,A02,088046,Muscolino; Micah S,27,0,28,1
1653298469270,HILD 10,A03,088047,Muscolino; Micah S,28,0,28,0
1653298469270,HILD 10,A04,088048,Muscolino; Micah S,27,0,28,1
1653298469270,HILD 10,A05,088049,Muscolino; Micah S,28,0,28,0
1653298469270,HILD 10,A06,088050,Muscolino; Micah S,27,0,28,1
1653298469802,HILD 30,A01,088052,Edington; Claire Ellen,24,0,28,4
1653298469802,HILD 30,A02,088053,Edington; Claire Ellen,28,0,28,0
1653298470330,HILD 41,A01,088055,Devereux; Andrew W,28,0,28,0
1653298470330,HILD 41,A02,088056,Devereux; Andrew W,28,0,28,0
1653298470857,HINE 116,A00,088070,Kayali; Hasan,47,0,50,3
1653298471384,HINE 144,A00,088071,Provence; Michael,40,0,45,5
1653298471908,HISC 106,A00,088072,Pineda De Avila; Nydia,47,0,50,3
1653298472434,HISC 115,A00,088073,Gere; Catherina M.,103,0,110,7
1653298472959,HITO 87,A00,094352,Patterson; Patrick H.,20,0,20,0
1653298472959,HITO 87,C00,094354,Patterson; Patrick H.,20,0,20,0
1653298472959,HITO 87,B00,094353,Hanna; Mark G.,20,0,20,0
1653298473492,HITO 100,A00,088074,Hanna; Mark G.,8,0,12,4
1653298474017,HITO 193,A00,091603,Hill; Seth J,9999,0,9999,0
1653298474543,HITO 196,A00,088075,Hendrickson; Gerald M.,20,0,20,0
1653298475068,HIUS 108B,A00,088076,Klann; Mary Cameron,48,0,51,3
1653298475591,HIUS 112,A00,088077,Plant; Rebecca Jo,144,0,148,4
1653298476115,HIUS 152A,A00,088078,Vandevelde; Kenneth Joseph,40,0,45,5
1653298476638,HIUS 155,A00,088079,Alvarez; Luis A,37,0,45,8
1653298477161,HIUS 183,A00,088080,Graham; Jessica Lynn,19,0,20,1
1653298477690,HUM 3,A01,087224,West; Geoffrey Scott,27,0,28,1
1653298477690,HUM 3,A02,087225,West; Geoffrey Scott,28,0,28,0
1653298477690,HUM 3,A03,087226,West; Geoffrey Scott,26,0,28,2
1653298477690,HUM 3,A04,087227,West; Geoffrey Scott,27,0,28,1
1653298477690,HUM 3,A05,087228,West; Geoffrey Scott,27,0,28,1
1653298477690,HUM 3,A06,087229,West; Geoffrey Scott,24,0,28,4
1653298477690,HUM 3,A07,087230,West; Geoffrey Scott,27,0,28,1
1653298477690,HUM 3,A08,087231,West; Geoffrey Scott,28,0,28,0
1653298477690,HUM 3,B01,087233,Staff,28,0,28,0
1653298477690,HUM 3,B02,087234,Staff,28,0,28,0
1653298477690,HUM 3,B03,087235,Staff,28,0,28,0
1653298477690,HUM 3,B04,087236,Staff,28,0,28,0
1653298477690,HUM 3,B05,087237,Staff,28,0,28,0
1653298477690,HUM 3,B06,087238,Staff,28,0,28,0
1653298477690,HUM 3,B07,087239,Staff,0,0,0,0
1653298477690,HUM 3,B08,087240,Staff,0,0,0,0
1653298477690,HUM 3,B09,087241,Staff,30,0,30,0
1653298477690,HUM 3,B10,087242,Staff,28,0,30,2
1653298477690,HUM 3,C01,087244,Patterson; Patrick H.,0,0,0,0
1653298477690,HUM 3,C02,087245,Patterson; Patrick H.,0,0,0,0
1653298477690,HUM 3,C03,087246,Patterson; Patrick H.,23,0,28,5
1653298477690,HUM 3,C04,087247,Patterson; Patrick H.,28,0,28,0
1653298477690,HUM 3,C05,087248,Patterson; Patrick H.,27,0,28,1
1653298477690,HUM 3,C06,087249,Patterson; Patrick H.,25,0,28,3
1653298477690,HUM 3,C07,087250,Patterson; Patrick H.,27,0,28,1
1653298477690,HUM 3,C08,087251,Patterson; Patrick H.,28,0,28,0
1653298477690,HUM 3,C09,087252,Patterson; Patrick H.,28,0,28,0
1653298477690,HUM 3,C10,087253,Patterson; Patrick H.,27,0,28,1
1653298477690,HUM 3,D01,087255,Lyon; Antony J.,24,0,28,4
1653298477690,HUM 3,D02,087256,Lyon; Antony J.,28,0,28,0
1653298477690,HUM 3,D03,087257,Lyon; Antony J.,0,0,0,0
1653298477690,HUM 3,D04,087258,Lyon; Antony J.,0,0,0,0
1653298477690,HUM 3,D05,087259,Lyon; Antony J.,27,0,28,1
1653298477690,HUM 3,D06,087260,Lyon; Antony J.,28,0,28,0
1653298477690,HUM 3,D07,087261,Lyon; Antony J.,21,0,28,7
1653298477690,HUM 3,D08,087262,Lyon; Antony J.,20,0,28,8
1653298477690,HUM 3,D09,087263,Lyon; Antony J.,28,0,28,0
1653298477690,HUM 3,D10,087264,Lyon; Antony J.,27,0,28,1
1653298477690,HUM 3,D11,087265,Lyon; Antony J.,30,0,30,0
1653298477690,HUM 3,D12,087266,Lyon; Antony J.,30,0,30,0
1653298477690,HUM 3,D13,087267,Lyon; Antony J.,26,0,28,2
1653298477690,HUM 3,D14,087268,Lyon; Antony J.,25,0,28,3
1653298478213,INTL 101,A01,088176,Day; Joel Keith,19,0,20,1
1653298478213,INTL 101,A02,088177,Day; Joel Keith,20,0,20,0
1653298478213,INTL 101,A03,088178,Day; Joel Keith,17,0,20,3
1653298478213,INTL 101,A04,088179,Day; Joel Keith,19,0,20,1
1653298478213,INTL 101,A05,088180,Day; Joel Keith,19,0,20,1
1653298478213,INTL 101,A06,088181,Day; Joel Keith,18,0,20,2
1653298478743,INTL 102,A01,088183,Walter; Barbara Florence,19,0,20,1
1653298478743,INTL 102,A02,088184,Walter; Barbara Florence,19,0,20,1
1653298478743,INTL 102,A03,088185,Walter; Barbara Florence,18,0,20,2
1653298478743,INTL 102,A04,088186,Walter; Barbara Florence,16,0,20,4
1653298478743,INTL 102,A05,088187,Walter; Barbara Florence,19,0,20,1
1653298478743,INTL 102,A06,088188,Walter; Barbara Florence,19,0,20,1
1653298479268,INTL 190,A00,088189,Auerbach; Bradford C,0,0,0,0
1653298479268,INTL 190,B00,088190,Auerbach; Bradford C,0,0,0,0
1653298479268,INTL 190,C00,088191,Fortier; Jana,0,0,0,0
1653298479268,INTL 190,D00,088192,Kshatriya; Krista C,0,0,0,0
1653298479268,INTL 190,E00,088193,Nadkarni; Vidya,0,0,0,0
1653298479268,INTL 190,F00,088194,Scott; Jeffrey F,0,0,0,0
1653298479268,INTL 190,G00,088195,Segui; Alan S,0,0,0,0
1653298479268,INTL 190,H00,088196,Segui; Alan S,0,0,0,0
1653298479797,INTL 190H,A00,088197,Gibson; Clark C,0,0,0,0
1653298480354,JAPN 10A,A01,086851,Maruyama; Rie,15,0,15,0
1653298480354,JAPN 10A,A02,086852,Maruyama; Rie,15,0,15,0
1653298480354,JAPN 10A,B01,086854,Staff,13,0,13,0
1653298480354,JAPN 10A,B02,086855,Staff,13,0,13,0
1653298480354,JAPN 10A,C01,086857,McKee; Mayumi Mochizuki,13,0,13,0
1653298480354,JAPN 10A,C02,086858,McKee; Mayumi Mochizuki,11,0,13,2
1653298480354,JAPN 10A,D01,086860,Sato; Kyoko,13,0,13,0
1653298480354,JAPN 10A,D02,086861,Sato; Kyoko,13,0,13,0
1653298480354,JAPN 10A,E01,086863,Kamioka; Sachiko,12,0,13,1
1653298480354,JAPN 10A,E02,086864,Kamioka; Sachiko,12,0,13,1
1653298480354,JAPN 10A,F01,086866,Sato; Kyoko,13,0,13,0
1653298480354,JAPN 10A,F02,086867,Sato; Kyoko,13,0,13,0
1653298480354,JAPN 10A,G01,086869,Maruyama; Rie,8,0,13,5
1653298480354,JAPN 10A,G02,086870,Maruyama; Rie,13,0,13,0
1653298480354,JAPN 10A,H01,086872,Kamioka; Sachiko,12,0,13,1
1653298480354,JAPN 10A,H02,086873,Kamioka; Sachiko,11,0,13,2
1653298480354,JAPN 10A,I01,086875,Staff,12,0,13,1
1653298480354,JAPN 10A,I02,086876,Staff,13,0,13,0
1653298480354,JAPN 10A,J01,086878,McKee; Mayumi Mochizuki,12,0,13,1
1653298480354,JAPN 10A,J02,086879,McKee; Mayumi Mochizuki,13,0,13,0
1653298480354,JAPN 10A,K01,086881,Inada; Minori,13,0,13,0
1653298480354,JAPN 10A,K02,086882,Inada; Minori,12,0,13,1
1653298480354,JAPN 10A,L01,086884,Tipton; Yuko,13,0,13,0
1653298480354,JAPN 10A,L02,086885,Tipton; Yuko,13,0,13,0
1653298480354,JAPN 10A,M01,086887,Inada; Minori,12,0,13,1
1653298480354,JAPN 10A,M02,086888,Inada; Minori,13,0,13,0
1653298480354,JAPN 10A,N01,086890,McKee; Mayumi Mochizuki,13,0,13,0
1653298480354,JAPN 10A,N02,086891,McKee; Mayumi Mochizuki,11,0,13,2
1653298480354,JAPN 10A,O01,086893,Staff,13,0,13,0
1653298480354,JAPN 10A,O02,086894,Staff,12,0,13,1
1653298480354,JAPN 10A,P01,086896,Tipton; Yuko,15,0,15,0
1653298480354,JAPN 10A,P02,086897,Tipton; Yuko,15,0,15,0
1653298480892,JAPN 20A,A01,086899,Simpson; Junko Tokuda,11,0,13,2
1653298480892,JAPN 20A,A02,086900,Simpson; Junko Tokuda,12,0,13,1
1653298480892,JAPN 20A,B01,086902,Takeda; Izumi,11,0,13,2
1653298480892,JAPN 20A,B02,086903,Takeda; Izumi,12,0,13,1
1653298480892,JAPN 20A,C01,086905,Ross; Kayoko F,12,0,13,1
1653298480892,JAPN 20A,C02,086906,Ross; Kayoko F,12,0,13,1
1653298480892,JAPN 20A,D01,086908,Takeda; Izumi,10,0,13,3
1653298480892,JAPN 20A,D02,086909,Takeda; Izumi,13,0,13,0
1653298480892,JAPN 20A,E01,086911,Maruyama; Rie,11,0,13,2
1653298480892,JAPN 20A,E02,086912,Maruyama; Rie,11,0,13,2
1653298480892,JAPN 20A,F01,086914,Kamioka; Sachiko,7,0,13,6
1653298480892,JAPN 20A,F02,086915,Kamioka; Sachiko,9,0,13,4
1653298480892,JAPN 20A,G01,086917,Ross; Kayoko F,13,0,13,0
1653298480892,JAPN 20A,G02,086918,Ross; Kayoko F,12,0,13,1
1653298481416,JAPN 130A,A01,086920,Simpson; Junko Tokuda,6,0,10,4
1653298481416,JAPN 130A,A02,086921,Simpson; Junko Tokuda,5,0,10,5
1653298481416,JAPN 130A,B01,086923,Ross; Kayoko F,9,0,10,1
1653298481416,JAPN 130A,B02,086924,Ross; Kayoko F,9,0,10,1
1653298481941,JAPN 135A,A00,086925,Inada; Minori,14,0,15,1
1653298481941,JAPN 135A,B00,086926,Takeda; Izumi,15,0,15,0
1653298482473,JAPN 140A,A00,086927,Sato; Kyoko,19,0,20,1
1653298482996,JWSP 1,A01,086445,Shuster; Alana,15,0,15,0
1653298482996,JWSP 1,A02,086446,Shuster; Alana,15,0,15,0
1653298483525,JWSP 104,A01,086448,Shuster; Alana,15,0,15,0
1653298484055,LATI 10,A01,093588,Kennemore; Amy Michelle,31,0,32,1
1653298484055,LATI 10,A02,093589,Kennemore; Amy Michelle,32,0,32,0
1653298484055,LATI 10,A03,093590,Kennemore; Amy Michelle,32,0,32,0
1653298484581,LATI 50,A01,093592,Kokinis; Troy Andreas,32,0,32,0
1653298484581,LATI 50,A02,093593,Kokinis; Troy Andreas,31,0,32,1
1653298484581,LATI 50,A03,093595,Kokinis; Troy Andreas,32,0,32,0
1653298485107,LATI 122A,A00,093649,Andrews; Abigail Leslie,0,0,0,0
1653298485635,LATI 180,A00,093597,Staff,36,0,40,4
1653298486161,LIAB 1A,A00,087085,Saab; Dima,13,0,14,1
1653298486161,LIAB 1A,B00,087086,Saab; Dima,13,0,14,1
1653298486161,LIAB 1A,C00,087087,Saab; Dima,14,0,14,0
1653298486161,LIAB 1A,D00,087088,El Cheddadi; Youniss,14,0,14,0
1653298486689,LIAB 1AX,A00,087089,Akjeje; Abdelhak,28,0,28,0
1653298486689,LIAB 1AX,B00,087091,Akjeje; Abdelhak,28,0,28,0
1653298487217,LIAB 1D,A00,087093,El Cheddadi; Youniss,13,0,14,1
1653298487217,LIAB 1D,B00,087094,El Cheddadi; Youniss,12,0,14,2
1653298487742,LIAB 1DX,A00,087095,Akjeje; Abdelhak,27,0,28,1
1653298488267,LIDS 19,001,095098,Goodall; Grant Todd,9999,0,9999,0
1653298488267,LIDS 19,002,095099,Goodall; Grant Todd,9999,0,9999,0
1653298488267,LIDS 19,003,095100,Goodall; Grant Todd,9999,0,9999,0
1653298488267,LIDS 19,004,095101,Goodall; Grant Todd,9999,0,9999,0
1653298488267,LIDS 19,005,095102,Goodall; Grant Todd,9999,0,9999,0
1653298488267,LIDS 19,006,095103,Goodall; Grant Todd,9999,0,9999,0
1653298488267,LIDS 19,007,095104,Goodall; Grant Todd,9999,0,9999,0
1653298488267,LIDS 19,008,095105,Goodall; Grant Todd,9999,0,9999,0
1653298488267,LIDS 19,009,095106,Goodall; Grant Todd,9999,0,9999,0
1653298488267,LIDS 19,010,095107,Goodall; Grant Todd,9999,0,9999,0
1653298488267,LIDS 19,011,095108,Goodall; Grant Todd,9999,0,9999,0
1653298488267,LIDS 19,012,095109,Goodall; Grant Todd,9999,0,9999,0
1653298488795,LIFR 1A,A00,087097,Goodall; Grant Todd,13,0,14,1
1653298488795,LIFR 1A,B00,087098,Goodall; Grant Todd,13,0,14,1
1653298488795,LIFR 1A,C00,087099,Goodall; Grant Todd,12,0,14,2
1653298488795,LIFR 1A,D00,087100,Goodall; Grant Todd,12,0,14,2
1653298488795,LIFR 1A,E00,087101,Goodall; Grant Todd,14,0,14,0
1653298488795,LIFR 1A,F00,087102,Goodall; Grant Todd,13,0,14,1
1653298489320,LIFR 1AX,A00,087103,Goodall; Grant Todd,27,0,28,1
1653298489320,LIFR 1AX,B00,087104,Goodall; Grant Todd,27,0,28,1
1653298489320,LIFR 1AX,C00,087105,Goodall; Grant Todd,25,0,28,3
1653298489844,LIFR 1B,A00,087106,Goodall; Grant Todd,14,0,14,0
1653298489844,LIFR 1B,B00,087107,Goodall; Grant Todd,13,0,14,1
1653298489844,LIFR 1B,C00,087108,Goodall; Grant Todd,13,0,14,1
1653298489844,LIFR 1B,D00,087109,Goodall; Grant Todd,13,0,14,1
1653298490371,LIFR 1BX,A00,087110,Goodall; Grant Todd,26,0,28,2
1653298490371,LIFR 1BX,B00,087111,Goodall; Grant Todd,26,0,28,2
1653298490908,LIFR 1D,A00,087112,Goodall; Grant Todd,14,0,14,0
1653298490908,LIFR 1D,B00,087113,Goodall; Grant Todd,12,0,14,2
1653298490908,LIFR 1D,C00,087114,Goodall; Grant Todd,11,0,14,3
1653298490908,LIFR 1D,D00,087115,Goodall; Grant Todd,10,0,14,4
1653298491437,LIFR 1DX,A00,087116,Goodall; Grant Todd,26,0,28,2
1653298491437,LIFR 1DX,B00,087117,Goodall; Grant Todd,23,0,28,5
1653298491959,LIFR 11,A00,087118,Goodall; Grant Todd,10,0,10,0
1653298492485,LIGM 1A,A00,087119,Riebeling; Elke,14,0,14,0
1653298492485,LIGM 1A,B00,087120,Riebeling; Elke,14,0,14,0
1653298492485,LIGM 1A,C00,087121,Riebeling; Elke,12,0,14,2
1653298492485,LIGM 1A,D00,087122,Riebeling; Elke,14,0,14,0
1653298492485,LIGM 1A,E00,087123,Riebeling; Elke,14,0,14,0
1653298493009,LIGM 1AX,A00,087124,Riebeling; Elke,28,0,28,0
1653298493009,LIGM 1AX,B00,087125,Riebeling; Elke,28,0,28,0
1653298493009,LIGM 1AX,C00,087126,Riebeling; Elke,27,0,28,1
1653298493536,LIGM 1D,A00,087127,Riebeling; Elke,14,0,14,0
1653298493536,LIGM 1D,B00,087128,Riebeling; Elke,12,0,14,2
1653298494063,LIGM 1DX,A00,087129,Riebeling; Elke,26,0,28,2
1653298494590,LIGM 11,A00,087130,Goodall; Grant Todd,10,0,10,0
1653298495116,LIGN 5,A00,087005,Goodall; Grant Todd,74,0,75,1
1653298495645,LIGN 7,A00,087006,Mayberry; Rachel,139,0,146,7
1653298496174,LIGN 8,A00,087007,McIntosh; Justin Daniel,244,0,250,6
1653298496701,LIGN 17,A00,087008,Kehler; Andrew Scott,218,0,220,2
1653298497236,LIGN 101,A01,087010,Styler; William Francis,29,0,30,1
1653298497236,LIGN 101,A02,087011,Styler; William Francis,29,0,30,1
1653298497236,LIGN 101,A03,087012,Styler; William Francis,29,0,30,1
1653298497236,LIGN 101,A04,087013,Styler; William Francis,29,0,30,1
1653298497762,LIGN 110,A01,087015,Garellek; Marc,29,0,30,1
1653298497762,LIGN 110,A02,087016,Garellek; Marc,26,0,30,4
1653298497762,LIGN 110,A03,087017,Garellek; Marc,26,0,30,4
1653298497762,LIGN 110,A04,087018,Garellek; Marc,28,0,30,2
1653298498289,LIGN 121,A01,087020,Drake; Emily C,23,0,25,2
1653298498289,LIGN 121,A02,087021,Drake; Emily C,24,0,25,1
1653298498815,LIGN 150,A00,093702,Staff,71,0,75,4
1653298499338,LIGN 152,A00,087023,Caballero; Gabriela Hernandez,16,0,20,4
1653298499865,LIGN 154,A00,087024,Kluender; Robert,70,0,70,0
1653298500388,LIGN 167,A00,087025,Bergen; Leon,70,0,100,30
1653298500912,LIGN 187,A00,087026,McIntosh; Justin Daniel,20,0,20,0
1653298501441,LIHL 112F,A00,086505,Alicio; Atilio,25,0,28,3
1653298501964,LIHL 114F,A00,086506,Staff,21,0,28,7
1653298502489,LIHL 117F,A00,086508,Sadegholvad; Elham,20,0,20,0
1653298503017,LIHL 118,A00,086509,Staff,25,0,28,3
1653298503540,LIHL 119F,A00,086510,Staff,26,0,28,2
1653298504063,LIHL 124F,A00,086511,Staff,27,0,28,1
1653298504589,LIHL 132F,A00,086512,Alicio; Atilio,28,0,28,0
1653298505113,LIIT 1A,A00,087131,Riebeling; Elke,14,0,14,0
1653298505113,LIIT 1A,B00,087132,Riebeling; Elke,14,0,14,0
1653298505113,LIIT 1A,C00,087133,Riebeling; Elke,12,0,14,2
1653298505113,LIIT 1A,D00,087134,Riebeling; Elke,14,0,14,0
1653298505642,LIIT 1AX,A00,087135,Riebeling; Elke,28,0,28,0
1653298505642,LIIT 1AX,B00,087136,Riebeling; Elke,26,0,28,2
1653298506170,LIPO 1A,A00,087137,Paladini; Denise,14,0,14,0
1653298506170,LIPO 1A,B00,087138,Paladini; Denise,10,0,14,4
1653298506694,LIPO 1AX,A00,087139,De Abreu; Cassia,18,0,22,4
1653298506694,LIPO 1AX,B00,087140,De Abreu; Cassia,22,0,22,0
1653298507219,LIPO 1D,A00,087141,Paladini; Denise,10,0,14,4
1653298507742,LIPO 1DX,A00,087143,De Abreu; Cassia,10,0,14,4
1653298508268,LISL 1A,A00,087145,Lott; Margaret S.,10,0,14,4
1653298508268,LISL 1A,B00,087146,Lott; Margaret S.,14,0,14,0
1653298508268,LISL 1A,C00,087147,Lott; Margaret S.,10,0,14,4
1653298508268,LISL 1A,D00,087148,Lott; Margaret S.,11,0,14,3
1653298508268,LISL 1A,E00,087149,Lott; Margaret S.,13,0,14,1
1653298508268,LISL 1A,F00,087150,Lott; Margaret S.,12,0,14,2
1653298508268,LISL 1A,G00,087151,Lott; Margaret S.,13,0,14,1
1653298508268,LISL 1A,H00,087152,Lott; Margaret S.,13,0,14,1
1653298508805,LISL 1AX,A00,087153,Lott; Margaret S.,28,0,28,0
1653298508805,LISL 1AX,B00,087154,Lott; Margaret S.,25,0,28,3
1653298508805,LISL 1AX,C00,087155,Lott; Margaret S.,25,0,28,3
1653298508805,LISL 1AX,D00,087156,Lott; Margaret S.,24,0,28,4
1653298509400,LISL 1B,A00,087157,Lott; Margaret S.,13,0,14,1
1653298509400,LISL 1B,B00,087158,Lott; Margaret S.,12,0,14,2
1653298509400,LISL 1B,C00,087159,Lott; Margaret S.,11,0,14,3
1653298509400,LISL 1B,D00,087160,Lott; Margaret S.,13,0,14,1
1653298509400,LISL 1B,E00,087161,Lott; Margaret S.,13,0,14,1
1653298509400,LISL 1B,F00,087162,Lott; Margaret S.,13,0,14,1
1653298509926,LISL 1BX,A00,087163,Lott; Margaret S.,23,0,28,5
1653298509926,LISL 1BX,B00,087164,Lott; Margaret S.,26,0,28,2
1653298509926,LISL 1BX,C00,087165,Lott; Margaret S.,28,0,28,0
1653298510450,LISL 1D,A00,087166,Lott; Margaret S.,14,0,14,0
1653298510450,LISL 1D,B00,087167,Lott; Margaret S.,14,0,14,0
1653298510450,LISL 1D,C00,087168,Lott; Margaret S.,8,0,14,6
1653298510450,LISL 1D,D00,087169,Lott; Margaret S.,13,0,14,1
1653298510978,LISL 1DX,A00,087170,Lott; Margaret S.,23,0,28,5
1653298510978,LISL 1DX,B00,087171,Lott; Margaret S.,26,0,28,2
1653298511504,LISP 1A,001,087172,Munoz Sanchez; Alicia,13,0,14,1
1653298511504,LISP 1A,002,087173,Munoz Sanchez; Alicia,12,0,14,2
1653298511504,LISP 1A,003,087174,Munoz Sanchez; Alicia,13,0,14,1
1653298511504,LISP 1A,004,087175,Munoz Sanchez; Alicia,12,0,14,2
1653298511504,LISP 1A,005,087176,Munoz Sanchez; Alicia,10,0,14,4
1653298511504,LISP 1A,006,087177,Munoz Sanchez; Alicia,12,0,14,2
1653298511504,LISP 1A,007,087178,Munoz Sanchez; Alicia,12,0,14,2
1653298511504,LISP 1A,008,087179,Munoz Sanchez; Alicia,14,0,14,0
1653298512028,LISP 1AX,A00,087180,Munoz Sanchez; Alicia,27,0,28,1
1653298512028,LISP 1AX,B00,087181,Munoz Sanchez; Alicia,24,0,28,4
1653298512028,LISP 1AX,C00,087182,Munoz Sanchez; Alicia,25,0,28,3
1653298512028,LISP 1AX,D00,087183,Munoz Sanchez; Alicia,25,0,28,3
1653298512554,LISP 1B,001,087184,Munoz Sanchez; Alicia,14,0,14,0
1653298512554,LISP 1B,002,087185,Munoz Sanchez; Alicia,14,0,14,0
1653298512554,LISP 1B,003,087186,Munoz Sanchez; Alicia,11,0,14,3
1653298512554,LISP 1B,004,087187,Munoz Sanchez; Alicia,12,0,14,2
1653298512554,LISP 1B,005,087188,Munoz Sanchez; Alicia,13,0,14,1
1653298512554,LISP 1B,006,087189,Munoz Sanchez; Alicia,13,0,14,1
1653298512554,LISP 1B,007,087190,Munoz Sanchez; Alicia,14,0,14,0
1653298512554,LISP 1B,008,087191,Munoz Sanchez; Alicia,13,0,14,1
1653298512554,LISP 1B,009,087192,Munoz Sanchez; Alicia,14,0,14,0
1653298512554,LISP 1B,010,087193,Munoz Sanchez; Alicia,13,0,14,1
1653298512554,LISP 1B,011,087194,Munoz Sanchez; Alicia,14,0,14,0
1653298513085,LISP 1BX,A00,087195,Munoz Sanchez; Alicia,28,0,28,0
1653298513085,LISP 1BX,B00,087196,Munoz Sanchez; Alicia,26,0,28,2
1653298513085,LISP 1BX,C00,087197,Munoz Sanchez; Alicia,26,0,28,2
1653298513085,LISP 1BX,D00,087198,Munoz Sanchez; Alicia,26,0,28,2
1653298513085,LISP 1BX,E00,087199,Munoz Sanchez; Alicia,28,0,28,0
1653298513616,LISP 1D,001,087200,Munoz Sanchez; Alicia,13,0,14,1
1653298513616,LISP 1D,002,087201,Munoz Sanchez; Alicia,14,0,14,0
1653298513616,LISP 1D,003,087202,Munoz Sanchez; Alicia,8,0,14,6
1653298513616,LISP 1D,004,087203,Munoz Sanchez; Alicia,5,0,14,9
1653298513616,LISP 1D,005,087204,Munoz Sanchez; Alicia,11,0,14,3
1653298513616,LISP 1D,006,087205,Munoz Sanchez; Alicia,13,0,14,1
1653298513616,LISP 1D,007,087206,Munoz Sanchez; Alicia,13,0,14,1
1653298513616,LISP 1D,008,087207,Munoz Sanchez; Alicia,13,0,14,1
1653298513616,LISP 1D,009,087208,Munoz Sanchez; Alicia,14,0,14,0
1653298513616,LISP 1D,010,087209,Munoz Sanchez; Alicia,12,0,14,2
1653298513616,LISP 1D,011,087210,Munoz Sanchez; Alicia,13,0,14,1
1653298513616,LISP 1D,012,087211,Munoz Sanchez; Alicia,14,0,14,0
1653298513616,LISP 1D,013,087212,Munoz Sanchez; Alicia,14,0,14,0
1653298513616,LISP 1D,014,087213,Munoz Sanchez; Alicia,14,0,14,0
1653298514140,LISP 1DX,A00,087214,Munoz Sanchez; Alicia,27,0,28,1
1653298514140,LISP 1DX,B00,087215,Munoz Sanchez; Alicia,23,0,28,5
1653298514140,LISP 1DX,C00,087216,Munoz Sanchez; Alicia,23,0,28,5
1653298514140,LISP 1DX,D00,087217,Munoz Sanchez; Alicia,25,0,28,3
1653298514140,LISP 1DX,E00,087218,Munoz Sanchez; Alicia,27,0,28,1
1653298514140,LISP 1DX,F00,087219,Munoz Sanchez; Alicia,25,0,28,3
1653298514140,LISP 1DX,G00,087220,Munoz Sanchez; Alicia,28,0,28,0
1653298514667,LISP 15,A00,087221,Munoz Sanchez; Alicia,19,0,20,1
1653298515191,LISP 18,A00,087222,Munoz Sanchez; Alicia,15,0,20,5
1653298515720,LTAM 110,A00,087352,Chacon; Gloria Elizabeth,35,0,40,5
1653298516243,LTCS 87,A00,094011,Nguyen; Hoang Tan,19,0,20,1
1653298516767,LTCS 111,A00,087353,Vitkus; Daniel J.,40,0,40,0
1653298517293,LTCS 119,A00,087354,Nguyen; Hoang Tan,29,0,30,1
1653298517818,LTCS 130,A00,087355,Kim; Joo Ok,37,0,40,3
1653298518341,LTCS 165,A00,087356,Kim; Joo Ok,38,0,40,2
1653298518869,LTEA 120A,A00,087357,Fiss; Geraldine Anna,291,0,300,9
1653298519392,LTEA 140,A00,094009,Lee; Jin-Kyung,28,0,32,4
1653298519915,LTEA 142,A00,087358,Lee; Jin-Kyung,103,0,120,17
1653298520442,LTEN 21,A01,087275,Lampert-Weissig; Lisa,25,0,25,0
1653298520442,LTEN 21,A02,087276,Lampert-Weissig; Lisa,25,0,25,0
1653298520442,LTEN 21,A03,087277,Lampert-Weissig; Lisa,25,0,25,0
1653298520442,LTEN 21,A04,087278,Lampert-Weissig; Lisa,25,0,25,0
1653298520966,LTEN 25,A01,087280,Johnson; Sara E.,25,0,25,0
1653298520966,LTEN 25,A02,087281,Johnson; Sara E.,25,0,25,0
1653298520966,LTEN 25,A03,087282,Johnson; Sara E.,23,0,25,2
1653298520966,LTEN 25,A04,087283,Johnson; Sara E.,25,0,25,0
1653298521496,LTEN 29,A01,087285,Ruiz; Ariana,24,0,25,1
1653298521496,LTEN 29,A02,087286,Ruiz; Ariana,25,0,25,0
1653298521496,LTEN 29,A03,087287,Ruiz; Ariana,24,0,25,1
1653298521496,LTEN 29,A04,087288,Ruiz; Ariana,24,0,25,1
1653298522020,LTEN 107,A00,087359,Lampert-Weissig; Lisa,39,0,40,1
1653298522543,LTEN 117,A00,087360,Vitkus; Daniel J.,40,0,40,0
1653298523068,LTEN 127,A00,087361,Loose; Margaret,38,0,40,2
1653298523592,LTEN 142,A00,094010,Loose; Margaret,38,0,40,2
1653298524118,LTEN 148,A00,087363,Walkiewicz; Kathryn A,40,0,40,0
1653298524644,LTEN 152,A00,087364,Walkiewicz; Kathryn A,37,0,40,3
1653298525168,LTEN 180,A00,087365,Ruiz; Ariana,18,0,20,2
1653298525694,LTFR 2A,A01,087290,Ploye; Catherine,23,0,25,2
1653298526223,LTFR 2B,A01,087292,Ploye; Catherine,25,0,25,0
1653298526750,LTFR 104,A00,087366,Ploye; Catherine,25,0,25,0
1653298527280,LTFR 116,A00,087367,Zhiri; Oumelbanine,13,0,15,2
1653298527804,LTGK 1,A00,087293,Myerston Santana; Jacobo,27,0,30,3
1653298528328,LTGK 103,A00,087368,duBois; Page Ann,14,0,15,1
1653298528852,LTGM 2A,A01,087295,Fischer-Grunski; Eva K,24,0,25,1
1653298529377,LTIT 2A,A01,087297,De Marchi Gherini; Adriana,24,0,25,1
1653298529903,LTKO 1A,A01,087299,Staff,24,0,25,1
1653298529903,LTKO 1A,B01,087301,Staff,25,0,25,0
1653298529903,LTKO 1A,C01,087303,Staff,25,0,25,0
1653298529903,LTKO 1A,D01,087305,Staff,25,0,25,0
1653298529903,LTKO 1A,E01,087307,Staff,24,0,25,1
1653298529903,LTKO 1A,F01,087309,Staff,25,0,25,0
1653298529903,LTKO 1A,G01,087311,Staff,25,0,25,0
1653298529903,LTKO 1A,H01,087313,Staff,24,0,25,1
1653298529903,LTKO 1A,I01,087315,Staff,25,0,25,0
1653298530427,LTKO 2A,A01,087317,Staff,24,0,25,1
1653298530427,LTKO 2A,B01,087319,Staff,22,0,25,3
1653298530427,LTKO 2A,C01,087321,Lee; Jeyseon,24,0,25,1
1653298530955,LTKO 130,A00,087369,Lee; Jeyseon,25,0,25,0
1653298531479,LTLA 1,A00,087322,Murray; Kourtney Kristine,38,0,40,2
1653298532015,LTLA 100,A00,087371,Kelting; Edward William,23,0,25,2
1653298532540,LTRU 1A,A01,087324,Wells; Patricia Rebecca,23,0,25,2
1653298533063,LTRU 2A,A01,087326,Wells; Patricia Rebecca,20,0,20,0
1653298533591,LTRU 104B,A01,087373,Wells; Patricia Rebecca,14,0,15,1
1653298534115,LTSP 2A,A01,087328,Staff,25,0,25,0
1653298534115,LTSP 2A,B01,087330,Staff,22,0,25,3
1653298534115,LTSP 2A,C01,087332,Staff,22,0,25,3
1653298534642,LTSP 2B,A01,087334,Staff,22,0,25,3
1653298534642,LTSP 2B,B01,087336,Staff,19,0,25,6
1653298535167,LTSP 2D,A00,087337,Staff,25,0,25,0
1653298535167,LTSP 2D,B00,087338,Staff,25,0,25,0
1653298535167,LTSP 2D,C00,087339,Staff,25,0,25,0
1653298535692,LTSP 100A,A00,087374,Arcos Herrera; Carol,23,0,25,2
1653298536219,LTSP 116,A00,087375,Blanco; John D,29,0,30,1
1653298536744,LTSP 140,A00,087376,Chacon; Gloria Elizabeth,30,0,30,0
1653298537268,LTSP 175,A00,087377,Arcos Herrera; Carol,30,0,30,0
1653298537795,LTTH 150,A00,087379,Cohen; Alain J. J.,40,0,40,0
1653298538319,LTWL 19A,A00,087340,Myerston Santana; Jacobo,39,0,40,1
1653298538846,LTWL 87,A00,094012,Lampert-Weissig; Lisa,20,0,20,0
1653298539369,LTWL 116,A00,087380,Nguyen; Hoang Tan,60,0,60,0
1653298539893,LTWL 120,A00,087381,Fiss; Geraldine Anna,37,0,40,3
1653298540417,LTWL 172,A00,087382,De Marchi Gherini; Adriana,40,0,40,0
1653298540943,LTWL 180,A00,087383,Kontje; Todd Curtis,39,0,40,1
1653298541466,LTWL 194,A00,087384,Suzuki; Erin M.,31,0,32,1
1653298541991,LTWR 8A,A01,087342,Jemc; Jaclyn,24,0,25,1
1653298541991,LTWR 8A,A02,087343,Jemc; Jaclyn,25,0,25,0
1653298541991,LTWR 8A,A03,087344,Jemc; Jaclyn,24,0,25,1
1653298541991,LTWR 8A,A04,087345,Jemc; Jaclyn,24,0,25,1
1653298542519,LTWR 8C,A01,087348,Forbes; Camille,25,0,25,0
1653298542519,LTWR 8C,A02,087349,Forbes; Camille,25,0,25,0
1653298542519,LTWR 8C,A03,087350,Forbes; Camille,25,0,25,0
1653298542519,LTWR 8C,A04,087351,Forbes; Camille,23,0,25,2
1653298543042,LTWR 100,A00,087385,Staff,12,0,15,3
1653298543567,LTWR 102,A00,087386,Staff,14,0,15,1
1653298544092,LTWR 115,A00,087387,Carroll; Amy Sara,24,0,30,6
1653298544615,LTWR 119,A00,087388,Staff,22,0,30,8
1653298545139,LTWR 140,A00,087389,Carroll; Amy Sara,37,0,40,3
1653298545662,LTWR 194,A00,087390,Som; Brandon D,35,0,40,5
1653298546192,MAE 2,A01,090334,Anderson; Mark Ronald,8,0,8,0
1653298546192,MAE 2,A02,090335,Anderson; Mark Ronald,8,0,8,0
1653298546192,MAE 2,A03,090336,Anderson; Mark Ronald,8,0,8,0
1653298546192,MAE 2,A04,090337,Anderson; Mark Ronald,8,0,8,0
1653298546192,MAE 2,A05,090338,Anderson; Mark Ronald,8,0,8,0
1653298546192,MAE 2,A06,090339,Anderson; Mark Ronald,8,0,8,0
1653298546192,MAE 2,A07,090340,Anderson; Mark Ronald,8,0,8,0
1653298546192,MAE 2,A08,090341,Anderson; Mark Ronald,7,0,8,1
1653298546192,MAE 2,A09,090342,Anderson; Mark Ronald,8,0,8,0
1653298546724,MAE 3,A01,090344,Delson; Nathan Joseph,21,0,22,1
1653298546724,MAE 3,A02,090345,Delson; Nathan Joseph,20,0,22,2
1653298546724,MAE 3,A03,090346,Delson; Nathan Joseph,21,0,22,1
1653298546724,MAE 3,A04,090347,Delson; Nathan Joseph,22,0,22,0
1653298546724,MAE 3,B01,090349,Qi; Huihui,18,0,22,4
1653298546724,MAE 3,B02,090350,Qi; Huihui,17,0,22,5
1653298546724,MAE 3,B03,090351,Qi; Huihui,20,0,22,2
1653298546724,MAE 3,B04,090352,Qi; Huihui,19,0,22,3
1653298547265,MAE 8,A01,090354,Pham; Hieu Tan,182,0,185,3
1653298547789,MAE 11,A00,090355,Nomura; Keiko K.,155,0,165,10
1653298548312,MAE 20,A00,090356,Bandaru; Prabhakar,160,0,160,0
1653298548312,MAE 20,B00,090357,Evdokimenko; Ekaterina,145,0,160,15
1653298548852,MAE 21,A01,090359,Cai; Shengqiang,8,0,9,1
1653298548852,MAE 21,A02,090360,Cai; Shengqiang,9,0,9,0
1653298548852,MAE 21,A03,090361,Cai; Shengqiang,6,0,9,3
1653298548852,MAE 21,A04,090362,Cai; Shengqiang,7,0,9,2
1653298548852,MAE 21,A05,090363,Cai; Shengqiang,0,0,0,0
1653298548852,MAE 21,A06,090364,Cai; Shengqiang,9,0,9,0
1653298548852,MAE 21,A07,090365,Cai; Shengqiang,9,0,9,0
1653298548852,MAE 21,A08,090366,Cai; Shengqiang,8,0,9,1
1653298548852,MAE 21,A09,090367,Cai; Shengqiang,8,0,9,1
1653298548852,MAE 21,A10,090368,Cai; Shengqiang,0,0,0,0
1653298548852,MAE 21,A11,090369,Cai; Shengqiang,9,0,9,0
1653298548852,MAE 21,A12,090370,Cai; Shengqiang,8,0,9,1
1653298549379,MAE 30A,A00,090371,Lal; Ratnesh,72,0,75,3
1653298549902,MAE 40,A00,090372,Bitmead; Robert R.,167,0,175,8
1653298550426,MAE 101A,A00,090373,Bahadori; Mohammad Yousef,105,0,115,10
1653298550969,MAE 101C,A00,090374,Poulikakos; Lisa Voula,41,0,110,69
1653298550969,MAE 101C,B00,090375,Chen; Renkun,96,0,110,14
1653298551497,MAE 104,A00,090376,Sanchez; Antonio Luis,78,0,120,42
1653298552031,MAE 105,A00,090377,Saintillan; David,154,0,170,16
1653298552561,MAE 107,A00,090378,Lindsey; Stephanie,104,0,110,6
1653298552561,MAE 107,B00,090379,Tolley; Michael Thomas,85,0,110,25
1653298553090,MAE 118,A00,090380,Krasheninnikov; Sergei,27,0,45,18
1653298553614,MAE 131A,A00,090381,Ghazinejad; Maziar,70,0,75,5
1653298554137,MAE 133,A00,090382,Frazier; Michael,26,0,33,7
1653298554660,MAE 143A,A00,090383,de Oliveira; Mauricio,74,0,100,26
1653298555186,MAE 144,A00,090384,Bewley; Thomas R,50,0,70,20
1653298555710,MAE 148,A01,091597,Staff,32,0,32,0
1653298556237,MAE 150,A00,090385,Friend; James Robert,69,0,90,21
1653298556237,MAE 150,B00,090386,Ghazinejad; Maziar,4,0,90,86
1653298556762,MAE 152,A00,090387,Tynan; George Robert,0,0,16,16
1653298556762,MAE 152,B00,090388,Tynan; George Robert,0,0,16,16
1653298556762,MAE 152,C00,090389,Tynan; George Robert,0,0,16,16
1653298556762,MAE 152,D00,090390,Tynan; George Robert,0,0,16,16
1653298557305,MAE 156A,A01,090392,Delson; Nathan Joseph,2,0,12,10
1653298557305,MAE 156A,A02,090393,Delson; Nathan Joseph,1,0,12,11
1653298557305,MAE 156A,A03,090394,Delson; Nathan Joseph,4,0,12,8
1653298557837,MAE 170,A01,090396,Lubarda; Marko,14,0,30,16
1653298557837,MAE 170,A02,090397,Lubarda; Marko,19,0,30,11
1653298557837,MAE 170,A03,090398,Lubarda; Marko,28,0,30,2
1653298557837,MAE 170,A04,090399,Lubarda; Marko,20,0,30,10
1653298557837,MAE 170,B01,090401,Diagne; Mamadou Lamine,30,0,30,0
1653298557837,MAE 170,B02,090402,Diagne; Mamadou Lamine,27,0,30,3
1653298557837,MAE 170,B03,090403,Diagne; Mamadou Lamine,28,0,30,2
1653298557837,MAE 170,B04,090404,Diagne; Mamadou Lamine,28,0,30,2
1653298558371,MAE 180A,A00,090405,McEneaney; William Michael,110,0,125,15
1653298558893,MAE 181,A00,090406,Bahadori; Mohammad Yousef,46,0,60,14
1653298559418,MAE 190,A00,090407,Anderson; Mark Ronald,27,0,45,18
1653298559945,MAE 191,A01,090409,Qi; Huihui,25,0,32,7
1653298560471,MATH 2,A01,089123,Hammock; Frances H,0,0,0,0
1653298560471,MATH 2,B01,089126,Hammock; Frances H,0,0,0,0
1653298560471,MATH 2,C01,089129,Hammock; Frances H,0,0,0,0
1653298560471,MATH 2,D01,094201,Harel; Guershon,0,0,0,0
1653298561001,MATH 3C,A01,089132,Bowers; Adam R.,0,0,0,0
1653298561001,MATH 3C,A02,089133,Bowers; Adam R.,0,0,0,0
1653298561001,MATH 3C,A03,089134,Bowers; Adam R.,0,0,0,0
1653298561001,MATH 3C,A04,089135,Bowers; Adam R.,0,0,0,0
1653298561001,MATH 3C,A05,089136,Bowers; Adam R.,0,0,0,0
1653298561001,MATH 3C,A06,089137,Bowers; Adam R.,0,0,0,0
1653298561001,MATH 3C,A07,089138,Bowers; Adam R.,0,0,0,0
1653298561001,MATH 3C,A08,089139,Bowers; Adam R.,0,0,0,0
1653298561001,MATH 3C,A09,089140,Bowers; Adam R.,0,0,0,0
1653298561001,MATH 3C,A10,089141,Bowers; Adam R.,0,0,0,0
1653298561001,MATH 3C,A11,089142,Bowers; Adam R.,0,0,0,0
1653298561001,MATH 3C,A12,089143,Bowers; Adam R.,0,0,0,0
1653298561001,MATH 3C,A13,089144,Bowers; Adam R.,0,0,0,0
1653298561001,MATH 3C,A14,089145,Bowers; Adam R.,0,0,0,0
1653298561001,MATH 3C,A15,089146,Bowers; Adam R.,0,0,0,0
1653298561001,MATH 3C,A16,089147,Bowers; Adam R.,0,0,0,0
1653298561001,MATH 3C,A17,089148,Bowers; Adam R.,0,0,0,0
1653298561001,MATH 3C,A18,089149,Bowers; Adam R.,0,0,0,0
1653298561001,MATH 3C,A19,089150,Bowers; Adam R.,0,0,0,0
1653298561001,MATH 3C,A20,089151,Bowers; Adam R.,0,0,0,0
1653298561001,MATH 3C,A21,089152,Bowers; Adam R.,0,0,0,0
1653298561001,MATH 3C,A22,089153,Bowers; Adam R.,0,0,0,0
1653298561001,MATH 3C,A23,089154,Bowers; Adam R.,0,0,0,0
1653298561001,MATH 3C,A24,089155,Bowers; Adam R.,0,0,0,0
1653298561001,MATH 3C,B01,089158,Staff,0,0,0,0
1653298561001,MATH 3C,B02,089159,Staff,0,0,0,0
1653298561001,MATH 3C,B03,089160,Staff,0,0,0,0
1653298561001,MATH 3C,B04,089161,Staff,0,0,0,0
1653298561001,MATH 3C,C01,094244,Staff,0,0,0,0
1653298561001,MATH 3C,C02,094245,Staff,0,0,0,0
1653298561001,MATH 3C,C03,094246,Staff,0,0,0,0
1653298561001,MATH 3C,C04,094247,Staff,0,0,0,0
1653298561537,MATH 4C,A01,089164,Staff,0,0,0,0
1653298561537,MATH 4C,A02,089165,Staff,0,0,0,0
1653298561537,MATH 4C,A03,089166,Staff,0,0,0,0
1653298561537,MATH 4C,B01,089169,Ganzberger; Geoffrey Michael,0,0,0,0
1653298561537,MATH 4C,B02,089170,Ganzberger; Geoffrey Michael,0,0,0,0
1653298561537,MATH 4C,B03,089171,Ganzberger; Geoffrey Michael,0,0,0,0
1653298561537,MATH 4C,C01,089174,Ganzberger; Geoffrey Michael,0,0,0,0
1653298561537,MATH 4C,C02,089175,Ganzberger; Geoffrey Michael,0,0,0,0
1653298561537,MATH 4C,C03,089176,Ganzberger; Geoffrey Michael,0,0,0,0
1653298561537,MATH 4C,D01,094249,Ganzberger; Geoffrey Michael,0,0,0,0
1653298561537,MATH 4C,D02,094250,Ganzberger; Geoffrey Michael,0,0,0,0
1653298561537,MATH 4C,D03,094251,Ganzberger; Geoffrey Michael,0,0,0,0
1653298562082,MATH 10A,A01,089179,Jin; Muzhi,5,0,5,0
1653298562082,MATH 10A,A02,089180,Jin; Muzhi,5,0,5,0
1653298562082,MATH 10A,A03,089181,Jin; Muzhi,4,0,5,1
1653298562082,MATH 10A,A04,089182,Jin; Muzhi,4,0,5,1
1653298562082,MATH 10A,A05,089183,Jin; Muzhi,5,0,5,0
1653298562082,MATH 10A,A06,089184,Jin; Muzhi,5,0,5,0
1653298562082,MATH 10A,A07,089185,Jin; Muzhi,5,0,5,0
1653298562082,MATH 10A,A08,089186,Jin; Muzhi,5,0,5,0
1653298562082,MATH 10A,B01,089188,Stevens; Laura Jeanne,1,0,5,4
1653298562082,MATH 10A,B02,089189,Stevens; Laura Jeanne,4,0,5,1
1653298562082,MATH 10A,B03,089190,Stevens; Laura Jeanne,4,0,5,1
1653298562082,MATH 10A,B04,089191,Stevens; Laura Jeanne,5,0,5,0
1653298562082,MATH 10A,B05,089192,Stevens; Laura Jeanne,4,0,5,1
1653298562082,MATH 10A,B06,089193,Stevens; Laura Jeanne,5,0,5,0
1653298562082,MATH 10A,B07,089194,Stevens; Laura Jeanne,5,0,5,0
1653298562082,MATH 10A,B08,089195,Stevens; Laura Jeanne,4,0,5,1
1653298562082,MATH 10A,C01,089197,Jin; Muzhi,1,0,5,4
1653298562082,MATH 10A,C02,089198,Jin; Muzhi,5,0,5,0
1653298562082,MATH 10A,C03,089199,Jin; Muzhi,5,0,5,0
1653298562082,MATH 10A,C04,089200,Jin; Muzhi,5,0,5,0
1653298562082,MATH 10A,C05,089201,Jin; Muzhi,5,0,5,0
1653298562082,MATH 10A,C06,089202,Jin; Muzhi,5,0,5,0
1653298562082,MATH 10A,D01,089204,Upton; James Thomas,4,0,5,1
1653298562082,MATH 10A,D02,089205,Upton; James Thomas,5,0,5,0
1653298562082,MATH 10A,D03,089206,Upton; James Thomas,5,0,5,0
1653298562082,MATH 10A,D04,089207,Upton; James Thomas,5,0,5,0
1653298562082,MATH 10A,E01,089211,Greenfeld; Be'Eri,5,0,5,0
1653298562082,MATH 10A,E02,089212,Greenfeld; Be'Eri,3,0,5,2
1653298562082,MATH 10A,E03,089213,Greenfeld; Be'Eri,4,0,5,1
1653298562082,MATH 10A,E04,089214,Greenfeld; Be'Eri,5,0,5,0
1653298562082,MATH 10A,E05,089215,Greenfeld; Be'Eri,5,0,5,0
1653298562082,MATH 10A,E06,089216,Greenfeld; Be'Eri,5,0,5,0
1653298562700,MATH 10B,A01,089218,Stevens; Laura Jeanne,7,0,8,1
1653298562700,MATH 10B,A02,089219,Stevens; Laura Jeanne,7,0,8,1
1653298562700,MATH 10B,A03,089220,Stevens; Laura Jeanne,8,0,8,0
1653298562700,MATH 10B,A04,089221,Stevens; Laura Jeanne,6,0,8,2
1653298562700,MATH 10B,A05,089222,Stevens; Laura Jeanne,2,0,8,6
1653298562700,MATH 10B,A06,089223,Stevens; Laura Jeanne,0,0,8,8
1653298562700,MATH 10B,A07,089224,Stevens; Laura Jeanne,6,0,8,2
1653298562700,MATH 10B,A08,089225,Stevens; Laura Jeanne,4,0,8,4
1653298562700,MATH 10B,B01,089227,Staff,8,0,8,0
1653298562700,MATH 10B,B02,089228,Staff,8,0,8,0
1653298562700,MATH 10B,B03,089229,Staff,7,0,8,1
1653298562700,MATH 10B,B04,089230,Staff,8,0,8,0
1653298562700,MATH 10B,B05,089231,Staff,8,0,8,0
1653298562700,MATH 10B,B06,089232,Staff,8,0,8,0
1653298562700,MATH 10B,B07,089233,Staff,8,0,8,0
1653298562700,MATH 10B,B08,089234,Staff,8,0,8,0
1653298562700,MATH 10B,C01,089236,McKinley; Gweneth Anne,4,0,8,4
1653298562700,MATH 10B,C02,089237,McKinley; Gweneth Anne,8,0,8,0
1653298562700,MATH 10B,C03,089238,McKinley; Gweneth Anne,8,0,8,0
1653298562700,MATH 10B,C04,089239,McKinley; Gweneth Anne,8,0,8,0
1653298562700,MATH 10B,C05,089240,McKinley; Gweneth Anne,8,0,8,0
1653298562700,MATH 10B,C06,089241,McKinley; Gweneth Anne,8,0,8,0
1653298563223,MATH 10C,A01,089243,Staff,13,0,20,7
1653298563223,MATH 10C,A02,089244,Staff,20,0,20,0
1653298563223,MATH 10C,A03,089245,Staff,18,0,20,2
1653298563223,MATH 10C,A04,089246,Staff,20,0,20,0
1653298563223,MATH 10C,A05,089247,Staff,19,0,20,1
1653298563223,MATH 10C,A06,089248,Staff,20,0,20,0
1653298563223,MATH 10C,A07,094505,Staff,20,0,20,0
1653298563223,MATH 10C,A08,094506,Staff,20,0,20,0
1653298563223,MATH 10C,B01,089250,Staff,19,0,20,1
1653298563223,MATH 10C,B02,089251,Staff,19,0,20,1
1653298563223,MATH 10C,B03,089252,Staff,14,0,20,6
1653298563223,MATH 10C,B04,089253,Staff,20,0,20,0
1653298563223,MATH 10C,B05,089254,Staff,20,0,20,0
1653298563223,MATH 10C,B06,089255,Staff,18,0,20,2
1653298563757,MATH 11,A01,089258,Rava; Denise,1,0,15,14
1653298563757,MATH 11,A02,089260,Rava; Denise,9,0,15,6
1653298563757,MATH 11,A03,089263,Rava; Denise,10,0,15,5
1653298563757,MATH 11,A04,089265,Rava; Denise,13,0,15,2
1653298563757,MATH 11,A05,089267,Rava; Denise,10,0,15,5
1653298563757,MATH 11,A06,089269,Rava; Denise,14,0,15,1
1653298563757,MATH 11,A07,089271,Rava; Denise,14,0,15,1
1653298563757,MATH 11,A08,089273,Rava; Denise,13,0,15,2
1653298563757,MATH 11,B01,089279,Staff,4,0,15,11
1653298563757,MATH 11,B02,089281,Staff,14,0,15,1
1653298563757,MATH 11,B03,089283,Staff,14,0,15,1
1653298563757,MATH 11,B04,089284,Staff,15,0,15,0
1653298563757,MATH 11,B05,089286,Staff,14,0,15,1
1653298563757,MATH 11,B06,089288,Staff,15,0,15,0
1653298563757,MATH 11,B07,089289,Staff,14,0,15,1
1653298563757,MATH 11,B08,089290,Staff,14,0,15,1
1653298564295,MATH 18,A01,089303,Anzaldo; Leesa B,5,0,10,5
1653298564295,MATH 18,A02,089304,Anzaldo; Leesa B,6,0,10,4
1653298564295,MATH 18,A03,089305,Anzaldo; Leesa B,10,0,10,0
1653298564295,MATH 18,A04,089306,Anzaldo; Leesa B,8,0,10,2
1653298564295,MATH 18,A05,089307,Anzaldo; Leesa B,10,0,10,0
1653298564295,MATH 18,A06,089308,Anzaldo; Leesa B,9,0,10,1
1653298564295,MATH 18,A07,089309,Anzaldo; Leesa B,10,0,10,0
1653298564295,MATH 18,A08,089310,Anzaldo; Leesa B,10,0,10,0
1653298564295,MATH 18,A09,089311,Anzaldo; Leesa B,10,0,10,0
1653298564295,MATH 18,A10,089312,Anzaldo; Leesa B,10,0,10,0
1653298564295,MATH 18,A11,089313,Anzaldo; Leesa B,9,0,10,1
1653298564295,MATH 18,A12,089314,Anzaldo; Leesa B,10,0,10,0
1653298564295,MATH 18,A13,089315,Anzaldo; Leesa B,9,0,10,1
1653298564295,MATH 18,A14,089316,Anzaldo; Leesa B,10,0,10,0
1653298564295,MATH 18,A15,089317,Anzaldo; Leesa B,9,0,10,1
1653298564295,MATH 18,A16,089318,Anzaldo; Leesa B,10,0,10,0
1653298564295,MATH 18,A17,089319,Anzaldo; Leesa B,9,0,10,1
1653298564295,MATH 18,A18,089320,Anzaldo; Leesa B,10,0,10,0
1653298564295,MATH 18,A19,089321,Anzaldo; Leesa B,0,0,0,0
1653298564295,MATH 18,A20,089322,Anzaldo; Leesa B,0,0,0,0
1653298564295,MATH 18,A21,089323,Anzaldo; Leesa B,9,0,10,1
1653298564295,MATH 18,A22,089324,Anzaldo; Leesa B,7,0,10,3
1653298564295,MATH 18,A23,089325,Anzaldo; Leesa B,10,0,10,0
1653298564295,MATH 18,A24,089326,Anzaldo; Leesa B,9,0,10,1
1653298564295,MATH 18,B01,089329,Staff,13,0,13,0
1653298564295,MATH 18,B02,089330,Staff,12,0,13,1
1653298564295,MATH 18,B03,089331,Staff,12,0,13,1
1653298564295,MATH 18,B04,089332,Staff,13,0,13,0
1653298564295,MATH 18,B05,089333,Staff,12,0,13,1
1653298564295,MATH 18,C01,089336,Staff,13,0,13,0
1653298564295,MATH 18,C02,089337,Staff,11,0,13,2
1653298564295,MATH 18,C03,089338,Staff,0,0,0,0
1653298564295,MATH 18,C04,089339,Staff,0,0,0,0
1653298564295,MATH 18,C05,089340,Staff,0,0,0,1
1653298564295,MATH 18,D01,094194,Staff,0,0,0,0
1653298564295,MATH 18,D02,094195,Staff,0,0,0,0
1653298564295,MATH 18,D03,094196,Staff,0,0,0,0
1653298564295,MATH 18,D04,094197,Staff,0,0,0,0
1653298564295,MATH 18,D05,094198,Staff,0,0,0,0
1653298564825,MATH 20A,A01,089343,Staff,5,0,5,0
1653298564825,MATH 20A,A02,089344,Staff,5,0,5,0
1653298564825,MATH 20A,A03,089345,Staff,5,0,5,0
1653298564825,MATH 20A,B01,089347,Suk; Andrew Hoon,2,0,3,1
1653298564825,MATH 20A,B02,089348,Suk; Andrew Hoon,3,0,3,0
1653298564825,MATH 20A,B03,089349,Suk; Andrew Hoon,3,0,3,0
1653298564825,MATH 20A,B04,089350,Suk; Andrew Hoon,3,0,3,0
1653298564825,MATH 20A,B05,089351,Suk; Andrew Hoon,3,0,3,0
1653298564825,MATH 20A,B06,089352,Suk; Andrew Hoon,2,0,3,1
1653298564825,MATH 20A,B07,089353,Suk; Andrew Hoon,3,0,3,0
1653298564825,MATH 20A,B08,089354,Suk; Andrew Hoon,3,0,3,0
1653298564825,MATH 20A,B09,089355,Suk; Andrew Hoon,3,0,3,0
1653298564825,MATH 20A,B10,089356,Suk; Andrew Hoon,3,0,3,0
1653298564825,MATH 20A,B11,089357,Suk; Andrew Hoon,3,0,3,0
1653298564825,MATH 20A,B12,089358,Suk; Andrew Hoon,3,0,3,0
1653298564825,MATH 20A,B13,089359,Suk; Andrew Hoon,2,0,3,1
1653298564825,MATH 20A,B14,089360,Suk; Andrew Hoon,3,0,3,0
1653298564825,MATH 20A,B15,089361,Suk; Andrew Hoon,3,0,3,0
1653298564825,MATH 20A,B16,089362,Suk; Andrew Hoon,3,0,3,0
1653298564825,MATH 20A,B17,089363,Suk; Andrew Hoon,3,0,3,0
1653298564825,MATH 20A,B18,089364,Suk; Andrew Hoon,0,0,0,0
1653298564825,MATH 20A,B19,089365,Suk; Andrew Hoon,3,0,3,0
1653298564825,MATH 20A,B20,089366,Suk; Andrew Hoon,3,0,3,0
1653298564825,MATH 20A,B21,089367,Suk; Andrew Hoon,3,0,3,0
1653298564825,MATH 20A,B22,089368,Suk; Andrew Hoon,3,0,3,0
1653298564825,MATH 20A,B23,089369,Suk; Andrew Hoon,3,0,3,0
1653298564825,MATH 20A,B24,089370,Suk; Andrew Hoon,3,0,3,0
1653298565359,MATH 20B,A01,089372,Quarfoot; David James,8,0,8,0
1653298565359,MATH 20B,A02,089373,Quarfoot; David James,8,0,8,0
1653298565359,MATH 20B,A03,089374,Quarfoot; David James,7,0,8,1
1653298565359,MATH 20B,A04,089375,Quarfoot; David James,7,0,8,1
1653298565359,MATH 20B,A05,089376,Quarfoot; David James,0,0,0,0
1653298565359,MATH 20B,A06,089377,Quarfoot; David James,0,0,0,0
1653298565359,MATH 20B,A07,089378,Quarfoot; David James,0,0,0,0
1653298565359,MATH 20B,A08,089379,Quarfoot; David James,0,0,0,0
1653298565359,MATH 20B,A09,089380,Quarfoot; David James,0,0,0,0
1653298565359,MATH 20B,A10,089381,Quarfoot; David James,0,0,0,0
1653298565359,MATH 20B,A11,089382,Quarfoot; David James,0,0,0,0
1653298565359,MATH 20B,A12,089383,Quarfoot; David James,0,0,0,0
1653298565359,MATH 20B,A13,089384,Quarfoot; David James,0,0,0,0
1653298565359,MATH 20B,A14,089385,Quarfoot; David James,0,0,0,0
1653298565359,MATH 20B,A15,089386,Quarfoot; David James,0,0,0,0
1653298565359,MATH 20B,A16,089387,Quarfoot; David James,0,0,0,0
1653298565359,MATH 20B,A17,089388,Quarfoot; David James,8,0,8,0
1653298565359,MATH 20B,A18,089389,Quarfoot; David James,8,0,8,0
1653298565359,MATH 20B,A19,089390,Quarfoot; David James,8,0,8,0
1653298565359,MATH 20B,A20,089391,Quarfoot; David James,8,0,8,0
1653298565359,MATH 20B,A21,089392,Quarfoot; David James,8,0,8,0
1653298565359,MATH 20B,A22,089393,Quarfoot; David James,7,0,8,1
1653298565359,MATH 20B,A23,089394,Quarfoot; David James,7,0,8,1
1653298565359,MATH 20B,A24,089395,Quarfoot; David James,8,0,8,0
1653298565359,MATH 20B,B01,089397,Lahiri; Aranya,7,0,10,3
1653298565359,MATH 20B,B02,089398,Lahiri; Aranya,10,0,10,0
1653298565359,MATH 20B,B03,089399,Lahiri; Aranya,10,0,10,0
1653298565359,MATH 20B,B04,089400,Lahiri; Aranya,10,0,10,0
1653298565359,MATH 20B,B05,089401,Lahiri; Aranya,10,0,10,0
1653298565359,MATH 20B,C01,089403,Lahiri; Aranya,0,0,0,0
1653298565359,MATH 20B,C02,089404,Lahiri; Aranya,8,0,10,2
1653298565359,MATH 20B,C03,089405,Lahiri; Aranya,10,0,10,0
1653298565359,MATH 20B,C04,089406,Lahiri; Aranya,9,0,10,1
1653298565359,MATH 20B,C05,089407,Lahiri; Aranya,9,0,10,1
1653298565899,MATH 20C,A01,089409,Um; Ko Woon,10,0,10,0
1653298565899,MATH 20C,A02,089410,Um; Ko Woon,10,0,10,0
1653298565899,MATH 20C,A03,089411,Um; Ko Woon,9,0,10,1
1653298565899,MATH 20C,A04,089412,Um; Ko Woon,9,0,10,1
1653298565899,MATH 20C,A05,089413,Um; Ko Woon,10,0,10,0
1653298565899,MATH 20C,A06,089414,Um; Ko Woon,9,0,10,1
1653298565899,MATH 20C,A07,094270,Um; Ko Woon,10,0,10,0
1653298565899,MATH 20C,A08,094271,Um; Ko Woon,10,0,10,0
1653298565899,MATH 20C,A09,094272,Um; Ko Woon,7,0,10,3
1653298565899,MATH 20C,A10,094273,Um; Ko Woon,10,0,10,0
1653298565899,MATH 20C,A11,094274,Um; Ko Woon,10,0,10,0
1653298565899,MATH 20C,A12,094275,Um; Ko Woon,8,0,10,2
1653298565899,MATH 20C,A13,094276,Um; Ko Woon,10,0,10,0
1653298565899,MATH 20C,A14,094277,Um; Ko Woon,10,0,10,0
1653298565899,MATH 20C,A15,094278,Um; Ko Woon,10,0,10,0
1653298565899,MATH 20C,A16,094279,Um; Ko Woon,10,0,10,0
1653298565899,MATH 20C,B03,089418,Zhang; Ming,7,0,15,8
1653298565899,MATH 20C,B04,089419,Zhang; Ming,13,0,15,2
1653298565899,MATH 20C,B05,089420,Zhang; Ming,13,0,15,2
1653298565899,MATH 20C,C01,089423,Staff,15,0,15,0
1653298565899,MATH 20C,C02,089424,Staff,15,0,15,0
1653298565899,MATH 20C,C03,089425,Staff,15,0,15,0
1653298565899,MATH 20C,C04,089426,Staff,15,0,15,0
1653298565899,MATH 20C,C05,089427,Staff,15,0,15,0
1653298565899,MATH 20C,D04,089433,Zhang; Ming,13,0,15,2
1653298565899,MATH 20C,D05,089434,Zhang; Ming,15,0,15,0
1653298565899,MATH 20C,E01,089439,Staff,15,0,15,0
1653298565899,MATH 20C,E02,089440,Staff,15,0,15,0
1653298565899,MATH 20C,E03,089441,Staff,15,0,15,0
1653298565899,MATH 20C,E04,089442,Staff,15,0,15,0
1653298565899,MATH 20C,E05,089443,Staff,15,0,15,0
1653298565899,MATH 20C,E06,089444,Staff,15,0,15,0
1653298565899,MATH 20C,A17,094280,Um; Ko Woon,0,0,0,0
1653298565899,MATH 20C,A18,094281,Um; Ko Woon,0,0,0,0
1653298565899,MATH 20C,A19,094282,Um; Ko Woon,0,0,0,0
1653298565899,MATH 20C,A20,094283,Um; Ko Woon,0,0,0,0
1653298565899,MATH 20C,A21,094284,Um; Ko Woon,0,0,0,0
1653298565899,MATH 20C,A22,094285,Um; Ko Woon,0,0,0,0
1653298565899,MATH 20C,A23,094286,Um; Ko Woon,0,0,0,0
1653298565899,MATH 20C,A24,094287,Um; Ko Woon,0,0,0,0
1653298565899,MATH 20C,B01,089416,Zhang; Ming,0,0,0,0
1653298565899,MATH 20C,B02,089417,Zhang; Ming,0,0,0,0
1653298565899,MATH 20C,D01,089430,Zhang; Ming,0,0,0,0
1653298565899,MATH 20C,D02,089431,Zhang; Ming,0,0,0,0
1653298565899,MATH 20C,D03,089432,Zhang; Ming,0,0,0,0
1653298566430,MATH 20D,A01,089455,Lee; Kisun,11,0,25,14
1653298566430,MATH 20D,A02,089456,Lee; Kisun,24,0,25,1
1653298566430,MATH 20D,A03,089457,Lee; Kisun,24,0,25,1
1653298566430,MATH 20D,A04,089458,Lee; Kisun,25,0,25,0
1653298566430,MATH 20D,A05,089459,Lee; Kisun,25,0,25,0
1653298566430,MATH 20D,A06,089460,Lee; Kisun,25,0,25,0
1653298566430,MATH 20D,B01,089463,Lee; Kisun,20,0,25,5
1653298566430,MATH 20D,B02,089464,Lee; Kisun,25,0,25,0
1653298566430,MATH 20D,B03,089465,Lee; Kisun,24,0,25,1
1653298566430,MATH 20D,B04,089466,Lee; Kisun,25,0,25,0
1653298566430,MATH 20D,B05,089467,Lee; Kisun,23,0,25,2
1653298566430,MATH 20D,B06,089468,Lee; Kisun,24,0,25,1
1653298566430,MATH 20D,C01,089471,Staff,23,0,25,2
1653298566430,MATH 20D,C02,089472,Staff,25,0,25,0
1653298566430,MATH 20D,C03,089473,Staff,25,0,25,0
1653298566430,MATH 20D,C04,089474,Staff,25,0,25,0
1653298566430,MATH 20D,C05,089475,Staff,25,0,25,0
1653298566430,MATH 20D,C06,089476,Staff,25,0,25,0
1653298566958,MATH 20E,A01,089479,Eggers; John Dietrich,17,0,24,7
1653298566958,MATH 20E,A02,089480,Eggers; John Dietrich,24,0,25,1
1653298566958,MATH 20E,A03,089481,Eggers; John Dietrich,25,0,25,0
1653298566958,MATH 20E,A04,089482,Eggers; John Dietrich,25,0,25,0
1653298566958,MATH 20E,A05,089483,Eggers; John Dietrich,19,0,25,6
1653298566958,MATH 20E,A06,089484,Eggers; John Dietrich,25,0,25,0
1653298566958,MATH 20E,A07,089485,Eggers; John Dietrich,24,0,25,1
1653298566958,MATH 20E,A08,089486,Eggers; John Dietrich,24,0,25,1
1653298566958,MATH 20E,B01,089488,Staff,15,0,25,10
1653298566958,MATH 20E,B02,089489,Staff,21,0,25,4
1653298566958,MATH 20E,B03,089490,Staff,25,0,25,0
1653298566958,MATH 20E,B04,089491,Staff,25,0,25,0
1653298566958,MATH 20E,B05,089492,Staff,24,0,25,1
1653298566958,MATH 20E,B06,089493,Staff,24,0,25,1
1653298566958,MATH 20E,B07,089494,Staff,25,0,25,0
1653298566958,MATH 20E,B08,089495,Staff,25,0,25,0
1653298566958,MATH 20E,C01,089497,Staff,23,0,25,2
1653298566958,MATH 20E,C02,089498,Staff,25,0,25,0
1653298566958,MATH 20E,C03,089499,Staff,25,0,25,0
1653298566958,MATH 20E,C04,089500,Staff,25,0,25,0
1653298566958,MATH 20E,C05,089501,Staff,25,0,25,0
1653298566958,MATH 20E,C06,089502,Staff,25,0,25,0
1653298566958,MATH 20E,C07,089503,Staff,25,0,25,0
1653298566958,MATH 20E,C08,089504,Staff,25,0,25,0
1653298567482,MATH 31AH,A01,089506,Rabin; Jeffrey Mark,35,0,35,0
1653298567482,MATH 31AH,A02,089507,Rabin; Jeffrey Mark,35,0,35,0
1653298568005,MATH 87,A00,094827,Meyer; David A.,20,0,20,0
1653298568527,MATH 96,A00,094836,Kane; Daniel Mertz,11,0,30,19
1653298569050,MATH 100A,A01,089509,Kedlaya; Kiran S.,23,0,30,7
1653298569050,MATH 100A,A02,089510,Kedlaya; Kiran S.,28,0,30,2
1653298569050,MATH 100A,B01,089512,Greenfeld; Be'Eri,24,0,30,6
1653298569050,MATH 100A,B02,089513,Greenfeld; Be'Eri,30,0,30,0
1653298569577,MATH 102,A01,089515,Hodges; Reuven Moses,25,0,30,5
1653298569577,MATH 102,A02,089516,Hodges; Reuven Moses,30,0,30,0
1653298569577,MATH 102,A03,089517,Hodges; Reuven Moses,30,0,30,0
1653298569577,MATH 102,A04,089518,Hodges; Reuven Moses,29,0,30,1
1653298569577,MATH 102,B01,089520,Hodges; Reuven Moses,29,0,30,1
1653298569577,MATH 102,B02,089521,Hodges; Reuven Moses,29,0,30,1
1653298569577,MATH 102,B03,089522,Hodges; Reuven Moses,29,0,30,1
1653298569577,MATH 102,B04,089523,Hodges; Reuven Moses,30,0,30,0
1653298570102,MATH 103A,A01,089525,Staff,27,0,30,3
1653298570102,MATH 103A,A02,089526,Staff,30,0,30,0
1653298570102,MATH 103A,B01,089528,Seward; Brandon M.,9,0,30,21
1653298570102,MATH 103A,B02,089529,Seward; Brandon M.,22,0,30,8
1653298570102,MATH 103A,C01,089531,Staff,27,0,30,3
1653298570102,MATH 103A,C02,089532,Staff,28,0,30,2
1653298570102,MATH 103A,D01,089534,Staff,28,0,30,2
1653298570102,MATH 103A,D02,089535,Staff,28,0,30,2
1653298570628,MATH 109,A01,089537,Chung; Kwun,9,0,10,1
1653298570628,MATH 109,A02,089538,Chung; Kwun,10,0,10,0
1653298570628,MATH 109,B01,089540,Belmont; Eva Kinoshita,9,0,10,1
1653298570628,MATH 109,B02,089541,Belmont; Eva Kinoshita,6,0,10,4
1653298570628,MATH 109,C01,089543,Chow; Bennett,8,0,10,2
1653298570628,MATH 109,C02,089544,Chow; Bennett,10,0,10,0
1653298570628,MATH 109,D01,089546,Chung; Kwun,9,0,10,1
1653298570628,MATH 109,D02,089547,Chung; Kwun,9,0,10,1
1653298570628,MATH 109,E01,089549,Schweinsberg; Jason,6,0,10,4
1653298570628,MATH 109,E02,089550,Schweinsberg; Jason,10,0,10,0
1653298571156,MATH 110,A01,089552,Wenzl; Hans G,27,0,35,8
1653298571156,MATH 110,A02,089553,Wenzl; Hans G,33,0,35,2
1653298571680,MATH 111A,A01,089555,Meyer; David A.,0,0,0,1
1653298572206,MATH 120A,A01,089557,Manners; Frederick,30,0,35,5
1653298572206,MATH 120A,A02,089558,Manners; Frederick,33,0,35,2
1653298572731,MATH 140A,A01,089560,Seward; Brandon M.,25,0,30,5
1653298572731,MATH 140A,A02,089561,Seward; Brandon M.,29,0,30,1
1653298572731,MATH 140A,B01,089563,Chan; Pak Yeung,30,0,30,0
1653298572731,MATH 140A,B02,089564,Chan; Pak Yeung,22,0,30,8
1653298573255,MATH 142A,A01,089566,Staff,29,0,30,1
1653298573255,MATH 142A,A02,089567,Staff,29,0,30,1
1653298573255,MATH 142A,B01,089569,Staff,30,0,30,0
1653298573255,MATH 142A,B02,089570,Staff,29,0,30,1
1653298573255,MATH 142A,C01,089572,Staff,26,0,30,4
1653298573255,MATH 142A,C02,089573,Staff,29,0,30,1
1653298573255,MATH 142A,D01,089575,Eggers; John Dietrich,15,0,30,15
1653298573255,MATH 142A,D02,089576,Eggers; John Dietrich,27,0,30,3
1653298573781,MATH 144,A01,089578,Bejenaru; Ioan,29,0,30,1
1653298574309,MATH 150A,A01,089580,Chow; Bennett,29,0,35,6
1653298574309,MATH 150A,A02,089581,Chow; Bennett,34,0,35,1
1653298575356,MATH 153,A01,094204,Harel; Guershon,33,0,35,2
1653298575882,MATH 154,A01,089590,Verstraete; Jacques Allan,3,0,30,27
1653298575882,MATH 154,A02,089591,Verstraete; Jacques Allan,23,0,30,7
1653298575882,MATH 154,A03,089592,Verstraete; Jacques Allan,28,0,30,2
1653298575882,MATH 154,A04,089593,Verstraete; Jacques Allan,26,0,30,4
1653298576408,MATH 155A,A01,089595,Buss; Samuel R,22,0,35,13
1653298576408,MATH 155A,A02,089596,Buss; Samuel R,32,0,35,3
1653298576936,MATH 160A,A01,089598,Manners; Frederick,28,0,35,7
1653298576936,MATH 160A,A02,094207,Manners; Frederick,34,0,35,1
1653298577460,MATH 170A,A01,089600,Liu; Shuang,24,0,25,1
1653298577460,MATH 170A,A02,089601,Liu; Shuang,24,0,25,1
1653298577460,MATH 170A,A03,089602,Liu; Shuang,24,0,25,1
1653298577460,MATH 170A,A04,089603,Liu; Shuang,23,0,25,2
1653298577460,MATH 170A,B01,089605,Dumitriu; Ioana,8,0,25,17
1653298577460,MATH 170A,B02,089606,Dumitriu; Ioana,20,0,25,5
1653298577460,MATH 170A,B03,089607,Dumitriu; Ioana,21,0,25,4
1653298577460,MATH 170A,B04,089608,Dumitriu; Ioana,25,0,25,0
1653298577984,MATH 173A,A01,089610,Cloninger; Alexander,0,0,35,35
1653298577984,MATH 173A,A02,089611,Cloninger; Alexander,2,0,35,33
1653298577984,MATH 173A,A03,089612,Cloninger; Alexander,20,0,35,15
1653298578508,MATH 174,A01,089614,Cheng; Li-Tien,23,0,25,2
1653298578508,MATH 174,A02,089615,Cheng; Li-Tien,25,0,25,0
1653298579040,MATH 180A,A01,089617,Jekel; David Andrew,0,0,25,25
1653298579040,MATH 180A,A02,089618,Jekel; David Andrew,23,0,25,2
1653298579040,MATH 180A,A03,089619,Jekel; David Andrew,22,0,25,3
1653298579040,MATH 180A,A04,089620,Jekel; David Andrew,22,0,25,3
1653298579040,MATH 180A,A05,089621,Jekel; David Andrew,24,0,25,1
1653298579040,MATH 180A,A06,089622,Jekel; David Andrew,23,0,25,2
1653298579040,MATH 180A,B01,089624,Agarwal; Pooja,23,0,25,2
1653298579040,MATH 180A,B02,089625,Agarwal; Pooja,24,0,25,1
1653298579040,MATH 180A,B03,089626,Agarwal; Pooja,22,0,25,3
1653298579040,MATH 180A,B04,089627,Agarwal; Pooja,25,0,25,0
1653298579040,MATH 180A,B05,089628,Agarwal; Pooja,24,0,25,1
1653298579040,MATH 180A,B06,089629,Agarwal; Pooja,25,0,25,0
1653298579040,MATH 180A,C01,089631,Staff,22,0,25,3
1653298579040,MATH 180A,C02,089632,Staff,25,0,25,0
1653298579040,MATH 180A,C03,089633,Staff,25,0,25,0
1653298579040,MATH 180A,C04,089634,Staff,25,0,25,0
1653298579570,MATH 180C,A01,089636,Fitzsimmons; Patrick J,4,0,25,21
1653298579570,MATH 180C,A02,089637,Fitzsimmons; Patrick J,21,0,25,4
1653298580094,MATH 181B,A01,089639,Rava; Denise,31,0,35,4
1653298580094,MATH 181B,A02,089640,Rava; Denise,34,0,35,1
1653298580094,MATH 181B,A03,089641,Rava; Denise,31,0,35,4
1653298580094,MATH 181B,A04,089642,Rava; Denise,35,0,35,0
1653298580618,MATH 183,A01,089644,Staff,10,0,25,15
1653298580618,MATH 183,A02,089645,Staff,23,0,25,2
1653298580618,MATH 183,A03,089646,Staff,23,0,25,2
1653298580618,MATH 183,A04,089647,Staff,25,0,25,0
1653298580618,MATH 183,A05,089648,Staff,19,0,25,6
1653298580618,MATH 183,A06,089649,Staff,22,0,25,3
1653298580618,MATH 183,A07,089650,Staff,25,0,25,0
1653298580618,MATH 183,A08,089651,Staff,25,0,25,0
1653298581143,MATH 184,A01,089653,Kane; Daniel Mertz,24,0,30,6
1653298581143,MATH 184,A02,089654,Kane; Daniel Mertz,30,0,30,0
1653298581143,MATH 184,A03,089655,Kane; Daniel Mertz,30,0,30,0
1653298581143,MATH 184,A04,089656,Kane; Daniel Mertz,30,0,30,0
1653298581666,MATH 187A,A01,089658,Bucur; Alina Ioana,0,0,25,25
1653298581666,MATH 187A,A02,089659,Bucur; Alina Ioana,12,0,25,13
1653298581666,MATH 187A,A03,089660,Bucur; Alina Ioana,0,0,25,25
1653298581666,MATH 187A,A04,089661,Bucur; Alina Ioana,17,0,25,8
1653298582190,MATH 187B,A01,089663,Bucur; Alina Ioana,28,0,35,7
1653298582190,MATH 187B,A02,089664,Bucur; Alina Ioana,34,0,35,1
1653298582718,MATH 188,A01,094817,Sam; Steven V,33,0,35,2
1653298583242,MATH 190A,A01,089666,Sam; Steven V,21,0,35,14
1653298583765,MATH 196,A00,089667,Spolaor; Luca,33,0,45,12
1653298584293,MCWP 40,004,093486,Wastal; Carrie King,0,0,3,3
1653298584293,MCWP 40,005,093487,Wastal; Carrie King,0,0,3,3
1653298584293,MCWP 40,006,093488,Wastal; Carrie King,3,0,3,0
1653298584293,MCWP 40,007,093489,Wastal; Carrie King,3,0,3,0
1653298584293,MCWP 40,008,093490,Wastal; Carrie King,2,0,3,1
1653298584293,MCWP 40,009,093491,Wastal; Carrie King,2,0,3,1
1653298584293,MCWP 40,013,093495,Wastal; Carrie King,3,0,3,0
1653298584293,MCWP 40,014,093496,Wastal; Carrie King,0,0,3,3
1653298584293,MCWP 40,015,093497,Wastal; Carrie King,3,0,3,0
1653298584293,MCWP 40,016,093498,Wastal; Carrie King,3,0,3,0
1653298584293,MCWP 40,017,093499,Wastal; Carrie King,3,0,3,0
1653298584293,MCWP 40,018,093500,Wastal; Carrie King,1,0,3,2
1653298584293,MCWP 40,020,093502,Wastal; Carrie King,0,0,0,0
1653298584293,MCWP 40,021,093503,Wastal; Carrie King,3,0,3,0
1653298584293,MCWP 40,022,093504,Wastal; Carrie King,2,0,3,1
1653298584293,MCWP 40,023,093505,Wastal; Carrie King,2,0,3,1
1653298584293,MCWP 40,024,093506,Wastal; Carrie King,2,0,3,1
1653298584293,MCWP 40,026,093508,Wastal; Carrie King,3,0,3,0
1653298584293,MCWP 40,027,093509,Wastal; Carrie King,3,0,3,0
1653298584293,MCWP 40,028,093510,Wastal; Carrie King,3,0,3,0
1653298584293,MCWP 40,029,093511,Wastal; Carrie King,3,0,3,0
1653298584293,MCWP 40,030,093512,Wastal; Carrie King,2,0,3,1
1653298584293,MCWP 40,032,093514,Wastal; Carrie King,2,0,3,1
1653298584293,MCWP 40,033,093515,Wastal; Carrie King,3,0,3,0
1653298584293,MCWP 40,034,093516,Wastal; Carrie King,3,0,3,0
1653298584293,MCWP 40,035,093517,Wastal; Carrie King,3,0,3,0
1653298584293,MCWP 40,038,093520,Wastal; Carrie King,2,0,3,1
1653298584293,MCWP 40,039,093521,Wastal; Carrie King,3,0,3,0
1653298584293,MCWP 40,041,093523,Wastal; Carrie King,2,0,3,1
1653298584293,MCWP 40,042,093524,Wastal; Carrie King,3,0,3,0
1653298584293,MCWP 40,043,093525,Wastal; Carrie King,0,0,0,0
1653298584293,MCWP 40,049,093531,Wastal; Carrie King,2,0,3,1
1653298584293,MCWP 40,050,093532,Wastal; Carrie King,3,0,3,0
1653298584293,MCWP 40,051,093533,Wastal; Carrie King,3,0,3,0
1653298584827,MCWP 50,001,093534,Wastal; Carrie King,0,0,0,0
1653298584827,MCWP 50,002,093535,Wastal; Carrie King,0,0,3,3
1653298584827,MCWP 50,003,093536,Wastal; Carrie King,0,0,3,3
1653298584827,MCWP 50,004,093537,Wastal; Carrie King,0,0,3,3
1653298584827,MCWP 50,005,093538,Wastal; Carrie King,0,0,3,3
1653298584827,MCWP 50,006,093539,Wastal; Carrie King,2,0,3,1
1653298584827,MCWP 50,007,093540,Wastal; Carrie King,0,0,3,3
1653298584827,MCWP 50,008,093541,Wastal; Carrie King,0,0,3,3
1653298584827,MCWP 50,009,093542,Wastal; Carrie King,0,0,3,3
1653298584827,MCWP 50,010,093543,Wastal; Carrie King,0,0,3,3
1653298584827,MCWP 50,013,093546,Wastal; Carrie King,1,0,3,2
1653298584827,MCWP 50,014,093547,Wastal; Carrie King,0,0,3,3
1653298584827,MCWP 50,015,093548,Wastal; Carrie King,0,0,3,3
1653298584827,MCWP 50,016,093549,Wastal; Carrie King,0,0,0,0
1653298585358,MCWP 125,A00,093550,Wilson; Marion E.,3,0,3,0
1653298585358,MCWP 125,B00,093551,Guillen; Melinda,3,0,3,0
1653298585358,MCWP 125,C00,093552,Guillen; Melinda,3,0,3,0
1653298585358,MCWP 125,D00,093553,Guillen; Melinda,3,0,3,0
1653298585358,MCWP 125,E00,093554,Miller; Elizabeth Deen,3,0,3,0
1653298585358,MCWP 125,F00,093555,Miller; Elizabeth Deen,3,0,3,0
1653298585358,MCWP 125,G00,093556,Miller; Elizabeth Deen,3,0,3,0
1653298585889,MGT 3,A00,087704,Wagner; Timothy Ryan,90,0,90,0
1653298586417,MGT 4,A01,087706,Levkoff; Steven B.,2,0,3,1
1653298586417,MGT 4,A02,087707,Levkoff; Steven B.,3,0,3,0
1653298586417,MGT 4,A03,092659,Levkoff; Steven B.,1,0,4,3
1653298586942,MGT 5,A00,087708,Houskeeper; Robert,194,0,196,2
1653298587467,MGT 12,A00,087709,Pecore; Joseph P.,91,0,100,9
1653298587467,MGT 12,B00,087710,Lindenberger; Wade Douglas,91,0,100,9
1653298587991,MGT 16,A00,087711,Campbell; Robert Harold,108,0,110,2
1653298587991,MGT 16,B00,087712,Campbell; Robert Harold,110,0,110,0
1653298587991,MGT 16,C00,087713,Lindenberger; Wade Douglas,100,0,110,10
1653298587991,MGT 16,D00,087714,Lindenberger; Wade Douglas,107,0,110,3
1653298587991,MGT 16,E00,094819,Buchanan; Harold G,99,0,100,1
1653298588521,MGT 18,A00,087715,McKay; Michael J,88,0,90,2
1653298588521,MGT 18,B00,087716,McKay; Michael J,90,0,90,0
1653298588521,MGT 18,C00,087717,McKay; Michael J,88,0,90,2
1653298588521,MGT 18,D00,087718,McKay; Mary A,90,0,90,0
1653298588521,MGT 18,E00,087719,McKay; Mary A,87,0,90,3
1653298589050,MGT 45,A00,087720,Pecore; Joseph P.,136,0,150,14
1653298589050,MGT 45,B00,087721,Pecore; Joseph P.,140,0,150,10
1653298589578,MGT 52,A00,087722,Deal; Jennifer Jean,83,0,90,7
1653298590105,MGT 71,A00,087723,August; Terrence,60,0,90,30
1653298591154,MGT 103,A00,087726,Ehrich; Kristine R,86,0,90,4
1653298591154,MGT 103,B00,087727,Ehrich; Kristine R,89,0,90,1
1653298591154,MGT 103,C00,087728,Eberhard; Craig A,89,0,90,1
1653298591154,MGT 103,D00,087729,Eberhard; Craig A,88,0,90,2
1653298591154,MGT 103,E00,087730,Demill; Burritt,75,0,90,15
1653298591154,MGT 103,F00,087731,Bates; Kenneth Walter,81,0,90,9
1653298591154,MGT 103,G00,087732,Bates; Kenneth Walter,88,0,90,2
1653298591677,MGT 105,A00,087733,Campbell; Robert Harold,102,0,120,18
1653298592199,MGT 106,A00,087734,Eberhard; Craig A,81,0,90,9
1653298592728,MGT 108R,A00,087735,Amir; On,84,0,90,6
1653298593251,MGT 109,A00,087736,Staff,77,0,90,13
1653298593777,MGT 112,A00,087737,Somasundaram; Tyagarajan,89,0,90,1
1653298593777,MGT 112,B00,087738,Somasundaram; Tyagarajan,86,0,90,4
1653298593777,MGT 112,C00,087739,Ehrich; Kristine R,86,0,90,4
1653298593777,MGT 112,D00,087740,Zimmermann; Carsten,65,0,90,25
1653298594305,MGT 121A,A00,087741,Wang; Helen Shan,65,0,70,5
1653298594305,MGT 121A,B00,087742,Wang; Helen Shan,64,0,70,6
1653298594831,MGT 131A,A00,087743,Houskeeper; Robert,146,0,150,4
1653298595355,MGT 132,A00,087744,Blakley; Bruce,88,0,90,2
1653298595889,MGT 134,A00,087745,Houskeeper; Robert,84,0,90,6
1653298596412,MGT 135,A00,087746,Anderson; John Charles,83,0,90,7
1653298596936,MGT 139,A00,087747,Perols; Johan Lars,88,0,90,2
1653298597464,MGT 153,A00,087748,Perols; Johan Lars,82,0,90,8
1653298597464,MGT 153,B00,087749,Phiroz; Zal Navroze,76,0,90,14
1653298597464,MGT 153,C00,087750,Phiroz; Zal Navroze,87,0,90,3
1653298597987,MGT 162R,A00,087751,Gneezy; Uri,64,0,90,26
1653298598513,MGT 164,A00,087752,McKay; Mary A,90,0,90,0
1653298598513,MGT 164,B00,087753,Meyer; Alison Bloomfield,0,0,0,0
1653298598513,MGT 164,C00,087754,Smith; Pamela Karen,82,0,90,8
1653298599041,MGT 166,A00,087755,Moran; Cathleen L.,89,0,90,1
1653298599041,MGT 166,B00,087756,Moran; Cathleen L.,90,0,90,0
1653298599041,MGT 166,C00,087757,Moran; Cathleen L.,90,0,90,0
1653298599041,MGT 166,D00,087758,Demill; Burritt,56,0,90,34
1653298599580,MGT 167,A00,087759,Klaas; Jeffrey David,88,0,90,2
1653298599580,MGT 167,B00,087760,Jacob; Jo Dee C,83,0,90,7
1653298600107,MGT 171,A00,087761,Phiroz; Zal Navroze,85,0,90,5
1653298600636,MGT 172,A00,087762,Hedges; Kathleen & Royal; Rebecca,96,0,100,4
1653298600636,MGT 172,B00,087763,Hedges; Kathleen,79,0,90,11
1653298600636,MGT 172,C00,087764,Zimmermann; Carsten,90,0,90,0
1653298601164,MGT 172R,A00,094888,Erat; Sanjiv,90,0,90,0
1653298601690,MGT 173,A00,087765,Hayes; Sherry Lorine,80,0,100,20
1653298602216,MGT 175,A00,087766,Gopal; Christopher S.,84,0,90,6
1653298602745,MGT 181,A00,087767,Buchanan; Harold G,114,0,120,6
1653298602745,MGT 181,B00,087768,Buchanan; Harold G,110,0,120,10
1653298602745,MGT 181,C00,087769,Bliss; Barbara Ann,109,0,120,11
1653298603792,MGT 185,A00,087771,Dunn; Louis Jean,84,0,90,6
1653298604316,MGT 187,A00,087772,Dunn; Louis Jean,138,0,146,8
1653298604850,MMW 11,A01,086931,duBois; Page Ann,4,0,4,0
1653298604850,MMW 11,A02,086932,duBois; Page Ann,4,0,4,0
1653298604850,MMW 11,A03,086933,duBois; Page Ann,3,0,4,1
1653298604850,MMW 11,A04,086934,duBois; Page Ann,3,0,4,1
1653298604850,MMW 11,A05,086935,duBois; Page Ann,4,0,4,0
1653298604850,MMW 11,A06,086936,duBois; Page Ann,3,0,4,1
1653298604850,MMW 11,A07,086937,duBois; Page Ann,4,0,4,0
1653298604850,MMW 11,A08,086938,duBois; Page Ann,4,0,4,0
1653298604850,MMW 11,A09,086939,duBois; Page Ann,4,0,4,0
1653298604850,MMW 11,A10,086940,duBois; Page Ann,4,0,4,0
1653298604850,MMW 11,A11,086941,duBois; Page Ann,4,0,4,0
1653298604850,MMW 11,A12,093877,duBois; Page Ann,3,0,4,1
1653298605380,MMW 11R,A01,093852,Herbst; Matthew,4,0,4,0
1653298605380,MMW 11R,A02,093853,Herbst; Matthew,4,0,4,0
1653298605380,MMW 11R,A03,093854,Herbst; Matthew,4,0,4,0
1653298605380,MMW 11R,A04,093855,Herbst; Matthew,4,0,4,0
1653298605380,MMW 11R,A05,093856,Herbst; Matthew,4,0,4,0
1653298605380,MMW 11R,A06,093857,Herbst; Matthew,4,0,4,0
1653298605380,MMW 11R,A07,093858,Herbst; Matthew,4,0,4,0
1653298605380,MMW 11R,A08,093859,Herbst; Matthew,4,0,4,0
1653298605380,MMW 11R,A09,093860,Herbst; Matthew,4,0,4,0
1653298605380,MMW 11R,A10,093861,Herbst; Matthew,4,0,4,0
1653298605380,MMW 11R,A11,093862,Herbst; Matthew,4,0,4,0
1653298605380,MMW 11R,A12,093863,Herbst; Matthew,4,0,4,0
1653298605380,MMW 11R,B01,093865,Herbst; Matthew,4,0,4,0
1653298605380,MMW 11R,B02,093866,Herbst; Matthew,4,0,4,0
1653298605380,MMW 11R,B03,093867,Herbst; Matthew,4,0,4,0
1653298605380,MMW 11R,B04,093868,Herbst; Matthew,4,0,4,0
1653298605380,MMW 11R,B05,093869,Herbst; Matthew,4,0,4,0
1653298605380,MMW 11R,B06,093870,Herbst; Matthew,4,0,4,0
1653298605380,MMW 11R,B07,093871,Herbst; Matthew,4,0,4,0
1653298605380,MMW 11R,B08,093872,Herbst; Matthew,4,0,4,0
1653298605380,MMW 11R,B09,093873,Herbst; Matthew,4,0,4,0
1653298605380,MMW 11R,B10,093874,Herbst; Matthew,4,0,4,0
1653298605380,MMW 11R,B11,093875,Herbst; Matthew,4,0,4,0
1653298605380,MMW 11R,B12,093876,Herbst; Matthew,4,0,4,0
1653298605906,MMW 14,A01,086968,Chang; Edmond Yi-Teh,28,0,28,0
1653298605906,MMW 14,A02,086969,Chang; Edmond Yi-Teh,27,0,28,1
1653298605906,MMW 14,A03,086970,Chang; Edmond Yi-Teh,21,0,28,7
1653298605906,MMW 14,A04,086971,Chang; Edmond Yi-Teh,27,0,28,1
1653298605906,MMW 14,A05,086972,Chang; Edmond Yi-Teh,26,0,28,2
1653298605906,MMW 14,A06,086973,Chang; Edmond Yi-Teh,28,0,28,0
1653298605906,MMW 14,A07,086974,Chang; Edmond Yi-Teh,27,0,28,1
1653298605906,MMW 14,A08,086975,Chang; Edmond Yi-Teh,25,0,28,3
1653298605906,MMW 14,A09,086976,Chang; Edmond Yi-Teh,0,0,0,0
1653298605906,MMW 14,A10,086977,Chang; Edmond Yi-Teh,27,0,28,1
1653298605906,MMW 14,A11,086978,Chang; Edmond Yi-Teh,26,0,28,2
1653298605906,MMW 14,A12,086979,Chang; Edmond Yi-Teh,27,0,28,1
1653298605906,MMW 14,A13,086980,Chang; Edmond Yi-Teh,28,0,28,0
1653298606431,MMW 121,A01,086982,Chang; Edmond Yi-Teh,0,0,0,0
1653298606431,MMW 121,A02,086983,Chang; Edmond Yi-Teh,0,0,0,0
1653298606431,MMW 121,A03,086984,Chang; Edmond Yi-Teh,2,0,4,2
1653298606431,MMW 121,A04,086985,Chang; Edmond Yi-Teh,4,0,4,0
1653298606431,MMW 121,A05,086986,Chang; Edmond Yi-Teh,4,0,4,0
1653298606431,MMW 121,A06,086987,Chang; Edmond Yi-Teh,4,0,4,0
1653298606431,MMW 121,A07,086988,Chang; Edmond Yi-Teh,4,0,4,0
1653298606431,MMW 121,A08,086989,Chang; Edmond Yi-Teh,4,0,4,0
1653298606431,MMW 121,B01,086991,Patterson; Patrick H.,4,0,4,0
1653298606431,MMW 121,B02,086992,Patterson; Patrick H.,4,0,4,0
1653298606431,MMW 121,B03,086993,Patterson; Patrick H.,4,0,4,0
1653298606431,MMW 121,B04,086994,Patterson; Patrick H.,3,0,4,1
1653298606431,MMW 121,B05,086995,Patterson; Patrick H.,4,0,4,0
1653298606431,MMW 121,B06,086996,Patterson; Patrick H.,4,0,4,0
1653298606431,MMW 121,B07,086997,Patterson; Patrick H.,4,0,4,0
1653298606431,MMW 121,B08,086998,Patterson; Patrick H.,4,0,4,0
1653298606431,MMW 121,B09,086999,Patterson; Patrick H.,4,0,4,0
1653298606431,MMW 121,B10,087000,Patterson; Patrick H.,4,0,4,0
1653298606431,MMW 121,B11,087001,Patterson; Patrick H.,0,0,0,0
1653298606431,MMW 121,B12,087002,Patterson; Patrick H.,0,0,0,0
1653298606957,MUS 1A,A01,090497,Staff,19,0,20,1
1653298606957,MUS 1A,A02,090498,Staff,13,0,20,7
1653298606957,MUS 1A,A03,090499,Staff,18,0,20,2
1653298606957,MUS 1A,A04,090500,Staff,19,0,20,1
1653298606957,MUS 1A,A05,090501,Staff,20,0,20,0
1653298606957,MUS 1A,A06,090502,Staff,20,0,20,0
1653298606957,MUS 1A,B01,090504,Staff,18,0,20,2
1653298606957,MUS 1A,B02,090505,Staff,20,0,20,0
1653298606957,MUS 1A,B03,090506,Staff,18,0,20,2
1653298606957,MUS 1A,B04,090507,Staff,18,0,20,2
1653298606957,MUS 1A,B05,090508,Staff,16,0,20,4
1653298606957,MUS 1A,B06,090509,Staff,20,0,20,0
1653298607481,MUS 2A,A01,090511,Carlson; Erik Norman,19,0,20,1
1653298608011,MUS 2AK,A00,090512,Ohnishi; Takae,24,0,25,1
1653298608011,MUS 2AK,B00,090513,Ohnishi; Takae,15,0,15,0
1653298608539,MUS 4,A01,090515,Staff,24,0,25,1
1653298608539,MUS 4,A02,090516,Staff,24,0,25,1
1653298608539,MUS 4,A03,090517,Staff,22,0,25,3
1653298608539,MUS 4,A04,090518,Staff,24,0,25,1
1653298608539,MUS 4,A05,090519,Staff,25,0,25,0
1653298608539,MUS 4,A06,090520,Staff,25,0,25,0
1653298608539,MUS 4,A07,090521,Staff,24,0,25,1
1653298608539,MUS 4,A08,090522,Staff,24,0,25,1
1653298609063,MUS 5,A01,090524,Staff,20,0,20,0
1653298609063,MUS 5,A02,090525,Staff,18,0,20,2
1653298609063,MUS 5,A03,090526,Staff,20,0,20,0
1653298609063,MUS 5,A04,090527,Staff,20,0,20,0
1653298609063,MUS 5,A05,090528,Staff,19,0,20,1
1653298609587,MUS 6,A01,090530,Staff,22,0,25,3
1653298609587,MUS 6,A02,090531,Staff,25,0,25,0
1653298609587,MUS 6,A03,090532,Staff,25,0,25,0
1653298609587,MUS 6,A04,090533,Staff,23,0,25,2
1653298610112,MUS 8,A01,090535,Kenyatta; Kamau,17,0,25,8
1653298610112,MUS 8,A02,090536,Kenyatta; Kamau,19,0,25,6
1653298610112,MUS 8,A03,090537,Kenyatta; Kamau,17,0,25,8
1653298610112,MUS 8,A04,090538,Kenyatta; Kamau,21,0,25,4
1653298610641,MUS 12,A01,090540,Narucki; Susan M,20,0,20,0
1653298610641,MUS 12,A02,090541,Narucki; Susan M,20,0,20,0
1653298610641,MUS 12,A03,090542,Narucki; Susan M,17,0,20,3
1653298611168,MUS 15,A01,090544,Staff,21,0,25,4
1653298611168,MUS 15,A02,090545,Staff,23,0,25,2
1653298611168,MUS 15,A03,090546,Staff,24,0,25,1
1653298611168,MUS 15,A04,090547,Staff,22,0,25,3
1653298611168,MUS 15,A05,090548,Staff,25,0,25,0
1653298611168,MUS 15,A06,090549,Staff,24,0,25,1
1653298611695,MUS 19R,A01,090551,Britt; King James,17,0,20,3
1653298611695,MUS 19R,A02,090552,Britt; King James,19,0,20,1
1653298611695,MUS 19R,A03,090553,Britt; King James,20,0,20,0
1653298611695,MUS 19R,A04,090554,Britt; King James,19,0,20,1
1653298611695,MUS 19R,A05,090555,Britt; King James,20,0,20,0
1653298611695,MUS 19R,A06,090556,Britt; King James,18,0,20,2
1653298611695,MUS 19R,A07,090557,Britt; King James,19,0,20,1
1653298611695,MUS 19R,A08,090558,Britt; King James,19,0,20,1
1653298611695,MUS 19R,A09,090559,Britt; King James,20,0,20,0
1653298611695,MUS 19R,A10,090560,Britt; King James,20,0,20,0
1653298611695,MUS 19R,B01,090562,Britt; King James,10,0,10,0
1653298611695,MUS 19R,B02,090563,Britt; King James,10,0,10,0
1653298611695,MUS 19R,B03,090564,Britt; King James,10,0,10,0
1653298611695,MUS 19R,B04,090565,Britt; King James,10,0,10,0
1653298611695,MUS 19R,B05,090566,Britt; King James,10,0,10,0
1653298611695,MUS 19R,B06,090567,Britt; King James,10,0,10,0
1653298611695,MUS 19R,B07,090568,Britt; King James,10,0,10,0
1653298611695,MUS 19R,B08,090569,Britt; King James,10,0,10,0
1653298611695,MUS 19R,B09,090570,Britt; King James,10,0,10,0
1653298611695,MUS 19R,B10,090571,Britt; King James,10,0,10,0
1653298612219,MUS 20,A01,090573,Borgo; David Garcia,12,0,15,3
1653298612219,MUS 20,A02,090574,Borgo; David Garcia,14,0,15,1
1653298612219,MUS 20,A03,090575,Borgo; David Garcia,13,0,15,2
1653298612748,MUS 32,001,094074,Staff,10,0,10,0
1653298612748,MUS 32,002,094075,Kenyatta; Kamau,10,0,10,0
1653298612748,MUS 32,003,094076,Curtis; Charles Rector,10,0,10,0
1653298612748,MUS 32,005,094078,Terrazas Perez; Wilfrido D,10,0,10,0
1653298612748,MUS 32,006,094079,Ohnishi; Takae,10,0,10,0
1653298612748,MUS 32,007,094080,Burr; Anthony I,10,0,10,0
1653298612748,MUS 32,008,094081,Carlson; Erik Norman,10,0,10,0
1653298612748,MUS 32,009,094082,Dresser; Mark Stuart,10,0,10,0
1653298612748,MUS 32,011,094084,Richards; Stephanie F,10,0,10,0
1653298612748,MUS 32,012,094085,Borgo; David Garcia,10,0,10,0
1653298612748,MUS 32,013,094086,Paganos Koukakis; Dimitrios,10,0,10,0
1653298612748,MUS 32,014,094087,Jones; Michael David,10,0,10,0
1653298613278,MUS 32V,A00,094355,Zazueta Cervera; Miguel Angel,10,0,10,0
1653298613278,MUS 32V,B00,094089,Flores; Mariana,10,0,10,0
1653298613802,MUS 32VM,A00,094090,Zazueta Cervera; Miguel Angel,15,0,15,0
1653298614334,MUS 33A,A00,090576,Liang; Lei,24,0,25,1
1653298614864,MUS 43,A00,090577,Burr; Anthony I,92,0,100,8
1653298615394,MUS 95C,B00,094829,Staff,28,0,30,2
1653298615988,MUS 95D,A00,090579,Staff,30,0,30,0
1653298616513,MUS 95E,A00,090580,Staff,30,0,30,0
1653298617044,MUS 95G,A00,090581,Anderson; Kenneth,384,0,395,11
1653298617044,MUS 95G,B00,090582,Anderson; Kenneth,393,0,395,2
1653298617570,MUS 95JC,A00,090583,Kenyatta; Kamau,35,0,35,0
1653298618097,MUS 95L,A00,090584,Staff,30,0,30,0
1653298618624,MUS 95W,A00,090585,Seshadri; Kartik,60,0,60,0
1653298618624,MUS 95W,B00,090586,Seshadri; Kartik,30,0,30,0
1653298619148,MUS 101A,A01,090588,Staff,29,0,30,1
1653298619678,MUS 103A,A00,090589,Ung; Chinary,15,0,15,0
1653298620202,MUS 107,A00,090590,Terrazas Perez; Wilfrido D,30,0,30,0
1653298620764,MUS 111,A00,090591,Yadegari; Shahrokh D,124,0,130,6
1653298621288,MUS 114,A00,090592,Curtis; Charles Rector,117,0,125,8
1653298621812,MUS 120A,A01,090594,Cimini; Amy Marie,29,0,30,1
1653298622339,MUS 126R,A00,090595,Borgo; David Garcia,106,0,115,9
1653298622864,MUS 130,A00,090596,Ohnishi; Takae,30,0,30,0
1653298623388,MUS 132,001,094091,Nourai; Keyarash,10,0,10,0
1653298623388,MUS 132,002,094093,Kenyatta; Kamau,10,0,10,0
1653298623388,MUS 132,003,094094,Curtis; Charles Rector,10,0,10,0
1653298623388,MUS 132,005,094096,Terrazas Perez; Wilfrido D,10,0,10,0
1653298623388,MUS 132,006,094097,Ohnishi; Takae,10,0,10,0
1653298623388,MUS 132,007,094098,Burr; Anthony I,10,0,10,0
1653298623388,MUS 132,008,094099,Carlson; Erik Norman,10,0,10,0
1653298623388,MUS 132,009,094100,Dresser; Mark Stuart,10,0,10,0
1653298623388,MUS 132,011,094102,Richards; Stephanie F,10,0,10,0
1653298623388,MUS 132,012,094103,Borgo; David Garcia,10,0,10,0
1653298623388,MUS 132,013,094104,Jones; Michael David,10,0,10,0
1653298623388,MUS 132,014,094105,Staff,10,0,10,0
1653298623911,MUS 132V,A00,094106,Narucki; Susan M,15,0,15,0
1653298624434,MUS 134,A00,090597,Staff,30,0,30,0
1653298624957,MUS 137A,A00,090598,Kenyatta; Kamau,30,0,30,0
1653298625480,MUS 143,A00,090599,Staff,26,0,30,4
1653298626533,MUS 173,A00,090600,Britt; King James,19,0,30,11
1653298627057,MUS 174A,A00,090601,Staff,8,0,15,7
1653298628114,NANO 4,A01,088199,Vazquez Mena; Oscar,20,0,20,0
1653298628114,NANO 4,B01,088201,Vazquez Mena; Oscar,20,0,20,0
1653298628114,NANO 4,C01,088203,Vazquez Mena; Oscar,20,0,20,0
1653298628641,NANO 15,A01,088205,Lubarda; Vlado,50,0,50,0
1653298628641,NANO 15,B01,088207,Lubarda; Vlado,50,0,50,0
1653298629165,NANO 20L,A00,088208,Sirbuly; Donald,27,0,30,3
1653298629165,NANO 20L,B00,088209,Sirbuly; Donald,29,0,30,1
1653298629691,NANO 100L,A00,088210,Vecchio; Kenneth S,24,0,30,6
1653298630225,NANO 102,A00,088211,Tao; Andrea Rae,94,0,100,6
1653298630752,NANO 110,A00,088212,Pascal; Tod A,99,0,100,1
1653298631281,NANO 111,A00,088213,Fenning; David,45,0,50,5
1653298631804,NANO 117,A00,088214,Cubukcu; Ertugrul,71,0,75,4
1653298632329,NANO 119,A00,088215,Vazquez Mena; Oscar,50,0,50,0
1653298632852,NANO 159,A00,088216,Wang; Joseph,33,0,40,7
1653298633375,NANO 181,A01,088218,Ong; Shyue Ping,22,0,25,3
1653298633903,PHIL 1,A00,090815,Sher; Gila,57,0,60,3
1653298634430,PHIL 10,A01,090817,Grush; Rick Scott,37,0,40,3
1653298634430,PHIL 10,A02,090818,Grush; Rick Scott,37,0,40,3
1653298634430,PHIL 10,A03,090819,Grush; Rick Scott,38,0,40,2
1653298634430,PHIL 10,A04,090820,Grush; Rick Scott,40,0,40,0
1653298634430,PHIL 10,A05,090821,Grush; Rick Scott,38,0,40,2
1653298634430,PHIL 10,A06,090822,Grush; Rick Scott,39,0,40,1
1653298634964,PHIL 12,A01,090824,Bechtel; William,20,0,25,5
1653298634964,PHIL 12,A02,090825,Bechtel; William,24,0,25,1
1653298634964,PHIL 12,A03,090826,Bechtel; William,25,0,25,0
1653298634964,PHIL 12,A04,090827,Bechtel; William,25,0,25,0
1653298635489,PHIL 13,A01,090829,Wonderly; Monique L.,25,0,25,0
1653298635489,PHIL 13,A02,090830,Wonderly; Monique L.,24,0,25,1
1653298635489,PHIL 13,A03,090831,Wonderly; Monique L.,24,0,25,1
1653298635489,PHIL 13,A04,090832,Wonderly; Monique L.,25,0,25,0
1653298636018,PHIL 27,A01,090834,Harrell; Maralee Mae,23,0,35,12
1653298636018,PHIL 27,A02,090835,Harrell; Maralee Mae,35,0,35,0
1653298636018,PHIL 27,A03,090836,Harrell; Maralee Mae,33,0,35,2
1653298636018,PHIL 27,A04,090837,Harrell; Maralee Mae,33,0,35,2
1653298636018,PHIL 27,A05,090838,Harrell; Maralee Mae,35,0,35,0
1653298636018,PHIL 27,A06,090839,Harrell; Maralee Mae,35,0,35,0
1653298636550,PHIL 28,A01,090841,Bazargan-Forward; Saba,31,0,35,4
1653298636550,PHIL 28,A02,090842,Bazargan-Forward; Saba,31,0,35,4
1653298636550,PHIL 28,A03,090843,Bazargan-Forward; Saba,35,0,35,0
1653298636550,PHIL 28,A04,090844,Bazargan-Forward; Saba,30,0,35,5
1653298636550,PHIL 28,A05,090845,Bazargan-Forward; Saba,33,0,35,2
1653298636550,PHIL 28,A06,090846,Bazargan-Forward; Saba,34,0,35,1
1653298636550,PHIL 28,A07,090847,Bazargan-Forward; Saba,32,0,35,3
1653298636550,PHIL 28,A08,090848,Bazargan-Forward; Saba,33,0,35,2
1653298637077,PHIL 31,A00,090849,Johnson; Monte,59,0,60,1
1653298637605,PHIL 100,A00,090852,Nelkin; Dana Kay,28,0,35,7
1653298638133,PHIL 110,A00,090853,Johnson; Monte,29,0,30,1
1653298638655,PHIL 120,A00,090854,Rickless; Samuel Charles,23,0,35,12
1653298639182,PHIL 123,A00,090855,Sher; Gila,38,0,40,2
1653298639705,PHIL 131,A00,090856,Cohen; Jonathan David,34,0,35,1
1653298640228,PHIL 132,A00,090857,Carr; Jennifer Rose,33,0,35,2
1653298640757,PHIL 138,A00,090858,Brink; David O.,34,0,40,6
1653298641281,PHIL 147,A00,090860,Fulkerson; Matthew Todd,33,0,35,2
1653298641807,PHIL 150,A00,090861,Bechtel; William,36,0,40,4
1653298642336,PHIL 155,A00,090862,Vargas; Manuel Rogelio,38,0,40,2
1653298642862,PHIL 165,A00,090863,Rickless; Samuel Charles,58,0,70,12
1653298643385,PHIL 172,A00,090864,Bazargan-Forward; Saba,37,0,40,3
1653298643911,PHIL 173,A00,090865,Wonderly; Monique L.,33,0,40,7
1653298644436,PHYS 1A,A00,088555,Koslover; Elena F,354,0,362,8
1653298644436,PHYS 1A,B00,088556,Koslover; Elena F,343,0,362,19
1653298644436,PHYS 1A,C00,088557,Shpyrko; Oleg,326,0,362,36
1653298644961,PHYS 1AL,001,088558,Tsai; Philbert S,30,0,30,0
1653298644961,PHYS 1AL,002,088559,Tsai; Philbert S,30,0,30,0
1653298644961,PHYS 1AL,003,088560,Tsai; Philbert S,23,0,30,7
1653298644961,PHYS 1AL,004,088561,Tsai; Philbert S,26,0,30,4
1653298644961,PHYS 1AL,005,088562,Tsai; Philbert S,24,0,30,6
1653298644961,PHYS 1AL,006,088563,Tsai; Philbert S,30,0,30,0
1653298644961,PHYS 1AL,007,088564,Tsai; Philbert S,26,0,30,4
1653298644961,PHYS 1AL,008,088565,Tsai; Philbert S,29,0,30,1
1653298644961,PHYS 1AL,009,088566,Tsai; Philbert S,28,0,30,2
1653298644961,PHYS 1AL,010,088567,Tsai; Philbert S,30,0,30,0
1653298644961,PHYS 1AL,011,088568,Tsai; Philbert S,29,0,30,1
1653298644961,PHYS 1AL,012,088569,Tsai; Philbert S,29,0,30,1
1653298644961,PHYS 1AL,013,088570,Tsai; Philbert S,30,0,30,0
1653298644961,PHYS 1AL,014,088571,Tsai; Philbert S,29,0,30,1
1653298644961,PHYS 1AL,015,088572,Tsai; Philbert S,23,0,30,7
1653298644961,PHYS 1AL,016,088573,Tsai; Philbert S,28,0,30,2
1653298644961,PHYS 1AL,017,088574,Tsai; Philbert S,29,0,30,1
1653298644961,PHYS 1AL,018,088575,Tsai; Philbert S,28,0,30,2
1653298644961,PHYS 1AL,019,088576,Tsai; Philbert S,26,0,30,4
1653298644961,PHYS 1AL,020,088577,Tsai; Philbert S,29,0,30,1
1653298644961,PHYS 1AL,021,088578,Tsai; Philbert S,30,0,30,0
1653298644961,PHYS 1AL,022,088579,Tsai; Philbert S,30,0,30,0
1653298644961,PHYS 1AL,023,088580,Tsai; Philbert S,30,0,30,0
1653298644961,PHYS 1AL,024,088581,Tsai; Philbert S,30,0,30,0
1653298644961,PHYS 1AL,025,088582,Tsai; Philbert S,26,0,30,4
1653298644961,PHYS 1AL,026,088583,Tsai; Philbert S,29,0,30,1
1653298644961,PHYS 1AL,027,088584,Tsai; Philbert S,28,0,30,2
1653298644961,PHYS 1AL,028,088585,Tsai; Philbert S,30,0,30,0
1653298644961,PHYS 1AL,029,088586,Tsai; Philbert S,27,0,30,3
1653298644961,PHYS 1AL,030,088587,Tsai; Philbert S,29,0,30,1
1653298644961,PHYS 1AL,031,088588,Tsai; Philbert S,30,0,30,0
1653298644961,PHYS 1AL,032,088589,Tsai; Philbert S,30,0,30,0
1653298644961,PHYS 1AL,033,088590,Tsai; Philbert S,30,0,30,0
1653298644961,PHYS 1AL,034,088591,Tsai; Philbert S,30,0,30,0
1653298644961,PHYS 1AL,035,088592,Tsai; Philbert S,29,0,30,1
1653298644961,PHYS 1AL,036,088593,Tsai; Philbert S,30,0,30,0
1653298645486,PHYS 1B,A00,088594,Groisman; Alexander,351,0,360,9
1653298646009,PHYS 1BL,001,088595,Tsai; Philbert S,30,0,30,0
1653298646009,PHYS 1BL,002,088596,Tsai; Philbert S,25,0,30,5
1653298646009,PHYS 1BL,003,088597,Tsai; Philbert S,27,0,30,3
1653298646009,PHYS 1BL,004,088598,Tsai; Philbert S,30,0,30,0
1653298646009,PHYS 1BL,005,088599,Tsai; Philbert S,29,0,30,1
1653298646009,PHYS 1BL,006,088600,Tsai; Philbert S,25,0,30,5
1653298646009,PHYS 1BL,007,088601,Tsai; Philbert S,30,0,30,0
1653298646009,PHYS 1BL,008,088602,Tsai; Philbert S,29,0,30,1
1653298646009,PHYS 1BL,009,088603,Tsai; Philbert S,30,0,30,0
1653298646009,PHYS 1BL,010,088604,Tsai; Philbert S,30,0,30,0
1653298646009,PHYS 1BL,011,088605,Tsai; Philbert S,28,0,30,2
1653298646009,PHYS 1BL,012,088606,Tsai; Philbert S,26,0,30,4
1653298646535,PHYS 1C,A00,088607,Tsai; Philbert S,334,0,360,26
1653298647064,PHYS 1CL,001,088608,Tsai; Philbert S,30,0,30,0
1653298647064,PHYS 1CL,002,088609,Tsai; Philbert S,24,0,30,6
1653298647064,PHYS 1CL,003,088610,Tsai; Philbert S,24,0,30,6
1653298647064,PHYS 1CL,004,088611,Tsai; Philbert S,29,0,30,1
1653298647064,PHYS 1CL,005,088612,Tsai; Philbert S,17,0,30,13
1653298647064,PHYS 1CL,006,088613,Tsai; Philbert S,19,0,30,11
1653298647064,PHYS 1CL,007,088614,Tsai; Philbert S,30,0,30,0
1653298647064,PHYS 1CL,008,088615,Tsai; Philbert S,26,0,30,4
1653298647064,PHYS 1CL,009,088616,Tsai; Philbert S,27,0,30,3
1653298647064,PHYS 1CL,010,088617,Tsai; Philbert S,29,0,30,1
1653298647064,PHYS 1CL,011,088618,Tsai; Philbert S,27,0,30,3
1653298647064,PHYS 1CL,012,088619,Tsai; Philbert S,24,0,30,6
1653298647599,PHYS 2A,A01,092602,Meyertholen; Andrew D.,26,0,30,4
1653298647599,PHYS 2A,A02,092603,Meyertholen; Andrew D.,28,0,30,2
1653298647599,PHYS 2A,A03,092604,Meyertholen; Andrew D.,29,0,30,1
1653298647599,PHYS 2A,A04,092605,Meyertholen; Andrew D.,30,0,30,0
1653298647599,PHYS 2A,A05,092606,Meyertholen; Andrew D.,29,0,30,1
1653298647599,PHYS 2A,A06,092607,Meyertholen; Andrew D.,29,0,30,1
1653298647599,PHYS 2A,A07,092608,Meyertholen; Andrew D.,30,0,30,0
1653298647599,PHYS 2A,A08,092609,Meyertholen; Andrew D.,30,0,30,0
1653298647599,PHYS 2A,A09,092610,Meyertholen; Andrew D.,27,0,30,3
1653298647599,PHYS 2A,A10,092611,Meyertholen; Andrew D.,30,0,30,0
1653298647599,PHYS 2A,A11,092612,Meyertholen; Andrew D.,30,0,30,0
1653298647599,PHYS 2A,A12,094499,Meyertholen; Andrew D.,27,0,30,3
1653298648124,PHYS 2B,A01,092613,Branson; James G,28,0,30,2
1653298648124,PHYS 2B,A02,092614,Branson; James G,29,0,30,1
1653298648124,PHYS 2B,A03,092615,Branson; James G,30,0,30,0
1653298648124,PHYS 2B,A04,092616,Branson; James G,30,0,30,0
1653298648124,PHYS 2B,A05,092617,Branson; James G,29,0,30,1
1653298648124,PHYS 2B,A06,092618,Branson; James G,29,0,30,1
1653298648124,PHYS 2B,A07,092619,Branson; James G,29,0,30,1
1653298648124,PHYS 2B,A08,092620,Branson; James G,0,0,0,0
1653298648124,PHYS 2B,A09,092621,Branson; James G,0,0,0,0
1653298648124,PHYS 2B,A10,092622,Branson; James G,0,0,0,0
1653298648124,PHYS 2B,A11,092623,Branson; James G,0,0,0,0
1653298648124,PHYS 2B,A12,092624,Branson; James G,30,0,30,0
1653298648679,PHYS 2C,A01,092625,Barreiro Guerrero; Julio,27,0,30,3
1653298648679,PHYS 2C,A02,092626,Barreiro Guerrero; Julio,28,0,30,2
1653298648679,PHYS 2C,A03,092627,Barreiro Guerrero; Julio,29,0,30,1
1653298648679,PHYS 2C,A04,092628,Barreiro Guerrero; Julio,29,0,30,1
1653298648679,PHYS 2C,A05,092629,Barreiro Guerrero; Julio,30,0,30,0
1653298648679,PHYS 2C,A06,092630,Barreiro Guerrero; Julio,30,0,30,0
1653298648679,PHYS 2C,A07,092631,Barreiro Guerrero; Julio,30,0,30,0
1653298648679,PHYS 2C,A08,092632,Barreiro Guerrero; Julio,30,0,30,0
1653298648679,PHYS 2C,A09,092633,Barreiro Guerrero; Julio,29,0,30,1
1653298648679,PHYS 2C,A10,092634,Barreiro Guerrero; Julio,29,0,30,1
1653298648679,PHYS 2C,A11,092635,Barreiro Guerrero; Julio,27,0,30,3
1653298648679,PHYS 2C,A12,092636,Barreiro Guerrero; Julio,29,0,30,1
1653298648679,PHYS 2C,B01,092637,Barreiro Guerrero; Julio,29,0,30,1
1653298648679,PHYS 2C,B02,092638,Barreiro Guerrero; Julio,30,0,30,0
1653298648679,PHYS 2C,B03,092639,Barreiro Guerrero; Julio,28,0,30,2
1653298648679,PHYS 2C,B04,092640,Barreiro Guerrero; Julio,29,0,30,1
1653298648679,PHYS 2C,B05,092641,Barreiro Guerrero; Julio,26,0,30,4
1653298648679,PHYS 2C,B06,092642,Barreiro Guerrero; Julio,28,0,30,2
1653298648679,PHYS 2C,B07,092643,Barreiro Guerrero; Julio,29,0,30,1
1653298648679,PHYS 2C,B08,092644,Barreiro Guerrero; Julio,30,0,30,0
1653298648679,PHYS 2C,B09,092645,Barreiro Guerrero; Julio,29,0,30,1
1653298648679,PHYS 2C,B10,092646,Barreiro Guerrero; Julio,29,0,30,1
1653298648679,PHYS 2C,B11,092647,Barreiro Guerrero; Julio,30,0,30,0
1653298648679,PHYS 2C,B12,092648,Barreiro Guerrero; Julio,30,0,30,0
1653298649203,PHYS 2CL,A01,088625,Du; Chunhui,26,0,30,4
1653298649203,PHYS 2CL,A02,088626,Du; Chunhui,29,0,30,1
1653298649203,PHYS 2CL,A03,088627,Du; Chunhui,21,0,30,9
1653298649203,PHYS 2CL,A04,088628,Du; Chunhui,30,0,30,0
1653298649203,PHYS 2CL,A05,088629,Du; Chunhui,29,0,30,1
1653298649203,PHYS 2CL,A06,088630,Du; Chunhui,24,0,30,6
1653298649203,PHYS 2CL,A07,088631,Du; Chunhui,28,0,30,2
1653298649203,PHYS 2CL,A08,088632,Du; Chunhui,28,0,30,2
1653298649203,PHYS 2CL,A09,088633,Du; Chunhui,24,0,30,6
1653298649203,PHYS 2CL,A10,088634,Du; Chunhui,29,0,30,1
1653298649203,PHYS 2CL,A11,088635,Du; Chunhui,27,0,30,3
1653298649203,PHYS 2CL,A12,088636,Du; Chunhui,30,0,30,0
1653298649734,PHYS 2D,A01,092649,Hirsch; Jorge Eduardo,30,0,30,0
1653298649734,PHYS 2D,A02,092650,Hirsch; Jorge Eduardo,28,0,30,2
1653298649734,PHYS 2D,A03,092651,Hirsch; Jorge Eduardo,30,0,30,0
1653298649734,PHYS 2D,A04,092652,Hirsch; Jorge Eduardo,30,0,30,0
1653298649734,PHYS 2D,A05,092653,Hirsch; Jorge Eduardo,30,0,30,0
1653298649734,PHYS 2D,A06,092654,Hirsch; Jorge Eduardo,30,0,30,0
1653298650261,PHYS 2DL,A01,088639,Butov; Leonid,7,0,16,9
1653298650261,PHYS 2DL,A02,088640,Butov; Leonid,13,0,16,3
1653298650261,PHYS 2DL,A03,094501,Butov; Leonid,13,0,16,3
1653298650261,PHYS 2DL,A04,094502,Butov; Leonid,16,0,16,0
1653298650789,PHYS 4C,A01,092655,Averitt; Richard Douglas,28,0,30,2
1653298650789,PHYS 4C,A02,092656,Averitt; Richard Douglas,30,0,30,0
1653298650789,PHYS 4C,A03,092657,Averitt; Richard Douglas,30,0,30,0
1653298650789,PHYS 4C,A04,092658,Staff,30,0,30,0
1653298651318,PHYS 5,A01,092662,Konopacky; Quinn Morgan,197,0,200,3
1653298651846,PHYS 10,A01,092663,Tytler; David Robert,191,0,192,1
1653298652369,PHYS 100A,A01,092660,Shpyrko; Oleg,114,0,120,6
1653298652894,PHYS 110A,A01,092664,Arovas; Daniel P,116,0,120,4
1653298653420,PHYS 122,A01,088647,Yang; Liang,30,0,40,10
1653298653944,PHYS 130B,A01,092661,Grover; Tarun,106,0,120,14
1653298654472,PHYS 139,A00,088649,Kuti; Julius,19,0,20,1
1653298654997,PHYS 140A,A01,092665,Shotwell; Brian,105,0,120,15
1653298655521,PHYS 161,A01,092666,Fuller; George Michael,46,0,65,19
1653298656046,PHYS 163,A01,092667,Keres; Dusan,48,0,50,2
1653298656581,PHYS 175,A00,088653,Dudko; Olga,18,0,20,2
1653298657107,PHYS 191,A00,088654,Shpyrko; Oleg,26,0,30,4
1653298657650,POLI 11D,A01,090896,Ferree; Karen E,29,0,30,1
1653298657650,POLI 11D,A02,090897,Ferree; Karen E,28,0,30,2
1653298657650,POLI 11D,A03,090899,Ferree; Karen E,28,0,30,2
1653298657650,POLI 11D,A04,090900,Ferree; Karen E,29,0,30,1
1653298658180,POLI 12D,A01,090902,Roeder; Philip G,26,0,30,4
1653298658180,POLI 12D,A02,090903,Roeder; Philip G,27,0,30,3
1653298658180,POLI 12D,A05,090906,Roeder; Philip G,28,0,30,2
1653298658180,POLI 12D,A06,090907,Roeder; Philip G,30,0,30,0
1653298658709,POLI 13DR,A01,090909,Forman; Fonna,26,0,30,4
1653298658709,POLI 13DR,A02,090910,Forman; Fonna,30,0,30,0
1653298658709,POLI 13DR,A03,090911,Forman; Fonna,28,0,30,2
1653298658709,POLI 13DR,A04,090912,Forman; Fonna,30,0,30,0
1653298658709,POLI 13DR,A05,090913,Forman; Fonna,28,0,30,2
1653298658709,POLI 13DR,A06,090914,Forman; Fonna,34,0,34,0
1653298659236,POLI 27,A01,090916,Elgin; Samuel Zincke,23,0,30,7
1653298659236,POLI 27,A02,090917,Elgin; Samuel Zincke,26,0,30,4
1653298659236,POLI 27,A03,090918,Elgin; Samuel Zincke,30,0,30,0
1653298659236,POLI 27,A04,090919,Elgin; Samuel Zincke,28,0,30,2
1653298659236,POLI 27,A05,090920,Elgin; Samuel Zincke,24,0,30,6
1653298659236,POLI 27,A06,090921,Elgin; Samuel Zincke,29,0,30,1
1653298659758,POLI 28,A01,090923,Elgin; Samuel Zincke,23,0,30,7
1653298659758,POLI 28,A02,090924,Elgin; Samuel Zincke,26,0,30,4
1653298659758,POLI 28,A05,090927,Elgin; Samuel Zincke,23,0,30,7
1653298659758,POLI 28,A06,090928,Elgin; Samuel Zincke,23,0,30,7
1653298660288,POLI 30D,A01,090930,Desposato; Scott,22,0,24,2
1653298660288,POLI 30D,A02,090931,Desposato; Scott,22,0,24,2
1653298660288,POLI 30D,A03,090932,Desposato; Scott,23,0,24,1
1653298660288,POLI 30D,A04,090933,Desposato; Scott,24,0,24,0
1653298660288,POLI 30D,A05,090934,Desposato; Scott,23,0,24,1
1653298660288,POLI 30D,A06,090935,Desposato; Scott,24,0,24,0
1653298660812,POLI 100G,A00,090936,Fletcher; Nathan,199,0,208,9
1653298661336,POLI 100V,A00,090937,Gause; LaGina,111,0,115,4
1653298661860,POLI 100W,A00,090938,Paglayan; Agustina,161,0,165,4
1653298662388,POLI 104A,A00,090940,Smith; Glenn Chatmas,186,0,195,9
1653298662911,POLI 104F,A00,090941,Smith; Glenn Chatmas,11,0,19,8
1653298663435,POLI 104M,A00,090942,Stephens; Mattheus E,156,0,165,9
1653298663963,POLI 110A,A00,090943,Wiens; David,39,0,44,5
1653298664497,POLI 110F,A00,090944,Elgin; Samuel Zincke,50,0,50,0
1653298665028,POLI 113A,A00,090945,Magagna; Victor Valentine,469,0,475,6
1653298665028,POLI 113A,B00,090946,Magagna; Victor Valentine,467,0,475,8
1653298665573,POLI 117R,A00,090947,Forman; Fonna,16,0,40,24
1653298666097,POLI 120E,A00,090948,Strom; Kaare,47,0,50,3
1653298666632,POLI 120G,A00,090949,Fisk; David Lee,110,0,115,5
1653298667159,POLI 120H,A00,090950,Fisk; David Lee,111,0,115,4
1653298667684,POLI 133A,A00,090951,Naoi; Megumi,156,0,165,9
1653298668206,POLI 135,A00,090952,Fisk; David Lee,111,0,115,4
1653298668734,POLI 142J,A00,090953,Slantchev; Branislav,45,0,50,5
1653298669340,POLI 143,A00,090954,Gartzke; Erik,111,0,115,4
1653298669871,POLI 149,A00,090955,Joseph; Michael F,152,0,165,13
1653298670394,POLI 151,A00,090956,Schneider; Christina,92,0,100,8
1653298670918,POLI 165,A00,090957,Warren; Scott,45,0,50,5
1653298671442,POLI 178,A00,090958,Joseph; Michael F,34,0,50,16
1653298671967,POLI 191A,A00,090959,Forman; Fonna & Hoston; Germaine,25,0,25,0
1653298672493,POLI 194,A00,090960,Hill; Seth J,9999,0,9999,0
1653298673016,POLI 194SD,A00,090961,Nichter; Maysa,9999,0,9999,0
1653298673539,POLI 197SD,001,090962,Nichter; Maysa,9999,0,9999,0
1653298674061,PSYC 1,A00,088391,Ferreira; Victor,194,0,200,6
1653298674589,PSYC 2,A00,093916,Moranton; Nirelia Melbina-,192,0,195,3
1653298675113,PSYC 3,A00,088392,Pilegard; Celeste Cristine,221,0,225,4
1653298675638,PSYC 6,A00,088393,McCullough; Michael E,198,0,200,2
1653298676163,PSYC 7,A00,088394,Powell; Lindsey Jane,196,0,200,4
1653298676696,PSYC 60,A01,088397,Lowe; Angela Beth,12,0,25,13
1653298676696,PSYC 60,A02,088398,Lowe; Angela Beth,25,0,25,0
1653298676696,PSYC 60,A03,088399,Lowe; Angela Beth,24,0,25,1
1653298676696,PSYC 60,A04,088400,Lowe; Angela Beth,23,0,25,2
1653298676696,PSYC 60,A05,088401,Lowe; Angela Beth,24,0,25,1
1653298676696,PSYC 60,A06,088402,Lowe; Angela Beth,25,0,25,0
1653298676696,PSYC 60,A07,088403,Lowe; Angela Beth,24,0,25,1
1653298676696,PSYC 60,B01,088405,Rickard; Timothy C.,25,0,25,0
1653298676696,PSYC 60,B02,088406,Rickard; Timothy C.,25,0,25,0
1653298676696,PSYC 60,B03,088407,Rickard; Timothy C.,25,0,25,0
1653298676696,PSYC 60,B04,088408,Rickard; Timothy C.,23,0,25,2
1653298676696,PSYC 60,B05,088410,Rickard; Timothy C.,24,0,25,1
1653298676696,PSYC 60,B06,088411,Rickard; Timothy C.,24,0,25,1
1653298676696,PSYC 60,B07,088412,Rickard; Timothy C.,24,0,25,1
1653298677224,PSYC 70,A01,088414,Pilegard; Celeste Cristine,17,0,25,8
1653298677224,PSYC 70,A02,088415,Pilegard; Celeste Cristine,24,0,25,1
1653298677224,PSYC 70,A03,088416,Pilegard; Celeste Cristine,25,0,25,0
1653298677224,PSYC 70,A04,088417,Pilegard; Celeste Cristine,25,0,25,0
1653298677224,PSYC 70,A05,088418,Pilegard; Celeste Cristine,22,0,25,3
1653298677224,PSYC 70,A06,088419,Pilegard; Celeste Cristine,19,0,25,6
1653298677760,PSYC 71,A01,088421,Lowe; Angela Beth,15,0,25,10
1653298677760,PSYC 71,A02,088422,Lowe; Angela Beth,21,0,25,4
1653298677760,PSYC 71,B01,088424,Steiner; Eric Tomas,20,0,25,5
1653298677760,PSYC 71,B02,088425,Steiner; Eric Tomas,23,0,25,2
1653298678291,PSYC 87,A00,093915,Gorman; Michael R.,20,0,20,0
1653298678826,PSYC 88,A00,088426,Dobkins; Karen R.,61,0,65,4
1653298679352,PSYC 100,A00,088428,Chapman; Eddie Nathaniel,125,0,170,45
1653298679880,PSYC 101,A00,088429,Heyman; Gail D.,148,0,170,22
1653298680404,PSYC 102,A00,093917,Moranton; Nirelia Melbina-,162,0,170,8
1653298680928,PSYC 104,A00,088430,Fine; Rachel,163,0,175,12
1653298681454,PSYC 116A,A01,088433,Lang; Ariel,25,0,25,0
1653298681988,PSYC 122,A00,088434,Miller; Cory T.,103,0,115,12
1653298682512,PSYC 125,A00,088436,Rose; Fred E.,90,0,120,30
1653298683036,PSYC 134,A00,088437,Kaye; Walter H.,235,0,250,15
1653298683559,PSYC 137,A00,088438,Fine; Rachel,210,0,216,6
1653298684084,PSYC 145,A00,093918,Staff,73,0,90,17
1653298684612,PSYC 147,A00,088441,Wong; Lauren Hitomi,120,0,146,26
1653298685135,PSYC 154,A00,093919,Lacefield; Katharine I,270,0,295,25
1653298685661,PSYC 158,A00,088443,Willis; Jarryd Thomas,250,0,295,45
1653298686187,PSYC 162,A00,088444,Wixted; John T,210,0,225,15
1653298686716,PSYC 167,A00,088445,Walker; Caren Michelle,0,0,30,30
1653298687240,PSYC 168,A00,088446,Chapman; Eddie Nathaniel,222,0,250,28
1653298687766,PSYC 171,A00,088447,Mukku; Dhananjaya,66,0,75,9
1653298688293,PSYC 178,A00,088448,Glaser; Dale,105,0,120,15
1653298688817,PSYC 179,A00,088449,Lacefield; Katharine I,193,0,250,57
1653298689339,PSYC 181,A00,088450,Anagnostaras; Stephan,284,0,300,16
1653298689862,PSYC 189,A00,088451,Gentner; Tim,19,0,31,12
1653298690390,PSYC 193,A00,088452,Gremel; Christina M,19,0,20,1
1653298690390,PSYC 193,B00,088453,Staff,19,0,20,1
1653298690913,PSYC 193L,A01,088455,Staff,33,0,35,2
1653298691436,PSYC 194A,A01,088461,Heyman; Gail D.,35,0,35,0
1653298691967,RELI 1,A01,086478,Kalleres; Dayna,20,0,20,0
1653298691967,RELI 1,A02,086479,Kalleres; Dayna,19,0,20,1
1653298692491,RELI 147,A00,088409,Caciola; Nancy A,0,0,0,0
1653298693014,REV 1,A01,092308,Leigh; Brian,24,0,24,0
1653298693014,REV 1,A02,092310,Leigh; Brian,24,0,24,0
1653298693014,REV 1,A03,092312,Leigh; Brian,24,0,24,0
1653298693014,REV 1,A04,092314,Leigh; Brian,24,0,24,0
1653298693014,REV 1,A05,092316,Leigh; Brian,24,0,24,0
1653298693537,REV 2,A01,092318,Staff,28,0,28,0
1653298693537,REV 2,A02,092319,Staff,28,0,28,0
1653298694060,REV 20,A00,092320,Staff,40,0,40,0
1653298694585,REV 87,A00,092321,Lyon; Antony J.,20,0,20,0
1653298695116,SE 1,A01,088674,Van Den Einde; Yael Dahlia,48,0,48,0
1653298695116,SE 1,A02,088675,Van Den Einde; Yael Dahlia,47,0,48,1
1653298695116,SE 1,A03,088676,Van Den Einde; Yael Dahlia,46,0,48,2
1653298695643,SE 101A,A00,088677,Morrison; Machel Leigh,191,0,200,9
1653298696175,SE 101C,A00,088678,Zhu; Qiang,137,0,145,8
1653298696703,SE 125,A00,088679,Conte; Joel P,143,0,145,2
1653298697228,SE 130A,A00,088680,Loh; Kenneth J. H.,110,0,115,5
1653298697757,SE 131B,A00,088681,Krysl; Petr,84,0,115,31
1653298698280,SE 142,A01,088683,Staff,11,0,18,7
1653298698280,SE 142,A02,088684,Staff,13,0,18,5
1653298698806,SE 164,A01,088686,Loh; Kenneth J. H.,14,0,16,2
1653298699332,SE 180,A00,088687,Elgamal; Ahmed,66,0,75,9
1653298699856,SE 181,A01,088689,McCartney; John Scott,25,0,30,5
1653298699856,SE 181,A02,088690,McCartney; John Scott,14,0,30,16
1653298699856,SE 181,A03,088691,McCartney; John Scott,25,0,25,0
1653298699856,SE 181,A04,088692,McCartney; John Scott,25,0,25,0
1653298700379,SIO 12,A00,088342,Staff,141,0,146,5
1653298700902,SIO 15,A00,088343,Laske; Gabi,333,0,340,7
1653298701426,SIO 30,A01,092382,Castillo; Paterno R.,28,0,35,7
1653298701426,SIO 30,A02,092383,Castillo; Paterno R.,32,0,35,3
1653298701426,SIO 30,A03,092384,Castillo; Paterno R.,35,0,35,0
1653298701426,SIO 30,A04,092385,Castillo; Paterno R.,35,0,35,0
1653298701953,SIO 40,A00,088345,Barbeau; Katherine,144,0,146,2
1653298702481,SIO 50,A01,088347,Cook; Geoffrey W,11,0,14,3
1653298702481,SIO 50,A02,088348,Cook; Geoffrey W,11,0,14,3
1653298703007,SIO 87,A00,088350,Cook; Geoffrey W,20,0,20,0
1653298703007,SIO 87,B00,088351,Cook; Geoffrey W,20,0,20,0
1653298703007,SIO 87,C00,094017,Gilbert; Jack Anthony,20,0,20,0
1653298703007,SIO 87,D00,094018,Gerwick; William Henry,20,0,20,0
1653298703534,SIO 90,A00,088352,Staff,56,0,60,4
1653298704066,SIO 100,A00,088354,Norris; Richard D. & Gee; Jeffrey S,10,0,20,10
1653298704594,SIO 101,A01,088356,Aluwihare; Lihini & Decima; Moira R.,1,0,30,29
1653298704594,SIO 101,A02,088357,Aluwihare; Lihini & Decima; Moira R.,15,0,30,15
1653298705121,SIO 103,A01,088359,Parnell-Turner; Ross Ernes,21,0,25,4
1653298705648,SIO 105,A00,088360,Driscoll; Neal W.,18,0,20,2
1653298706177,SIO 108,A01,088363,Teranes; Jane,15,0,20,5
1653298706706,SIO 109R,A00,088364,Forman; Fonna,27,0,40,13
1653298707237,SIO 110,A01,088366,Staff,8,0,29,21
1653298707761,SIO 117,A01,088368,Keeling; Ralph F.,31,0,36,5
1653298708284,SIO 123,A00,088369,Allen; Andrew Ellis,61,0,70,9
1653298708811,SIO 132,A01,092386,Hechinger; Ryan F. & Kacev; David,17,0,28,11
1653298708811,SIO 132,A02,092387,Hechinger; Ryan F. & Kacev; David,26,0,28,2
1653298708811,SIO 132,A03,092388,Hechinger; Ryan F. & Kacev; David,28,0,28,0
1653298708811,SIO 132,A04,092389,Hechinger; Ryan F. & Kacev; David,23,0,28,5
1653298708811,SIO 132,A05,092390,Hechinger; Ryan F. & Kacev; David,27,0,28,1
1653298708811,SIO 132,A06,092391,Hechinger; Ryan F. & Kacev; David,27,0,28,1
1653298709343,SIO 136,A01,088373,Kacev; David & Bowman; Jeff Shovlowsky,0,0,5,7
1653298709343,SIO 136,B01,088376,Kacev; David & Bowman; Jeff Shovlowsky,0,0,5,5
1653298709868,SIO 155,A01,088379,Day; James M.D.,1,0,5,4
1653298710390,SIO 170,A00,088380,Cook; Geoffrey W,29,0,30,1
1653298710920,SIO 171,A01,088382,Rudnick; Daniel Lars,37,0,40,3
1653298711448,SIO 175,A01,088384,Merrifield; Mark A,22,0,25,3
1653298711974,SIO 177,A00,088385,Becker; Janet Maria,15,0,20,5
1653298712503,SIO 179,A01,088387,Martz; Todd R.,7,0,15,8
1653298713553,SIO 189,A00,088390,Hamdoun; Amr,35,0,60,25
1653298714075,SIO 194,A00,091602,Hill; Seth J,9999,0,9999,0
1653298714603,SOCE 194,A00,091601,Hill; Seth J,9999,0,9999,0
1653298715128,SOCI 1,A01,093704,Skrentny; John David,19,0,20,1
1653298715128,SOCI 1,A02,093705,Skrentny; John David,20,0,20,0
1653298715128,SOCI 1,A03,093706,Skrentny; John David,18,0,20,2
1653298715128,SOCI 1,A04,093707,Skrentny; John David,19,0,20,1
1653298715128,SOCI 1,A05,093708,Skrentny; John David,17,0,20,3
1653298715128,SOCI 1,A06,093709,Skrentny; John David,20,0,20,0
1653298715128,SOCI 1,A07,093710,Skrentny; John David,20,0,20,0
1653298715128,SOCI 1,A08,093711,Skrentny; John David,20,0,20,0
1653298715128,SOCI 1,A09,093712,Skrentny; John David,20,0,20,0
1653298715128,SOCI 1,A10,093713,Skrentny; John David,20,0,20,0
1653298715128,SOCI 1,A11,093714,Skrentny; John David,20,0,20,0
1653298715657,SOCI 30,A01,093716,Staff,30,0,30,0
1653298715657,SOCI 30,A02,093717,Staff,30,0,30,0
1653298716180,SOCI 60,A01,093719,Staff,17,0,20,3
1653298716180,SOCI 60,A02,093720,Staff,18,0,20,2
1653298716180,SOCI 60,A03,093721,Staff,20,0,20,0
1653298716180,SOCI 60,A04,093722,Staff,20,0,20,0
1653298716711,SOCI 87,A00,093819,Blair-Loy; Mary,20,0,20,0
1653298717241,SOCI 100,A01,093724,Estefan; Michel,15,0,20,5
1653298717241,SOCI 100,A02,093725,Estefan; Michel,5,0,20,15
1653298717764,SOCI 104,A00,093728,Gong; Neil M,22,0,25,3
1653298718290,SOCI 104Q,A00,093729,Staff,23,0,25,2
1653298718816,SOCI 106,A00,093730,Staff,25,0,25,0
1653298719337,SOCI 109,A00,093731,Staff,21,0,25,4
1653298719860,SOCI 110,A00,093732,Binder; Amy,24,0,25,1
1653298721439,SOCI 117,A01,091568,Chung; Luz Marina,29,0,35,6
1653298721439,SOCI 117,A02,091569,Chung; Luz Marina,35,0,35,0
1653298721963,SOCI 118,A00,093735,Staff,0,0,0,0
1653298722580,SOCI 120T,A00,093736,Lampland; Martha,50,0,50,0
1653298722580,SOCI 120T,B00,094832,Staff,69,0,70,1
1653298723103,SOCI 122,A00,093737,Lewis; Kevin Michael,62,0,70,8
1653298723630,SOCI 123,A00,094831,Staff,57,0,65,8
1653298724155,SOCI 125,A00,093738,Staff,115,0,120,5
1653298724682,SOCI 127,A00,094894,Staff,54,0,56,2
1653298725206,SOCI 132,A00,093739,Blair-Loy; Mary,51,0,60,9
1653298726253,SOCI 136F,A00,094830,Staff,45,0,56,11
1653298726779,SOCI 138,A00,093741,Navon; Daniel,117,0,120,3
1653298727303,SOCI 140A,A00,093743,Gong; Neil M,53,0,60,7
1653298727828,SOCI 141,A00,093744,Summers; Valerie R.,111,0,120,9
1653298728878,SOCI 144,A00,093746,Staff,0,0,0,0
1653298730977,SOCI 159,A00,094902,Staff,49,0,50,1
1653298731504,SOCI 160,A00,093750,Staff,0,0,0,0
1653298732031,SOCI 165,A00,093751,Rona-Tas; Akos,43,0,48,5
1653298732558,SOCI 165A,A00,094206,Hallin; Daniel C,3,0,4,1
1653298733086,SOCI 166,A00,093752,Lampland; Martha,52,0,56,4
1653298733618,SOCI 176,A00,093753,Turner; Christena L.,44,0,48,4
1653298734141,SOCI 180,A00,094901,Staff,56,0,56,0
1653298734664,SOCI 185,A00,094903,Staff,55,0,56,1
1653298735190,SOCI 196A,A00,093754,Shafir; Gershon,20,0,20,0
1653298735726,SXTH 1,A01,092351,Bronstein; Phoebe Malan,18,0,18,0
1653298735726,SXTH 1,A02,092352,Bronstein; Phoebe Malan,18,0,18,0
1653298735726,SXTH 1,A03,092353,Bronstein; Phoebe Malan,18,0,18,0
1653298736266,SXTH 20A,A00,092355,Chilukuri; Lakshmi N,56,0,56,0
1653298736803,SYN 2,001,091487,Gladstein; Jill M,13,0,15,2
1653298736803,SYN 2,002,091488,Gladstein; Jill M,14,0,15,1
1653298736803,SYN 2,003,091490,Gladstein; Jill M,12,0,15,3
1653298736803,SYN 2,004,091491,Gladstein; Jill M,15,0,15,0
1653298736803,SYN 2,005,091493,Gladstein; Jill M,15,0,15,0
1653298736803,SYN 2,006,091495,Gladstein; Jill M,15,0,15,0
1653298736803,SYN 2,007,091496,Gladstein; Jill M,15,0,15,0
1653298736803,SYN 2,008,091497,Gladstein; Jill M,14,0,15,1
1653298736803,SYN 2,009,091499,Gladstein; Jill M,13,0,15,2
1653298736803,SYN 2,010,091501,Gladstein; Jill M,13,0,15,2
1653298736803,SYN 2,011,091502,Gladstein; Jill M,13,0,15,2
1653298736803,SYN 2,012,091503,Gladstein; Jill M,15,0,15,0
1653298736803,SYN 2,013,091505,Gladstein; Jill M,13,0,15,2
1653298736803,SYN 2,014,091506,Gladstein; Jill M,12,0,15,3
1653298736803,SYN 2,015,091508,Gladstein; Jill M,14,0,15,1
1653298736803,SYN 2,016,091509,Gladstein; Jill M,12,0,15,3
1653298736803,SYN 2,017,091510,Gladstein; Jill M,14,0,15,1
1653298736803,SYN 2,018,091512,Gladstein; Jill M,15,0,15,0
1653298736803,SYN 2,019,091513,Gladstein; Jill M,15,0,15,0
1653298736803,SYN 2,020,091514,Gladstein; Jill M,15,0,15,0
1653298736803,SYN 2,021,091516,Gladstein; Jill M,12,0,15,3
1653298736803,SYN 2,022,091517,Gladstein; Jill M,13,0,15,2
1653298736803,SYN 2,023,091518,Gladstein; Jill M,15,0,15,0
1653298736803,SYN 2,024,091519,Gladstein; Jill M,15,0,15,0
1653298736803,SYN 2,025,091520,Gladstein; Jill M,11,0,15,4
1653298736803,SYN 2,026,091521,Gladstein; Jill M,15,0,15,0
1653298736803,SYN 2,027,091522,Gladstein; Jill M,0,0,0,0
1653298736803,SYN 2,028,091523,Gladstein; Jill M,0,0,0,0
1653298736803,SYN 2,029,091524,Gladstein; Jill M,0,0,0,0
1653298736803,SYN 2,030,091525,Gladstein; Jill M,0,0,0,0
1653298736803,SYN 2,031,091526,Gladstein; Jill M,14,0,15,1
1653298736803,SYN 2,032,091527,Gladstein; Jill M,15,0,15,0
1653298736803,SYN 2,033,091528,Gladstein; Jill M,0,0,0,0
1653298736803,SYN 2,034,091529,Gladstein; Jill M,15,0,15,0
1653298736803,SYN 2,035,091530,Gladstein; Jill M,15,0,15,0
1653298736803,SYN 2,036,091531,Gladstein; Jill M,15,0,15,0
1653298736803,SYN 2,037,091532,Gladstein; Jill M,15,0,15,0
1653298736803,SYN 2,038,091533,Gladstein; Jill M,15,0,15,0
1653298736803,SYN 2,039,091534,Gladstein; Jill M,15,0,15,0
1653298736803,SYN 2,040,091535,Gladstein; Jill M,15,0,15,0
1653298737328,SYN 100,A01,091537,Gladstein; Jill M,26,0,30,4
1653298737328,SYN 100,B01,091539,Gladstein; Jill M,26,0,30,4
1653298737328,SYN 100,C01,091541,Gladstein; Jill M,26,0,30,4
1653298737328,SYN 100,D01,091543,Gladstein; Jill M,25,0,30,5
1653298737328,SYN 100,E01,091545,Gladstein; Jill M,28,0,30,2
1653298737860,TDAC 1,A00,088922,Walsh; Kim C.,10,0,10,0
1653298737860,TDAC 1,B00,088923,Walsh; Kim C.,8,0,10,2
1653298737860,TDAC 1,C00,088924,Walsh; Kim C.,0,0,10,10
1653298737860,TDAC 1,D00,088925,Walsh; Kim C.,7,0,10,3
1653298737860,TDAC 1,E00,088926,Walsh; Kim C.,2,0,10,8
1653298737860,TDAC 1,F00,088927,Walsh; Kim C.,9,0,10,1
1653298738385,TDAC 101,A00,088972,Harting; Carla Kelso,9,0,10,1
1653298738385,TDAC 101,B00,088973,Salovey; Todd,8,0,10,2
1653298738385,TDAC 101,C00,088974,Walsh; Kim C.,6,0,10,4
1653298738908,TDAC 102,A00,088975,Basso; Beatrice,9,0,10,1
1653298738908,TDAC 102,B00,088976,Basso; Beatrice,7,0,10,3
1653298739432,TDAC 103A,A00,094044,Castro; Robert Jess,32,0,35,3
1653298739959,TDAC 108,A00,088977,Staff,20,0,20,0
1653298740482,TDAC 109,A00,088978,Blair; Kyle Adam,20,0,20,0
1653298741005,TDAC 115,A00,088979,Newcomb; James,20,0,20,0
1653298741531,TDAC 122,A00,088981,Staff,30,0,30,0
1653298742057,TDAC 123,A00,088982,Staff,30,0,30,0
1653298742582,TDDE 1,A01,088929,Benzoni; Elisa,9,0,11,2
1653298742582,TDDE 1,A02,088930,Benzoni; Elisa,11,0,11,0
1653298742582,TDDE 1,A03,088931,Benzoni; Elisa,11,0,11,0
1653298742582,TDDE 1,A04,088932,Benzoni; Elisa,10,0,11,1
1653298742582,TDDE 1,A05,088933,Benzoni; Elisa,11,0,11,0
1653298743106,TDDE 130,A00,088983,Staff,20,0,20,0
1653298743631,TDDE 132,A00,094263,Staff,20,0,20,0
1653298744192,TDDE 169A,A00,094046,Petrovich; Victoria A.,18,0,20,2
1653298744715,TDDM 1,A00,088934,Snaith; Yolande,6,0,10,4
1653298745245,TDDM 5,A00,088935,Smith; Alison D,30,0,30,0
1653298745770,TDDR 101,A00,088986,Powell; Lora,34,0,35,1
1653298746297,TDDR 111,A00,088987,Stalling; Vanessa,24,0,30,6
1653298746297,TDDR 111,B00,094045,Castro; Robert Jess,14,0,16,2
1653298746824,TDDR 190,A00,088988,Stalling; Vanessa,10,0,10,0
1653298747348,TDGE 1,A01,088937,Salovey; Todd,12,0,12,0
1653298747348,TDGE 1,A02,088938,Salovey; Todd,10,0,12,2
1653298747348,TDGE 1,A03,088939,Salovey; Todd,8,0,12,4
1653298747348,TDGE 1,A04,088940,Salovey; Todd,12,0,12,0
1653298747348,TDGE 1,A05,088941,Salovey; Todd,11,0,12,1
1653298747348,TDGE 1,A06,088942,Salovey; Todd,12,0,12,0
1653298747875,TDGE 10,A00,088943,Havis; Allan,191,0,200,9
1653298748402,TDGE 11,A00,088944,Staff,200,0,200,0
1653298748935,TDGE 25,A00,088945,Harting; Carla Kelso,19,0,20,1
1653298748935,TDGE 25,B00,088946,Harting; Carla Kelso,19,0,20,1
1653298748935,TDGE 25,C00,088947,Harting; Carla Kelso,20,0,20,0
1653298748935,TDGE 25,D00,088948,Harting; Carla Kelso,19,0,20,1
1653298748935,TDGE 25,E00,088949,Harting; Carla Kelso,20,0,20,0
1653298748935,TDGE 25,F00,088950,Harting; Carla Kelso,19,0,20,1
1653298748935,TDGE 25,G00,088951,Harting; Carla Kelso,19,0,20,1
1653298749458,TDGE 127,A00,088990,Havis; Allan,188,0,200,12
1653298749986,TDHD 21,A00,088952,Jun; Grace Shin Hae,20,0,20,0
1653298750513,TDHT 10,A00,088953,Power; Jade Yukana,14,0,14,0
1653298750513,TDHT 10,B00,088954,Power; Jade Yukana,13,0,14,1
1653298751043,TDHT 21,A01,088956,Power; Jade Yukana,17,0,18,1
1653298751043,TDHT 21,A02,088957,Power; Jade Yukana,7,0,11,4
1653298751043,TDHT 21,A03,088958,Power; Jade Yukana,11,0,11,0
1653298751569,TDHT 101,A00,088994,Burelle; Julie Sara Veronique,21,0,25,4
1653298752100,TDHT 114,A00,094208,Williams; Madison Mae,47,0,50,3
1653298752627,TDHT 119,A00,094299,Burelle; Julie Sara Veronique,25,0,25,0
1653298753154,TDMV 1,A00,088959,Weinberg; Sadie,23,0,30,7
1653298753680,TDMV 2,A00,088960,Sammartano; Tonnie,27,0,30,3
1653298753680,TDMV 2,B00,094043,Duran; Marcos Antonio,29,0,30,1
1653298754203,TDMV 3,A00,088961,Arcidiacono; Kristin,27,0,30,3
1653298754733,TDMV 110,A00,088995,Wilson; Terry A.,0,0,0,0
1653298755266,TDMV 120,A00,088996,Smith; Alison D,17,0,20,3
1653298755791,TDMV 122,A00,088997,Chaleff; Rebecca,28,0,30,2
1653298756317,TDMV 130,A00,094042,Rincon; Alicia,30,0,30,0
1653298756844,TDMV 138,A00,088998,Jun; Grace Shin Hae,12,0,40,28
1653298757375,TDMV 142,A00,088999,Caligagan; Tony,28,0,40,12
1653298757898,TDMV 143,A00,094041,Foster-King; Sandra,37,0,40,3
1653298758421,TDMV 146,A00,089000,Caligagan; Tony,39,0,40,1
1653298758946,TDPF 160,A00,094264,Snaith; Yolande,30,0,30,0
1653298758946,TDPF 160,B00,094265,Smith; Alison D,30,0,30,0
1653298758946,TDPF 160,C00,094266,Weinberg; Sadie,30,0,30,0
1653298759477,TDPR 6,A01,088963,Benzoni; Elisa,25,0,25,0
1653298759477,TDPR 6,A02,088964,Benzoni; Elisa,25,0,25,0
1653298760000,TDPR 102,A00,089003,Staff,15,0,15,0
1653298760523,TDPR 104,A00,089004,Powell; Lora,15,0,15,0
1653298761051,TDPW 1,A00,088965,Staff,10,0,10,0
1653298761051,TDPW 1,B00,088966,Staff,10,0,10,0
1653298761051,TDPW 1,C00,088967,Staff,9,0,10,1
1653298761051,TDPW 1,D00,088968,Staff,9,0,10,1
1653298761051,TDPW 1,E00,088969,Staff,10,0,10,0
1653298761051,TDPW 1,F00,088970,Staff,9,0,10,1
1653298761575,TDTR 10,A00,088971,Wilson; Terry A.,22,0,25,3
1653298762108,TMC 2,A01,092358,Carver; Leslie J.,20,0,20,0
1653298762108,TMC 2,A02,092359,Carver; Leslie J.,20,0,20,0
1653298762108,TMC 2,A03,092360,Carver; Leslie J.,20,0,20,0
1653298762108,TMC 2,A04,092361,Carver; Leslie J.,20,0,20,0
1653298762108,TMC 2,A05,092362,Carver; Leslie J.,20,0,20,0
1653298762108,TMC 2,A06,092363,Carver; Leslie J.,20,0,20,0
1653298762633,TMC 15,A00,092364,Atkinson; Arthur Laird,20,0,20,0
1653298763157,TMC 20,A00,092365,Carver; Leslie J.,20,0,20,0
1653298763681,TMC 90,A00,092366,Mell; Loren K.,20,0,20,0
1653298764203,TMC 120,A01,092368,Staff,20,0,20,0
1653298764727,USP 1,A01,087520,Kwak; Nancy,19,0,20,1
1653298764727,USP 1,A02,087521,Kwak; Nancy,17,0,20,3
1653298764727,USP 1,A03,087522,Kwak; Nancy,16,0,20,4
1653298764727,USP 1,A04,087523,Kwak; Nancy,19,0,20,1
1653298765250,USP 2,A01,087525,Lerner; Amy M,29,0,30,1
1653298765250,USP 2,A02,087526,Lerner; Amy M,29,0,30,1
1653298765778,USP 4,A00,094267,Polat; Soydan Alihan,16,0,20,4
1653298765778,USP 4,B00,094268,Staff,20,0,20,0
1653298766304,USP 5,A01,087532,Staff,26,0,30,4
1653298766304,USP 5,A02,087533,Staff,27,0,30,3
1653298766827,USP 6,A01,094322,Shvartzberg Carrio; Manuel,20,0,20,0
1653298766827,USP 6,A02,094323,Shvartzberg Carrio; Manuel,20,0,20,0
1653298767351,USP 15,A01,087535,Anderson; William Raymond,20,0,25,5
1653298767351,USP 15,A02,087536,Anderson; William Raymond,23,0,25,2
1653298767874,USP 25,A00,087537,Staff,0,0,7,7
1653298768398,USP 50,A00,087538,Martin; Isaac,38,0,40,2
1653298768932,USP 124,A00,087539,Bussell; Mirle Rabinowitz,26,0,35,9
1653298769454,USP 125,A00,087540,Staff,17,0,23,6
1653298769980,USP 136,A00,087541,Staff,23,0,25,2
1653298770514,USP 144,A00,087542,Staff,136,0,146,10
1653298771042,USP 151,A00,087543,Boomhower; Matthew Charles,18,0,20,2
1653298771567,USP 152,A01,087545,Moeder; Nathan L,17,0,20,3
1653298771567,USP 152,A02,087546,Moeder; Nathan L,20,0,20,0
1653298772092,USP 153,A00,087547,Moden; Kelly Kjestine,27,0,30,3
1653298772619,USP 161,A00,094854,Wartell; Julie Dara,25,0,25,0
1653298773145,USP 169,A00,087548,Bajaj; Ravi Siddharth,30,0,35,5
1653298773669,USP 170,A00,087549,Hinds; Juli Beth,30,0,35,5
1653298774193,USP 171,A00,087550,Lerner; Amy M,38,0,50,12
1653298774715,USP 176,A00,094853,Staff,24,0,25,1
1653298775243,USP 177A,A00,087551,Peerson; Susan,20,0,22,2
1653298775840,USP 184,A00,094324,Shvartzberg Carrio; Manuel,24,0,25,1
1653298776364,USP 185A,A01,087553,Norr; Alex Vaughn,28,0,30,2
1653298776364,USP 185A,B01,087555,Boomhower; Matthew Charles,26,0,30,4
1653298776887,USP 186,A01,087557,Pezzoli; Keith,22,0,25,3
1653298776887,USP 186,A02,087558,Pezzoli; Keith,20,0,25,5
1653298777948,USP 191A,A00,087561,Rothberg; Scott Jacob,18,0,20,2
1653298778472,USP 194,A00,091599,Hill; Seth J,9999,0,9999,0
1653298779005,VIS 1,A01,088809,Tonies; Joshua Vanjaymes,10,0,10,0
1653298779005,VIS 1,A02,088810,Tonies; Joshua Vanjaymes,10,0,10,0
1653298779005,VIS 1,A03,088811,Tonies; Joshua Vanjaymes,3,0,10,7
1653298779005,VIS 1,A04,088812,Tonies; Joshua Vanjaymes,8,0,10,2
1653298779005,VIS 1,A05,088813,Tonies; Joshua Vanjaymes,4,0,10,6
1653298779005,VIS 1,A06,088814,Tonies; Joshua Vanjaymes,6,0,10,4
1653298779005,VIS 1,A07,088815,Tonies; Joshua Vanjaymes,6,0,10,4
1653298779005,VIS 1,A08,088816,Tonies; Joshua Vanjaymes,9,0,10,1
1653298779005,VIS 1,A09,088817,Tonies; Joshua Vanjaymes,8,0,10,2
1653298779005,VIS 1,A10,088818,Tonies; Joshua Vanjaymes,8,0,10,2
1653298779005,VIS 1,A11,088819,Tonies; Joshua Vanjaymes,3,0,10,7
1653298779005,VIS 1,A12,088820,Tonies; Joshua Vanjaymes,6,0,10,4
1653298779005,VIS 1,A13,088821,Tonies; Joshua Vanjaymes,6,0,10,4
1653298779005,VIS 1,A14,088822,Tonies; Joshua Vanjaymes,7,0,10,3
1653298779005,VIS 1,A15,088823,Tonies; Joshua Vanjaymes,7,0,10,3
1653298779005,VIS 1,A16,088824,Tonies; Joshua Vanjaymes,8,0,10,2
1653298779532,VIS 20,A01,088826,Woods; Ann,19,0,20,1
1653298779532,VIS 20,A02,088827,Woods; Ann,20,0,20,0
1653298779532,VIS 20,A03,088828,Woods; Ann,18,0,20,2
1653298779532,VIS 20,A04,088829,Woods; Ann,17,0,20,3
1653298779532,VIS 20,A05,088830,Woods; Ann,20,0,20,0
1653298779532,VIS 20,A06,088831,Woods; Ann,20,0,20,0
1653298779532,VIS 20,A07,088832,Woods; Ann,20,0,20,0
1653298779532,VIS 20,A08,088833,Woods; Ann,20,0,20,0
1653298779532,VIS 20,A09,088834,Woods; Ann,18,0,20,2
1653298779532,VIS 20,A10,088835,Woods; Ann,19,0,20,1
1653298779532,VIS 20,A11,088836,Woods; Ann,20,0,20,0
1653298779532,VIS 20,A12,088837,Woods; Ann,20,0,20,0
1653298780054,VIS 23,A00,088838,Rose; Jordan M,3,0,3,0
1653298780578,VIS 30,A01,088840,Stone; Patricia,11,0,11,0
1653298780578,VIS 30,A02,088841,Stone; Patricia,7,0,11,4
1653298780578,VIS 30,A03,094821,Stone; Patricia,8,0,11,3
1653298780578,VIS 30,A04,094822,Stone; Patricia,11,0,11,0
1653298781104,VIS 41,A01,088844,D'Elena-Tweed; Jessica Erin,9,0,10,1
1653298781104,VIS 41,A02,088845,D'Elena-Tweed; Jessica Erin,9,0,10,1
1653298781104,VIS 41,A03,088846,D'Elena-Tweed; Jessica Erin,9,0,10,1
1653298781104,VIS 41,A04,088847,D'Elena-Tweed; Jessica Erin,9,0,10,1
1653298781104,VIS 41,A05,088848,D'Elena-Tweed; Jessica Erin,10,0,10,0
1653298781104,VIS 41,A06,088849,D'Elena-Tweed; Jessica Erin,10,0,10,0
1653298781104,VIS 41,A07,088850,D'Elena-Tweed; Jessica Erin,10,0,10,0
1653298781104,VIS 41,A08,088851,D'Elena-Tweed; Jessica Erin,10,0,10,0
1653298781632,VIS 60,A01,088853,Sepuya; Paul Mpagi,9,0,10,1
1653298781632,VIS 60,A02,088854,Sepuya; Paul Mpagi,10,0,10,0
1653298781632,VIS 60,A03,088855,Sepuya; Paul Mpagi,10,0,10,0
1653298781632,VIS 60,A04,088856,Sepuya; Paul Mpagi,10,0,10,0
1653298781632,VIS 60,A05,088857,Sepuya; Paul Mpagi,10,0,10,0
1653298781632,VIS 60,A06,088858,Sepuya; Paul Mpagi,10,0,10,0
1653298781632,VIS 60,A07,088859,Sepuya; Paul Mpagi,9,0,10,1
1653298781632,VIS 60,A08,093932,Sepuya; Paul Mpagi,10,0,10,0
1653298782156,VIS 70N,A01,088861,Segade; Alexandro Abraham,8,0,8,0
1653298782156,VIS 70N,A02,088862,Segade; Alexandro Abraham,8,0,8,0
1653298782156,VIS 70N,A03,088863,Segade; Alexandro Abraham,8,0,8,0
1653298782156,VIS 70N,A04,088864,Segade; Alexandro Abraham,8,0,8,0
1653298782156,VIS 70N,A05,088865,Segade; Alexandro Abraham,7,0,8,1
1653298782156,VIS 70N,A06,088866,Segade; Alexandro Abraham,8,0,8,0
1653298782686,VIS 80,A01,088868,Adler; Amy,9,0,10,1
1653298782686,VIS 80,A02,088869,Adler; Amy,8,0,10,2
1653298782686,VIS 80,A03,088870,Adler; Amy,9,0,10,1
1653298782686,VIS 80,A04,088871,Adler; Amy,8,0,10,2
1653298782686,VIS 80,A05,088872,Adler; Amy,10,0,10,0
1653298782686,VIS 80,A06,088873,Adler; Amy,7,0,10,3
1653298783211,VIS 100,A00,088874,Cruz; Edwin Teddy,65,0,75,10
1653298783738,VIS 105A,A00,088875,Tonies; Joshua Vanjaymes,26,0,30,4
1653298784263,VIS 105B,A00,088876,Staff,25,0,30,5
1653298784790,VIS 106A,A00,088877,Tobe; Geoffroy,21,0,25,4
1653298785314,VIS 106B,A00,088878,Staff,21,0,25,4
1653298785840,VIS 106C,A00,088879,Staff,9,0,15,6
1653298786363,VIS 107B,A00,088880,Gallaccio; Anya,24,0,25,1
1653298786885,VIS 108,A00,093894,Gallaccio; Anya,5,0,15,10
1653298787412,VIS 110A,A00,093895,Dean; Danielle Adobi,15,0,15,0
1653298787934,VIS 110B,A00,088881,Adler; Amy,14,0,15,1
1653298788459,VIS 125E,A00,093896,Welchman; John C.,75,0,75,0
1653298788988,VIS 126HN,A00,088882,Newsome; Elizabeth Ann,74,0,75,1
1653298789513,VIS 126P,A00,088883,Wardwell; Mariana Razo,72,0,75,3
1653298790035,VIS 128E,A00,088884,Staff,68,0,75,7
1653298790558,VIS 132,A00,088885,Miller; Nicole L,15,0,15,0
1653298791082,VIS 133,A01,094348,D'Elena-Tweed; Jessica Erin,34,0,34,0
1653298791082,VIS 133,A02,094492,D'Elena-Tweed; Jessica Erin,33,0,34,1
1653298791610,VIS 142,A01,088887,Stalbaum; Brett,14,0,15,1
1653298791610,VIS 142,A02,088888,Stalbaum; Brett,10,0,15,5
1653298791610,VIS 142,A03,088889,Stalbaum; Brett,15,0,15,0
1653298791610,VIS 142,A04,088890,Stalbaum; Brett,8,0,15,7
1653298791610,VIS 142,A05,088891,Stalbaum; Brett,14,0,15,1
1653298791610,VIS 142,A06,094828,Stalbaum; Brett,15,0,15,0
1653298792135,VIS 143,A00,088892,Akten; Mehmet,11,0,22,11
1653298792658,VIS 147A,A01,088894,Stalbaum; Brett,20,0,22,2
1653298792658,VIS 147A,A02,088895,Stalbaum; Brett,17,0,22,5
1653298793184,VIS 149,A00,088896,Akten; Mehmet,11,0,15,4
1653298793709,VIS 150,A00,093893,Tufenkian; Armand Yervant,24,0,30,6
1653298794232,VIS 151A,A00,088897,Williams; Alena J,13,0,15,2
1653298794760,VIS 163,A00,088901,Bratton; Benjamin H.,75,0,75,0
1653298795289,VIS 164,A00,088902,Nakayama; Yue,22,0,22,0
1653298795817,VIS 165A,A00,093892,Cross; Brian R,19,0,22,3
1653298796343,VIS 167,A00,088903,Ortiz-Torres; Ruben,19,0,22,3
1653298796872,VIS 174,A00,088905,Staff,21,0,22,1
1653298796872,VIS 174,B00,088906,Kauffmann; Casey,22,0,22,0
1653298797397,VIS 175,A00,093891,Staff,18,0,22,4
1653298797922,VIS 177,A00,088907,Segade; Alexandro Abraham,20,0,22,2
1653298798445,VIS 178,A00,093890,Staff,17,0,22,5
1653298798968,VIS 179,A00,093889,Kauffmann; Casey,21,0,22,1
1653298799495,VIS 180A,A00,093888,Nakayama; Yue,16,0,22,6
1653298800022,VIS 180B,A00,088908,Miller; Nicole L,21,0,22,1
1653298800545,VIS 183A,A00,088909,Sepuya; Paul Mpagi,20,0,22,2
1653298801072,WCWP 10A,001,086588,Gagnon; Jeffrey C,15,0,15,0
1653298801072,WCWP 10A,002,086589,Gagnon; Jeffrey C,14,0,15,1
1653298801072,WCWP 10A,003,086590,Gagnon; Jeffrey C,15,0,15,0
1653298801072,WCWP 10A,004,086591,Gagnon; Jeffrey C,15,0,15,0
1653298801072,WCWP 10A,005,086592,Gagnon; Jeffrey C,15,0,15,0
1653298801072,WCWP 10A,006,086593,Gagnon; Jeffrey C,15,0,15,0
1653298801072,WCWP 10A,007,086594,Gagnon; Jeffrey C,15,0,15,0
1653298801072,WCWP 10A,008,086595,Gagnon; Jeffrey C,15,0,15,0
1653298801072,WCWP 10A,009,086596,Gagnon; Jeffrey C,15,0,15,0
1653298801072,WCWP 10A,010,086597,Gagnon; Jeffrey C,15,0,15,0
1653298801072,WCWP 10A,011,086598,Gagnon; Jeffrey C,20,0,20,0
1653298801072,WCWP 10A,012,086599,Gagnon; Jeffrey C,20,0,20,0
1653298801072,WCWP 10A,013,086600,Gagnon; Jeffrey C,20,0,20,0
1653298801072,WCWP 10A,014,086601,Gagnon; Jeffrey C,20,0,20,0
1653298801072,WCWP 10A,015,086602,Gagnon; Jeffrey C,20,0,20,0
1653298801072,WCWP 10A,016,086603,Gagnon; Jeffrey C,20,0,20,0
1653298801072,WCWP 10A,017,086604,Gagnon; Jeffrey C,20,0,20,0
1653298801072,WCWP 10A,018,086605,Gagnon; Jeffrey C,19,0,20,1
1653298801072,WCWP 10A,019,086606,Gagnon; Jeffrey C,19,0,20,1
1653298801072,WCWP 10A,020,086607,Gagnon; Jeffrey C,20,0,20,0
1653298801072,WCWP 10A,021,086608,Gagnon; Jeffrey C,20,0,20,0
1653298801072,WCWP 10A,022,086609,Gagnon; Jeffrey C,20,0,20,0
1653298801072,WCWP 10A,023,086610,Gagnon; Jeffrey C,19,0,20,1
1653298801072,WCWP 10A,024,086611,Gagnon; Jeffrey C,20,0,20,0
1653298801072,WCWP 10A,025,086612,Gagnon; Jeffrey C,0,0,0,0
1653298801072,WCWP 10A,026,086613,Gagnon; Jeffrey C,0,0,0,0
1653298801072,WCWP 10A,027,086614,Gagnon; Jeffrey C,0,0,0,0
1653298801072,WCWP 10A,028,086615,Gagnon; Jeffrey C,0,0,0,0
1653298801072,WCWP 10A,029,086616,Gagnon; Jeffrey C,0,0,0,0
1653298801072,WCWP 10A,030,086617,Gagnon; Jeffrey C,15,0,15,0
1653298801072,WCWP 10A,031,086618,Gagnon; Jeffrey C,15,0,15,0
1653298801072,WCWP 10A,032,093687,Gagnon; Jeffrey C,15,0,15,0
1653298801072,WCWP 10A,033,093688,Gagnon; Jeffrey C,15,0,15,0
1653298801072,WCWP 10A,034,093689,Gagnon; Jeffrey C,0,0,0,0
1653298801072,WCWP 10A,035,093690,Gagnon; Jeffrey C,0,0,0,0
1653298801598,WCWP 10B,003,086621,Gagnon; Jeffrey C,0,0,0,0
1653298801598,WCWP 10B,004,086622,Gagnon; Jeffrey C,16,0,20,4
1653298801598,WCWP 10B,005,086623,Gagnon; Jeffrey C,18,0,20,2
1653298801598,WCWP 10B,006,086624,Gagnon; Jeffrey C,20,0,20,0
1653298801598,WCWP 10B,007,086625,Gagnon; Jeffrey C,0,0,0,0
1653298802125,WCWP 100,A00,086626,McCleary; Keith Long,20,0,20,0
1653298802125,WCWP 100,B00,086627,McCleary; Keith Long,20,0,20,0
1653298802125,WCWP 100,C00,086628,McCleary; Keith Long,18,0,20,2
1653298802125,WCWP 100,D00,086629,Twohig; Niall Ivan,17,0,20,3
1653298802125,WCWP 100,E00,086630,Twohig; Niall Ivan,17,0,20,3
1653298802125,WCWP 100,F00,086631,Twohig; Niall Ivan,18,0,20,2
1653298802125,WCWP 100,G00,086632,Young; Mark T,20,0,20,0
1653298802125,WCWP 100,H00,086633,Young; Mark T,20,0,20,0
1653298860127,AAS 10,A01,085689,Butler; Elizabeth Annette,28,0,34,6
1653298860127,AAS 10,A02,085690,Butler; Elizabeth Annette,34,0,34,0
1653298860650,AAS 170,A00,085691,Butler; Elizabeth Annette,30,0,32,2
1653298861175,AIP 197,001,085683,Staff,100,0,100,0
1653298861175,AIP 197,002,085684,Rao; Ramesh R,50,0,50,0
1653298861696,AIP 197DC,001,085696,Anderson; Patrick W.,27,0,27,0
1653298862223,AIP 197T,A00,085685,Anderson; Patrick W.,15,0,15,0
1653298862746,ANAR 100,A00,094326,Fortier; Jana,22,0,25,3
1653298863275,ANAR 104,A01,085846,Staff,13,0,15,2
1653298863800,ANAR 120,A00,085847,Staff,15,0,15,0
1653298864325,ANAR 143,A00,094288,Staff,31,0,32,1
1653298864850,ANBI 100,A00,085849,Marchetto; Maria Carolina,31,0,34,3
1653298865375,ANBI 112,A00,085850,Marchetto; Maria Carolina,21,0,28,7
1653298865898,ANBI 118,A00,085851,Fox; Patrick Keolu Ozer,32,0,32,0
1653298866423,ANBI 136,A00,085852,Semendeferi; Ekaterini,20,0,22,2
1653298866946,ANBI 141,A00,085854,Gagneux; Pascal,186,0,192,6
1653298867471,ANBI 145,A00,085855,Staff,30,0,32,2
1653298867996,ANBI 175,A00,085857,Staff,30,0,32,2
1653298868521,ANSC 104,A00,094290,Yeh; Rihan Wen Xin,40,0,46,6
1653298869047,ANSC 105,A00,085859,Olivas Hernandez; Olga Lid,36,0,37,1
1653298869569,ANSC 120,A00,085860,Jassal; Aftab,51,0,56,5
1653298870100,ANSC 121,A00,085861,Staff,29,0,32,3
1653298871147,ANSC 148,A00,085866,Staff,71,0,73,2
1653298871674,ANSC 169,A00,085869,Fortier; Jana,23,0,25,2
1653298872196,ANSC 175,A00,085871,Pedersen; David,28,0,32,4
1653298872723,ANTH 1,A00,085803,Varma; Saiba,146,0,146,0
1653298873250,ANTH 2,A01,085805,Staff,43,0,44,1
1653298873250,ANTH 2,A02,085806,Staff,42,0,44,2
1653298873250,ANTH 2,A03,085807,Staff,44,0,44,0
1653298873250,ANTH 2,A04,085808,Staff,44,0,44,0
1653298873250,ANTH 2,A05,085809,Staff,40,0,40,0
1653298873778,ANTH 4,A01,085811,Yeh; Rihan Wen Xin,32,0,32,0
1653298873778,ANTH 4,A02,095113,Yeh; Rihan Wen Xin,32,0,32,0
1653298873778,ANTH 4,A03,095114,Yeh; Rihan Wen Xin,32,0,32,0
1653298873778,ANTH 4,A04,095115,Yeh; Rihan Wen Xin,34,0,34,0
1653298874304,ANTH 10,A00,085814,Stewart; Alexander B,215,0,216,1
1653298874830,ANTH 21,A01,085816,Kang; Byung Chu,35,0,35,0
1653298874830,ANTH 21,A02,085817,Kang; Byung Chu,35,0,35,0
1653298874830,ANTH 21,A03,085818,Kang; Byung Chu,35,0,35,0
1653298874830,ANTH 21,A04,085819,Kang; Byung Chu,35,0,35,0
1653298874830,ANTH 21,A05,085820,Kang; Byung Chu,33,0,35,2
1653298874830,ANTH 21,A06,085821,Kang; Byung Chu,33,0,35,2
1653298874830,ANTH 21,A07,085822,Kang; Byung Chu,35,0,35,0
1653298874830,ANTH 21,A08,085823,Kang; Byung Chu,35,0,35,0
1653298874830,ANTH 21,A09,085824,Kang; Byung Chu,0,0,0,0
1653298874830,ANTH 21,A10,085825,Kang; Byung Chu,0,0,0,0
1653298874830,ANTH 21,A11,095111,Kang; Byung Chu,30,0,30,0
1653298874830,ANTH 21,A12,095112,Kang; Byung Chu,30,0,30,0
1653298874830,ANTH 21,B01,085827,Staff,36,0,36,0
1653298874830,ANTH 21,B02,085828,Staff,36,0,36,0
1653298874830,ANTH 21,B03,085829,Staff,36,0,36,0
1653298874830,ANTH 21,B04,085830,Staff,38,0,38,0
1653298875355,ANTH 23,A01,085832,Stewart; Alexander B,31,0,31,0
1653298875355,ANTH 23,A02,085833,Stewart; Alexander B,31,0,31,0
1653298875355,ANTH 23,A03,085834,Stewart; Alexander B,31,0,31,0
1653298875355,ANTH 23,A04,085835,Stewart; Alexander B,31,0,31,0
1653298875355,ANTH 23,A05,085836,Stewart; Alexander B,31,0,31,0
1653298875355,ANTH 23,A06,085837,Stewart; Alexander B,0,0,0,0
1653298875355,ANTH 23,A07,085838,Stewart; Alexander B,0,0,0,0
1653298875877,ANTH 87,A00,085842,Staff,20,0,20,0
1653298875877,ANTH 87,B00,085843,Staff,20,0,20,0
1653298876404,ANTH 101,A01,085873,Goldstein; Paul S,33,0,36,3
1653298876404,ANTH 101,A02,085874,Goldstein; Paul S,33,0,36,3
1653298876404,ANTH 101,A03,085875,Goldstein; Paul S,36,0,36,0
1653298876404,ANTH 101,A04,085876,Goldstein; Paul S,36,0,38,2
1653298876929,ANTH 105,A00,085877,Staff,39,0,40,1
1653298877451,ANTH 108,A00,085878,Staff,31,0,32,1
1653298877980,ANTH 192,A00,094234,Kaiser; Bronwyn Nicole & Non; Amy L,20,0,20,0
1653298878505,ANTH 196A,A00,085879,Varma; Saiba,20,0,20,0
1653298879051,AWP 3,001,085697,Staff,13,0,13,0
1653298879051,AWP 3,002,085698,Staff,13,0,13,0
1653298879051,AWP 3,003,085699,Staff,13,0,13,0
1653298879051,AWP 3,004,085700,Staff,0,0,0,0
1653298879051,AWP 3,005,085701,Staff,0,0,0,0
1653298879051,AWP 3,006,085703,Staff,0,0,0,0
1653298879051,AWP 3,007,085704,Staff,13,0,13,0
1653298879051,AWP 3,008,085707,Staff,0,0,0,0
1653298879051,AWP 3,009,085709,Staff,13,0,13,0
1653298879051,AWP 3,010,085710,Staff,13,0,13,0
1653298879051,AWP 3,011,085711,Staff,0,0,0,0
1653298879051,AWP 3,012,085712,Staff,0,0,0,0
1653298879051,AWP 3,013,085713,Staff,13,0,13,0
1653298879051,AWP 3,014,085715,Staff,13,0,13,0
1653298879051,AWP 3,015,085717,Staff,13,0,13,0
1653298879051,AWP 3,016,085719,Staff,13,0,13,0
1653298879051,AWP 3,017,085720,Staff,13,0,13,0
1653298879051,AWP 3,018,085721,Staff,13,0,13,0
1653298879051,AWP 3,019,085722,Staff,13,0,13,0
1653298879051,AWP 3,020,085723,Staff,13,0,13,0
1653298879051,AWP 3,021,085724,Staff,13,0,13,0
1653298879051,AWP 3,022,085725,Staff,13,0,13,0
1653298879051,AWP 3,023,085726,Staff,13,0,13,0
1653298879051,AWP 3,024,085727,Staff,13,0,13,0
1653298879051,AWP 3,025,085728,Staff,13,0,13,0
1653298879051,AWP 3,026,085729,Staff,13,0,13,0
1653298879051,AWP 3,027,085730,Staff,13,0,13,0
1653298879051,AWP 3,028,085731,Staff,13,0,13,0
1653298879051,AWP 3,029,085732,Staff,13,0,13,0
1653298879051,AWP 3,030,085733,Staff,13,0,13,0
1653298879051,AWP 3,031,085734,Staff,13,0,13,0
1653298879051,AWP 3,032,085735,Staff,13,0,13,0
1653298879051,AWP 3,033,085736,Staff,13,0,13,0
1653298879051,AWP 3,034,085737,Staff,13,0,13,0
1653298879051,AWP 3,035,085738,Staff,13,0,13,0
1653298879051,AWP 3,036,085739,Staff,13,0,13,0
1653298879051,AWP 3,037,085740,Staff,13,0,13,0
1653298879051,AWP 3,038,085741,Staff,13,0,13,0
1653298879051,AWP 3,039,085742,Staff,13,0,13,0
1653298879051,AWP 3,040,085743,Staff,13,0,13,0
1653298879051,AWP 3,041,085744,Staff,13,0,13,0
1653298879051,AWP 3,042,085745,Staff,13,0,13,0
1653298879051,AWP 3,043,085746,Staff,13,0,13,0
1653298879051,AWP 3,044,085747,Staff,13,0,13,0
1653298879051,AWP 3,045,085748,Staff,13,0,13,0
1653298879051,AWP 3,046,085749,Staff,13,0,13,0
1653298879051,AWP 3,047,085750,Staff,13,0,13,0
1653298879051,AWP 3,048,085751,Staff,13,0,13,0
1653298879051,AWP 3,049,085752,Staff,13,0,13,0
1653298879051,AWP 3,050,085753,Staff,13,0,13,0
1653298879051,AWP 3,051,085754,Staff,13,0,13,0
1653298879051,AWP 3,052,085755,Staff,0,0,0,0
1653298879051,AWP 3,053,085756,Staff,13,0,13,0
1653298879051,AWP 3,054,085757,Staff,0,0,0,0
1653298879051,AWP 3,055,085758,Staff,13,0,13,0
1653298879051,AWP 3,056,085759,Staff,13,0,13,0
1653298879051,AWP 3,057,085760,Staff,13,0,13,0
1653298879051,AWP 3,058,085761,Staff,13,0,13,0
1653298879051,AWP 3,059,085762,Staff,13,0,13,0
1653298879051,AWP 3,060,085763,Staff,13,0,13,0
1653298879051,AWP 3,061,085764,Staff,13,0,13,0
1653298879051,AWP 3,062,085765,Staff,13,0,13,0
1653298879051,AWP 3,063,085766,Staff,13,0,13,0
1653298879051,AWP 3,064,085767,Staff,13,0,13,0
1653298879051,AWP 3,065,085768,Staff,13,0,13,0
1653298879051,AWP 3,066,085769,Staff,0,0,0,0
1653298879577,AWP 4A,001,085770,Staff,0,0,0,0
1653298879577,AWP 4A,002,085771,Staff,13,0,13,0
1653298879577,AWP 4A,003,085772,Staff,13,0,13,0
1653298879577,AWP 4A,004,085773,Staff,13,0,13,0
1653298879577,AWP 4A,005,085774,Staff,0,0,0,0
1653298879577,AWP 4A,006,085775,Staff,13,0,13,0
1653298879577,AWP 4A,007,085776,Staff,0,0,0,0
1653298879577,AWP 4A,008,085777,Staff,0,0,0,0
1653298879577,AWP 4A,009,085778,Staff,0,0,0,0
1653298879577,AWP 4A,010,085779,Staff,13,0,13,0
1653298879577,AWP 4A,011,085780,Staff,13,0,13,0
1653298879577,AWP 4A,012,085781,Staff,0,0,0,0
1653298879577,AWP 4A,013,085782,Staff,13,0,13,0
1653298879577,AWP 4A,014,085783,Staff,13,0,13,0
1653298879577,AWP 4A,015,085784,Staff,13,0,13,0
1653298879577,AWP 4A,016,085785,Staff,13,0,13,0
1653298879577,AWP 4A,017,085786,Staff,13,0,13,0
1653298879577,AWP 4A,018,085787,Staff,0,0,0,0
1653298879577,AWP 4A,019,085788,Staff,13,0,13,0
1653298879577,AWP 4A,020,085789,Staff,13,0,13,0
1653298879577,AWP 4A,021,085790,Staff,0,0,0,0
1653298879577,AWP 4A,022,085791,Staff,13,0,13,0
1653298879577,AWP 4A,023,085792,Staff,0,0,0,0
1653298879577,AWP 4A,024,085793,Staff,0,0,0,0
1653298879577,AWP 4A,025,085794,Staff,13,0,13,0
1653298879577,AWP 4A,026,085795,Staff,13,0,13,0
1653298879577,AWP 4A,027,085796,Staff,13,0,13,0
1653298879577,AWP 4A,028,085797,Staff,13,0,13,0
1653298879577,AWP 4A,029,085798,Staff,0,0,0,0
1653298879577,AWP 4A,030,085799,Staff,0,0,0,0
1653298879577,AWP 4A,031,093835,Staff,0,0,0,0
1653298880101,AWP 4B,001,085800,Staff,0,0,0,0
1653298880101,AWP 4B,002,085801,Staff,0,0,0,0
1653298880626,BENG 2,A00,085936,Wheeler; Bruce Christopher,28,0,30,2
1653298881153,BENG 110,A01,085939,Mc Culloch; Andrew Douglas,20,0,30,10
1653298881153,BENG 110,A02,085940,Mc Culloch; Andrew Douglas,18,0,30,12
1653298881153,BENG 110,A03,085941,Mc Culloch; Andrew Douglas,27,0,30,3
1653298881677,BENG 119A,A01,085943,Wheeler; Bruce Christopher,29,0,30,1
1653298882204,BENG 122A,A01,085945,Cauwenberghs; Gert,18,0,25,7
1653298882204,BENG 122A,A02,085946,Cauwenberghs; Gert,22,0,25,3
1653298882204,BENG 122A,A03,085947,Cauwenberghs; Gert,22,0,25,3
1653298882727,BENG 126A,A01,085949,Wheeler; Bruce Christopher,30,0,30,0
1653298883344,BENG 127A,A01,085951,Wheeler; Bruce Christopher,28,0,30,2
1653298883872,BENG 128A,A01,085953,Wheeler; Bruce Christopher,29,0,30,1
1653298884400,BENG 134,A01,085955,Smarr; Benjamin,0,0,0,0
1653298884928,BENG 135,A00,085956,Wheeler; Bruce Christopher,23,0,30,7
1653298885451,BENG 141,A00,085958,Lal; Ratnesh,20,0,30,10
1653298885975,BENG 147A,A01,085963,Wheeler; Bruce Christopher,30,0,30,0
1653298886501,BENG 148A,A01,085967,Wheeler; Bruce Christopher,30,0,30,0
1653298887025,BENG 149A,A01,085969,Wheeler; Bruce Christopher,30,0,30,0
1653298887553,BENG 161A,A01,085971,Fraley; Stephanie I.,20,0,25,5
1653298887553,BENG 161A,A02,085972,Fraley; Stephanie I.,13,0,25,12
1653298887553,BENG 161A,A03,085973,Fraley; Stephanie I.,9,0,25,16
1653298888077,BENG 162,A01,085975,Mali; Prashant Gulab Ram,0,0,35,35
1653298888077,BENG 162,A02,085976,Mali; Prashant Gulab Ram,26,0,35,9
1653298888600,BENG 166A,A00,085977,Sah; Robert Lie-Yuan,0,0,0,0
1653298889123,BENG 169A,A01,085982,Wheeler; Bruce Christopher,28,0,30,2
1653298889648,BENG 179A,A01,085984,Wheeler; Bruce Christopher,30,0,30,0
1653298890175,BENG 183,A01,085986,Zhong; Sheng,13,0,30,17
1653298890175,BENG 183,A02,085987,Zhong; Sheng,15,0,30,15
1653298890175,BENG 183,A03,085988,Zhong; Sheng,20,0,30,10
1653298890698,BENG 187B,A00,085989,Wheeler; Bruce Christopher,105,0,170,65
1653298891221,BENG 196,001,094047,Engler; Adam J.,9999,0,9999,0
1653298891746,BIBC 100,A01,092918,Huffaker; Alisa,0,0,19,19
1653298891746,BIBC 100,A02,092919,Huffaker; Alisa,19,0,19,0
1653298891746,BIBC 100,A03,092920,Huffaker; Alisa,18,0,19,1
1653298891746,BIBC 100,A04,092921,Huffaker; Alisa,18,0,19,1
1653298891746,BIBC 100,A05,092922,Huffaker; Alisa,19,0,19,0
1653298891746,BIBC 100,A06,092923,Huffaker; Alisa,18,0,19,1
1653298891746,BIBC 100,A07,092924,Huffaker; Alisa,10,0,19,9
1653298891746,BIBC 100,A08,092925,Huffaker; Alisa,17,0,19,2
1653298891746,BIBC 100,A09,092926,Huffaker; Alisa,19,0,19,0
1653298891746,BIBC 100,A10,092927,Huffaker; Alisa,11,0,19,8
1653298892279,BIBC 102,A01,092997,Schmelz; Eric Alexander,16,0,19,3
1653298892279,BIBC 102,A02,092998,Schmelz; Eric Alexander,5,0,19,14
1653298892279,BIBC 102,A03,092999,Schmelz; Eric Alexander,1,0,19,18
1653298892279,BIBC 102,A04,093000,Schmelz; Eric Alexander,17,0,19,2
1653298892279,BIBC 102,A05,093001,Schmelz; Eric Alexander,9,0,19,10
1653298892279,BIBC 102,A06,093002,Schmelz; Eric Alexander,16,0,19,3
1653298892279,BIBC 102,A07,093003,Schmelz; Eric Alexander,19,0,19,0
1653298892279,BIBC 102,A08,093004,Schmelz; Eric Alexander,19,0,19,0
1653298892279,BIBC 102,A09,093005,Schmelz; Eric Alexander,14,0,19,5
1653298892279,BIBC 102,B01,093064,Coleman; Aaron B.,19,0,19,0
1653298892279,BIBC 102,B02,093065,Coleman; Aaron B.,17,0,19,2
1653298892279,BIBC 102,B03,093066,Coleman; Aaron B.,16,0,19,3
1653298892279,BIBC 102,B04,093067,Coleman; Aaron B.,11,0,19,8
1653298892279,BIBC 102,B05,093068,Coleman; Aaron B.,18,0,19,1
1653298892279,BIBC 102,B06,093069,Coleman; Aaron B.,16,0,19,3
1653298892279,BIBC 102,B07,093070,Coleman; Aaron B.,19,0,19,0
1653298892279,BIBC 102,B08,093071,Coleman; Aaron B.,15,0,19,4
1653298892279,BIBC 102,B09,093072,Coleman; Aaron B.,17,0,19,2
1653298892809,BIBC 103,A01,089887,Bozinovic; Goran,19,0,24,5
1653298892809,BIBC 103,A02,089888,Bozinovic; Goran,23,0,24,1
1653298892809,BIBC 103,B01,089890,Burg; Michael,2,0,24,22
1653298892809,BIBC 103,B02,089891,Burg; Michael,20,0,24,4
1653298892809,BIBC 103,C01,089893,Beyhan; Sinem,14,0,24,10
1653298892809,BIBC 103,C02,089894,Beyhan; Sinem,22,0,24,2
1653298892809,BIBC 103,D01,089896,Coleman; Aaron B.,10,0,24,14
1653298892809,BIBC 103,D02,089897,Coleman; Aaron B.,22,0,24,2
1653298893335,BIBC 194,A00,089898,Hui; Enfu,16,0,27,11
1653298893872,BICD 100,A01,092396,Smith; Laurie,21,0,22,1
1653298893872,BICD 100,A02,092397,Smith; Laurie,22,0,22,0
1653298893872,BICD 100,A03,092398,Smith; Laurie,21,0,22,1
1653298893872,BICD 100,A04,092399,Smith; Laurie,22,0,22,0
1653298893872,BICD 100,A05,092400,Smith; Laurie,21,0,22,1
1653298893872,BICD 100,A06,092401,Smith; Laurie,22,0,22,0
1653298893872,BICD 100,A07,092402,Smith; Laurie,22,0,22,0
1653298893872,BICD 100,A08,092403,Smith; Laurie,22,0,22,0
1653298893872,BICD 100,B01,093073,Mueller; Liam O'Connor,21,0,22,1
1653298893872,BICD 100,B02,093074,Mueller; Liam O'Connor,22,0,22,0
1653298893872,BICD 100,B03,093075,Mueller; Liam O'Connor,22,0,22,0
1653298893872,BICD 100,B04,093076,Mueller; Liam O'Connor,22,0,22,0
1653298893872,BICD 100,B05,093077,Mueller; Liam O'Connor,22,0,22,0
1653298893872,BICD 100,B06,093078,Mueller; Liam O'Connor,22,0,22,0
1653298893872,BICD 100,B07,093079,Mueller; Liam O'Connor,21,0,22,1
1653298893872,BICD 100,B08,093080,Mueller; Liam O'Connor,22,0,22,0
1653298893872,BICD 100,C01,093021,McDonnell; Lisa Marie,21,0,22,1
1653298893872,BICD 100,C02,093022,McDonnell; Lisa Marie,20,0,22,2
1653298893872,BICD 100,C03,093023,McDonnell; Lisa Marie,22,0,22,0
1653298893872,BICD 100,C04,093024,McDonnell; Lisa Marie,22,0,22,0
1653298893872,BICD 100,C05,093025,McDonnell; Lisa Marie,22,0,22,0
1653298893872,BICD 100,C06,093026,McDonnell; Lisa Marie,22,0,22,0
1653298893872,BICD 100,C07,093027,McDonnell; Lisa Marie,20,0,22,2
1653298893872,BICD 100,C08,093028,McDonnell; Lisa Marie,22,0,22,0
1653298893872,BICD 100,D01,093081,Day; Christopher D,22,0,22,0
1653298893872,BICD 100,D02,093082,Day; Christopher D,17,0,22,5
1653298893872,BICD 100,D03,093083,Day; Christopher D,21,0,22,1
1653298893872,BICD 100,D04,093084,Day; Christopher D,19,0,22,3
1653298893872,BICD 100,D05,093085,Day; Christopher D,22,0,22,0
1653298893872,BICD 100,D06,093086,Day; Christopher D,20,0,22,2
1653298893872,BICD 100,D07,093087,Day; Christopher D,19,0,22,3
1653298893872,BICD 100,D08,093088,Day; Christopher D,20,0,22,2
1653298894404,BICD 110,A01,093089,Kiger; Amy,29,0,32,3
1653298894404,BICD 110,A02,093091,Kiger; Amy,32,0,32,0
1653298894404,BICD 110,A03,093092,Kiger; Amy,31,0,32,1
1653298894404,BICD 110,A04,093093,Kiger; Amy,31,0,32,1
1653298894404,BICD 110,A05,093094,Kiger; Amy,26,0,32,6
1653298894404,BICD 110,A06,093095,Kiger; Amy,31,0,32,1
1653298894404,BICD 110,A07,093096,Kiger; Amy,31,0,32,1
1653298894404,BICD 110,B01,093029,Grossman; Emily N,21,0,32,11
1653298894404,BICD 110,B02,093030,Grossman; Emily N,28,0,32,4
1653298894404,BICD 110,B03,093031,Grossman; Emily N,32,0,32,0
1653298894404,BICD 110,B04,093032,Grossman; Emily N,28,0,32,4
1653298894404,BICD 110,B05,093033,Grossman; Emily N,26,0,32,6
1653298894404,BICD 110,B06,093034,Grossman; Emily N,19,0,32,13
1653298894404,BICD 110,B07,093035,Grossman; Emily N,20,0,32,12
1653298894927,BICD 140,A01,093097,Zuniga; Elina I,19,0,32,13
1653298894927,BICD 140,A02,093098,Zuniga; Elina I,17,0,32,15
1653298894927,BICD 140,A03,093099,Zuniga; Elina I,30,0,32,2
1653298894927,BICD 140,A04,093100,Zuniga; Elina I,32,0,32,0
1653298894927,BICD 140,A05,093101,Zuniga; Elina I,29,0,32,3
1653298894927,BICD 140,A06,093102,Zuniga; Elina I,27,0,32,5
1653298895456,BIEB 102,A01,092528,Butler; Shannon Rhey,22,0,27,5
1653298895456,BIEB 102,A02,092529,Butler; Shannon Rhey,17,0,27,10
1653298895456,BIEB 102,A03,092530,Butler; Shannon Rhey,24,0,27,3
1653298895456,BIEB 102,A04,092531,Butler; Shannon Rhey,26,0,27,1
1653298895456,BIEB 102,A05,092532,Butler; Shannon Rhey,25,0,27,2
1653298895456,BIEB 102,A06,092533,Butler; Shannon Rhey,24,0,27,3
1653298895456,BIEB 102,A07,092534,Butler; Shannon Rhey,23,0,27,4
1653298895982,BIEB 121,A00,089907,Holway; David A.,0,0,32,32
1653298896515,BIEB 126,A01,092974,Kohn; Joshua R,24,0,27,3
1653298896515,BIEB 126,A02,092975,Kohn; Joshua R,26,0,27,1
1653298896515,BIEB 126,A03,092976,Kohn; Joshua R,23,0,27,4
1653298896515,BIEB 126,A04,092977,Kohn; Joshua R,25,0,27,2
1653298896515,BIEB 126,A05,092978,Kohn; Joshua R,27,0,27,0
1653298897045,BIEB 146,A01,093054,Petrie; Katherine Lynn,1,0,27,26
1653298897045,BIEB 146,A02,093055,Petrie; Katherine Lynn,4,0,27,23
1653298897045,BIEB 146,A03,093056,Petrie; Katherine Lynn,0,0,27,27
1653298897045,BIEB 146,A04,093057,Petrie; Katherine Lynn,0,0,27,27
1653298897045,BIEB 146,A05,093058,Petrie; Katherine Lynn,20,0,27,7
1653298897045,BIEB 146,A06,093059,Petrie; Katherine Lynn,26,0,27,1
1653298897045,BIEB 146,A07,093060,Petrie; Katherine Lynn,16,0,27,11
1653298897045,BIEB 146,A08,093061,Petrie; Katherine Lynn,25,0,27,2
1653298897045,BIEB 146,A09,093062,Petrie; Katherine Lynn,17,0,27,10
1653298897569,BIEB 150,A01,093103,Rennison; Diana,16,0,27,11
1653298897569,BIEB 150,A02,093104,Rennison; Diana,21,0,27,6
1653298897569,BIEB 150,A03,093105,Rennison; Diana,26,0,27,1
1653298897569,BIEB 150,A04,093106,Rennison; Diana,24,0,27,3
1653298897569,BIEB 150,A05,093107,Rennison; Diana,25,0,27,2
1653298897569,BIEB 150,A06,093108,Rennison; Diana,27,0,27,0
1653298898094,BIEB 158,A01,094057,Reese; Aspen Taylor & Jackrel; Sara,31,0,32,1
1653298898094,BIEB 158,A02,094058,Reese; Aspen Taylor & Jackrel; Sara,28,0,32,4
1653298898094,BIEB 158,A03,094059,Reese; Aspen Taylor & Jackrel; Sara,31,0,32,1
1653298898094,BIEB 158,A04,094060,Reese; Aspen Taylor & Jackrel; Sara,32,0,32,0
1653298898624,BIEB 174,A01,092465,Cleland; Elsa Eleanor & Barton; Andrew David,27,0,27,0
1653298898624,BIEB 174,A02,092466,Cleland; Elsa Eleanor & Barton; Andrew David,27,0,27,0
1653298898624,BIEB 174,A03,092467,Cleland; Elsa Eleanor & Barton; Andrew David,23,0,27,4
1653298898624,BIEB 174,A04,092468,Cleland; Elsa Eleanor & Barton; Andrew David,20,0,27,7
1653298898624,BIEB 174,A05,092469,Cleland; Elsa Eleanor & Barton; Andrew David,25,0,27,2
1653298898624,BIEB 174,A06,092470,Cleland; Elsa Eleanor & Barton; Andrew David,27,0,27,0
1653298898624,BIEB 174,A07,092471,Cleland; Elsa Eleanor & Barton; Andrew David,25,0,27,2
1653298899150,BILD 1,A01,092884,Pickett; Brooke Elizabeth,16,0,19,3
1653298899150,BILD 1,A02,092885,Pickett; Brooke Elizabeth,19,0,19,0
1653298899150,BILD 1,A03,092886,Pickett; Brooke Elizabeth,19,0,19,0
1653298899150,BILD 1,A04,092887,Pickett; Brooke Elizabeth,18,0,19,1
1653298899150,BILD 1,A05,092888,Pickett; Brooke Elizabeth,19,0,19,0
1653298899150,BILD 1,A06,092889,Pickett; Brooke Elizabeth,19,0,19,0
1653298899150,BILD 1,A07,092890,Pickett; Brooke Elizabeth,17,0,19,2
1653298899150,BILD 1,B01,092891,Pekkurnaz Banghart; Gulcin,19,0,19,0
1653298899150,BILD 1,B02,092892,Pekkurnaz Banghart; Gulcin,16,0,19,3
1653298899150,BILD 1,B03,092893,Pekkurnaz Banghart; Gulcin,19,0,19,0
1653298899150,BILD 1,B04,092894,Pekkurnaz Banghart; Gulcin,19,0,19,0
1653298899150,BILD 1,B05,092895,Pekkurnaz Banghart; Gulcin,17,0,19,2
1653298899150,BILD 1,B06,092896,Pekkurnaz Banghart; Gulcin,19,0,19,0
1653298899150,BILD 1,B07,092897,Pekkurnaz Banghart; Gulcin,19,0,19,0
1653298899150,BILD 1,C01,092421,Meaders; Clara Leigh,18,0,19,1
1653298899150,BILD 1,C02,092422,Meaders; Clara Leigh,18,0,19,1
1653298899150,BILD 1,C03,092423,Meaders; Clara Leigh,17,0,19,2
1653298899150,BILD 1,C04,092424,Meaders; Clara Leigh,16,0,19,3
1653298899150,BILD 1,C05,092425,Meaders; Clara Leigh,19,0,19,0
1653298899150,BILD 1,C06,092426,Meaders; Clara Leigh,19,0,19,0
1653298899150,BILD 1,C07,092427,Meaders; Clara Leigh,19,0,19,0
1653298899150,BILD 1,D01,092428,Meaders; Clara Leigh,14,0,19,5
1653298899150,BILD 1,D02,092429,Meaders; Clara Leigh,19,0,19,0
1653298899150,BILD 1,D03,092430,Meaders; Clara Leigh,19,0,19,0
1653298899150,BILD 1,D04,092431,Meaders; Clara Leigh,19,0,19,0
1653298899150,BILD 1,D05,092432,Meaders; Clara Leigh,19,0,19,0
1653298899150,BILD 1,D06,092433,Meaders; Clara Leigh,19,0,19,0
1653298899150,BILD 1,D07,092434,Meaders; Clara Leigh,19,0,19,0
1653298899150,BILD 1,E01,092445,Cooper; Andrew Michael,19,0,19,0
1653298899150,BILD 1,E02,092446,Cooper; Andrew Michael,19,0,19,0
1653298899150,BILD 1,E03,092447,Cooper; Andrew Michael,19,0,19,0
1653298899150,BILD 1,E04,092448,Cooper; Andrew Michael,19,0,19,0
1653298899150,BILD 1,E05,092449,Cooper; Andrew Michael,17,0,19,2
1653298899150,BILD 1,E06,092450,Cooper; Andrew Michael,19,0,19,0
1653298899150,BILD 1,E07,092451,Cooper; Andrew Michael,19,0,19,0
1653298899695,BILD 2,A01,092822,Glasgow; Stacey Marie,25,0,25,0
1653298899695,BILD 2,A02,092823,Glasgow; Stacey Marie,24,0,25,1
1653298899695,BILD 2,A03,092824,Glasgow; Stacey Marie,24,0,25,1
1653298899695,BILD 2,A04,092825,Glasgow; Stacey Marie,25,0,25,0
1653298899695,BILD 2,A05,092826,Glasgow; Stacey Marie,25,0,25,0
1653298899695,BILD 2,A06,092827,Glasgow; Stacey Marie,25,0,25,0
1653298899695,BILD 2,A07,092828,Glasgow; Stacey Marie,25,0,25,0
1653298899695,BILD 2,B01,092830,Owens; Melinda Tsao-Ying,25,0,25,0
1653298899695,BILD 2,B02,092831,Owens; Melinda Tsao-Ying,21,0,25,4
1653298899695,BILD 2,B03,092832,Owens; Melinda Tsao-Ying,23,0,25,2
1653298899695,BILD 2,B04,092833,Owens; Melinda Tsao-Ying,25,0,25,0
1653298899695,BILD 2,B05,092834,Owens; Melinda Tsao-Ying,24,0,25,1
1653298899695,BILD 2,B06,092835,Owens; Melinda Tsao-Ying,21,0,25,4
1653298899695,BILD 2,B07,092836,Owens; Melinda Tsao-Ying,25,0,25,0
1653298899695,BILD 2,C01,092668,Owens; Melinda Tsao-Ying,24,0,25,1
1653298899695,BILD 2,C02,092669,Owens; Melinda Tsao-Ying,23,0,25,2
1653298899695,BILD 2,C03,092670,Owens; Melinda Tsao-Ying,22,0,25,3
1653298899695,BILD 2,C04,092671,Owens; Melinda Tsao-Ying,25,0,25,0
1653298899695,BILD 2,C05,092672,Owens; Melinda Tsao-Ying,25,0,25,0
1653298899695,BILD 2,C06,092673,Owens; Melinda Tsao-Ying,24,0,25,1
1653298899695,BILD 2,C07,092674,Owens; Melinda Tsao-Ying,25,0,25,0
1653298900224,BILD 3,A01,092454,Stockwell; Sarah R,17,0,19,2
1653298900224,BILD 3,A02,092455,Stockwell; Sarah R,17,0,19,2
1653298900224,BILD 3,A03,092456,Stockwell; Sarah R,18,0,19,1
1653298900224,BILD 3,A04,092457,Stockwell; Sarah R,19,0,19,0
1653298900224,BILD 3,A05,092458,Stockwell; Sarah R,19,0,19,0
1653298900224,BILD 3,A06,092459,Stockwell; Sarah R,18,0,19,1
1653298900224,BILD 3,A07,092460,Stockwell; Sarah R,18,0,19,1
1653298900224,BILD 3,A08,092461,Stockwell; Sarah R,19,0,19,0
1653298900224,BILD 3,A09,092462,Stockwell; Sarah R,19,0,19,0
1653298900224,BILD 3,B01,092479,Stockwell; Sarah R,19,0,19,0
1653298900224,BILD 3,B02,092480,Stockwell; Sarah R,18,0,19,1
1653298900224,BILD 3,B03,092481,Stockwell; Sarah R,18,0,19,1
1653298900224,BILD 3,B04,092482,Stockwell; Sarah R,19,0,19,0
1653298900224,BILD 3,B05,092483,Stockwell; Sarah R,19,0,19,0
1653298900224,BILD 3,B06,092484,Stockwell; Sarah R,19,0,19,0
1653298900224,BILD 3,B07,092485,Stockwell; Sarah R,19,0,19,0
1653298900224,BILD 3,B08,092486,Stockwell; Sarah R,18,0,19,1
1653298900224,BILD 3,B09,092487,Stockwell; Sarah R,18,0,19,1
1653298900224,BILD 3,C01,092412,Butler; Shannon Rhey,18,0,19,1
1653298900224,BILD 3,C02,092413,Butler; Shannon Rhey,15,0,19,4
1653298900224,BILD 3,C03,092414,Butler; Shannon Rhey,19,0,19,0
1653298900224,BILD 3,C04,092415,Butler; Shannon Rhey,19,0,19,0
1653298900224,BILD 3,C05,092416,Butler; Shannon Rhey,19,0,19,0
1653298900224,BILD 3,C06,092417,Butler; Shannon Rhey,19,0,19,0
1653298900224,BILD 3,C07,092418,Butler; Shannon Rhey,19,0,19,0
1653298900224,BILD 3,C08,092419,Butler; Shannon Rhey,19,0,19,0
1653298900224,BILD 3,C09,092420,Butler; Shannon Rhey,19,0,19,0
1653298900224,BILD 3,D01,092898,Reuther; Keefe,18,0,19,1
1653298900224,BILD 3,D02,092899,Reuther; Keefe,19,0,19,0
1653298900224,BILD 3,D03,092900,Reuther; Keefe,19,0,19,0
1653298900224,BILD 3,D04,092901,Reuther; Keefe,19,0,19,0
1653298900224,BILD 3,D05,092902,Reuther; Keefe,19,0,19,0
1653298900224,BILD 3,D06,092903,Reuther; Keefe,19,0,19,0
1653298900224,BILD 3,D07,092904,Reuther; Keefe,18,0,19,1
1653298900224,BILD 3,D08,092905,Reuther; Keefe,19,0,19,0
1653298900224,BILD 3,D09,092906,Reuther; Keefe,19,0,19,0
1653298900750,BILD 4,A01,089840,Mel; Stephanie,0,0,0,0
1653298900750,BILD 4,A02,089841,Mel; Stephanie,0,0,0,0
1653298900750,BILD 4,A03,089842,Mel; Stephanie,0,0,0,0
1653298900750,BILD 4,A04,089843,Mel; Stephanie,0,0,0,0
1653298900750,BILD 4,A05,089844,Mel; Stephanie,0,0,0,0
1653298900750,BILD 4,A06,089845,Mel; Stephanie,0,0,0,0
1653298900750,BILD 4,A07,089846,Mel; Stephanie,0,0,0,0
1653298900750,BILD 4,A08,089847,Mel; Stephanie,0,0,0,0
1653298900750,BILD 4,A09,089848,Mel; Stephanie,0,0,0,0
1653298900750,BILD 4,A10,089849,Mel; Stephanie,0,0,0,0
1653298900750,BILD 4,A11,089850,Mel; Stephanie,0,0,0,0
1653298900750,BILD 4,A12,089851,Mel; Stephanie,0,0,0,0
1653298900750,BILD 4,A13,089852,Mel; Stephanie,0,0,0,0
1653298900750,BILD 4,A14,089853,Mel; Stephanie,0,0,0,0
1653298900750,BILD 4,A15,089854,Mel; Stephanie,0,0,0,0
1653298900750,BILD 4,A16,089855,Mel; Stephanie,0,0,0,0
1653298900750,BILD 4,B01,089857,Lo; Stanley M.,0,0,0,0
1653298900750,BILD 4,B02,089858,Lo; Stanley M.,0,0,0,0
1653298900750,BILD 4,B03,089859,Lo; Stanley M.,0,0,0,0
1653298900750,BILD 4,B04,089860,Lo; Stanley M.,0,0,0,0
1653298900750,BILD 4,B05,089861,Lo; Stanley M.,0,0,0,0
1653298900750,BILD 4,B06,089862,Lo; Stanley M.,0,0,0,0
1653298900750,BILD 4,B07,089863,Lo; Stanley M.,0,0,0,0
1653298900750,BILD 4,B08,089864,Lo; Stanley M.,0,0,0,0
1653298900750,BILD 4,B09,089865,Lo; Stanley M.,0,0,0,0
1653298900750,BILD 4,B10,089866,Lo; Stanley M.,0,0,0,0
1653298900750,BILD 4,B11,089867,Lo; Stanley M.,0,0,0,0
1653298900750,BILD 4,B12,089868,Lo; Stanley M.,0,0,0,0
1653298900750,BILD 4,B13,089869,Lo; Stanley M.,0,0,0,0
1653298900750,BILD 4,B14,089870,Lo; Stanley M.,0,0,0,0
1653298900750,BILD 4,B15,089871,Lo; Stanley M.,0,0,0,0
1653298900750,BILD 4,B16,089872,Lo; Stanley M.,0,0,0,0
1653298901274,BILD 5,A01,092907,Reuther; Keefe,31,0,32,1
1653298901274,BILD 5,A02,092908,Reuther; Keefe,30,0,32,2
1653298901808,BILD 10,A01,092909,Gustafson-Brown; Cindy,27,0,27,0
1653298901808,BILD 10,A02,092910,Gustafson-Brown; Cindy,27,0,27,0
1653298901808,BILD 10,A03,092911,Gustafson-Brown; Cindy,27,0,27,0
1653298901808,BILD 10,A04,092912,Gustafson-Brown; Cindy,27,0,27,0
1653298901808,BILD 10,A05,092913,Gustafson-Brown; Cindy,25,0,27,2
1653298901808,BILD 10,A06,092914,Gustafson-Brown; Cindy,26,0,27,1
1653298901808,BILD 10,A07,092915,Gustafson-Brown; Cindy,27,0,27,0
1653298901808,BILD 10,A08,092916,Gustafson-Brown; Cindy,27,0,27,0
1653298901808,BILD 10,A09,092917,Gustafson-Brown; Cindy,27,0,27,0
1653298902332,BILD 20,A01,092956,Rana; Brinda Kanti,24,0,27,3
1653298902332,BILD 20,A02,092957,Rana; Brinda Kanti,24,0,27,3
1653298902332,BILD 20,A03,092958,Rana; Brinda Kanti,27,0,27,0
1653298902332,BILD 20,A04,092959,Rana; Brinda Kanti,27,0,27,0
1653298902860,BILD 32,A01,092990,Burg; Michael,27,0,27,0
1653298902860,BILD 32,A02,092991,Burg; Michael,26,0,27,1
1653298902860,BILD 32,A03,092992,Burg; Michael,27,0,27,0
1653298902860,BILD 32,A04,092993,Burg; Michael,26,0,27,1
1653298902860,BILD 32,A05,092994,Burg; Michael,27,0,27,0
1653298902860,BILD 32,A06,092995,Burg; Michael,27,0,27,0
1653298902860,BILD 32,A07,092996,Burg; Michael,27,0,27,0
1653298903384,BILD 60,A01,092392,Hammond; LaTisha Marie,24,0,24,0
1653298903384,BILD 60,A02,092393,Hammond; LaTisha Marie,24,0,24,0
1653298903384,BILD 60,B01,092394,Macagno; Eduardo R.,23,0,24,1
1653298903384,BILD 60,B02,092395,Macagno; Eduardo R.,24,0,24,0
1653298903909,BILD 62,A01,092949,Aljadeff; Johnatan,31,0,32,1
1653298903909,BILD 62,A02,092950,Aljadeff; Johnatan,32,0,32,0
1653298903909,BILD 62,A03,092951,Aljadeff; Johnatan,32,0,32,0
1653298904432,BILD 80,A00,089880,Pogliano; Joseph,27,0,30,3
1653298904962,BIMM 100,A01,092435,Pasquinelli; Amy,32,0,32,0
1653298904962,BIMM 100,A02,092436,Pasquinelli; Amy,30,0,32,2
1653298904962,BIMM 100,A03,092437,Pasquinelli; Amy,32,0,32,0
1653298904962,BIMM 100,A04,092438,Pasquinelli; Amy,31,0,32,1
1653298904962,BIMM 100,A05,092439,Pasquinelli; Amy,32,0,32,0
1653298904962,BIMM 100,A06,092440,Pasquinelli; Amy,32,0,32,0
1653298904962,BIMM 100,A07,092441,Pasquinelli; Amy,32,0,32,0
1653298904962,BIMM 100,A08,092442,Pasquinelli; Amy,32,0,32,0
1653298904962,BIMM 100,A09,092443,Pasquinelli; Amy,32,0,32,0
1653298904962,BIMM 100,A10,092444,Pasquinelli; Amy,32,0,32,0
1653298904962,BIMM 100,B01,092518,Pruneda-Paz; Jose L.,26,0,32,6
1653298904962,BIMM 100,B02,092519,Pruneda-Paz; Jose L.,19,0,32,13
1653298904962,BIMM 100,B03,092520,Pruneda-Paz; Jose L.,20,0,32,12
1653298904962,BIMM 100,B04,092521,Pruneda-Paz; Jose L.,24,0,32,8
1653298904962,BIMM 100,B05,092522,Pruneda-Paz; Jose L.,23,0,32,9
1653298904962,BIMM 100,B06,092523,Pruneda-Paz; Jose L.,24,0,32,8
1653298904962,BIMM 100,B07,092524,Pruneda-Paz; Jose L.,28,0,32,4
1653298904962,BIMM 100,B08,092525,Pruneda-Paz; Jose L.,25,0,32,7
1653298904962,BIMM 100,B09,092526,Pruneda-Paz; Jose L.,26,0,32,6
1653298904962,BIMM 100,B10,092527,Pruneda-Paz; Jose L.,24,0,32,8
1653298905494,BIMM 101,A01,089915,Rusert; Jessica Marie,22,0,24,2
1653298905494,BIMM 101,A02,089916,Rusert; Jessica Marie,21,0,24,3
1653298905494,BIMM 101,A03,089917,Rusert; Jessica Marie,21,0,24,3
1653298905494,BIMM 101,A04,089918,Rusert; Jessica Marie,20,0,24,4
1653298905494,BIMM 101,B01,089920,Grossman; Emily N,0,0,24,24
1653298905494,BIMM 101,B02,089921,Grossman; Emily N,1,0,24,23
1653298905494,BIMM 101,C01,089923,Day; Christopher D,0,0,24,24
1653298905494,BIMM 101,C02,089924,Day; Christopher D,0,0,24,24
1653298905494,BIMM 101,D01,089926,Cooper; Andrew Michael,18,0,24,6
1653298905494,BIMM 101,D02,089927,Cooper; Andrew Michael,24,0,24,0
1653298905494,BIMM 101,E01,089929,McDonnell; Lisa Marie,1,0,24,23
1653298905494,BIMM 101,E02,089930,McDonnell; Lisa Marie,12,0,24,12
1653298906017,BIMM 110,A01,092472,Tour; Ella,26,0,32,6
1653298906017,BIMM 110,A02,092473,Tour; Ella,23,0,32,9
1653298906017,BIMM 110,A03,092474,Tour; Ella,29,0,32,3
1653298906017,BIMM 110,A04,092475,Tour; Ella,27,0,32,5
1653298906017,BIMM 110,A05,092476,Tour; Ella,32,0,32,0
1653298906017,BIMM 110,A06,092477,Tour; Ella,30,0,32,2
1653298906017,BIMM 110,A07,092478,Tour; Ella,29,0,32,3
1653298906544,BIMM 120,A01,092979,Allen; Eric,28,0,32,4
1653298906544,BIMM 120,A02,092980,Allen; Eric,1,0,32,31
1653298906544,BIMM 120,A03,092981,Allen; Eric,14,0,32,18
1653298906544,BIMM 120,A04,092982,Allen; Eric,27,0,32,5
1653298906544,BIMM 120,A05,092983,Allen; Eric,30,0,32,2
1653298906544,BIMM 120,A06,092984,Allen; Eric,29,0,32,3
1653298906544,BIMM 120,A07,092985,Allen; Eric,20,0,32,12
1653298906544,BIMM 120,A08,092986,Allen; Eric,30,0,32,2
1653298906544,BIMM 120,A09,092987,Allen; Eric,30,0,32,2
1653298906544,BIMM 120,A10,092988,Allen; Eric,30,0,32,2
1653298906544,BIMM 120,A11,092989,Allen; Eric,32,0,32,0
1653298907069,BIMM 121,A01,089934,Petrie; Katherine Lynn,0,0,24,24
1653298907069,BIMM 121,A02,089935,Petrie; Katherine Lynn,0,0,24,24
1653298907069,BIMM 121,B01,089937,Pickett; Brooke Elizabeth,0,0,24,24
1653298907069,BIMM 121,B02,089938,Pickett; Brooke Elizabeth,0,0,24,24
1653298907069,BIMM 121,C01,089940,Pirino; Giorgia,0,0,24,24
1653298907069,BIMM 121,C02,089941,Pirino; Giorgia,0,0,24,24
1653298907069,BIMM 121,C03,089942,Pirino; Giorgia,0,0,24,24
1653298907069,BIMM 121,C04,089943,Pirino; Giorgia,0,0,24,24
1653298907591,BIMM 122,A01,093006,Russell; Alistair B,18,0,32,14
1653298907591,BIMM 122,A02,093007,Russell; Alistair B,16,0,32,16
1653298907591,BIMM 122,A03,093008,Russell; Alistair B,26,0,32,6
1653298907591,BIMM 122,A04,093009,Russell; Alistair B,32,0,32,0
1653298907591,BIMM 122,A05,093010,Russell; Alistair B,30,0,32,2
1653298908120,BIMM 124,A01,092404,Gustafson-Brown; Cindy,26,0,32,6
1653298908120,BIMM 124,A02,092405,Gustafson-Brown; Cindy,29,0,32,3
1653298908120,BIMM 124,A03,092406,Gustafson-Brown; Cindy,30,0,32,2
1653298908120,BIMM 124,A04,092407,Gustafson-Brown; Cindy,32,0,32,0
1653298908120,BIMM 124,A05,092408,Gustafson-Brown; Cindy,28,0,32,4
1653298908120,BIMM 124,A06,092409,Gustafson-Brown; Cindy,31,0,32,1
1653298908120,BIMM 124,A07,092410,Gustafson-Brown; Cindy,32,0,32,0
1653298908663,BIMM 140,A01,089947,Suel; Gurol Mehmet & Hao; Nan,16,0,27,11
1653298908663,BIMM 140,A02,089948,Suel; Gurol Mehmet & Hao; Nan,24,0,27,3
1653298908663,BIMM 140,A03,089949,Suel; Gurol Mehmet & Hao; Nan,21,0,27,6
1653298908663,BIMM 140,A04,089950,Suel; Gurol Mehmet & Hao; Nan,25,0,27,2
1653298908663,BIMM 140,A05,089951,Suel; Gurol Mehmet & Hao; Nan,24,0,27,3
1653298909193,BIMM 143,A01,089953,Grant; Barry J,0,0,40,40
1653298909193,BIMM 143,B01,089955,Fan; Chun Chieh,39,0,40,1
1653298909193,BIMM 143,C01,089957,Bozinovic; Goran,29,0,40,11
1653298909726,BIMM 194,A00,089958,Hasty; Jeff M,15,0,27,12
1653298909726,BIMM 194,B00,089959,Golden; James W,19,0,27,8
1653298909726,BIMM 194,C00,089960,Lykke-Andersen; Jens,2,0,27,25
1653298909726,BIMM 194,D00,094317,Golden; Susan S.,25,0,27,2
1653298910250,BIPN 100,A01,093011,Cooke; James Edward,7,0,19,12
1653298910250,BIPN 100,A02,093012,Cooke; James Edward,10,0,19,9
1653298910250,BIPN 100,A03,093013,Cooke; James Edward,8,0,19,11
1653298910250,BIPN 100,A04,093014,Cooke; James Edward,12,0,19,7
1653298910250,BIPN 100,A05,093015,Cooke; James Edward,17,0,19,2
1653298910250,BIPN 100,A06,093016,Cooke; James Edward,12,0,19,7
1653298910250,BIPN 100,A07,093017,Cooke; James Edward,12,0,19,7
1653298910250,BIPN 100,A08,093018,Cooke; James Edward,18,0,19,1
1653298910250,BIPN 100,A09,093019,Cooke; James Edward,17,0,19,2
1653298910250,BIPN 100,A10,093020,Cooke; James Edward,18,0,19,1
1653298910250,BIPN 100,B01,093036,Reyes Gonzalez; Catalina,17,0,19,2
1653298910250,BIPN 100,B02,093037,Reyes Gonzalez; Catalina,14,0,19,5
1653298910250,BIPN 100,B03,093038,Reyes Gonzalez; Catalina,16,0,19,3
1653298910250,BIPN 100,B04,093039,Reyes Gonzalez; Catalina,19,0,19,0
1653298910250,BIPN 100,B05,093040,Reyes Gonzalez; Catalina,19,0,19,0
1653298910250,BIPN 100,B06,093041,Reyes Gonzalez; Catalina,19,0,19,0
1653298910250,BIPN 100,B07,093042,Reyes Gonzalez; Catalina,14,0,19,5
1653298910250,BIPN 100,B08,093043,Reyes Gonzalez; Catalina,16,0,19,3
1653298910250,BIPN 100,B09,093044,Reyes Gonzalez; Catalina,19,0,19,0
1653298910250,BIPN 100,B10,093045,Reyes Gonzalez; Catalina,19,0,19,0
1653298910786,BIPN 102,A01,093046,Reyes Gonzalez; Catalina,28,0,32,4
1653298910786,BIPN 102,A02,093047,Reyes Gonzalez; Catalina,17,0,32,15
1653298910786,BIPN 102,A05,093050,Reyes Gonzalez; Catalina,29,0,32,3
1653298910786,BIPN 102,A06,093051,Reyes Gonzalez; Catalina,15,0,32,17
1653298910786,BIPN 102,A07,093052,Reyes Gonzalez; Catalina,29,0,32,3
1653298910786,BIPN 102,A08,093053,Reyes Gonzalez; Catalina,31,0,32,1
1653298911309,BIPN 105,A01,089966,Armour; Jon Christopher,0,0,21,21
1653298911309,BIPN 105,A02,089967,Armour; Jon Christopher,0,0,21,21
1653298911309,BIPN 105,A03,089968,Armour; Jon Christopher,3,0,21,18
1653298911309,BIPN 105,A04,089969,Armour; Jon Christopher,10,0,21,11
1653298911835,BIPN 140,A01,092514,Spitzer; Nicholas & Su; Chih-Ying,9,0,19,10
1653298911835,BIPN 140,A02,092515,Spitzer; Nicholas & Su; Chih-Ying,12,0,19,7
1653298911835,BIPN 140,A03,092516,Spitzer; Nicholas & Su; Chih-Ying,11,0,19,8
1653298911835,BIPN 140,A04,092517,Spitzer; Nicholas & Su; Chih-Ying,15,0,19,4
1653298911835,BIPN 140,B01,092952,Banghart; Matthew Ryan,12,0,19,7
1653298911835,BIPN 140,B02,092953,Banghart; Matthew Ryan,19,0,19,0
1653298911835,BIPN 140,B03,092954,Banghart; Matthew Ryan,19,0,19,0
1653298911835,BIPN 140,B04,092955,Banghart; Matthew Ryan,19,0,19,0
1653298912360,BIPN 145,A01,089973,Marino; Marc J,35,0,42,7
1653298912360,BIPN 145,A02,089974,Marino; Marc J,36,0,42,6
1653298912360,BIPN 145,B01,089976,Juavinett; Ashley Lauren,0,0,42,42
1653298912889,BIPN 148,A01,092960,Leutgeb; Jill K.,31,0,32,1
1653298912889,BIPN 148,A02,092961,Leutgeb; Jill K.,25,0,32,7
1653298912889,BIPN 148,A03,092962,Leutgeb; Jill K.,29,0,31,2
1653298912889,BIPN 148,A04,092963,Leutgeb; Jill K.,31,0,31,0
1653298912889,BIPN 148,A05,092964,Leutgeb; Jill K.,31,0,31,0
1653298912889,BIPN 148,A06,094351,Leutgeb; Jill K.,26,0,31,5
1653298912889,BIPN 148,A07,092966,Leutgeb; Jill K.,26,0,31,5
1653298912889,BIPN 148,A08,092967,Leutgeb; Jill K.,26,0,31,5
1653298913411,BIPN 189,A00,090665,Gentner; Tim,0,0,25,25
1653298913938,BIPN 194,A00,089978,Pekkurnaz Banghart; Gulcin,17,0,27,10
1653298913938,BIPN 194,B00,089979,Leutgeb; Stefan,24,0,27,3
1653298914474,BISP 194,A00,089980,Wertheim; Joel Okrent,8,0,27,19
1653298915012,CAT 1,A01,086671,Bronstein; Phoebe Malan,17,0,17,0
1653298915012,CAT 1,A02,086672,Bronstein; Phoebe Malan,13,0,17,4
1653298915012,CAT 1,A03,086673,Bronstein; Phoebe Malan,17,0,17,0
1653298915012,CAT 1,A04,086674,Bronstein; Phoebe Malan,15,0,17,2
1653298915012,CAT 1,A05,086675,Bronstein; Phoebe Malan,17,0,17,0
1653298915012,CAT 1,A06,086676,Bronstein; Phoebe Malan,17,0,17,0
1653298915012,CAT 1,A07,086677,Bronstein; Phoebe Malan,16,0,17,1
1653298915012,CAT 1,A08,086678,Bronstein; Phoebe Malan,17,0,17,0
1653298915012,CAT 1,A09,086679,Bronstein; Phoebe Malan,16,0,17,1
1653298915012,CAT 1,A10,086680,Bronstein; Phoebe Malan,17,0,17,0
1653298915012,CAT 1,A11,086681,Bronstein; Phoebe Malan,16,0,17,1
1653298915012,CAT 1,A12,086682,Bronstein; Phoebe Malan,17,0,17,0
1653298915012,CAT 1,A13,086683,Bronstein; Phoebe Malan,17,0,17,0
1653298915012,CAT 1,A14,086684,Bronstein; Phoebe Malan,17,0,17,0
1653298915012,CAT 1,A15,086685,Bronstein; Phoebe Malan,17,0,17,0
1653298915012,CAT 1,A16,086686,Bronstein; Phoebe Malan,17,0,17,0
1653298915012,CAT 1,B01,086688,Bigham; David Joseph,17,0,17,0
1653298915012,CAT 1,B02,086689,Bigham; David Joseph,16,0,17,1
1653298915012,CAT 1,B03,086690,Bigham; David Joseph,17,0,17,0
1653298915012,CAT 1,B04,086691,Bigham; David Joseph,17,0,17,0
1653298915012,CAT 1,B05,086692,Bigham; David Joseph,16,0,17,1
1653298915012,CAT 1,B06,086693,Bigham; David Joseph,17,0,17,0
1653298915012,CAT 1,B07,086694,Bigham; David Joseph,17,0,17,0
1653298915012,CAT 1,B08,086695,Bigham; David Joseph,17,0,17,0
1653298915012,CAT 1,B09,086696,Bigham; David Joseph,17,0,17,0
1653298915012,CAT 1,B10,086697,Bigham; David Joseph,17,0,17,0
1653298915012,CAT 1,B11,086698,Bigham; David Joseph,17,0,17,0
1653298915012,CAT 1,B12,086699,Bigham; David Joseph,17,0,17,0
1653298915012,CAT 1,B13,086700,Bigham; David Joseph,15,0,17,2
1653298915012,CAT 1,B14,086701,Bigham; David Joseph,17,0,17,0
1653298915012,CAT 1,C01,086703,Algaze; Guillermo,17,0,17,0
1653298915012,CAT 1,C02,086704,Algaze; Guillermo,17,0,17,0
1653298915012,CAT 1,C03,086705,Algaze; Guillermo,17,0,17,0
1653298915012,CAT 1,C04,086706,Algaze; Guillermo,17,0,17,0
1653298915012,CAT 1,C05,086707,Algaze; Guillermo,17,0,17,0
1653298915012,CAT 1,C06,086708,Algaze; Guillermo,17,0,17,0
1653298915012,CAT 1,C07,086709,Algaze; Guillermo,17,0,17,0
1653298915012,CAT 1,C08,086710,Algaze; Guillermo,17,0,17,0
1653298915012,CAT 1,C09,086711,Algaze; Guillermo,17,0,17,0
1653298915012,CAT 1,C10,086712,Algaze; Guillermo,17,0,17,0
1653298915012,CAT 1,C11,086713,Algaze; Guillermo,17,0,17,0
1653298915012,CAT 1,C12,086714,Algaze; Guillermo,17,0,17,0
1653298915012,CAT 1,C13,086715,Algaze; Guillermo,17,0,17,0
1653298915012,CAT 1,C14,086716,Algaze; Guillermo,16,0,17,1
1653298915012,CAT 1,C15,086717,Algaze; Guillermo,17,0,17,0
1653298915012,CAT 1,C16,086718,Algaze; Guillermo,16,0,17,1
1653298915012,CAT 1,D01,086720,Staff,17,0,17,0
1653298915012,CAT 1,D02,086721,Staff,17,0,17,0
1653298915012,CAT 1,D03,086722,Staff,17,0,17,0
1653298915012,CAT 1,D04,086723,Staff,17,0,17,0
1653298915012,CAT 1,D05,086724,Staff,16,0,17,1
1653298915012,CAT 1,D06,086725,Staff,16,0,17,1
1653298915012,CAT 1,D07,086726,Staff,17,0,17,0
1653298915012,CAT 1,D08,086727,Staff,17,0,17,0
1653298915012,CAT 1,D09,086728,Staff,16,0,17,1
1653298915012,CAT 1,D10,086729,Staff,17,0,17,0
1653298915012,CAT 1,D11,086730,Staff,17,0,17,0
1653298915012,CAT 1,D12,086731,Staff,17,0,17,0
1653298915012,CAT 1,D13,086732,Staff,17,0,17,0
1653298915012,CAT 1,D14,086733,Staff,17,0,17,0
1653298915535,CAT 3,A01,086735,Gumm; Elizabeth Ashley,14,0,15,1
1653298915535,CAT 3,A02,086736,Gumm; Elizabeth Ashley,14,0,15,1
1653298915535,CAT 3,A03,086737,Gumm; Elizabeth Ashley,15,0,15,0
1653298915535,CAT 3,A04,086738,Gumm; Elizabeth Ashley,15,0,15,0
1653298915535,CAT 3,A05,086739,Gumm; Elizabeth Ashley,15,0,15,0
1653298915535,CAT 3,A06,086740,Gumm; Elizabeth Ashley,15,0,15,0
1653298916057,CAT 124,A01,086742,Staff,15,0,15,0
1653298916588,CAT 125R,A01,094882,Staff,14,0,16,2
1653298916588,CAT 125R,A02,086745,Staff,16,0,16,0
1653298916588,CAT 125R,A03,086746,Staff,14,0,16,2
1653298916588,CAT 125R,A04,086747,Staff,13,0,16,3
1653298916588,CAT 125R,A05,086748,Staff,15,0,16,1
1653298916588,CAT 125R,A06,086749,Staff,12,0,16,4
1653298916588,CAT 125R,A07,086750,Staff,14,0,16,2
1653298916588,CAT 125R,A08,094883,Staff,14,0,16,2
1653298916588,CAT 125R,A09,094884,Staff,16,0,16,0
1653298916588,CAT 125R,A10,094885,Staff,15,0,16,1
1653298916588,CAT 125R,A14,086761,Staff,15,0,16,1
1653298916588,CAT 125R,A15,086762,Staff,16,0,16,0
1653298916588,CAT 125R,A16,086763,Staff,13,0,16,3
1653298916588,CAT 125R,A17,086764,Staff,14,0,16,2
1653298916588,CAT 125R,A18,086765,Staff,14,0,16,2
1653298916588,CAT 125R,A19,086766,Staff,14,0,16,2
1653298917113,CCS 101,A00,088353,Staff,29,0,35,6
1653298917638,CENG 4,A01,086204,Bae; Jinhye,30,0,30,0
1653298917638,CENG 4,A02,086205,Bae; Jinhye,30,0,30,0
1653298917638,CENG 4,B01,086207,Drews; Aaron,30,0,30,0
1653298917638,CENG 4,B02,086208,Drews; Aaron,30,0,30,0
1653298918167,CENG 15,A01,086210,Lubarda; Vlado,63,0,65,2
1653298918167,CENG 15,B01,086212,Lubarda; Vlado,65,0,65,0
1653298918691,CENG 100,A00,086213,Chen; Zheng,147,0,150,3
1653298919215,CENG 101A,A00,086214,Bae; Jinhye,142,0,150,8
1653298919738,CENG 120,A00,086215,Opatkiewicz; Justin Paul,125,0,150,25
1653298920266,CENG 122,A00,086216,Opatkiewicz; Justin Paul,137,0,150,13
1653298920797,CGS 2A,A01,086271,Shelby; Karen Lee,12,0,15,3
1653298920797,CGS 2A,A02,086272,Shelby; Karen Lee,13,0,15,2
1653298920797,CGS 2A,A03,086273,Shelby; Karen Lee,14,0,15,1
1653298920797,CGS 2A,A04,086274,Shelby; Karen Lee,15,0,15,0
1653298921322,CGS 100A,A00,086275,Perez; Roy,26,0,32,6
1653298921844,CGS 101,A00,086276,Shelby; Karen Lee,30,0,30,0
1653298922368,CGS 106,A00,086277,Shelby; Karen Lee,24,0,30,6
1653298922892,CGS 119,A00,086279,Nguyen; Hoang Tan,27,0,30,3
1653298923420,CGS 121,A00,086280,Martin Sandino; Amanda Maria Yoland,19,0,20,1
1653298923942,CGS 122,A00,086281,Whitley; Leila Marie,20,0,20,0
1653298924468,CGS 123,A00,086282,Staff,0,0,0,0
1653298924992,CGS 127,A00,086283,Whitley; Leila Marie,15,0,15,0
1653298925518,CGS 130,A00,086284,Martin Sandino; Amanda Maria Yoland,15,0,15,0
1653298926043,CGS 187,A00,086285,Perez; Roy,15,0,16,1
1653298926568,CGS 190,A00,086286,Staff,5,0,5,0
1653298927092,CHEM 4,A01,089669,Bussey; Thomas J,40,0,40,0
1653298927092,CHEM 4,A02,089670,Bussey; Thomas J,42,0,42,0
1653298927092,CHEM 4,A03,089671,Bussey; Thomas J,40,0,42,2
1653298927092,CHEM 4,A04,089672,Bussey; Thomas J,42,0,42,0
1653298927092,CHEM 4,A05,089673,Bussey; Thomas J,40,0,42,2
1653298927092,CHEM 4,A06,089674,Bussey; Thomas J,40,0,42,2
1653298927092,CHEM 4,A07,089675,Bussey; Thomas J,42,0,42,0
1653298927092,CHEM 4,A08,089676,Bussey; Thomas J,42,0,42,0
1653298927092,CHEM 4,A09,089677,Bussey; Thomas J,41,0,41,0
1653298927092,CHEM 4,A10,089678,Bussey; Thomas J,40,0,40,0
1653298927657,CHEM 6A,A01,092734,Pomeroy; Robert S.,4,0,4,0
1653298927657,CHEM 6A,A02,092735,Pomeroy; Robert S.,4,0,4,0
1653298927657,CHEM 6A,A03,092736,Pomeroy; Robert S.,4,0,4,0
1653298927657,CHEM 6A,A04,092737,Pomeroy; Robert S.,4,0,4,0
1653298927657,CHEM 6A,A05,092738,Pomeroy; Robert S.,4,0,4,0
1653298927657,CHEM 6A,A06,092739,Pomeroy; Robert S.,4,0,4,0
1653298927657,CHEM 6A,A07,092740,Pomeroy; Robert S.,4,0,4,0
1653298927657,CHEM 6A,A08,092741,Pomeroy; Robert S.,4,0,4,0
1653298927657,CHEM 6A,A09,092742,Pomeroy; Robert S.,0,0,0,0
1653298927657,CHEM 6A,B01,092744,Schurmeier; Kimberly,4,0,4,0
1653298927657,CHEM 6A,B02,092746,Schurmeier; Kimberly,4,0,4,0
1653298927657,CHEM 6A,B03,092749,Schurmeier; Kimberly,4,0,4,0
1653298927657,CHEM 6A,B04,092751,Schurmeier; Kimberly,4,0,4,0
1653298927657,CHEM 6A,B05,092753,Schurmeier; Kimberly,4,0,4,0
1653298927657,CHEM 6A,B06,092755,Schurmeier; Kimberly,3,0,4,1
1653298927657,CHEM 6A,B07,092756,Schurmeier; Kimberly,4,0,4,0
1653298927657,CHEM 6A,B08,092757,Schurmeier; Kimberly,4,0,4,0
1653298927657,CHEM 6A,B09,092758,Schurmeier; Kimberly,0,0,0,0
1653298927657,CHEM 6A,C01,092805,Schurmeier; Kimberly,4,0,4,0
1653298927657,CHEM 6A,C02,092806,Schurmeier; Kimberly,4,0,4,0
1653298927657,CHEM 6A,C03,092807,Schurmeier; Kimberly,4,0,4,0
1653298927657,CHEM 6A,C04,092808,Schurmeier; Kimberly,4,0,4,0
1653298927657,CHEM 6A,C05,092809,Schurmeier; Kimberly,4,0,4,0
1653298927657,CHEM 6A,C06,092810,Schurmeier; Kimberly,4,0,4,0
1653298927657,CHEM 6A,C07,092811,Schurmeier; Kimberly,4,0,4,0
1653298927657,CHEM 6A,C08,092812,Schurmeier; Kimberly,4,0,4,0
1653298927657,CHEM 6A,C09,092813,Schurmeier; Kimberly,0,0,0,0
1653298927657,CHEM 6A,D01,092837,Stallings; Dontarie M,4,0,4,0
1653298927657,CHEM 6A,D02,092838,Stallings; Dontarie M,4,0,4,0
1653298927657,CHEM 6A,D03,092839,Stallings; Dontarie M,4,0,4,0
1653298927657,CHEM 6A,D04,092840,Stallings; Dontarie M,4,0,4,0
1653298927657,CHEM 6A,D05,092841,Stallings; Dontarie M,4,0,4,0
1653298927657,CHEM 6A,D06,092842,Stallings; Dontarie M,4,0,4,0
1653298927657,CHEM 6A,D07,092843,Stallings; Dontarie M,4,0,4,0
1653298927657,CHEM 6A,D08,092844,Stallings; Dontarie M,4,0,4,0
1653298927657,CHEM 6A,D09,092845,Stallings; Dontarie M,0,0,0,0
1653298927657,CHEM 6A,E01,092796,Brydges; Stacey,4,0,4,0
1653298927657,CHEM 6A,E02,092797,Brydges; Stacey,3,0,4,1
1653298927657,CHEM 6A,E03,092798,Brydges; Stacey,4,0,4,0
1653298927657,CHEM 6A,E04,092799,Brydges; Stacey,3,0,4,1
1653298927657,CHEM 6A,E05,092800,Brydges; Stacey,4,0,4,0
1653298927657,CHEM 6A,E06,092801,Brydges; Stacey,4,0,4,0
1653298927657,CHEM 6A,E07,092802,Brydges; Stacey,4,0,4,0
1653298927657,CHEM 6A,E08,092803,Brydges; Stacey,4,0,4,0
1653298927657,CHEM 6A,E09,092804,Brydges; Stacey,0,0,0,0
1653298927657,CHEM 6A,F01,092759,Brydges; Stacey,4,0,4,0
1653298927657,CHEM 6A,F02,092760,Brydges; Stacey,4,0,4,0
1653298927657,CHEM 6A,F03,092761,Brydges; Stacey,3,0,4,1
1653298927657,CHEM 6A,F04,092762,Brydges; Stacey,4,0,4,0
1653298927657,CHEM 6A,F05,092763,Brydges; Stacey,4,0,4,0
1653298927657,CHEM 6A,F06,092764,Brydges; Stacey,4,0,4,0
1653298927657,CHEM 6A,F07,092765,Brydges; Stacey,4,0,4,0
1653298927657,CHEM 6A,F08,092766,Brydges; Stacey,4,0,4,0
1653298927657,CHEM 6A,F09,092767,Brydges; Stacey,0,0,0,0
1653298927657,CHEM 6A,G01,092774,Zid; Brian M,0,0,4,4
1653298927657,CHEM 6A,G02,092775,Zid; Brian M,2,0,4,2
1653298927657,CHEM 6A,G03,092776,Zid; Brian M,2,0,4,2
1653298927657,CHEM 6A,G04,092777,Zid; Brian M,2,0,4,2
1653298927657,CHEM 6A,G05,092778,Zid; Brian M,4,0,4,0
1653298927657,CHEM 6A,G06,092779,Zid; Brian M,4,0,4,0
1653298927657,CHEM 6A,G07,092780,Zid; Brian M,3,0,4,1
1653298927657,CHEM 6A,G08,092781,Zid; Brian M,3,0,4,1
1653298927657,CHEM 6A,G09,092782,Zid; Brian M,0,0,0,0
1653298927657,CHEM 6A,H01,092846,Stallings; Dontarie M,4,0,4,0
1653298927657,CHEM 6A,H02,092847,Stallings; Dontarie M,3,0,4,1
1653298927657,CHEM 6A,H03,092848,Stallings; Dontarie M,4,0,4,0
1653298927657,CHEM 6A,H04,092849,Stallings; Dontarie M,4,0,4,0
1653298927657,CHEM 6A,H05,092850,Stallings; Dontarie M,4,0,4,0
1653298927657,CHEM 6A,H06,092851,Stallings; Dontarie M,3,0,4,1
1653298927657,CHEM 6A,H07,092852,Stallings; Dontarie M,4,0,4,0
1653298927657,CHEM 6A,H08,092853,Stallings; Dontarie M,3,0,4,1
1653298927657,CHEM 6A,H09,092854,Stallings; Dontarie M,0,0,0,0
1653298927657,CHEM 6A,I01,092814,Staff,0,0,0,0
1653298927657,CHEM 6A,I02,092815,Staff,0,0,0,0
1653298927657,CHEM 6A,I04,092816,Staff,0,0,0,0
1653298927657,CHEM 6A,I05,092817,Staff,0,0,0,0
1653298927657,CHEM 6A,I06,092818,Staff,0,0,0,0
1653298927657,CHEM 6A,I07,092819,Staff,0,0,0,0
1653298927657,CHEM 6A,I08,092820,Staff,0,0,0,0
1653298927657,CHEM 6A,I09,092821,Staff,0,0,0,0
1653298928181,CHEM 6AH,A01,092793,Paesani; Francesco,15,0,16,1
1653298928181,CHEM 6AH,A02,092794,Paesani; Francesco,16,0,16,0
1653298928181,CHEM 6AH,A03,092795,Paesani; Francesco,16,0,16,0
1653298928711,CHEM 6B,A01,092691,Hopkins; Patrycja Anna,21,0,25,4
1653298928711,CHEM 6B,A02,092692,Hopkins; Patrycja Anna,23,0,25,2
1653298928711,CHEM 6B,A03,092693,Hopkins; Patrycja Anna,25,0,25,0
1653298928711,CHEM 6B,A04,092694,Hopkins; Patrycja Anna,0,0,0,0
1653298928711,CHEM 6B,A05,092695,Hopkins; Patrycja Anna,24,0,25,1
1653298928711,CHEM 6B,A06,092696,Hopkins; Patrycja Anna,22,0,25,3
1653298928711,CHEM 6B,A07,092697,Hopkins; Patrycja Anna,24,0,25,1
1653298929237,CHEM 6C,A01,092708,Albizati; Kim F.,31,0,38,7
1653298929237,CHEM 6C,A02,092709,Albizati; Kim F.,32,0,38,6
1653298929237,CHEM 6C,A03,092710,Albizati; Kim F.,37,0,38,1
1653298929237,CHEM 6C,A04,092711,Albizati; Kim F.,36,0,38,2
1653298929237,CHEM 6C,A05,092712,Albizati; Kim F.,0,0,0,0
1653298929237,CHEM 6C,A06,092714,Albizati; Kim F.,33,0,38,5
1653298929237,CHEM 6C,A07,092715,Albizati; Kim F.,32,0,38,6
1653298929237,CHEM 6C,A08,092716,Albizati; Kim F.,37,0,38,1
1653298929237,CHEM 6C,A09,092717,Albizati; Kim F.,38,0,38,0
1653298929774,CHEM 7L,A01,089692,Leigh; Brian,11,0,19,8
1653298929774,CHEM 7L,A02,089693,Leigh; Brian,23,0,24,1
1653298929774,CHEM 7L,A03,089694,Leigh; Brian,24,0,24,0
1653298929774,CHEM 7L,A04,089695,Leigh; Brian,24,0,24,0
1653298929774,CHEM 7L,A05,089696,Leigh; Brian,23,0,24,1
1653298929774,CHEM 7L,A06,089697,Leigh; Brian,22,0,24,2
1653298929774,CHEM 7L,A07,089698,Leigh; Brian,21,0,21,0
1653298929774,CHEM 7L,A08,089699,Leigh; Brian,17,0,24,7
1653298929774,CHEM 7L,A09,089700,Leigh; Brian,23,0,24,1
1653298929774,CHEM 7L,A10,089701,Leigh; Brian,0,0,0,0
1653298929774,CHEM 7L,B01,089703,Leigh; Brian,18,0,24,6
1653298929774,CHEM 7L,B02,089704,Leigh; Brian,18,0,24,6
1653298929774,CHEM 7L,B03,089705,Leigh; Brian,23,0,24,1
1653298929774,CHEM 7L,B04,089706,Leigh; Brian,20,0,21,1
1653298929774,CHEM 7L,B05,089707,Leigh; Brian,17,0,24,7
1653298929774,CHEM 7L,B06,089708,Leigh; Brian,17,0,24,7
1653298929774,CHEM 7L,B07,089709,Leigh; Brian,17,0,24,7
1653298929774,CHEM 7L,B08,089710,Leigh; Brian,21,0,24,3
1653298929774,CHEM 7L,B09,089711,Leigh; Brian,21,0,24,3
1653298929774,CHEM 7L,B10,089712,Leigh; Brian,0,0,0,0
1653298929774,CHEM 7L,C01,089714,Staff,23,0,24,1
1653298929774,CHEM 7L,C02,089715,Staff,22,0,24,2
1653298929774,CHEM 7L,C03,089716,Staff,23,0,24,1
1653298929774,CHEM 7L,C04,089717,Staff,24,0,24,0
1653298929774,CHEM 7L,C05,089718,Staff,21,0,24,3
1653298929774,CHEM 7L,C06,089719,Staff,22,0,24,2
1653298929774,CHEM 7L,C07,089720,Staff,23,0,24,1
1653298929774,CHEM 7L,C08,089721,Staff,24,0,24,0
1653298929774,CHEM 7L,C09,089722,Staff,24,0,24,0
1653298929774,CHEM 7L,C10,089723,Staff,0,0,0,0
1653298930310,CHEM 40A,A01,092871,Schmidt; Valerie A,31,0,31,0
1653298930310,CHEM 40A,A02,092872,Schmidt; Valerie A,31,0,31,0
1653298930310,CHEM 40A,A03,092873,Schmidt; Valerie A,31,0,31,0
1653298930310,CHEM 40A,A04,092874,Schmidt; Valerie A,0,0,0,0
1653298930310,CHEM 40A,A05,092875,Schmidt; Valerie A,31,0,31,0
1653298930310,CHEM 40A,A06,092876,Schmidt; Valerie A,29,0,31,2
1653298930310,CHEM 40A,A07,092877,Schmidt; Valerie A,31,0,31,0
1653298930310,CHEM 40A,A08,092878,Schmidt; Valerie A,28,0,28,0
1653298930310,CHEM 40A,B01,089726,Lam; Tin Yiu,31,0,31,0
1653298930310,CHEM 40A,B02,089727,Lam; Tin Yiu,31,0,31,0
1653298930310,CHEM 40A,B03,089728,Lam; Tin Yiu,31,0,31,0
1653298930310,CHEM 40A,B04,089729,Lam; Tin Yiu,30,0,31,1
1653298930310,CHEM 40A,B05,089730,Lam; Tin Yiu,31,0,31,0
1653298930310,CHEM 40A,B06,089731,Lam; Tin Yiu,30,0,31,1
1653298930310,CHEM 40A,B07,089732,Lam; Tin Yiu,29,0,31,2
1653298930310,CHEM 40A,B08,089733,Lam; Tin Yiu,0,0,0,0
1653298930310,CHEM 40A,C01,092718,Albizati; Kim F.,17,0,31,14
1653298930310,CHEM 40A,C02,092719,Albizati; Kim F.,24,0,31,7
1653298930310,CHEM 40A,C03,092720,Albizati; Kim F.,12,0,31,19
1653298930310,CHEM 40A,C04,092721,Albizati; Kim F.,24,0,31,7
1653298930310,CHEM 40A,C05,092722,Albizati; Kim F.,21,0,31,10
1653298930310,CHEM 40A,C06,092723,Albizati; Kim F.,24,0,31,7
1653298930310,CHEM 40A,C07,092724,Albizati; Kim F.,30,0,31,1
1653298930310,CHEM 40A,C08,092725,Albizati; Kim F.,0,0,0,0
1653298930310,CHEM 40A,D01,092863,Yang; Jerry,28,0,31,3
1653298930310,CHEM 40A,D02,092864,Yang; Jerry,28,0,31,3
1653298930310,CHEM 40A,D03,092865,Yang; Jerry,31,0,31,0
1653298930310,CHEM 40A,D04,092866,Yang; Jerry,31,0,31,0
1653298930310,CHEM 40A,D05,092867,Yang; Jerry,0,0,0,0
1653298930310,CHEM 40A,D06,092868,Yang; Jerry,31,0,31,0
1653298930310,CHEM 40A,D07,092869,Yang; Jerry,31,0,31,0
1653298930310,CHEM 40A,D08,092870,Yang; Jerry,31,0,31,0
1653298930834,CHEM 40B,A01,092698,Oconnor; Joseph M.,24,0,34,10
1653298930834,CHEM 40B,A02,092699,Oconnor; Joseph M.,34,0,34,0
1653298930834,CHEM 40B,A03,092700,Oconnor; Joseph M.,0,0,0,0
1653298930834,CHEM 40B,A04,092701,Oconnor; Joseph M.,30,0,34,4
1653298930834,CHEM 40B,A05,092702,Oconnor; Joseph M.,33,0,34,1
1653298930834,CHEM 40B,A06,092703,Oconnor; Joseph M.,34,0,34,0
1653298930834,CHEM 40B,A07,092704,Oconnor; Joseph M.,32,0,34,2
1653298930834,CHEM 40B,A08,092705,Oconnor; Joseph M.,33,0,34,1
1653298930834,CHEM 40B,A09,092706,Oconnor; Joseph M.,34,0,34,0
1653298931358,CHEM 40C,A01,089739,Lam; Tin Yiu,0,0,0,0
1653298931358,CHEM 40C,A02,089740,Lam; Tin Yiu,0,0,0,0
1653298931358,CHEM 40C,A03,089741,Lam; Tin Yiu,0,0,0,0
1653298931358,CHEM 40C,A04,089742,Lam; Tin Yiu,13,0,34,21
1653298931358,CHEM 40C,A05,089743,Lam; Tin Yiu,32,0,34,2
1653298931358,CHEM 40C,A06,089744,Lam; Tin Yiu,31,0,34,3
1653298931887,CHEM 41A,A01,093840,Ternansky; Robert J.,29,0,33,4
1653298931887,CHEM 41A,A02,093841,Ternansky; Robert J.,32,0,33,1
1653298931887,CHEM 41A,A03,093842,Ternansky; Robert J.,33,0,33,0
1653298931887,CHEM 41A,A04,093843,Ternansky; Robert J.,30,0,33,3
1653298931887,CHEM 41A,A05,093844,Ternansky; Robert J.,31,0,33,2
1653298931887,CHEM 41A,A06,093845,Ternansky; Robert J.,27,0,27,0
1653298931887,CHEM 41A,A07,093846,Ternansky; Robert J.,32,0,33,1
1653298931887,CHEM 41A,A08,093847,Ternansky; Robert J.,33,0,33,0
1653298932412,CHEM 43A,A01,089746,Klosterman; Jeremy K,11,0,24,13
1653298932412,CHEM 43A,A02,089747,Klosterman; Jeremy K,16,0,24,8
1653298932412,CHEM 43A,A03,089748,Klosterman; Jeremy K,21,0,24,3
1653298932412,CHEM 43A,A04,089749,Klosterman; Jeremy K,22,0,24,2
1653298932412,CHEM 43A,A05,089750,Klosterman; Jeremy K,23,0,24,1
1653298932412,CHEM 43A,A06,089751,Klosterman; Jeremy K,9,0,24,15
1653298932412,CHEM 43A,A07,089752,Klosterman; Jeremy K,17,0,24,7
1653298932412,CHEM 43A,A08,089753,Klosterman; Jeremy K,16,0,24,8
1653298932412,CHEM 43A,A09,089754,Klosterman; Jeremy K,21,0,24,3
1653298932412,CHEM 43A,A10,089755,Klosterman; Jeremy K,21,0,24,3
1653298932412,CHEM 43A,A11,089756,Klosterman; Jeremy K,0,0,0,0
1653298932412,CHEM 43A,A12,089757,Klosterman; Jeremy K,0,0,0,0
1653298932412,CHEM 43A,A13,089758,Klosterman; Jeremy K,0,0,0,0
1653298932412,CHEM 43A,B01,089760,Klosterman; Jeremy K,0,0,0,0
1653298932412,CHEM 43A,B02,089761,Klosterman; Jeremy K,0,0,0,0
1653298932412,CHEM 43A,B03,089762,Klosterman; Jeremy K,16,0,24,8
1653298932412,CHEM 43A,B04,089763,Klosterman; Jeremy K,22,0,24,2
1653298932412,CHEM 43A,B05,089764,Klosterman; Jeremy K,23,0,24,1
1653298932412,CHEM 43A,B06,089765,Klosterman; Jeremy K,23,0,24,1
1653298932412,CHEM 43A,B07,089766,Klosterman; Jeremy K,17,0,24,7
1653298932412,CHEM 43A,B08,089767,Klosterman; Jeremy K,23,0,24,1
1653298932412,CHEM 43A,B09,089768,Klosterman; Jeremy K,24,0,24,0
1653298932412,CHEM 43A,B10,089769,Klosterman; Jeremy K,23,0,24,1
1653298932412,CHEM 43A,B11,089770,Klosterman; Jeremy K,22,0,24,2
1653298932412,CHEM 43A,B12,089771,Klosterman; Jeremy K,21,0,24,3
1653298932934,CHEM 87,A00,089772,Bussey; Thomas J,20,0,20,0
1653298933461,CHEM 96,A00,089773,Bussey; Thomas J,20,0,25,5
1653298933986,CHEM 100A,A01,089775,Pomeroy; Robert S.,22,0,24,2
1653298933986,CHEM 100A,A02,089776,Pomeroy; Robert S.,19,0,24,5
1653298933986,CHEM 100A,A03,089777,Pomeroy; Robert S.,13,0,24,11
1653298933986,CHEM 100A,A04,089778,Pomeroy; Robert S.,18,0,24,6
1653298933986,CHEM 100A,A05,089779,Pomeroy; Robert S.,19,0,24,5
1653298933986,CHEM 100A,A06,089780,Pomeroy; Robert S.,24,0,24,0
1653298933986,CHEM 100A,A07,089781,Pomeroy; Robert S.,0,0,0,0
1653298934510,CHEM 105A,A01,089783,Young; Mark,0,0,39,39
1653298934510,CHEM 105A,B01,089785,Young; Mark,26,0,39,13
1653298935032,CHEM 108,A01,089787,Ghosh; Gourisankar,1,0,22,21
1653298935032,CHEM 108,A02,089788,Ghosh; Gourisankar,6,0,22,16
1653298935032,CHEM 108,B01,089790,Ghosh; Gourisankar,13,0,22,9
1653298935032,CHEM 108,B02,089791,Ghosh; Gourisankar,20,0,22,2
1653298935563,CHEM 109,A01,089793,Hamaoka; Brent Y,4,0,22,18
1653298935563,CHEM 109,A02,089794,Hamaoka; Brent Y,10,0,22,12
1653298935563,CHEM 109,B01,089796,Hamaoka; Brent Y,6,0,22,16
1653298935563,CHEM 109,B02,089797,Hamaoka; Brent Y,18,0,22,4
1653298936092,CHEM 114A,A01,092855,Toor; Navtej,21,0,25,4
1653298936092,CHEM 114A,A02,092856,Toor; Navtej,25,0,25,0
1653298936092,CHEM 114A,A03,092857,Toor; Navtej,19,0,25,6
1653298936092,CHEM 114A,A04,092858,Toor; Navtej,24,0,25,1
1653298936092,CHEM 114A,A05,092859,Toor; Navtej,0,0,0,0
1653298936092,CHEM 114A,A06,092860,Toor; Navtej,14,0,25,11
1653298936092,CHEM 114A,A07,092861,Toor; Navtej,24,0,25,1
1653298936092,CHEM 114A,A08,092862,Toor; Navtej,24,0,25,1
1653298936706,CHEM 116,A01,092707,Ferguson; Fleur,7,0,35,28
1653298936706,CHEM 116,A02,094887,Ferguson; Fleur,31,0,35,4
1653298937233,CHEM 120A,A01,092785,Schimpf; Alina M,16,0,28,12
1653298937233,CHEM 120A,A02,092786,Schimpf; Alina M,26,0,28,2
1653298937233,CHEM 120A,A03,092787,Schimpf; Alina M,20,0,28,8
1653298937233,CHEM 120A,A04,092788,Schimpf; Alina M,27,0,28,1
1653298937233,CHEM 120A,A05,092789,Schimpf; Alina M,27,0,28,1
1653298937233,CHEM 120A,A06,092790,Schimpf; Alina M,0,0,0,0
1653298937233,CHEM 120A,A07,092791,Schimpf; Alina M,15,0,28,13
1653298937233,CHEM 120A,A08,092792,Schimpf; Alina M,0,0,0,0
1653298937760,CHEM 126A,A01,092768,Schoeneberg; Johannes,16,0,35,19
1653298937760,CHEM 126A,A02,092769,Schoeneberg; Johannes,35,0,35,0
1653298937760,CHEM 126A,A03,092770,Schoeneberg; Johannes,29,0,35,6
1653298937760,CHEM 126A,A04,092771,Schoeneberg; Johannes,0,0,0,0
1653298937760,CHEM 126A,A05,092772,Schoeneberg; Johannes,30,0,35,5
1653298937760,CHEM 126A,A06,092773,Schoeneberg; Johannes,33,0,35,2
1653298938283,CHEM 130,A01,092685,Sinha; Amitabha,28,0,38,10
1653298938283,CHEM 130,A02,092686,Sinha; Amitabha,31,0,38,7
1653298938283,CHEM 130,A03,092687,Sinha; Amitabha,34,0,38,4
1653298938806,CHEM 142,A00,089803,Esko; Jeffrey D. & Godula; Kamil,9,0,46,37
1653298939329,CHEM 143C,A01,089805,Ternansky; Robert J.,17,0,22,5
1653298939329,CHEM 143C,A02,089806,Ternansky; Robert J.,18,0,22,4
1653298939329,CHEM 143C,A03,089807,Ternansky; Robert J.,19,0,22,3
1653298939329,CHEM 143C,A04,089808,Ternansky; Robert J.,20,0,22,2
1653298939856,CHEM 152,A00,089809,Romero; Nathan A & Schmidt; Valerie A,35,0,40,5
1653298940384,CHEM 171,A01,092688,Slade; Jonathan,35,0,45,10
1653298940384,CHEM 171,A02,092689,Slade; Jonathan,44,0,45,1
1653298940384,CHEM 171,A03,092690,Slade; Jonathan,45,0,45,0
1653298940915,CHEM 186,A00,089811,Paesani; Francesco,9,0,15,6
1653298941444,CHIN 10AD,A01,086223,Staff,13,0,13,0
1653298941444,CHIN 10AD,A02,086224,Staff,12,0,13,1
1653298941444,CHIN 10AD,B01,086227,Staff,14,0,15,1
1653298941971,CHIN 10AM,A01,086230,Chen; Pei-Chia,16,0,16,0
1653298941971,CHIN 10AM,A02,086231,Chen; Pei-Chia,16,0,16,0
1653298942496,CHIN 10AN,A01,086234,Xu; Li,14,0,14,0
1653298942496,CHIN 10AN,A02,086235,Xu; Li,14,0,14,0
1653298942496,CHIN 10AN,B01,086240,Xu; Li,14,0,14,0
1653298942496,CHIN 10AN,B02,086242,Xu; Li,0,0,0,0
1653298942496,CHIN 10AN,C01,086245,Xu; Li,14,0,14,0
1653298942496,CHIN 10AN,C02,086246,Xu; Li,14,0,14,0
1653298943020,CHIN 20AD,A01,086248,Wang; Xiao,14,0,14,0
1653298943020,CHIN 20AD,A02,086249,Wang; Xiao,14,0,14,0
1653298943020,CHIN 20AD,B01,086251,Wang; Xiao,13,0,14,1
1653298943020,CHIN 20AD,B02,086252,Wang; Xiao,14,0,14,0
1653298943542,CHIN 20AM,A01,086254,Wang; Xiao,11,0,14,3
1653298943542,CHIN 20AM,A02,086255,Wang; Xiao,13,0,14,1
1653298943542,CHIN 20AM,B01,086257,Staff,15,0,15,0
1653298944067,CHIN 20AN,A01,086259,Anderson; Qin-Hong,11,0,12,1
1653298944067,CHIN 20AN,A02,086260,Anderson; Qin-Hong,12,0,12,0
1653298944067,CHIN 20AN,A03,086261,Anderson; Qin-Hong,0,0,0,0
1653298944067,CHIN 20AN,B01,086263,Anderson; Qin-Hong,12,0,13,1
1653298944067,CHIN 20AN,B02,086264,Anderson; Qin-Hong,13,0,13,0
1653298944592,CHIN 100AM,A00,086265,Anderson; Qin-Hong,20,0,20,0
1653298945117,CHIN 100AN,A00,086266,Chen; Pei-Chia,17,0,20,3
1653298945638,CHIN 185A,A00,086268,Staff,20,0,20,0
1653298946168,COGS 1,A01,087834,Barrera; Steven James,57,0,60,3
1653298946168,COGS 1,A02,087835,Barrera; Steven James,52,0,60,8
1653298946168,COGS 1,A03,087836,Barrera; Steven James,57,0,60,3
1653298946168,COGS 1,A04,087837,Barrera; Steven James,59,0,60,1
1653298946168,COGS 1,A05,087838,Barrera; Steven James,60,0,60,0
1653298946168,COGS 1,A06,087839,Barrera; Steven James,59,0,60,1
1653298946168,COGS 1,A07,087840,Barrera; Steven James,54,0,57,3
1653298946694,COGS 2,A01,087842,Boyle; Mary E. T.,64,0,64,0
1653298946694,COGS 2,A02,087843,Boyle; Mary E. T.,61,0,64,3
1653298946694,COGS 2,A03,087844,Boyle; Mary E. T.,64,0,64,0
1653298947216,COGS 3,A01,094312,Boyle; Mary E. T.,30,0,35,5
1653298947216,COGS 3,A02,094313,Boyle; Mary E. T.,33,0,35,2
1653298947216,COGS 3,A03,094314,Boyle; Mary E. T.,35,0,35,0
1653298947216,COGS 3,A04,094315,Boyle; Mary E. T.,35,0,35,0
1653298947216,COGS 3,A05,094316,Boyle; Mary E. T.,35,0,35,0
1653298947739,COGS 8,A01,087846,Staff,35,0,35,0
1653298948262,COGS 10,A01,094357,Hollan; James D.,53,0,60,7
1653298948262,COGS 10,A02,094358,Hollan; James D.,58,0,60,2
1653298948262,COGS 10,A03,094359,Hollan; James D.,59,0,60,1
1653298948262,COGS 10,A04,094360,Hollan; James D.,60,0,60,0
1653298948262,COGS 10,A05,094361,Hollan; James D.,60,0,60,0
1653298948787,COGS 11,A01,087848,Boyle; Mary E. T.,46,0,47,1
1653298948787,COGS 11,A02,087849,Boyle; Mary E. T.,44,0,47,3
1653298948787,COGS 11,A03,087850,Boyle; Mary E. T.,46,0,46,0
1653298949311,COGS 13,A01,087852,Davis; Joshua Daniel,56,0,60,4
1653298949311,COGS 13,A02,087853,Davis; Joshua Daniel,55,0,60,5
1653298949311,COGS 13,A03,087854,Davis; Joshua Daniel,57,0,60,3
1653298949311,COGS 13,A04,087855,Davis; Joshua Daniel,58,0,60,2
1653298949835,COGS 14A,A01,087857,Creel; Sarah,58,0,65,7
1653298949835,COGS 14A,A02,087858,Creel; Sarah,62,0,65,3
1653298949835,COGS 14A,A03,087859,Creel; Sarah,63,0,65,2
1653298949835,COGS 14A,A04,087860,Creel; Sarah,63,0,65,2
1653298950358,COGS 14B,A01,087862,Hoffman; Drew Ellen,56,0,60,4
1653298950358,COGS 14B,A02,087863,Hoffman; Drew Ellen,53,0,60,7
1653298950358,COGS 14B,A03,087864,Hoffman; Drew Ellen,60,0,60,0
1653298950882,COGS 15,A01,087866,Bergen; Benjamin,60,0,60,0
1653298950882,COGS 15,A02,087867,Bergen; Benjamin,59,0,60,1
1653298951409,COGS 17,A01,087869,Johnson; Christine M.,55,0,60,5
1653298951409,COGS 17,A02,087870,Johnson; Christine M.,58,0,60,2
1653298951409,COGS 17,A03,087871,Johnson; Christine M.,55,0,60,5
1653298951409,COGS 17,A04,087872,Johnson; Christine M.,60,0,60,0
1653298951409,COGS 17,A05,087873,Johnson; Christine M.,59,0,60,1
1653298951409,COGS 17,A06,087874,Johnson; Christine M.,60,0,60,0
1653298951936,COGS 18,A01,087876,Fleischer; Jason G,22,0,35,13
1653298951936,COGS 18,A02,087877,Fleischer; Jason G,31,0,35,4
1653298951936,COGS 18,A03,087878,Fleischer; Jason G,33,0,35,2
1653298951936,COGS 18,A04,087879,Fleischer; Jason G,33,0,35,2
1653298951936,COGS 18,A05,087880,Fleischer; Jason G,28,0,35,7
1653298951936,COGS 18,A06,087881,Fleischer; Jason G,34,0,35,1
1653298951936,COGS 18,A07,087882,Fleischer; Jason G,33,0,35,2
1653298951936,COGS 18,A08,087883,Fleischer; Jason G,31,0,35,4
1653298951936,COGS 18,A09,087884,Fleischer; Jason G,33,0,35,2
1653298952469,COGS 20,A01,090761,Borgo; David Garcia,5,0,5,0
1653298952469,COGS 20,A02,090762,Borgo; David Garcia,5,0,5,0
1653298952469,COGS 20,A03,090763,Borgo; David Garcia,5,0,5,0
1653298952996,COGS 87,A00,087885,Deak; Gedeon O.,20,0,20,0
1653298952996,COGS 87,B00,087886,Fleischer; Jason G,20,0,20,0
1653298953523,COGS 100,A01,087892,Kirsh; David Joel,56,0,60,4
1653298953523,COGS 100,A02,087893,Kirsh; David Joel,54,0,60,6
1653298953523,COGS 100,A03,087894,Kirsh; David Joel,54,0,60,6
1653298953523,COGS 100,A04,087895,Kirsh; David Joel,51,0,60,9
1653298953523,COGS 100,A05,087896,Kirsh; David Joel,48,0,60,12
1653298954047,COGS 101A,A01,087898,Hoffman; Drew Ellen,48,0,60,12
1653298954047,COGS 101A,A02,087899,Hoffman; Drew Ellen,58,0,60,2
1653298954047,COGS 101A,A03,087900,Hoffman; Drew Ellen,55,0,60,5
1653298954047,COGS 101A,A04,087901,Hoffman; Drew Ellen,58,0,60,2
1653298954047,COGS 101A,A05,087902,Hoffman; Drew Ellen,59,0,60,1
1653298954047,COGS 101A,A06,087903,Hoffman; Drew Ellen,56,0,60,4
1653298954579,COGS 101B,A01,087905,Barrera; Steven James,30,0,60,30
1653298954579,COGS 101B,A02,087906,Barrera; Steven James,52,0,60,8
1653298954579,COGS 101B,A03,087907,Barrera; Steven James,54,0,60,6
1653298955108,COGS 101C,A01,094240,Cooperrider; Kensy A,70,0,75,5
1653298955108,COGS 101C,A02,094241,Cooperrider; Kensy A,73,0,75,2
1653298955631,COGS 102A,A01,087909,Scott; Taylor Jackson,58,0,60,2
1653298955631,COGS 102A,A02,087910,Scott; Taylor Jackson,51,0,60,9
1653298956155,COGS 107A,A01,087912,Rangel; Lara M,51,0,60,9
1653298956155,COGS 107A,A02,087913,Rangel; Lara M,54,0,60,6
1653298956155,COGS 107A,A03,087914,Rangel; Lara M,47,0,60,13
1653298956155,COGS 107A,A04,087915,Rangel; Lara M,53,0,60,7
1653298956155,COGS 107A,A05,087916,Rangel; Lara M,55,0,60,5
1653298956155,COGS 107A,A06,087917,Rangel; Lara M,50,0,60,10
1653298956678,COGS 108,A01,087919,Fleischer; Jason G,14,0,60,46
1653298956678,COGS 108,A02,087920,Fleischer; Jason G,25,0,60,35
1653298956678,COGS 108,A03,087921,Fleischer; Jason G,40,0,60,20
1653298956678,COGS 108,A04,087922,Fleischer; Jason G,40,0,60,20
1653298956678,COGS 108,A05,087923,Fleischer; Jason G,48,0,60,12
1653298956678,COGS 108,A06,087924,Fleischer; Jason G,55,0,60,5
1653298956678,COGS 108,A07,087925,Fleischer; Jason G,42,0,57,15
1653298957205,COGS 110,A01,087927,Deak; Gedeon O.,30,0,35,5
1653298957205,COGS 110,A02,087928,Deak; Gedeon O.,33,0,35,2
1653298957733,COGS 116,A01,094228,Greene; Deanna Jacquelyn,51,0,52,1
1653298957733,COGS 116,A02,094229,Greene; Deanna Jacquelyn,52,0,52,0
1653298957733,COGS 116,A03,094230,Greene; Deanna Jacquelyn,50,0,52,2
1653298958256,COGS 118B,A01,087930,De Sa; Virginia,24,0,35,11
1653298958256,COGS 118B,A02,087931,De Sa; Virginia,28,0,35,7
1653298958256,COGS 118B,A03,087932,De Sa; Virginia,18,0,35,17
1653298958256,COGS 118B,A04,087933,De Sa; Virginia,29,0,35,6
1653298958256,COGS 118B,A05,087934,De Sa; Virginia,27,0,35,8
1653298958256,COGS 118B,A06,087935,De Sa; Virginia,27,0,35,8
1653298958783,COGS 120,A01,087937,Xia; Haijun,38,0,50,12
1653298958783,COGS 120,A02,087938,Xia; Haijun,32,0,50,18
1653298958783,COGS 120,A03,087939,Xia; Haijun,26,0,50,24
1653298958783,COGS 120,A04,087940,Xia; Haijun,1,0,50,49
1653298959307,COGS 128,A01,087944,Scott; Taylor Jackson,11,0,56,45
1653298959830,COGS 143,A01,087947,Johnson; Christine M.,23,0,40,17
1653298960353,COGS 153,A00,087949,Davis; Joshua Daniel,46,0,75,29
1653298960878,COGS 160,A00,087950,Deak; Gedeon O.,20,0,20,0
1653298960878,COGS 160,B00,094232,Saygin; Ayse P,40,0,40,0
1653298961401,COGS 175,A01,094238,Staff,27,0,40,13
1653298961927,COGS 187A,A01,087958,Kirsh; David Joel,22,0,50,28
1653298961927,COGS 187A,A02,087959,Kirsh; David Joel,30,0,50,20
1653298961927,COGS 187A,A03,087960,Kirsh; David Joel,34,0,45,11
1653298962454,COGS 190A,A00,087961,Staff,9999,0,9999,0
1653298962978,COGS 194,A00,087962,Hill; Seth J,9999,0,9999,0
1653298963503,COMM 10,A02,090628,Schmidt; Thomas Rainer,1,0,5,4
1653298963503,COMM 10,A03,090629,Schmidt; Thomas Rainer,3,0,5,2
1653298963503,COMM 10,A04,090630,Schmidt; Thomas Rainer,4,0,5,1
1653298963503,COMM 10,A05,090631,Schmidt; Thomas Rainer,4,0,5,1
1653298963503,COMM 10,A06,090632,Schmidt; Thomas Rainer,5,0,5,0
1653298963503,COMM 10,A07,090633,Schmidt; Thomas Rainer,5,0,5,0
1653298963503,COMM 10,A08,090634,Schmidt; Thomas Rainer,5,0,5,0
1653298963503,COMM 10,A09,090635,Schmidt; Thomas Rainer,5,0,5,0
1653298963503,COMM 10,A10,090636,Schmidt; Thomas Rainer,2,0,5,3
1653298963503,COMM 10,A11,090637,Schmidt; Thomas Rainer,4,0,5,1
1653298963503,COMM 10,A12,094013,Schmidt; Thomas Rainer,2,0,5,3
1653298963503,COMM 10,A13,094014,Schmidt; Thomas Rainer,5,0,5,0
1653298963503,COMM 10,A14,094015,Schmidt; Thomas Rainer,4,0,5,1
1653298963503,COMM 10,A15,094016,Schmidt; Thomas Rainer,5,0,5,0
1653298964026,COMM 100A,A01,090639,Irani; Lilly C,5,0,5,0
1653298964026,COMM 100A,A02,090640,Irani; Lilly C,4,0,5,1
1653298964026,COMM 100A,A03,090641,Irani; Lilly C,5,0,5,0
1653298964026,COMM 100A,A04,090642,Irani; Lilly C,3,0,5,2
1653298964026,COMM 100A,A05,090643,Irani; Lilly C,3,0,5,2
1653298964026,COMM 100A,A06,090644,Irani; Lilly C,4,0,5,1
1653298964026,COMM 100A,A07,090645,Irani; Lilly C,5,0,5,0
1653298964026,COMM 100A,A08,090646,Irani; Lilly C,5,0,5,0
1653298964026,COMM 100A,A09,090647,Irani; Lilly C,5,0,5,0
1653298964026,COMM 100A,A10,090648,Irani; Lilly C,5,0,5,0
1653298964026,COMM 100A,A11,090649,Irani; Lilly C,3,0,5,2
1653298964026,COMM 100A,A12,090650,Irani; Lilly C,5,0,5,0
1653298964564,COMM 101,A01,090652,Halm; Gavin Patrick,14,0,15,1
1653298964564,COMM 101,A02,090653,Halm; Gavin Patrick,14,0,15,1
1653298964564,COMM 101,A03,090654,Halm; Gavin Patrick,12,0,15,3
1653298964564,COMM 101,A04,090655,Halm; Gavin Patrick,13,0,15,2
1653298965089,COMM 101D,A00,090656,Halm; Gavin Patrick,14,0,15,1
1653298965612,COMM 101K,A00,090657,Ahn; Patricia Jeehyun,16,0,20,4
1653298966134,COMM 101T,A00,093701,Staff,20,0,20,0
1653298966656,COMM 102C,A01,090660,Staff,4,0,6,2
1653298966656,COMM 102C,A02,090661,Staff,6,0,6,0
1653298966656,COMM 102C,A03,090662,Staff,4,0,6,2
1653298967186,COMM 103D,A00,090663,Davis; Zeinabu I.,38,0,40,2
1653298967709,COMM 106E,A00,090667,Geiger; Richard Stuart,26,0,30,4
1653298968243,COMM 106G,A00,090668,Cordoba Azcarate; Matilde,25,0,30,5
1653298968770,COMM 108G,A00,090670,Walkover; Lillian B,30,0,30,0
1653298969294,COMM 109I,A00,090671,Tanaka; Stefan A.,30,0,30,0
1653298969817,COMM 109N,A00,094205,Hallin; Daniel C,25,0,30,5
1653298970344,COMM 110G,A00,090672,Whitworth-Smith; Andrew C,45,0,50,5
1653298970876,COMM 111P,A00,090673,Conner; Thomas Hartnell,27,0,30,3
1653298971399,COMM 111T,A00,090674,Iatarola; Briana Marie,27,0,30,3
1653298971922,COMM 124A,A00,090677,Sims; Christopher O,79,0,80,1
1653298972444,COMM 131,A00,090678,Fields; Gary,22,0,25,3
1653298972970,COMM 134,A00,090679,Kidman; Shawna F,16,0,25,9
1653298973493,COMM 146,A00,090680,Staff,22,0,25,3
1653298974016,COMM 166,A00,094493,Staff,24,0,25,1
1653298974549,COMM 172,A00,094066,Staff,23,0,25,2
1653298975087,COMM 182,A00,094063,Staff,25,0,25,0
1653298975617,COMM 190,A00,090686,Kidman; Shawna F,17,0,23,6
1653298975617,COMM 190,B00,090687,Irani; Lilly C,0,0,0,0
1653298975617,COMM 190,C00,090688,Keith; Kerry,21,0,23,2
1653298975617,COMM 190,D00,090689,Zilberg; Elana,23,0,23,0
1653298976141,COMM 194,A00,091600,Hill; Seth J,9999,0,9999,0
1653298976669,COMM 196A,A00,090690,Schmidt; Thomas Rainer,0,0,0,0
1653298977207,COMM 198,001,091397,Ahn; Patricia Jeehyun,9999,0,9999,0
1653298977207,COMM 198,002,091398,Alac; Morana,9999,0,9999,0
1653298977207,COMM 198,003,091399,Anderson; Patrick W.,9999,0,9999,0
1653298977207,COMM 198,004,091400,Boateng; Boatema,9999,0,9999,0
1653298977207,COMM 198,005,091401,Booker; Angela N,9999,0,9999,0
1653298977207,COMM 198,008,091402,Cordoba Azcarate; Matilde,9999,0,9999,0
1653298977207,COMM 198,009,091403,Davis; Zeinabu I.,9999,0,9999,0
1653298977207,COMM 198,010,091404,Dewaard; Andrew Michael,9999,0,9999,0
1653298977207,COMM 198,011,091405,Dominguez Rubio; Fernando,9999,0,9999,0
1653298977207,COMM 198,012,091406,Fattal; Alexander Leor,9999,0,9999,0
1653298977207,COMM 198,013,091407,Fields; Gary,9999,0,9999,0
1653298977207,COMM 198,014,091408,Gates; Kelly,9999,0,9999,0
1653298977207,COMM 198,015,091409,Goldfarb; Brian,9999,0,9999,0
1653298977207,COMM 198,018,091410,Hill; Erin Truesdell,9999,0,9999,0
1653298977207,COMM 198,019,091411,Horwitz; Robert B,9999,0,9999,0
1653298977207,COMM 198,021,091412,Irani; Lilly C,9999,0,9999,0
1653298977207,COMM 198,022,091413,Jack; Caroline Sarah,9999,0,9999,0
1653298977207,COMM 198,023,091414,Kidman; Shawna F,9999,0,9999,0
1653298977207,COMM 198,024,091415,Martinico; Daniel J,9999,0,9999,0
1653298977207,COMM 198,026,091416,Schmidt; Thomas Rainer,9999,0,9999,0
1653298977207,COMM 198,027,091417,Serlin; David,9999,0,9999,0
1653298977207,COMM 198,028,091418,Sims; Christopher O,9999,0,9999,0
1653298977207,COMM 198,029,091419,Tanaka; Stefan A.,9999,0,9999,0
1653298977207,COMM 198,030,091420,Zilberg; Elana,9999,0,9999,0
1653298977207,COMM 198,031,091421,Walkover; Lillian B,9999,0,9999,0
1653298977207,COMM 198,032,091422,Geiger; Richard Stuart,9999,0,9999,0
1653298977732,CSE 8A,A50,089985,Soosai Raj; Adalbert Geral,7,0,10,3
1653298977732,CSE 8A,A51,089986,Soosai Raj; Adalbert Geral,1,0,10,9
1653298977732,CSE 8A,A52,089987,Soosai Raj; Adalbert Geral,5,0,10,5
1653298977732,CSE 8A,A53,089988,Soosai Raj; Adalbert Geral,9,0,10,1
1653298977732,CSE 8A,B50,089990,Soosai Raj; Adalbert Geral,0,0,10,10
1653298977732,CSE 8A,B51,089991,Soosai Raj; Adalbert Geral,5,0,10,5
1653298977732,CSE 8A,B52,089992,Soosai Raj; Adalbert Geral,5,0,10,5
1653298977732,CSE 8A,B53,089993,Soosai Raj; Adalbert Geral,9,0,10,1
1653298977732,CSE 8A,C50,089995,Lerner; Sorin,0,0,10,10
1653298977732,CSE 8A,C51,089996,Lerner; Sorin,6,0,10,4
1653298977732,CSE 8A,C52,089997,Lerner; Sorin,9,0,10,1
1653298977732,CSE 8A,C53,089998,Lerner; Sorin,8,0,10,2
1653298978256,CSE 8B,A01,090000,Ochoa; Benjamin Lawrence,94,0,100,6
1653298978783,CSE 11,A01,090002,Cao; Yingjun,39,0,49,10
1653298978783,CSE 11,B01,090004,Cao; Yingjun,45,0,49,4
1653298978783,CSE 11,C01,090006,Cao; Yingjun,35,0,49,14
1653298979311,CSE 12,A01,090008,Staff,73,0,73,0
1653298979311,CSE 12,B01,090010,Staff,67,0,73,6
1653298979311,CSE 12,C01,090012,Staff,60,0,73,13
1653298979835,CSE 15L,A01,090014,Politz; Joseph Gibbs,4,0,10,6
1653298979835,CSE 15L,A02,090015,Politz; Joseph Gibbs,7,0,10,3
1653298979835,CSE 15L,A03,090016,Politz; Joseph Gibbs,9,0,10,1
1653298979835,CSE 15L,A04,090017,Politz; Joseph Gibbs,9,0,10,1
1653298979835,CSE 15L,A05,090018,Politz; Joseph Gibbs,9,0,10,1
1653298979835,CSE 15L,B01,090020,Politz; Joseph Gibbs,8,0,10,2
1653298979835,CSE 15L,B02,090021,Politz; Joseph Gibbs,6,0,10,4
1653298979835,CSE 15L,B03,090022,Politz; Joseph Gibbs,7,0,10,3
1653298979835,CSE 15L,B04,090023,Politz; Joseph Gibbs,7,0,10,3
1653298979835,CSE 15L,B05,090024,Politz; Joseph Gibbs,7,0,10,3
1653298980360,CSE 20,A01,090026,Staff,204,0,210,6
1653298980885,CSE 21,A01,090028,Impagliazzo; Russell,0,0,0,0
1653298980885,CSE 21,A02,094488,Impagliazzo; Russell,0,0,0,0
1653298980885,CSE 21,A03,094489,Impagliazzo; Russell,0,0,0,0
1653298981411,CSE 30,A01,092463,Muller; P Keith,73,0,100,27
1653298981411,CSE 30,A02,092464,Staff,97,0,100,3
1653298981933,CSE 87,A00,094193,Moshiri; Alexander Niema,20,0,20,0
1653298982459,CSE 95,A00,090030,Minnes Kemp; Mor Mia,35,0,35,0
1653298982459,CSE 95,B00,093883,Minnes Kemp; Mor Mia,35,0,35,0
1653298982459,CSE 95,C00,093885,Minnes Kemp; Mor Mia,35,0,35,0
1653298982987,CSE 100,A01,090033,Moshiri; Alexander Niema,68,0,114,46
1653298983512,CSE 100R,A01,093837,Moshiri; Alexander Niema,334,0,350,16
1653298984043,CSE 101,A01,090035,Saha; Barna,152,0,237,85
1653298984567,CSE 103,A01,090037,Freund; Yoav,60,0,75,15
1653298985093,CSE 105,A01,090039,Lovett; Shachar,201,0,225,24
1653298985624,CSE 106,A50,090042,Paturi; Ramamohan,11,0,30,19
1653298986147,CSE 107,A01,090044,Bellare; Mihir,94,0,120,26
1653298986676,CSE 110,A50,090047,Powell; Thomas Allan,39,0,50,11
1653298986676,CSE 110,A51,090048,Powell; Thomas Allan,39,0,50,11
1653298986676,CSE 110,A52,090049,Powell; Thomas Allan,48,0,50,2
1653298986676,CSE 110,A53,090050,Powell; Thomas Allan,49,0,50,1
1653298986676,CSE 110,A54,090051,Powell; Thomas Allan,45,0,50,5
1653298986676,CSE 110,A55,090052,Powell; Thomas Allan,50,0,50,0
1653298986676,CSE 110,A56,090053,Powell; Thomas Allan,49,0,50,1
1653298986676,CSE 110,A57,090054,Powell; Thomas Allan,41,0,45,4
1653298987199,CSE 118,A00,094897,Weibel; Nadir,0,0,0,0
1653298987723,CSE 120,A01,090056,Voelker; Geoffrey M.,226,0,300,74
1653298988245,CSE 124,A01,090058,Porter; George M,123,0,189,66
1653298988769,CSE 127,A01,090060,Savage; Stefan,46,0,189,143
1653298989291,CSE 130,A01,090062,Polikarpova; Nadezhda,171,0,189,18
1653298989901,CSE 132A,A01,090064,Deutsch; Alin Bernard,46,0,189,143
1653298990425,CSE 140,A01,090068,Eldon; John,169,0,196,27
1653298990425,CSE 140,B01,090070,Orailoglu; Alex,48,0,49,1
1653298990953,CSE 140L,A01,090072,Eldon; John,161,0,192,31
1653298990953,CSE 140L,B01,090075,Orailoglu; Alex,44,0,49,5
1653298991477,CSE 142,A01,090078,Porter; Leonard Emerson,86,0,146,60
1653298991477,CSE 142,B01,090080,Porter; Leonard Emerson,107,0,146,39
1653298992002,CSE 142L,A01,090082,Swanson; Steven James,48,0,146,98
1653298992002,CSE 142L,B01,090084,Swanson; Steven James,120,0,146,26
1653298992525,CSE 151B,A01,090088,Cottrell; Garrison W,258,0,328,70
1653298993052,CSE 152A,A01,090090,Chandraker; Manmohan Krishna,153,0,189,36
1653298993583,CSE 158,A01,090092,McAuley; Julian John,84,0,197,113
1653298994105,CSE 158R,A01,090094,McAuley; Julian John,306,0,353,47
1653298994629,CSE 167,A01,090096,Chern; Albert Ren-Haur,165,0,189,24
1653298995152,CSE 170,A01,090098,Vaccaro; Kristen Marie,20,0,20,0
1653298995152,CSE 170,A02,090099,Vaccaro; Kristen Marie,14,0,20,6
1653298995152,CSE 170,A03,090100,Vaccaro; Kristen Marie,14,0,20,6
1653298995152,CSE 170,A04,090101,Vaccaro; Kristen Marie,14,0,20,6
1653298995152,CSE 170,A05,090102,Vaccaro; Kristen Marie,18,0,20,2
1653298995676,CSE 190,A00,090103,Shalev; Aaron D,40,0,40,0
1653298995676,CSE 190,B00,090104,Vaccaro; Kristen Marie,100,0,100,0
1653298995676,CSE 190,C00,090105,Pannuto; Patrick William,25,0,25,0
1653298996198,CSE 191,A00,093848,Minnes Kemp; Mor Mia,9999,0,9999,0
1653298996721,CSE 193,A01,090107,Elsherif; May Elhussein,49,0,49,0
1653298997248,CSE 194,A01,090109,Munyaka; Imani N. S.,20,0,49,29
1653298997773,CSS 1,A01,086486,Staff,22,0,24,2
1653298997773,CSS 1,A02,086487,Staff,21,0,24,3
1653298997773,CSS 1,A03,086488,Staff,20,0,24,4
1653298997773,CSS 1,A04,086489,Staff,23,0,24,1
1653298998302,DOC 1,A01,086773,Solomon; Amanda Lee Albaniel,0,0,0,0
1653298998302,DOC 1,A02,086774,Solomon; Amanda Lee Albaniel,0,0,0,0
1653298998302,DOC 1,A03,086775,Solomon; Amanda Lee Albaniel,5,0,6,1
1653298998302,DOC 1,A04,086776,Solomon; Amanda Lee Albaniel,6,0,6,0
1653298998302,DOC 1,A05,086777,Solomon; Amanda Lee Albaniel,6,0,6,0
1653298998302,DOC 1,A06,086778,Solomon; Amanda Lee Albaniel,6,0,6,0
1653298998302,DOC 1,A07,086779,Solomon; Amanda Lee Albaniel,5,0,6,1
1653298998302,DOC 1,A08,086849,Solomon; Amanda Lee Albaniel,6,0,6,0
1653298998302,DOC 1,A09,086780,Solomon; Amanda Lee Albaniel,6,0,6,0
1653298998302,DOC 1,A10,086781,Solomon; Amanda Lee Albaniel,6,0,6,0
1653298998302,DOC 1,A11,086782,Solomon; Amanda Lee Albaniel,5,0,6,1
1653298998302,DOC 1,A12,086783,Solomon; Amanda Lee Albaniel,6,0,6,0
1653298998302,DOC 1,A13,086784,Solomon; Amanda Lee Albaniel,6,0,6,0
1653298998302,DOC 1,A14,086785,Solomon; Amanda Lee Albaniel,6,0,6,0
1653298998302,DOC 1,A15,086786,Solomon; Amanda Lee Albaniel,6,0,6,0
1653298998302,DOC 1,A16,086787,Solomon; Amanda Lee Albaniel,6,0,6,0
1653298998302,DOC 1,A17,086788,Solomon; Amanda Lee Albaniel,0,0,0,0
1653298998302,DOC 1,A18,086789,Solomon; Amanda Lee Albaniel,0,0,0,0
1653298998302,DOC 1,B01,086791,Solomon; Amanda Lee Albaniel,6,0,6,0
1653298998302,DOC 1,B02,086792,Solomon; Amanda Lee Albaniel,6,0,6,0
1653298998302,DOC 1,B03,086793,Solomon; Amanda Lee Albaniel,6,0,6,0
1653298998302,DOC 1,B04,086794,Solomon; Amanda Lee Albaniel,6,0,6,0
1653298998302,DOC 1,B05,086795,Solomon; Amanda Lee Albaniel,3,0,6,3
1653298998302,DOC 1,B06,086796,Solomon; Amanda Lee Albaniel,6,0,6,0
1653298998302,DOC 1,B07,086797,Solomon; Amanda Lee Albaniel,6,0,6,0
1653298998302,DOC 1,B08,086798,Solomon; Amanda Lee Albaniel,6,0,6,0
1653298998302,DOC 1,B09,086799,Solomon; Amanda Lee Albaniel,6,0,6,0
1653298998302,DOC 1,B10,086800,Solomon; Amanda Lee Albaniel,6,0,6,0
1653298998302,DOC 1,B11,086801,Solomon; Amanda Lee Albaniel,5,0,6,1
1653298998302,DOC 1,B12,086802,Solomon; Amanda Lee Albaniel,6,0,6,0
1653298998302,DOC 1,B13,086803,Solomon; Amanda Lee Albaniel,6,0,6,0
1653298998302,DOC 1,B14,086804,Solomon; Amanda Lee Albaniel,6,0,6,0
1653298998302,DOC 1,B15,086805,Solomon; Amanda Lee Albaniel,5,0,6,1
1653298998302,DOC 1,B16,086806,Solomon; Amanda Lee Albaniel,6,0,6,0
1653298998302,DOC 1,B17,086807,Solomon; Amanda Lee Albaniel,0,0,0,0
1653298998302,DOC 1,B18,086808,Solomon; Amanda Lee Albaniel,0,0,0,0
1653298998302,DOC 1,C01,086810,Strom; Megan C.,6,0,6,0
1653298998302,DOC 1,C02,086811,Strom; Megan C.,5,0,6,1
1653298998302,DOC 1,C03,086812,Strom; Megan C.,6,0,6,0
1653298998302,DOC 1,C04,086813,Strom; Megan C.,5,0,6,1
1653298998302,DOC 1,C05,086814,Strom; Megan C.,5,0,6,1
1653298998302,DOC 1,C06,086815,Strom; Megan C.,6,0,6,0
1653298998302,DOC 1,C07,086816,Strom; Megan C.,6,0,6,0
1653298998302,DOC 1,C08,086817,Strom; Megan C.,6,0,6,0
1653298998302,DOC 1,C09,086818,Strom; Megan C.,6,0,6,0
1653298998302,DOC 1,C10,086819,Strom; Megan C.,6,0,6,0
1653298998302,DOC 1,C11,086820,Strom; Megan C.,6,0,6,0
1653298998302,DOC 1,C12,086821,Strom; Megan C.,6,0,6,0
1653298998302,DOC 1,C13,086822,Strom; Megan C.,6,0,6,0
1653298998302,DOC 1,C14,086823,Strom; Megan C.,6,0,6,0
1653298998302,DOC 1,C15,086824,Strom; Megan C.,6,0,6,0
1653298998302,DOC 1,C16,086825,Strom; Megan C.,6,0,6,0
1653298998302,DOC 1,C17,086826,Strom; Megan C.,0,0,0,0
1653298998302,DOC 1,C18,086827,Strom; Megan C.,0,0,0,0
1653298998302,DOC 1,D01,086829,Strom; Megan C.,6,0,6,0
1653298998302,DOC 1,D02,086830,Strom; Megan C.,6,0,6,0
1653298998302,DOC 1,D03,086831,Strom; Megan C.,5,0,6,1
1653298998302,DOC 1,D04,086832,Strom; Megan C.,6,0,6,0
1653298998302,DOC 1,D05,086833,Strom; Megan C.,6,0,6,0
1653298998302,DOC 1,D06,086834,Strom; Megan C.,6,0,6,0
1653298998302,DOC 1,D07,086835,Strom; Megan C.,6,0,6,0
1653298998302,DOC 1,D08,086836,Strom; Megan C.,6,0,6,0
1653298998302,DOC 1,D09,086837,Strom; Megan C.,0,0,0,0
1653298998302,DOC 1,D10,086838,Strom; Megan C.,0,0,0,0
1653298998302,DOC 1,D11,086839,Strom; Megan C.,6,0,6,0
1653298998302,DOC 1,D12,086840,Strom; Megan C.,6,0,6,0
1653298998302,DOC 1,D13,086841,Strom; Megan C.,6,0,6,0
1653298998302,DOC 1,D14,086842,Strom; Megan C.,5,0,6,1
1653298998302,DOC 1,D15,086843,Strom; Megan C.,6,0,6,0
1653298998302,DOC 1,D16,086844,Strom; Megan C.,5,0,6,1
1653298998833,DOC 100D,A00,086845,Pass; Natalye Joann,0,0,0,0
1653298998833,DOC 100D,B00,086846,Pass; Natalye Joann,21,0,25,4
1653298998833,DOC 100D,C00,086847,Pass; Natalye Joann,23,0,25,2
1653298999358,DSC 10,A01,088092,Tiefenbruck; Janine LoBue,13,0,15,2
1653298999358,DSC 10,B01,088095,Tiefenbruck; Janine LoBue,9,0,15,6
1653298999358,DSC 10,C01,088098,Rampure; Suraj,0,0,15,15
1653298999883,DSC 20,A01,088101,Langlois; Marina,148,0,150,2
1653299000414,DSC 30,A01,088105,Langlois; Marina,74,0,75,1
1653299000944,DSC 40A,A01,088107,Rampure; Suraj,97,0,100,3
1653299000944,DSC 40A,B01,088109,Rampure; Suraj,99,0,100,1
1653299001472,DSC 40B,A01,088111,Eldridge; Justin Matthew,73,0,75,2
1653299001472,DSC 40B,B01,088113,Wang; Yusu,75,0,75,0
1653299002006,DSC 80,A01,088115,Eldridge; Justin Matthew,95,0,100,5
1653299002529,DSC 95,A01,088117,Langlois; Marina,20,0,20,0
1653299003057,DSC 96,A00,088118,Liao; Soohyun Nam,50,0,50,0
1653299003579,DSC 100,A01,088120,Salimi; Babak,164,0,175,11
1653299004104,DSC 102,A01,094320,Kumar; Arun Kumar,77,0,125,48
1653299004637,DSC 180A,A01,088124,Fraenkel; Aaron Mcmillan,0,0,0,0
1653299004637,DSC 180A,A02,088125,Fraenkel; Aaron Mcmillan,0,0,0,0
1653299004637,DSC 180A,A03,088126,Fraenkel; Aaron Mcmillan,0,0,0,0
1653299004637,DSC 180A,A04,088127,Fraenkel; Aaron Mcmillan,0,0,0,0
1653299004637,DSC 180A,A05,088128,Fraenkel; Aaron Mcmillan,0,0,0,0
1653299004637,DSC 180A,A06,088129,Fraenkel; Aaron Mcmillan,0,0,0,0
1653299004637,DSC 180A,A07,088130,Fraenkel; Aaron Mcmillan,0,0,0,0
1653299004637,DSC 180A,A08,088131,Fraenkel; Aaron Mcmillan,0,0,0,0
1653299004637,DSC 180A,A09,088132,Fraenkel; Aaron Mcmillan,0,0,0,0
1653299004637,DSC 180A,A10,088133,Fraenkel; Aaron Mcmillan,0,0,0,0
1653299004637,DSC 180A,A11,088134,Fraenkel; Aaron Mcmillan,0,0,0,0
1653299004637,DSC 180A,A12,088135,Fraenkel; Aaron Mcmillan,0,0,0,0
1653299004637,DSC 180A,A13,088136,Fraenkel; Aaron Mcmillan,0,0,0,0
1653299004637,DSC 180A,A14,088137,Fraenkel; Aaron Mcmillan,0,0,0,0
1653299004637,DSC 180A,A15,088138,Fraenkel; Aaron Mcmillan,0,0,0,0
1653299004637,DSC 180A,B01,088141,Fraenkel; Aaron Mcmillan,0,0,0,0
1653299004637,DSC 180A,B02,088142,Fraenkel; Aaron Mcmillan,0,0,0,0
1653299004637,DSC 180A,B03,088143,Fraenkel; Aaron Mcmillan,0,0,0,0
1653299004637,DSC 180A,B04,088144,Fraenkel; Aaron Mcmillan,0,0,0,0
1653299004637,DSC 180A,B05,088145,Fraenkel; Aaron Mcmillan,0,0,0,0
1653299004637,DSC 180A,B06,088146,Fraenkel; Aaron Mcmillan,0,0,0,0
1653299004637,DSC 180A,B07,088147,Fraenkel; Aaron Mcmillan,0,0,0,0
1653299004637,DSC 180A,B08,088148,Fraenkel; Aaron Mcmillan,0,0,0,0
1653299004637,DSC 180A,B09,088149,Fraenkel; Aaron Mcmillan,0,0,0,0
1653299004637,DSC 180A,B10,088150,Fraenkel; Aaron Mcmillan,0,0,0,0
1653299004637,DSC 180A,B11,088151,Fraenkel; Aaron Mcmillan,0,0,0,0
1653299004637,DSC 180A,B12,088152,Fraenkel; Aaron Mcmillan,0,0,0,0
1653299004637,DSC 180A,B13,088153,Fraenkel; Aaron Mcmillan,0,0,0,0
1653299004637,DSC 180A,B14,088154,Fraenkel; Aaron Mcmillan,0,0,0,0
1653299004637,DSC 180A,B15,088155,Fraenkel; Aaron Mcmillan,0,0,0,0
1653299005162,DSC 190,A01,088158,Mishne; Gal,48,0,50,2
1653299005162,DSC 190,B01,088160,Silberman; Jack,16,0,21,5
1653299005687,DSC 197,001,088161,Eldridge; Justin Matthew,9999,0,9999,0
1653299006210,DSGN 1,A01,087888,Meyer; Michael Wayne,49,0,53,4
1653299006210,DSGN 1,A02,087889,Meyer; Michael Wayne,47,0,53,6
1653299006210,DSGN 1,A03,087890,Meyer; Michael Wayne,43,0,53,10
1653299006736,DSGN 100,A01,087983,Dow; Steven P,39,0,40,1
1653299006736,DSGN 100,A02,087984,Dow; Steven P,40,0,40,0
1653299006736,DSGN 100,A03,087985,Dow; Steven P,34,0,40,6
1653299007262,DSGN 118,A01,087987,Xia; Haijun,55,0,60,5
1653299007262,DSGN 118,A02,087988,Xia; Haijun,56,0,60,4
1653299007784,DSGN 119,A00,087989,Staff,51,0,70,19
1653299008314,ECE 5,A01,090699,Morris; Karcher William,0,0,0,0
1653299008314,ECE 5,A02,090700,Morris; Karcher William,0,0,0,0
1653299008314,ECE 5,A03,090701,Morris; Karcher William,0,0,0,0
1653299008314,ECE 5,A04,090702,Morris; Karcher William,0,0,0,0
1653299008314,ECE 5,A05,090703,Morris; Karcher William,0,0,0,0
1653299008314,ECE 5,A06,090704,Morris; Karcher William,0,0,0,0
1653299008842,ECE 15,A01,090706,Schurgers; Curt,0,0,0,0
1653299008842,ECE 15,A02,090707,Schurgers; Curt,0,0,0,0
1653299009370,ECE 16,A01,090709,Khoshabeh; Ramsin,24,0,30,6
1653299009894,ECE 17,A01,090711,Gilja; Vikash,55,0,60,5
1653299010418,ECE 25,A50,090714,Liu; Zhaowei,0,0,0,0
1653299010418,ECE 25,A51,090715,Liu; Zhaowei,0,0,0,0
1653299010418,ECE 25,A52,090716,Liu; Zhaowei,0,0,0,0
1653299010942,ECE 30,A50,094300,Mir Arabbaygi; Siavash,25,0,30,5
1653299010942,ECE 30,A51,094301,Mir Arabbaygi; Siavash,29,0,30,1
1653299010942,ECE 30,A52,094302,Mir Arabbaygi; Siavash,27,0,30,3
1653299010942,ECE 30,A53,094303,Mir Arabbaygi; Siavash,29,0,30,1
1653299010942,ECE 30,A54,094304,Mir Arabbaygi; Siavash,25,0,25,0
1653299011472,ECE 35,A50,090720,Schurgers; Curt,0,0,0,0
1653299011472,ECE 35,A51,090721,Schurgers; Curt,0,0,0,0
1653299011472,ECE 35,A52,090722,Schurgers; Curt,0,0,0,0
1653299011472,ECE 35,A53,090723,Schurgers; Curt,0,0,0,0
1653299011472,ECE 35,A54,090724,Schurgers; Curt,0,0,0,0
1653299011472,ECE 35,A55,090725,Schurgers; Curt,0,0,0,0
1653299011472,ECE 35,B50,090729,Schurgers; Curt,0,0,0,0
1653299011472,ECE 35,B51,090730,Schurgers; Curt,0,0,0,0
1653299011472,ECE 35,B52,090731,Schurgers; Curt,0,0,0,0
1653299011472,ECE 35,B53,090732,Schurgers; Curt,0,0,0,0
1653299011472,ECE 35,B54,090733,Schurgers; Curt,0,0,0,0
1653299011472,ECE 35,B55,090734,Schurgers; Curt,0,0,0,0
1653299011996,ECE 45,A01,090736,Franceschetti; Massimo,56,0,57,1
1653299011996,ECE 45,A02,090737,Franceschetti; Massimo,50,0,58,8
1653299012521,ECE 65,A50,090741,Baghdadchi; Saharnaz,13,0,15,2
1653299012521,ECE 65,A51,090742,Baghdadchi; Saharnaz,5,0,10,5
1653299012521,ECE 65,A52,090743,Baghdadchi; Saharnaz,14,0,15,1
1653299012521,ECE 65,A53,090744,Baghdadchi; Saharnaz,8,0,10,2
1653299012521,ECE 65,A54,094865,Baghdadchi; Saharnaz,14,0,15,1
1653299012521,ECE 65,A55,094866,Baghdadchi; Saharnaz,9,0,10,1
1653299012521,ECE 65,A56,094867,Baghdadchi; Saharnaz,14,0,15,1
1653299012521,ECE 65,A57,094868,Baghdadchi; Saharnaz,15,0,15,0
1653299012521,ECE 65,A58,094869,Baghdadchi; Saharnaz,10,0,10,0
1653299013058,ECE 100,A01,090746,Baghdadchi; Saharnaz,16,0,20,4
1653299013058,ECE 100,A02,090747,Baghdadchi; Saharnaz,20,0,20,0
1653299013058,ECE 100,A03,090748,Baghdadchi; Saharnaz,18,0,20,2
1653299013058,ECE 100,A04,090749,Baghdadchi; Saharnaz,20,0,20,0
1653299013058,ECE 100,A05,090750,Baghdadchi; Saharnaz,18,0,20,2
1653299013058,ECE 100,A06,090751,Baghdadchi; Saharnaz,18,0,20,2
1653299013058,ECE 100,A07,090752,Baghdadchi; Saharnaz,20,0,20,0
1653299013587,ECE 101,A01,090754,Siegel; Paul H.,62,0,75,13
1653299013587,ECE 101,A02,090755,Siegel; Paul H.,71,0,75,4
1653299014123,ECE 102,A00,090756,Hsueh; Tzu-Chien,57,0,75,18
1653299014651,ECE 103,A01,090767,Lo; Yu-Hwa,45,0,50,5
1653299015180,ECE 107,A01,090769,Lomakin; Vitaliy,72,0,75,3
1653299015706,ECE 109,A01,090771,Zeger; Kenneth A.,176,0,180,4
1653299016228,ECE 111,A01,090774,Koushanfar; Farinaz,100,0,120,20
1653299016759,ECE 121A,A50,090777,Esmaili; Gholamreza,17,0,24,7
1653299016759,ECE 121A,A51,090778,Esmaili; Gholamreza,9,0,24,15
1653299016759,ECE 121A,A52,090779,Esmaili; Gholamreza,22,0,24,2
1653299017283,ECE 128A,A00,090780,Staff,40,0,70,30
1653299017813,ECE 135A,A00,090781,Kuzum; Duygu,30,0,30,0
1653299018342,ECE 143,A00,090782,Unpingco; Jose H.,0,0,0,2
1653299018870,ECE 148,A01,090784,Staff,32,0,32,0
1653299019394,ECE 155,A01,090786,Milstein; Laurence B.,16,0,20,4
1653299019921,ECE 158A,A01,090788,Franceschetti; Massimo,56,0,65,9
1653299020449,ECE 161A,A01,090790,Rao; Bhaskar D.,103,0,115,12
1653299020972,ECE 164,A00,090791,Hall; Drew A.,87,0,115,28
1653299021501,ECE 166,A50,090796,Rebeiz; Gabriel,6,0,12,6
1653299021501,ECE 166,A51,090797,Rebeiz; Gabriel,9,0,12,3
1653299021501,ECE 166,A52,090799,Rebeiz; Gabriel,1,0,12,11
1653299021501,ECE 166,A53,090800,Rebeiz; Gabriel,6,0,12,6
1653299021501,ECE 166,A54,094335,Rebeiz; Gabriel,11,0,12,1
1653299021501,ECE 166,A55,094336,Rebeiz; Gabriel,12,0,12,0
1653299021501,ECE 166,A56,094349,Rebeiz; Gabriel,13,0,15,2
1653299021501,ECE 166,A57,094350,Rebeiz; Gabriel,14,0,15,1
1653299022025,ECE 171A,A01,090802,Atanasov; Nikolay A.,45,0,60,15
1653299022547,ECE 171B,A01,090804,Shi; Yuanyuan,44,0,50,6
1653299023072,ECE 174,A01,090806,Pal; Piya,125,0,146,21
1653299023610,ECE 182,A01,090808,Lomakin; Vitaliy,23,0,23,0
1653299024137,ECE 187,A00,090809,Liu; Zhaowei,19,0,20,1
1653299024663,ECE 196,A00,090812,Morris; Karcher William,19,0,24,5
1653299024663,ECE 196,B00,094833,Morris; Karcher William,24,0,24,0
1653299025197,ECE 197,001,090813,Sievenpiper; Daniel F.,9999,0,9999,0
1653299025730,ECON 1,A01,092535,Staff,0,0,0,0
1653299025730,ECON 1,A02,092536,Staff,0,0,0,0
1653299025730,ECON 1,A03,092537,Staff,0,0,0,0
1653299025730,ECON 1,A04,092538,Staff,0,0,0,0
1653299025730,ECON 1,A05,092539,Staff,0,0,0,0
1653299025730,ECON 1,B01,092540,Ma; Alyson Chan,42,0,45,3
1653299025730,ECON 1,B02,092541,Ma; Alyson Chan,45,0,45,0
1653299025730,ECON 1,B03,092542,Ma; Alyson Chan,45,0,45,0
1653299025730,ECON 1,B04,092543,Ma; Alyson Chan,40,0,40,0
1653299025730,ECON 1,B05,092544,Ma; Alyson Chan,40,0,40,0
1653299025730,ECON 1,C01,092545,Tocoian; Oana,0,0,0,0
1653299025730,ECON 1,C02,092546,Tocoian; Oana,0,0,0,0
1653299025730,ECON 1,C03,092547,Tocoian; Oana,0,0,0,0
1653299025730,ECON 1,C04,092548,Tocoian; Oana,0,0,0,0
1653299025730,ECON 1,D01,094253,Levkoff; Steven B.,41,0,45,4
1653299025730,ECON 1,D02,094254,Levkoff; Steven B.,44,0,45,1
1653299025730,ECON 1,D03,094255,Levkoff; Steven B.,45,0,45,0
1653299025730,ECON 1,D04,094256,Levkoff; Steven B.,36,0,40,4
1653299025730,ECON 1,D05,094257,Levkoff; Steven B.,40,0,40,0
1653299026262,ECON 2,A01,092549,Staff,0,0,0,0
1653299026262,ECON 2,A02,092550,Staff,0,0,0,0
1653299026262,ECON 2,A03,092551,Staff,0,0,0,0
1653299026790,ECON 4,A01,092554,Levkoff; Steven B.,29,0,30,1
1653299026790,ECON 4,A02,092555,Levkoff; Steven B.,27,0,30,3
1653299026790,ECON 4,A03,092556,Levkoff; Steven B.,30,0,30,0
1653299027319,ECON 100A,A01,092557,Newhouse; Herbert S,23,0,30,7
1653299027319,ECON 100A,A02,092558,Newhouse; Herbert S,28,0,30,2
1653299027319,ECON 100A,A03,092559,Newhouse; Herbert S,29,0,30,1
1653299027319,ECON 100A,A04,092560,Newhouse; Herbert S,35,0,35,0
1653299027319,ECON 100A,B01,092561,Newhouse; Herbert S,20,0,30,10
1653299027319,ECON 100A,B02,092562,Newhouse; Herbert S,28,0,30,2
1653299027319,ECON 100A,B03,092563,Newhouse; Herbert S,15,0,30,15
1653299027319,ECON 100A,B04,092564,Newhouse; Herbert S,35,0,35,0
1653299027843,ECON 100B,A01,092565,Galperti; Simone,27,0,30,3
1653299027843,ECON 100B,A02,092566,Galperti; Simone,18,0,20,2
1653299027843,ECON 100B,A03,094496,Staff,27,0,30,3
1653299027843,ECON 100B,A04,094497,Staff,16,0,20,4
1653299027843,ECON 100B,B01,092567,Galperti; Simone,16,0,25,9
1653299028366,ECON 100C,A01,092569,Du; Songzi,62,0,75,13
1653299028366,ECON 100C,B01,092570,Du; Songzi,70,0,75,5
1653299028366,ECON 100C,B02,094258,Du; Songzi,75,0,75,0
1653299028890,ECON 100CH,A00,088284,Andreoni; James,20,0,20,0
1653299029415,ECON 109,A01,092572,Watson; Joel Christopher,68,0,75,7
1653299029415,ECON 109,B01,092573,Watson; Joel Christopher,68,0,75,7
1653299029946,ECON 110A,A01,092574,Alon; Titan Michael,12,0,25,13
1653299029946,ECON 110A,A02,092575,Alon; Titan Michael,24,0,25,1
1653299029946,ECON 110A,B01,092576,Alon; Titan Michael,24,0,25,1
1653299029946,ECON 110A,B02,092577,Alon; Titan Michael,25,0,25,0
1653299030475,ECON 110B,A01,092578,Trottner; Fabian Gunter We,16,0,25,9
1653299030475,ECON 110B,A02,094054,Trottner; Fabian Gunter We,23,0,25,2
1653299030475,ECON 110B,B01,092579,Trottner; Fabian Gunter We,7,0,25,18
1653299030475,ECON 110B,B02,094055,Trottner; Fabian Gunter We,24,0,25,1
1653299031002,ECON 116,A00,088291,Lowes; Sara Rachel,58,0,70,12
1653299031528,ECON 120A,A01,092580,Elliott; Graham,18,0,25,7
1653299031528,ECON 120A,A02,092581,Elliott; Graham,22,0,25,3
1653299031528,ECON 120A,B01,092582,Elliott; Graham,18,0,25,7
1653299031528,ECON 120A,B02,092583,Elliott; Graham,20,0,25,5
1653299031528,ECON 120A,C01,092584,Tocoian; Oana,27,0,30,3
1653299031528,ECON 120A,C02,092585,Tocoian; Oana,28,0,30,2
1653299031528,ECON 120A,C03,092586,Tocoian; Oana,40,0,40,0
1653299032052,ECON 120B,A01,092587,Candido; Maria Teresa,58,0,70,12
1653299032052,ECON 120B,A02,092588,Candido; Maria Teresa,51,0,60,9
1653299032052,ECON 120B,A03,092589,Candido; Maria Teresa,56,0,60,4
1653299032581,ECON 120C,A01,092590,Candido; Maria Teresa,48,0,60,12
1653299032581,ECON 120C,A02,092591,Candido; Maria Teresa,59,0,60,1
1653299032581,ECON 120C,A03,094310,Candido; Maria Teresa,73,0,75,2
1653299033106,ECON 121,A00,088298,Vogl; Tom Saul,36,0,50,14
1653299033629,ECON 130,A00,088299,Staff,59,0,75,16
1653299034157,ECON 131,A00,088300,Jacobsen; Mark,129,0,150,21
1653299034157,ECON 131,B00,088301,Jacobsen; Mark,15,0,30,15
1653299034684,ECON 152,A00,088302,Fadlon; Yizhak,34,0,50,16
1653299034684,ECON 152,B00,088303,Fadlon; Yizhak,49,0,50,1
1653299035207,ECON 168,A00,088304,Staff,54,0,60,6
1653299035730,ECON 191B,A00,088312,Galperti; Simone,20,0,20,0
1653299036262,EDS 25,A01,087581,Staff,9,0,10,1
1653299036262,EDS 25,A02,087582,Staff,10,0,10,0
1653299036262,EDS 25,A03,087583,Staff,7,0,10,3
1653299036262,EDS 25,A04,087584,Staff,10,0,10,0
1653299036785,EDS 31,A00,087585,Bussey; Thomas J,9,0,10,1
1653299037315,EDS 110R,A01,087597,Cohen; Shana R,43,0,50,7
1653299037315,EDS 110R,B01,093579,Cohen; Shana R,10,0,10,0
1653299037839,EDS 113,A00,087598,Staff,45,0,50,5
1653299038366,EDS 114,A01,088091,Eguchi; Emi,17,0,20,3
1653299038366,EDS 114,A02,087600,Eguchi; Emi,19,0,20,1
1653299038898,EDS 117,A01,087603,Chung; Luz Marina,25,0,35,10
1653299038898,EDS 117,A02,087604,Chung; Luz Marina,34,0,35,1
1653299039425,EDS 124AR,A01,087606,Simon; Elizabeth A,0,0,19,19
1653299039425,EDS 124AR,A02,087607,Simon; Elizabeth A,13,0,19,6
1653299039425,EDS 124AR,A03,087608,Simon; Elizabeth A,15,0,19,4
1653299039425,EDS 124AR,A04,087609,Simon; Elizabeth A,4,0,19,15
1653299039425,EDS 124AR,B01,087611,Simon; Elizabeth A,14,0,19,5
1653299039425,EDS 124AR,B02,087612,Simon; Elizabeth A,18,0,19,1
1653299039425,EDS 124AR,B03,087613,Simon; Elizabeth A,18,0,19,1
1653299039425,EDS 124AR,B04,087614,Simon; Elizabeth A,19,0,19,0
1653299039425,EDS 124AR,C01,094210,Simon; Elizabeth A,6,0,6,0
1653299039425,EDS 124AR,C02,094211,Simon; Elizabeth A,6,0,6,0
1653299039425,EDS 124AR,C03,094212,Simon; Elizabeth A,6,0,6,0
1653299039425,EDS 124AR,C04,094213,Simon; Elizabeth A,6,0,6,0
1653299039425,EDS 124AR,D01,094215,Simon; Elizabeth A,6,0,6,0
1653299039425,EDS 124AR,D02,094216,Simon; Elizabeth A,6,0,6,0
1653299039425,EDS 124AR,D03,094217,Simon; Elizabeth A,6,0,6,0
1653299039425,EDS 124AR,D04,094218,Simon; Elizabeth A,6,0,6,0
1653299039949,EDS 124BR,A00,087615,Eguchi; Emi,65,0,75,10
1653299039949,EDS 124BR,B00,093580,Eguchi; Emi,25,0,25,0
1653299040476,EDS 125,A00,087616,Jones; Gabrielle Anastasia,51,0,60,9
1653299041000,EDS 129A,A01,087618,Heinzman; Erica M.,43,0,50,7
1653299041530,EDS 130,A01,087620,Holtzman; Caren Lynn,17,0,20,3
1653299041530,EDS 130,A02,087621,Holtzman; Caren Lynn,20,0,20,0
1653299041530,EDS 130,A03,087622,Holtzman; Caren Lynn,20,0,20,0
1653299042053,EDS 131,A01,087624,Wishard Guerra; Alison G.,37,0,40,3
1653299042578,EDS 133,A01,087627,Bintliff; Amy S.V.,17,0,20,3
1653299042578,EDS 133,A02,087628,Bintliff; Amy S.V.,19,0,20,1
1653299043174,EDS 139,A00,087629,Holtzman; Caren Lynn,55,0,60,5
1653299043174,EDS 139,B00,087630,Heinzman; Erica M.,51,0,60,9
1653299043174,EDS 139,C00,087631,Bintliff; Amy S.V.,57,0,60,3
1653299043174,EDS 139,D00,087632,Wishard Guerra; Alison G.,58,0,60,2
1653299043174,EDS 139,E00,087633,Holtzman; Caren Lynn,30,0,30,0
1653299043174,EDS 139,F00,094886,Staff,25,0,25,0
1653299043701,EDS 146,A01,094220,Staff,25,0,25,0
1653299044224,EDS 164R,A01,087644,Wishard Guerra; Alison G.,37,0,40,3
1653299044224,EDS 164R,B01,093582,Wishard Guerra; Alison G.,20,0,20,0
1653299044758,EDS 190,A00,087645,Bresser; Bernard George,20,0,20,0
1653299044758,EDS 190,B00,087646,Pappas; Elizabeth,20,0,20,0
1653299044758,EDS 190,C00,087647,Scharton; Susan Michelle,20,0,20,0
1653299044758,EDS 190,E00,087648,Staff,20,0,20,0
1653299045281,ENG 10,A00,086288,Staff,30,0,30,0
1653299045281,ENG 10,B00,086289,Staff,30,0,30,0
1653299045806,ENG 15,A01,086291,Staff,35,0,35,0
1653299046349,ENG 20,A00,086292,Evdokimenko; Ekaterina,33,0,35,2
1653299046872,ENG 100D,A00,086293,Ngo; Anh-Thu T.,45,0,50,5
1653299046872,ENG 100D,B00,094309,Staff,46,0,50,4
1653299047409,ENG 100L,A00,086295,Kleissl; Jan,6,0,6,0
1653299047409,ENG 100L,B00,086296,Bratton; Maryann,8,0,8,0
1653299047409,ENG 100L,C00,086297,Nguyen; Truong Quang,10,0,10,0
1653299047409,ENG 100L,E00,086299,de Oliveira; Mauricio,8,0,8,0
1653299047409,ENG 100L,F00,086300,Goldberg; Charles G.,6,0,6,0
1653299047409,ENG 100L,G00,086301,Bratton; Maryann,6,0,6,0
1653299047409,ENG 100L,H00,086302,Staff,6,0,6,0
1653299047933,ENVR 30,A01,093565,Staff,29,0,30,1
1653299047933,ENVR 30,A02,093567,Staff,28,0,30,2
1653299047933,ENVR 30,A03,093568,Staff,25,0,30,5
1653299047933,ENVR 30,A04,093569,Staff,30,0,30,0
1653299047933,ENVR 30,A05,093570,Staff,29,0,30,1
1653299047933,ENVR 30,A06,093566,Staff,29,0,30,1
1653299048456,ENVR 102,A00,093571,Daly; Heather Marie,25,0,30,5
1653299049509,ERC 1,A01,092328,Herbst; Matthew,20,0,20,0
1653299049509,ERC 1,A02,092330,Herbst; Matthew,20,0,20,0
1653299049509,ERC 1,A03,092331,Herbst; Matthew,20,0,20,0
1653299049509,ERC 1,A04,092332,Herbst; Matthew,20,0,20,0
1653299049509,ERC 1,A05,092333,Herbst; Matthew,20,0,20,0
1653299049509,ERC 1,A06,092334,Herbst; Matthew,20,0,20,0
1653299050033,ERC 2,A01,092336,Rahimi; Babak,20,0,20,0
1653299050033,ERC 2,A02,092337,Rahimi; Babak,20,0,20,0
1653299050033,ERC 2,A03,092338,Rahimi; Babak,20,0,20,0
1653299050033,ERC 2,A04,092339,Rahimi; Babak,20,0,20,0
1653299050564,ERC 20,A00,092340,Evans; Ivan T,30,0,30,0
1653299050564,ERC 20,B00,092341,Evans; Ivan T,30,0,30,0
1653299051087,ERC 87,A00,093850,Herbst; Matthew,20,0,20,0
1653299051610,ERC 92,A00,092342,Staff,1,0,1,0
1653299051610,ERC 92,B00,092343,Staff,1,0,1,0
1653299051610,ERC 92,C00,092344,Staff,1,0,1,0
1653299051610,ERC 92,D00,092345,Staff,1,0,1,0
1653299051610,ERC 92,E00,092346,Staff,1,0,1,0
1653299051610,ERC 92,F00,092347,Staff,1,0,1,0
1653299052134,ESYS 90,A00,086303,Teranes; Jane,12,0,12,0
1653299052659,ESYS 101,A01,086305,Taylor; Jennifer Rebecca & Diaz; Julia Michelle,25,0,27,2
1653299052659,ESYS 101,A02,086306,Taylor; Jennifer Rebecca & Diaz; Julia Michelle,15,0,27,12
1653299052659,ESYS 101,A03,086307,Taylor; Jennifer Rebecca & Diaz; Julia Michelle,21,0,27,6
1653299052659,ESYS 101,A04,086308,Taylor; Jennifer Rebecca & Diaz; Julia Michelle,27,0,27,0
1653299053182,ESYS 187A,A01,086310,Teranes; Jane,38,0,40,2
1653299053182,ESYS 187A,B01,086312,Teranes; Jane,30,0,40,10
1653299053708,ETHN 1,A01,086314,Frank; Ross H.,15,0,15,0
1653299053708,ETHN 1,A02,086315,Frank; Ross H.,15,0,15,0
1653299053708,ETHN 1,A03,086316,Frank; Ross H.,14,0,15,1
1653299053708,ETHN 1,A04,086317,Frank; Ross H.,15,0,15,0
1653299053708,ETHN 1,A05,086318,Frank; Ross H.,15,0,15,0
1653299053708,ETHN 1,A06,086319,Frank; Ross H.,13,0,15,2
1653299053708,ETHN 1,A07,086320,Frank; Ross H.,15,0,15,0
1653299053708,ETHN 1,A08,086321,Frank; Ross H.,14,0,15,1
1653299053708,ETHN 1,A09,086322,Frank; Ross H.,15,0,15,0
1653299053708,ETHN 1,A10,086323,Frank; Ross H.,15,0,15,0
1653299053708,ETHN 1,A11,086324,Frank; Ross H.,15,0,15,0
1653299053708,ETHN 1,A12,086325,Frank; Ross H.,15,0,15,0
1653299053708,ETHN 1,A13,086326,Frank; Ross H.,15,0,15,0
1653299053708,ETHN 1,A14,086327,Frank; Ross H.,15,0,15,0
1653299053708,ETHN 1,A15,086328,Frank; Ross H.,15,0,15,0
1653299053708,ETHN 1,A16,086329,Frank; Ross H.,15,0,15,0
1653299054231,ETHN 100A,A00,086330,Patel; Shaista,41,0,48,7
1653299054759,ETHN 103,A00,086331,Perreira; Christopher Michael,63,0,70,7
1653299055286,ETHN 104,A00,086332,Staff,0,0,0,0
1653299055815,ETHN 106,A00,086333,Staff,0,0,0,0
1653299056341,ETHN 121,A00,086341,Sasaki; Christen T,20,0,28,8
1653299056867,ETHN 139,A00,086342,Ruiz; Ariana,16,0,20,4
1653299057395,ETHN 144M,A00,086343,Jolivette; Andrew J,66,0,70,4
1653299057921,ETHN 159,A00,088427,Graham; Jessica Lynn,0,0,0,0
1653299058446,ETHN 163E,A00,086344,Patel; Shaista,37,0,40,3
1653299058969,ETHN 178R,A00,090798,Borgo; David Garcia,15,0,20,5
1653299059502,ETHN 187,A00,086345,Perez; Roy,14,0,16,2
1653299060026,EXPR 100,A00,085686,Staff,9999,0,9999,0
1653299060558,FMPH 40,A00,086370,Emory; Kristen,70,0,75,5
1653299060558,FMPH 40,B00,086371,Romero; Sally Ann Dominick,71,0,75,4
1653299061080,FMPH 101,A00,086372,Brouwer; Kimberly,43,0,55,12
1653299061606,FMPH 102,A50,094498,Rana; Brinda Kanti,42,0,55,13
1653299062130,FMPH 110,A00,086374,Zoumas-Morse; Christine E.,61,0,65,4
1653299062654,FMPH 120,A00,086375,Nguyen-Grozavu; France T.,45,0,65,20
1653299062654,FMPH 120,B00,086376,Nguyen-Grozavu; France T.,60,0,65,5
1653299063179,FMPH 130,A00,086377,Staff,48,0,65,17
1653299064227,FMPH 161,A00,086379,Zoumas-Morse; Christine E.,58,0,65,7
1653299064756,FMPH 191,A00,086380,Harrell; Maralee Mae,58,0,60,2
1653299065281,FMPH 196A,A00,086381,Binkin; Nancy Jeanne,0,0,0,0
1653299065808,GLBH 20,A00,086407,Walkover; Lillian B,85,0,90,5
1653299066336,GLBH 100,A00,086408,Staff,55,0,56,1
1653299066336,GLBH 100,B00,086409,Wu; Hua,52,0,56,4
1653299066336,GLBH 100,D00,086411,Staff,38,0,40,2
1653299066860,GLBH 103,A00,086412,Hannah; Seth Donal,48,0,50,2
1653299067382,GLBH 105,A00,086413,Olivas Hernandez; Olga Lid,36,0,38,2
1653299067908,GLBH 106,A00,086414,Kayser; Georgia Lyn,40,0,40,0
1653299068432,GLBH 111,A01,094330,Burgos; Jose L.,0,0,0,0
1653299068432,GLBH 111,B01,094332,Burgos; Jose L.,0,0,0,0
1653299068956,GLBH 148,A00,086415,Staff,69,0,73,4
1653299069480,GLBH 181,A00,086417,Burgos; Jose L.,144,0,146,2
1653299070004,GSS 20,A00,094269,Staff,73,0,75,2
1653299070534,HDS 1,A01,086423,Staff,24,0,25,1
1653299070534,HDS 1,A02,086424,Staff,24,0,25,1
1653299070534,HDS 1,A03,086425,Staff,23,0,25,2
1653299070534,HDS 1,A04,086426,Staff,25,0,25,0
1653299070534,HDS 1,A05,086427,Staff,24,0,25,1
1653299070534,HDS 1,A06,086428,Staff,25,0,25,0
1653299070534,HDS 1,A07,086429,Staff,30,0,30,0
1653299071062,HDS 60,A01,086431,Staff,23,0,25,2
1653299071596,HDS 111,A00,086432,Staff,73,0,80,7
1653299072120,HDS 121,A01,086434,Deak; Gedeon O.,11,0,15,4
1653299072120,HDS 121,A02,086435,Deak; Gedeon O.,13,0,15,2
1653299072645,HDS 150,A00,086436,Staff,25,0,25,0
1653299072645,HDS 150,B00,086437,Staff,25,0,25,0
1653299073176,HDS 173,A00,086439,Staff,27,0,30,3
1653299073699,HDS 181,A01,086441,Staff,30,0,30,0
1653299074222,HDS 191,A01,086443,Staff,25,0,25,0
1653299074750,HIEA 129,A00,088057,Schneewind; Sarah,0,0,0,0
1653299075278,HIEA 137,A00,088058,Lu; Weijing,53,0,55,2
1653299075801,HIEA 144,A00,088059,Henry; Todd A.,44,0,45,1
1653299076325,HIEA 171,A00,088060,Lu; Weijing,15,0,15,0
1653299076853,HIEU 102,A00,088061,Watts; Edward J.,0,0,0,0
1653299077384,HIEU 107,A00,088062,Caciola; Nancy A,0,0,0,0
1653299077908,HIEU 108,A00,088063,Balberg; Mira,53,0,60,7
1653299078431,HIEU 128,A00,088064,Neuheiser; Joerg,0,0,0,0
1653299078954,HIEU 144,A00,094327,Staff,48,0,50,2
1653299079477,HIEU 149,A00,088065,Devereux; Andrew W,38,0,45,7
1653299080004,HIEU 154,A00,088066,Biess; Frank Peter,58,0,65,7
1653299080529,HIGL 114,A00,088067,Edington; Claire Ellen,53,0,55,2
1653299081057,HILA 119,A00,088068,Vitz; Matthew,49,0,51,2
1653299081583,HILA 122,A00,088069,Widener; Daniel,61,0,65,4
1653299082112,HILD 2A,A01,088024,Hanna; Mark G.,28,0,28,0
1653299082112,HILD 2A,A02,088025,Hanna; Mark G.,25,0,25,0
1653299082112,HILD 2A,A03,088026,Hanna; Mark G.,27,0,28,1
1653299082112,HILD 2A,A04,088027,Hanna; Mark G.,28,0,28,0
1653299082112,HILD 2A,A05,088028,Hanna; Mark G.,28,0,28,0
1653299082112,HILD 2A,A06,088029,Hanna; Mark G.,28,0,28,0
1653299082643,HILD 7A,A01,088031,Graham; Jessica Lynn,28,0,28,0
1653299082643,HILD 7A,A02,088032,Graham; Jessica Lynn,27,0,28,1
1653299082643,HILD 7A,A03,088033,Graham; Jessica Lynn,27,0,28,1
1653299082643,HILD 7A,A04,088034,Graham; Jessica Lynn,26,0,28,2
1653299082643,HILD 7A,A05,088035,Graham; Jessica Lynn,26,0,28,2
1653299082643,HILD 7A,A06,088037,Graham; Jessica Lynn,22,0,28,6
1653299082643,HILD 7A,A07,088038,Graham; Jessica Lynn,28,0,28,0
1653299082643,HILD 7A,A08,088039,Graham; Jessica Lynn,28,0,28,0
1653299082643,HILD 7A,A09,088040,Graham; Jessica Lynn,27,0,28,1
1653299082643,HILD 7A,A10,088041,Graham; Jessica Lynn,28,0,28,0
1653299082643,HILD 7A,A11,088042,Graham; Jessica Lynn,28,0,28,0
1653299082643,HILD 7A,A12,088043,Graham; Jessica Lynn,28,0,28,0
1653299083169,HILD 10,A01,088045,Muscolino; Micah S,27,0,28,1
1653299083169,HILD 10,A02,088046,Muscolino; Micah S,27,0,28,1
1653299083169,HILD 10,A03,088047,Muscolino; Micah S,28,0,28,0
1653299083169,HILD 10,A04,088048,Muscolino; Micah S,27,0,28,1
1653299083169,HILD 10,A05,088049,Muscolino; Micah S,28,0,28,0
1653299083169,HILD 10,A06,088050,Muscolino; Micah S,27,0,28,1
1653299083692,HILD 30,A01,088052,Edington; Claire Ellen,24,0,28,4
1653299083692,HILD 30,A02,088053,Edington; Claire Ellen,28,0,28,0
1653299084217,HILD 41,A01,088055,Devereux; Andrew W,28,0,28,0
1653299084217,HILD 41,A02,088056,Devereux; Andrew W,28,0,28,0
1653299084740,HINE 116,A00,088070,Kayali; Hasan,47,0,50,3
1653299085267,HINE 144,A00,088071,Provence; Michael,40,0,45,5
1653299085790,HISC 106,A00,088072,Pineda De Avila; Nydia,47,0,50,3
1653299086326,HISC 115,A00,088073,Gere; Catherina M.,103,0,110,7
1653299086853,HITO 87,A00,094352,Patterson; Patrick H.,20,0,20,0
1653299086853,HITO 87,C00,094354,Patterson; Patrick H.,20,0,20,0
1653299086853,HITO 87,B00,094353,Hanna; Mark G.,20,0,20,0
1653299087379,HITO 100,A00,088074,Hanna; Mark G.,8,0,12,4
1653299087905,HITO 193,A00,091603,Hill; Seth J,9999,0,9999,0
1653299088429,HITO 196,A00,088075,Hendrickson; Gerald M.,20,0,20,0
1653299088958,HIUS 108B,A00,088076,Klann; Mary Cameron,48,0,51,3
1653299089484,HIUS 112,A00,088077,Plant; Rebecca Jo,144,0,148,4
1653299090008,HIUS 152A,A00,088078,Vandevelde; Kenneth Joseph,40,0,45,5
1653299090532,HIUS 155,A00,088079,Alvarez; Luis A,37,0,45,8
1653299091058,HIUS 183,A00,088080,Graham; Jessica Lynn,19,0,20,1
1653299091584,HUM 3,A01,087224,West; Geoffrey Scott,27,0,28,1
1653299091584,HUM 3,A02,087225,West; Geoffrey Scott,28,0,28,0
1653299091584,HUM 3,A03,087226,West; Geoffrey Scott,26,0,28,2
1653299091584,HUM 3,A04,087227,West; Geoffrey Scott,27,0,28,1
1653299091584,HUM 3,A05,087228,West; Geoffrey Scott,27,0,28,1
1653299091584,HUM 3,A06,087229,West; Geoffrey Scott,24,0,28,4
1653299091584,HUM 3,A07,087230,West; Geoffrey Scott,27,0,28,1
1653299091584,HUM 3,A08,087231,West; Geoffrey Scott,28,0,28,0
1653299091584,HUM 3,B01,087233,Staff,28,0,28,0
1653299091584,HUM 3,B02,087234,Staff,28,0,28,0
1653299091584,HUM 3,B03,087235,Staff,28,0,28,0
1653299091584,HUM 3,B04,087236,Staff,28,0,28,0
1653299091584,HUM 3,B05,087237,Staff,28,0,28,0
1653299091584,HUM 3,B06,087238,Staff,28,0,28,0
1653299091584,HUM 3,B07,087239,Staff,0,0,0,0
1653299091584,HUM 3,B08,087240,Staff,0,0,0,0
1653299091584,HUM 3,B09,087241,Staff,30,0,30,0
1653299091584,HUM 3,B10,087242,Staff,28,0,30,2
1653299091584,HUM 3,C01,087244,Patterson; Patrick H.,0,0,0,0
1653299091584,HUM 3,C02,087245,Patterson; Patrick H.,0,0,0,0
1653299091584,HUM 3,C03,087246,Patterson; Patrick H.,23,0,28,5
1653299091584,HUM 3,C04,087247,Patterson; Patrick H.,28,0,28,0
1653299091584,HUM 3,C05,087248,Patterson; Patrick H.,27,0,28,1
1653299091584,HUM 3,C06,087249,Patterson; Patrick H.,25,0,28,3
1653299091584,HUM 3,C07,087250,Patterson; Patrick H.,27,0,28,1
1653299091584,HUM 3,C08,087251,Patterson; Patrick H.,28,0,28,0
1653299091584,HUM 3,C09,087252,Patterson; Patrick H.,28,0,28,0
1653299091584,HUM 3,C10,087253,Patterson; Patrick H.,27,0,28,1
1653299091584,HUM 3,D01,087255,Lyon; Antony J.,24,0,28,4
1653299091584,HUM 3,D02,087256,Lyon; Antony J.,28,0,28,0
1653299091584,HUM 3,D03,087257,Lyon; Antony J.,0,0,0,0
1653299091584,HUM 3,D04,087258,Lyon; Antony J.,0,0,0,0
1653299091584,HUM 3,D05,087259,Lyon; Antony J.,27,0,28,1
1653299091584,HUM 3,D06,087260,Lyon; Antony J.,28,0,28,0
1653299091584,HUM 3,D07,087261,Lyon; Antony J.,21,0,28,7
1653299091584,HUM 3,D08,087262,Lyon; Antony J.,20,0,28,8
1653299091584,HUM 3,D09,087263,Lyon; Antony J.,28,0,28,0
1653299091584,HUM 3,D10,087264,Lyon; Antony J.,27,0,28,1
1653299091584,HUM 3,D11,087265,Lyon; Antony J.,30,0,30,0
1653299091584,HUM 3,D12,087266,Lyon; Antony J.,30,0,30,0
1653299091584,HUM 3,D13,087267,Lyon; Antony J.,26,0,28,2
1653299091584,HUM 3,D14,087268,Lyon; Antony J.,25,0,28,3
1653299092109,INTL 101,A01,088176,Day; Joel Keith,19,0,20,1
1653299092109,INTL 101,A02,088177,Day; Joel Keith,20,0,20,0
1653299092109,INTL 101,A03,088178,Day; Joel Keith,17,0,20,3
1653299092109,INTL 101,A04,088179,Day; Joel Keith,19,0,20,1
1653299092109,INTL 101,A05,088180,Day; Joel Keith,19,0,20,1
1653299092109,INTL 101,A06,088181,Day; Joel Keith,18,0,20,2
1653299092639,INTL 102,A01,088183,Walter; Barbara Florence,19,0,20,1
1653299092639,INTL 102,A02,088184,Walter; Barbara Florence,19,0,20,1
1653299092639,INTL 102,A03,088185,Walter; Barbara Florence,18,0,20,2
1653299092639,INTL 102,A04,088186,Walter; Barbara Florence,16,0,20,4
1653299092639,INTL 102,A05,088187,Walter; Barbara Florence,19,0,20,1
1653299092639,INTL 102,A06,088188,Walter; Barbara Florence,19,0,20,1
1653299093166,INTL 190,A00,088189,Auerbach; Bradford C,0,0,0,0
1653299093166,INTL 190,B00,088190,Auerbach; Bradford C,0,0,0,0
1653299093166,INTL 190,C00,088191,Fortier; Jana,0,0,0,0
1653299093166,INTL 190,D00,088192,Kshatriya; Krista C,0,0,0,0
1653299093166,INTL 190,E00,088193,Nadkarni; Vidya,0,0,0,0
1653299093166,INTL 190,F00,088194,Scott; Jeffrey F,0,0,0,0
1653299093166,INTL 190,G00,088195,Segui; Alan S,0,0,0,0
1653299093166,INTL 190,H00,088196,Segui; Alan S,0,0,0,0
1653299093694,INTL 190H,A00,088197,Gibson; Clark C,0,0,0,0
1653299094229,JAPN 10A,A01,086851,Maruyama; Rie,15,0,15,0
1653299094229,JAPN 10A,A02,086852,Maruyama; Rie,15,0,15,0
1653299094229,JAPN 10A,B01,086854,Staff,13,0,13,0
1653299094229,JAPN 10A,B02,086855,Staff,13,0,13,0
1653299094229,JAPN 10A,C01,086857,McKee; Mayumi Mochizuki,13,0,13,0
1653299094229,JAPN 10A,C02,086858,McKee; Mayumi Mochizuki,11,0,13,2
1653299094229,JAPN 10A,D01,086860,Sato; Kyoko,13,0,13,0
1653299094229,JAPN 10A,D02,086861,Sato; Kyoko,13,0,13,0
1653299094229,JAPN 10A,E01,086863,Kamioka; Sachiko,12,0,13,1
1653299094229,JAPN 10A,E02,086864,Kamioka; Sachiko,12,0,13,1
1653299094229,JAPN 10A,F01,086866,Sato; Kyoko,13,0,13,0
1653299094229,JAPN 10A,F02,086867,Sato; Kyoko,13,0,13,0
1653299094229,JAPN 10A,G01,086869,Maruyama; Rie,8,0,13,5
1653299094229,JAPN 10A,G02,086870,Maruyama; Rie,13,0,13,0
1653299094229,JAPN 10A,H01,086872,Kamioka; Sachiko,12,0,13,1
1653299094229,JAPN 10A,H02,086873,Kamioka; Sachiko,11,0,13,2
1653299094229,JAPN 10A,I01,086875,Staff,12,0,13,1
1653299094229,JAPN 10A,I02,086876,Staff,13,0,13,0
1653299094229,JAPN 10A,J01,086878,McKee; Mayumi Mochizuki,12,0,13,1
1653299094229,JAPN 10A,J02,086879,McKee; Mayumi Mochizuki,13,0,13,0
1653299094229,JAPN 10A,K01,086881,Inada; Minori,13,0,13,0
1653299094229,JAPN 10A,K02,086882,Inada; Minori,12,0,13,1
1653299094229,JAPN 10A,L01,086884,Tipton; Yuko,13,0,13,0
1653299094229,JAPN 10A,L02,086885,Tipton; Yuko,13,0,13,0
1653299094229,JAPN 10A,M01,086887,Inada; Minori,12,0,13,1
1653299094229,JAPN 10A,M02,086888,Inada; Minori,13,0,13,0
1653299094229,JAPN 10A,N01,086890,McKee; Mayumi Mochizuki,13,0,13,0
1653299094229,JAPN 10A,N02,086891,McKee; Mayumi Mochizuki,11,0,13,2
1653299094229,JAPN 10A,O01,086893,Staff,13,0,13,0
1653299094229,JAPN 10A,O02,086894,Staff,12,0,13,1
1653299094229,JAPN 10A,P01,086896,Tipton; Yuko,15,0,15,0
1653299094229,JAPN 10A,P02,086897,Tipton; Yuko,15,0,15,0
1653299094768,JAPN 20A,A01,086899,Simpson; Junko Tokuda,11,0,13,2
1653299094768,JAPN 20A,A02,086900,Simpson; Junko Tokuda,12,0,13,1
1653299094768,JAPN 20A,B01,086902,Takeda; Izumi,11,0,13,2
1653299094768,JAPN 20A,B02,086903,Takeda; Izumi,12,0,13,1
1653299094768,JAPN 20A,C01,086905,Ross; Kayoko F,12,0,13,1
1653299094768,JAPN 20A,C02,086906,Ross; Kayoko F,12,0,13,1
1653299094768,JAPN 20A,D01,086908,Takeda; Izumi,10,0,13,3
1653299094768,JAPN 20A,D02,086909,Takeda; Izumi,13,0,13,0
1653299094768,JAPN 20A,E01,086911,Maruyama; Rie,11,0,13,2
1653299094768,JAPN 20A,E02,086912,Maruyama; Rie,11,0,13,2
1653299094768,JAPN 20A,F01,086914,Kamioka; Sachiko,7,0,13,6
1653299094768,JAPN 20A,F02,086915,Kamioka; Sachiko,9,0,13,4
1653299094768,JAPN 20A,G01,086917,Ross; Kayoko F,13,0,13,0
1653299094768,JAPN 20A,G02,086918,Ross; Kayoko F,12,0,13,1
1653299095296,JAPN 130A,A01,086920,Simpson; Junko Tokuda,6,0,10,4
1653299095296,JAPN 130A,A02,086921,Simpson; Junko Tokuda,5,0,10,5
1653299095296,JAPN 130A,B01,086923,Ross; Kayoko F,9,0,10,1
1653299095296,JAPN 130A,B02,086924,Ross; Kayoko F,9,0,10,1
1653299095824,JAPN 135A,A00,086925,Inada; Minori,14,0,15,1
1653299095824,JAPN 135A,B00,086926,Takeda; Izumi,15,0,15,0
1653299096443,JAPN 140A,A00,086927,Sato; Kyoko,19,0,20,1
1653299096966,JWSP 1,A01,086445,Shuster; Alana,15,0,15,0
1653299096966,JWSP 1,A02,086446,Shuster; Alana,15,0,15,0
1653299097490,JWSP 104,A01,086448,Shuster; Alana,15,0,15,0
1653299098019,LATI 10,A01,093588,Kennemore; Amy Michelle,31,0,32,1
1653299098019,LATI 10,A02,093589,Kennemore; Amy Michelle,32,0,32,0
1653299098019,LATI 10,A03,093590,Kennemore; Amy Michelle,32,0,32,0
1653299098540,LATI 50,A01,093592,Kokinis; Troy Andreas,32,0,32,0
1653299098540,LATI 50,A02,093593,Kokinis; Troy Andreas,31,0,32,1
1653299098540,LATI 50,A03,093595,Kokinis; Troy Andreas,32,0,32,0
1653299099064,LATI 122A,A00,093649,Andrews; Abigail Leslie,0,0,0,0
1653299099587,LATI 180,A00,093597,Staff,36,0,40,4
1653299100112,LIAB 1A,A00,087085,Saab; Dima,13,0,14,1
1653299100112,LIAB 1A,B00,087086,Saab; Dima,13,0,14,1
1653299100112,LIAB 1A,C00,087087,Saab; Dima,14,0,14,0
1653299100112,LIAB 1A,D00,087088,El Cheddadi; Youniss,14,0,14,0
1653299100641,LIAB 1AX,A00,087089,Akjeje; Abdelhak,28,0,28,0
1653299100641,LIAB 1AX,B00,087091,Akjeje; Abdelhak,28,0,28,0
1653299101167,LIAB 1D,A00,087093,El Cheddadi; Youniss,13,0,14,1
1653299101167,LIAB 1D,B00,087094,El Cheddadi; Youniss,12,0,14,2
1653299101690,LIAB 1DX,A00,087095,Akjeje; Abdelhak,27,0,28,1
1653299102219,LIDS 19,001,095098,Goodall; Grant Todd,9999,0,9999,0
1653299102219,LIDS 19,002,095099,Goodall; Grant Todd,9999,0,9999,0
1653299102219,LIDS 19,003,095100,Goodall; Grant Todd,9999,0,9999,0
1653299102219,LIDS 19,004,095101,Goodall; Grant Todd,9999,0,9999,0
1653299102219,LIDS 19,005,095102,Goodall; Grant Todd,9999,0,9999,0
1653299102219,LIDS 19,006,095103,Goodall; Grant Todd,9999,0,9999,0
1653299102219,LIDS 19,007,095104,Goodall; Grant Todd,9999,0,9999,0
1653299102219,LIDS 19,008,095105,Goodall; Grant Todd,9999,0,9999,0
1653299102219,LIDS 19,009,095106,Goodall; Grant Todd,9999,0,9999,0
1653299102219,LIDS 19,010,095107,Goodall; Grant Todd,9999,0,9999,0
1653299102219,LIDS 19,011,095108,Goodall; Grant Todd,9999,0,9999,0
1653299102219,LIDS 19,012,095109,Goodall; Grant Todd,9999,0,9999,0
1653299102743,LIFR 1A,A00,087097,Goodall; Grant Todd,13,0,14,1
1653299102743,LIFR 1A,B00,087098,Goodall; Grant Todd,13,0,14,1
1653299102743,LIFR 1A,C00,087099,Goodall; Grant Todd,12,0,14,2
1653299102743,LIFR 1A,D00,087100,Goodall; Grant Todd,12,0,14,2
1653299102743,LIFR 1A,E00,087101,Goodall; Grant Todd,14,0,14,0
1653299102743,LIFR 1A,F00,087102,Goodall; Grant Todd,13,0,14,1
1653299103266,LIFR 1AX,A00,087103,Goodall; Grant Todd,27,0,28,1
1653299103266,LIFR 1AX,B00,087104,Goodall; Grant Todd,27,0,28,1
1653299103266,LIFR 1AX,C00,087105,Goodall; Grant Todd,25,0,28,3
1653299103789,LIFR 1B,A00,087106,Goodall; Grant Todd,14,0,14,0
1653299103789,LIFR 1B,B00,087107,Goodall; Grant Todd,13,0,14,1
1653299103789,LIFR 1B,C00,087108,Goodall; Grant Todd,13,0,14,1
1653299103789,LIFR 1B,D00,087109,Goodall; Grant Todd,13,0,14,1
1653299104315,LIFR 1BX,A00,087110,Goodall; Grant Todd,26,0,28,2
1653299104315,LIFR 1BX,B00,087111,Goodall; Grant Todd,26,0,28,2
1653299104839,LIFR 1D,A00,087112,Goodall; Grant Todd,14,0,14,0
1653299104839,LIFR 1D,B00,087113,Goodall; Grant Todd,12,0,14,2
1653299104839,LIFR 1D,C00,087114,Goodall; Grant Todd,11,0,14,3
1653299104839,LIFR 1D,D00,087115,Goodall; Grant Todd,10,0,14,4
1653299105361,LIFR 1DX,A00,087116,Goodall; Grant Todd,26,0,28,2
1653299105361,LIFR 1DX,B00,087117,Goodall; Grant Todd,23,0,28,5
1653299105886,LIFR 11,A00,087118,Goodall; Grant Todd,10,0,10,0
1653299106411,LIGM 1A,A00,087119,Riebeling; Elke,14,0,14,0
1653299106411,LIGM 1A,B00,087120,Riebeling; Elke,14,0,14,0
1653299106411,LIGM 1A,C00,087121,Riebeling; Elke,12,0,14,2
1653299106411,LIGM 1A,D00,087122,Riebeling; Elke,14,0,14,0
1653299106411,LIGM 1A,E00,087123,Riebeling; Elke,14,0,14,0
1653299106934,LIGM 1AX,A00,087124,Riebeling; Elke,28,0,28,0
1653299106934,LIGM 1AX,B00,087125,Riebeling; Elke,28,0,28,0
1653299106934,LIGM 1AX,C00,087126,Riebeling; Elke,27,0,28,1
1653299107459,LIGM 1D,A00,087127,Riebeling; Elke,14,0,14,0
1653299107459,LIGM 1D,B00,087128,Riebeling; Elke,12,0,14,2
1653299107985,LIGM 1DX,A00,087129,Riebeling; Elke,26,0,28,2
1653299108510,LIGM 11,A00,087130,Goodall; Grant Todd,10,0,10,0
1653299109037,LIGN 5,A00,087005,Goodall; Grant Todd,74,0,75,1
1653299109561,LIGN 7,A00,087006,Mayberry; Rachel,139,0,146,7
1653299110086,LIGN 8,A00,087007,McIntosh; Justin Daniel,244,0,250,6
1653299110611,LIGN 17,A00,087008,Kehler; Andrew Scott,218,0,220,2
1653299111132,LIGN 101,A01,087010,Styler; William Francis,29,0,30,1
1653299111132,LIGN 101,A02,087011,Styler; William Francis,29,0,30,1
1653299111132,LIGN 101,A03,087012,Styler; William Francis,29,0,30,1
1653299111132,LIGN 101,A04,087013,Styler; William Francis,29,0,30,1
1653299111654,LIGN 110,A01,087015,Garellek; Marc,29,0,30,1
1653299111654,LIGN 110,A02,087016,Garellek; Marc,26,0,30,4
1653299111654,LIGN 110,A03,087017,Garellek; Marc,26,0,30,4
1653299111654,LIGN 110,A04,087018,Garellek; Marc,28,0,30,2
1653299112177,LIGN 121,A01,087020,Drake; Emily C,23,0,25,2
1653299112177,LIGN 121,A02,087021,Drake; Emily C,24,0,25,1
1653299112703,LIGN 150,A00,093702,Staff,71,0,75,4
1653299113242,LIGN 152,A00,087023,Caballero; Gabriela Hernandez,16,0,20,4
1653299113767,LIGN 154,A00,087024,Kluender; Robert,70,0,70,0
1653299114293,LIGN 167,A00,087025,Bergen; Leon,70,0,100,30
1653299114816,LIGN 187,A00,087026,McIntosh; Justin Daniel,20,0,20,0
1653299115343,LIHL 112F,A00,086505,Alicio; Atilio,25,0,28,3
1653299115866,LIHL 114F,A00,086506,Staff,21,0,28,7
1653299116391,LIHL 117F,A00,086508,Sadegholvad; Elham,20,0,20,0
1653299116917,LIHL 118,A00,086509,Staff,25,0,28,3
1653299117439,LIHL 119F,A00,086510,Staff,26,0,28,2
1653299117966,LIHL 124F,A00,086511,Staff,27,0,28,1
1653299118489,LIHL 132F,A00,086512,Alicio; Atilio,28,0,28,0
1653299119024,LIIT 1A,A00,087131,Riebeling; Elke,14,0,14,0
1653299119024,LIIT 1A,B00,087132,Riebeling; Elke,14,0,14,0
1653299119024,LIIT 1A,C00,087133,Riebeling; Elke,12,0,14,2
1653299119024,LIIT 1A,D00,087134,Riebeling; Elke,14,0,14,0
1653299119548,LIIT 1AX,A00,087135,Riebeling; Elke,28,0,28,0
1653299119548,LIIT 1AX,B00,087136,Riebeling; Elke,26,0,28,2
1653299120072,LIPO 1A,A00,087137,Paladini; Denise,14,0,14,0
1653299120072,LIPO 1A,B00,087138,Paladini; Denise,10,0,14,4
1653299120596,LIPO 1AX,A00,087139,De Abreu; Cassia,18,0,22,4
1653299120596,LIPO 1AX,B00,087140,De Abreu; Cassia,22,0,22,0
1653299121127,LIPO 1D,A00,087141,Paladini; Denise,10,0,14,4
1653299121654,LIPO 1DX,A00,087143,De Abreu; Cassia,10,0,14,4
1653299122180,LISL 1A,A00,087145,Lott; Margaret S.,10,0,14,4
1653299122180,LISL 1A,B00,087146,Lott; Margaret S.,14,0,14,0
1653299122180,LISL 1A,C00,087147,Lott; Margaret S.,10,0,14,4
1653299122180,LISL 1A,D00,087148,Lott; Margaret S.,11,0,14,3
1653299122180,LISL 1A,E00,087149,Lott; Margaret S.,13,0,14,1
1653299122180,LISL 1A,F00,087150,Lott; Margaret S.,12,0,14,2
1653299122180,LISL 1A,G00,087151,Lott; Margaret S.,13,0,14,1
1653299122180,LISL 1A,H00,087152,Lott; Margaret S.,13,0,14,1
1653299122708,LISL 1AX,A00,087153,Lott; Margaret S.,28,0,28,0
1653299122708,LISL 1AX,B00,087154,Lott; Margaret S.,25,0,28,3
1653299122708,LISL 1AX,C00,087155,Lott; Margaret S.,25,0,28,3
1653299122708,LISL 1AX,D00,087156,Lott; Margaret S.,24,0,28,4
1653299123233,LISL 1B,A00,087157,Lott; Margaret S.,13,0,14,1
1653299123233,LISL 1B,B00,087158,Lott; Margaret S.,12,0,14,2
1653299123233,LISL 1B,C00,087159,Lott; Margaret S.,11,0,14,3
1653299123233,LISL 1B,D00,087160,Lott; Margaret S.,13,0,14,1
1653299123233,LISL 1B,E00,087161,Lott; Margaret S.,13,0,14,1
1653299123233,LISL 1B,F00,087162,Lott; Margaret S.,13,0,14,1
1653299123757,LISL 1BX,A00,087163,Lott; Margaret S.,23,0,28,5
1653299123757,LISL 1BX,B00,087164,Lott; Margaret S.,26,0,28,2
1653299123757,LISL 1BX,C00,087165,Lott; Margaret S.,28,0,28,0
1653299124282,LISL 1D,A00,087166,Lott; Margaret S.,14,0,14,0
1653299124282,LISL 1D,B00,087167,Lott; Margaret S.,14,0,14,0
1653299124282,LISL 1D,C00,087168,Lott; Margaret S.,8,0,14,6
1653299124282,LISL 1D,D00,087169,Lott; Margaret S.,13,0,14,1
1653299124807,LISL 1DX,A00,087170,Lott; Margaret S.,23,0,28,5
1653299124807,LISL 1DX,B00,087171,Lott; Margaret S.,26,0,28,2
1653299125339,LISP 1A,001,087172,Munoz Sanchez; Alicia,13,0,14,1
1653299125339,LISP 1A,002,087173,Munoz Sanchez; Alicia,12,0,14,2
1653299125339,LISP 1A,003,087174,Munoz Sanchez; Alicia,13,0,14,1
1653299125339,LISP 1A,004,087175,Munoz Sanchez; Alicia,12,0,14,2
1653299125339,LISP 1A,005,087176,Munoz Sanchez; Alicia,10,0,14,4
1653299125339,LISP 1A,006,087177,Munoz Sanchez; Alicia,12,0,14,2
1653299125339,LISP 1A,007,087178,Munoz Sanchez; Alicia,12,0,14,2
1653299125339,LISP 1A,008,087179,Munoz Sanchez; Alicia,14,0,14,0
1653299125873,LISP 1AX,A00,087180,Munoz Sanchez; Alicia,27,0,28,1
1653299125873,LISP 1AX,B00,087181,Munoz Sanchez; Alicia,24,0,28,4
1653299125873,LISP 1AX,C00,087182,Munoz Sanchez; Alicia,25,0,28,3
1653299125873,LISP 1AX,D00,087183,Munoz Sanchez; Alicia,25,0,28,3
1653299126400,LISP 1B,001,087184,Munoz Sanchez; Alicia,14,0,14,0
1653299126400,LISP 1B,002,087185,Munoz Sanchez; Alicia,14,0,14,0
1653299126400,LISP 1B,003,087186,Munoz Sanchez; Alicia,11,0,14,3
1653299126400,LISP 1B,004,087187,Munoz Sanchez; Alicia,12,0,14,2
1653299126400,LISP 1B,005,087188,Munoz Sanchez; Alicia,13,0,14,1
1653299126400,LISP 1B,006,087189,Munoz Sanchez; Alicia,13,0,14,1
1653299126400,LISP 1B,007,087190,Munoz Sanchez; Alicia,14,0,14,0
1653299126400,LISP 1B,008,087191,Munoz Sanchez; Alicia,13,0,14,1
1653299126400,LISP 1B,009,087192,Munoz Sanchez; Alicia,14,0,14,0
1653299126400,LISP 1B,010,087193,Munoz Sanchez; Alicia,13,0,14,1
1653299126400,LISP 1B,011,087194,Munoz Sanchez; Alicia,14,0,14,0
1653299126928,LISP 1BX,A00,087195,Munoz Sanchez; Alicia,28,0,28,0
1653299126928,LISP 1BX,B00,087196,Munoz Sanchez; Alicia,26,0,28,2
1653299126928,LISP 1BX,C00,087197,Munoz Sanchez; Alicia,26,0,28,2
1653299126928,LISP 1BX,D00,087198,Munoz Sanchez; Alicia,26,0,28,2
1653299126928,LISP 1BX,E00,087199,Munoz Sanchez; Alicia,28,0,28,0
1653299127459,LISP 1D,001,087200,Munoz Sanchez; Alicia,13,0,14,1
1653299127459,LISP 1D,002,087201,Munoz Sanchez; Alicia,14,0,14,0
1653299127459,LISP 1D,003,087202,Munoz Sanchez; Alicia,8,0,14,6
1653299127459,LISP 1D,004,087203,Munoz Sanchez; Alicia,5,0,14,9
1653299127459,LISP 1D,005,087204,Munoz Sanchez; Alicia,11,0,14,3
1653299127459,LISP 1D,006,087205,Munoz Sanchez; Alicia,13,0,14,1
1653299127459,LISP 1D,007,087206,Munoz Sanchez; Alicia,13,0,14,1
1653299127459,LISP 1D,008,087207,Munoz Sanchez; Alicia,13,0,14,1
1653299127459,LISP 1D,009,087208,Munoz Sanchez; Alicia,14,0,14,0
1653299127459,LISP 1D,010,087209,Munoz Sanchez; Alicia,12,0,14,2
1653299127459,LISP 1D,011,087210,Munoz Sanchez; Alicia,13,0,14,1
1653299127459,LISP 1D,012,087211,Munoz Sanchez; Alicia,14,0,14,0
1653299127459,LISP 1D,013,087212,Munoz Sanchez; Alicia,14,0,14,0
1653299127459,LISP 1D,014,087213,Munoz Sanchez; Alicia,14,0,14,0
1653299127983,LISP 1DX,A00,087214,Munoz Sanchez; Alicia,27,0,28,1
1653299127983,LISP 1DX,B00,087215,Munoz Sanchez; Alicia,23,0,28,5
1653299127983,LISP 1DX,C00,087216,Munoz Sanchez; Alicia,23,0,28,5
1653299127983,LISP 1DX,D00,087217,Munoz Sanchez; Alicia,25,0,28,3
1653299127983,LISP 1DX,E00,087218,Munoz Sanchez; Alicia,27,0,28,1
1653299127983,LISP 1DX,F00,087219,Munoz Sanchez; Alicia,25,0,28,3
1653299127983,LISP 1DX,G00,087220,Munoz Sanchez; Alicia,28,0,28,0
1653299128510,LISP 15,A00,087221,Munoz Sanchez; Alicia,19,0,20,1
1653299129037,LISP 18,A00,087222,Munoz Sanchez; Alicia,15,0,20,5
1653299129561,LTAM 110,A00,087352,Chacon; Gloria Elizabeth,35,0,40,5
1653299130089,LTCS 87,A00,094011,Nguyen; Hoang Tan,19,0,20,1
1653299130616,LTCS 111,A00,087353,Vitkus; Daniel J.,40,0,40,0
1653299131139,LTCS 119,A00,087354,Nguyen; Hoang Tan,29,0,30,1
1653299131663,LTCS 130,A00,087355,Kim; Joo Ok,37,0,40,3
1653299132187,LTCS 165,A00,087356,Kim; Joo Ok,38,0,40,2
1653299132711,LTEA 120A,A00,087357,Fiss; Geraldine Anna,291,0,300,9
1653299133235,LTEA 140,A00,094009,Lee; Jin-Kyung,28,0,32,4
1653299133759,LTEA 142,A00,087358,Lee; Jin-Kyung,103,0,120,17
1653299134282,LTEN 21,A01,087275,Lampert-Weissig; Lisa,25,0,25,0
1653299134282,LTEN 21,A02,087276,Lampert-Weissig; Lisa,25,0,25,0
1653299134282,LTEN 21,A03,087277,Lampert-Weissig; Lisa,25,0,25,0
1653299134282,LTEN 21,A04,087278,Lampert-Weissig; Lisa,25,0,25,0
1653299134807,LTEN 25,A01,087280,Johnson; Sara E.,25,0,25,0
1653299134807,LTEN 25,A02,087281,Johnson; Sara E.,25,0,25,0
1653299134807,LTEN 25,A03,087282,Johnson; Sara E.,23,0,25,2
1653299134807,LTEN 25,A04,087283,Johnson; Sara E.,25,0,25,0
1653299135337,LTEN 29,A01,087285,Ruiz; Ariana,24,0,25,1
1653299135337,LTEN 29,A02,087286,Ruiz; Ariana,25,0,25,0
1653299135337,LTEN 29,A03,087287,Ruiz; Ariana,24,0,25,1
1653299135337,LTEN 29,A04,087288,Ruiz; Ariana,24,0,25,1
1653299135865,LTEN 107,A00,087359,Lampert-Weissig; Lisa,39,0,40,1
1653299136388,LTEN 117,A00,087360,Vitkus; Daniel J.,40,0,40,0
1653299136911,LTEN 127,A00,087361,Loose; Margaret,38,0,40,2
1653299137439,LTEN 142,A00,094010,Loose; Margaret,38,0,40,2
1653299137963,LTEN 148,A00,087363,Walkiewicz; Kathryn A,40,0,40,0
1653299138490,LTEN 152,A00,087364,Walkiewicz; Kathryn A,37,0,40,3
1653299139016,LTEN 180,A00,087365,Ruiz; Ariana,18,0,20,2
1653299139541,LTFR 2A,A01,087290,Ploye; Catherine,23,0,25,2
1653299140072,LTFR 2B,A01,087292,Ploye; Catherine,25,0,25,0
1653299140595,LTFR 104,A00,087366,Ploye; Catherine,25,0,25,0
1653299141118,LTFR 116,A00,087367,Zhiri; Oumelbanine,13,0,15,2
1653299141641,LTGK 1,A00,087293,Myerston Santana; Jacobo,27,0,30,3
1653299142165,LTGK 103,A00,087368,duBois; Page Ann,14,0,15,1
1653299142689,LTGM 2A,A01,087295,Fischer-Grunski; Eva K,24,0,25,1
1653299143212,LTIT 2A,A01,087297,De Marchi Gherini; Adriana,24,0,25,1
1653299143738,LTKO 1A,A01,087299,Staff,24,0,25,1
1653299143738,LTKO 1A,B01,087301,Staff,25,0,25,0
1653299143738,LTKO 1A,C01,087303,Staff,25,0,25,0
1653299143738,LTKO 1A,D01,087305,Staff,25,0,25,0
1653299143738,LTKO 1A,E01,087307,Staff,24,0,25,1
1653299143738,LTKO 1A,F01,087309,Staff,25,0,25,0
1653299143738,LTKO 1A,G01,087311,Staff,25,0,25,0
1653299143738,LTKO 1A,H01,087313,Staff,24,0,25,1
1653299143738,LTKO 1A,I01,087315,Staff,25,0,25,0
1653299144263,LTKO 2A,A01,087317,Staff,24,0,25,1
1653299144263,LTKO 2A,B01,087319,Staff,22,0,25,3
1653299144263,LTKO 2A,C01,087321,Lee; Jeyseon,24,0,25,1
1653299144790,LTKO 130,A00,087369,Lee; Jeyseon,25,0,25,0
1653299145314,LTLA 1,A00,087322,Murray; Kourtney Kristine,38,0,40,2
1653299145836,LTLA 100,A00,087371,Kelting; Edward William,23,0,25,2
1653299146360,LTRU 1A,A01,087324,Wells; Patricia Rebecca,23,0,25,2
1653299146884,LTRU 2A,A01,087326,Wells; Patricia Rebecca,20,0,20,0
1653299147407,LTRU 104B,A01,087373,Wells; Patricia Rebecca,14,0,15,1
1653299147934,LTSP 2A,A01,087328,Staff,25,0,25,0
1653299147934,LTSP 2A,B01,087330,Staff,22,0,25,3
1653299147934,LTSP 2A,C01,087332,Staff,22,0,25,3
1653299148460,LTSP 2B,A01,087334,Staff,22,0,25,3
1653299148460,LTSP 2B,B01,087336,Staff,19,0,25,6
1653299148986,LTSP 2D,A00,087337,Staff,25,0,25,0
1653299148986,LTSP 2D,B00,087338,Staff,25,0,25,0
1653299148986,LTSP 2D,C00,087339,Staff,25,0,25,0
1653299149587,LTSP 100A,A00,087374,Arcos Herrera; Carol,23,0,25,2
1653299150114,LTSP 116,A00,087375,Blanco; John D,29,0,30,1
1653299150642,LTSP 140,A00,087376,Chacon; Gloria Elizabeth,30,0,30,0
1653299151168,LTSP 175,A00,087377,Arcos Herrera; Carol,30,0,30,0
1653299151690,LTTH 150,A00,087379,Cohen; Alain J. J.,40,0,40,0
1653299152212,LTWL 19A,A00,087340,Myerston Santana; Jacobo,39,0,40,1
1653299152735,LTWL 87,A00,094012,Lampert-Weissig; Lisa,20,0,20,0
1653299153262,LTWL 116,A00,087380,Nguyen; Hoang Tan,60,0,60,0
1653299153786,LTWL 120,A00,087381,Fiss; Geraldine Anna,37,0,40,3
1653299154315,LTWL 172,A00,087382,De Marchi Gherini; Adriana,40,0,40,0
1653299154842,LTWL 180,A00,087383,Kontje; Todd Curtis,39,0,40,1
1653299155367,LTWL 194,A00,087384,Suzuki; Erin M.,31,0,32,1
1653299155895,LTWR 8A,A01,087342,Jemc; Jaclyn,24,0,25,1
1653299155895,LTWR 8A,A02,087343,Jemc; Jaclyn,25,0,25,0
1653299155895,LTWR 8A,A03,087344,Jemc; Jaclyn,24,0,25,1
1653299155895,LTWR 8A,A04,087345,Jemc; Jaclyn,24,0,25,1
1653299156418,LTWR 8C,A01,087348,Forbes; Camille,25,0,25,0
1653299156418,LTWR 8C,A02,087349,Forbes; Camille,25,0,25,0
1653299156418,LTWR 8C,A03,087350,Forbes; Camille,25,0,25,0
1653299156418,LTWR 8C,A04,087351,Forbes; Camille,23,0,25,2
1653299156944,LTWR 100,A00,087385,Staff,12,0,15,3
1653299157467,LTWR 102,A00,087386,Staff,14,0,15,1
1653299157993,LTWR 115,A00,087387,Carroll; Amy Sara,24,0,30,6
1653299158518,LTWR 119,A00,087388,Staff,22,0,30,8
1653299159041,LTWR 140,A00,087389,Carroll; Amy Sara,37,0,40,3
1653299159567,LTWR 194,A00,087390,Som; Brandon D,35,0,40,5
1653299160099,MAE 2,A01,090334,Anderson; Mark Ronald,8,0,8,0
1653299160099,MAE 2,A02,090335,Anderson; Mark Ronald,8,0,8,0
1653299160099,MAE 2,A03,090336,Anderson; Mark Ronald,8,0,8,0
1653299160099,MAE 2,A04,090337,Anderson; Mark Ronald,8,0,8,0
1653299160099,MAE 2,A05,090338,Anderson; Mark Ronald,8,0,8,0
1653299160099,MAE 2,A06,090339,Anderson; Mark Ronald,8,0,8,0
1653299160099,MAE 2,A07,090340,Anderson; Mark Ronald,8,0,8,0
1653299160099,MAE 2,A08,090341,Anderson; Mark Ronald,7,0,8,1
1653299160099,MAE 2,A09,090342,Anderson; Mark Ronald,8,0,8,0
1653299160641,MAE 3,A01,090344,Delson; Nathan Joseph,21,0,22,1
1653299160641,MAE 3,A02,090345,Delson; Nathan Joseph,20,0,22,2
1653299160641,MAE 3,A03,090346,Delson; Nathan Joseph,21,0,22,1
1653299160641,MAE 3,A04,090347,Delson; Nathan Joseph,22,0,22,0
1653299160641,MAE 3,B01,090349,Qi; Huihui,18,0,22,4
1653299160641,MAE 3,B02,090350,Qi; Huihui,17,0,22,5
1653299160641,MAE 3,B03,090351,Qi; Huihui,20,0,22,2
1653299160641,MAE 3,B04,090352,Qi; Huihui,19,0,22,3
1653299161169,MAE 8,A01,090354,Pham; Hieu Tan,182,0,185,3
1653299161693,MAE 11,A00,090355,Nomura; Keiko K.,155,0,165,10
1653299162222,MAE 20,A00,090356,Bandaru; Prabhakar,160,0,160,0
1653299162222,MAE 20,B00,090357,Evdokimenko; Ekaterina,145,0,160,15
1653299162751,MAE 21,A01,090359,Cai; Shengqiang,8,0,9,1
1653299162751,MAE 21,A02,090360,Cai; Shengqiang,9,0,9,0
1653299162751,MAE 21,A03,090361,Cai; Shengqiang,6,0,9,3
1653299162751,MAE 21,A04,090362,Cai; Shengqiang,7,0,9,2
1653299162751,MAE 21,A05,090363,Cai; Shengqiang,0,0,0,0
1653299162751,MAE 21,A06,090364,Cai; Shengqiang,9,0,9,0
1653299162751,MAE 21,A07,090365,Cai; Shengqiang,9,0,9,0
1653299162751,MAE 21,A08,090366,Cai; Shengqiang,8,0,9,1
1653299162751,MAE 21,A09,090367,Cai; Shengqiang,8,0,9,1
1653299162751,MAE 21,A10,090368,Cai; Shengqiang,0,0,0,0
1653299162751,MAE 21,A11,090369,Cai; Shengqiang,9,0,9,0
1653299162751,MAE 21,A12,090370,Cai; Shengqiang,8,0,9,1
1653299163275,MAE 30A,A00,090371,Lal; Ratnesh,72,0,75,3
1653299163798,MAE 40,A00,090372,Bitmead; Robert R.,167,0,175,8
1653299164324,MAE 101A,A00,090373,Bahadori; Mohammad Yousef,105,0,115,10
1653299164850,MAE 101C,A00,090374,Poulikakos; Lisa Voula,41,0,110,69
1653299164850,MAE 101C,B00,090375,Chen; Renkun,96,0,110,14
1653299165375,MAE 104,A00,090376,Sanchez; Antonio Luis,78,0,120,42
1653299165899,MAE 105,A00,090377,Saintillan; David,154,0,170,16
1653299166424,MAE 107,A00,090378,Lindsey; Stephanie,104,0,110,6
1653299166424,MAE 107,B00,090379,Tolley; Michael Thomas,85,0,110,25
1653299166952,MAE 118,A00,090380,Krasheninnikov; Sergei,27,0,45,18
1653299167476,MAE 131A,A00,090381,Ghazinejad; Maziar,70,0,75,5
1653299168000,MAE 133,A00,090382,Frazier; Michael,26,0,33,7
1653299168529,MAE 143A,A00,090383,de Oliveira; Mauricio,74,0,100,26
1653299169057,MAE 144,A00,090384,Bewley; Thomas R,50,0,70,20
1653299169580,MAE 148,A01,091597,Staff,32,0,32,0
1653299170125,MAE 150,A00,090385,Friend; James Robert,69,0,90,21
1653299170125,MAE 150,B00,090386,Ghazinejad; Maziar,4,0,90,86
1653299170651,MAE 152,A00,090387,Tynan; George Robert,0,0,16,16
1653299170651,MAE 152,B00,090388,Tynan; George Robert,0,0,16,16
1653299170651,MAE 152,C00,090389,Tynan; George Robert,0,0,16,16
1653299170651,MAE 152,D00,090390,Tynan; George Robert,0,0,16,16
1653299171180,MAE 156A,A01,090392,Delson; Nathan Joseph,2,0,12,10
1653299171180,MAE 156A,A02,090393,Delson; Nathan Joseph,1,0,12,11
1653299171180,MAE 156A,A03,090394,Delson; Nathan Joseph,4,0,12,8
1653299171711,MAE 170,A01,090396,Lubarda; Marko,14,0,30,16
1653299171711,MAE 170,A02,090397,Lubarda; Marko,19,0,30,11
1653299171711,MAE 170,A03,090398,Lubarda; Marko,28,0,30,2
1653299171711,MAE 170,A04,090399,Lubarda; Marko,20,0,30,10
1653299171711,MAE 170,B01,090401,Diagne; Mamadou Lamine,30,0,30,0
1653299171711,MAE 170,B02,090402,Diagne; Mamadou Lamine,27,0,30,3
1653299171711,MAE 170,B03,090403,Diagne; Mamadou Lamine,28,0,30,2
1653299171711,MAE 170,B04,090404,Diagne; Mamadou Lamine,28,0,30,2
1653299172233,MAE 180A,A00,090405,McEneaney; William Michael,110,0,125,15
1653299172766,MAE 181,A00,090406,Bahadori; Mohammad Yousef,46,0,60,14
1653299173291,MAE 190,A00,090407,Anderson; Mark Ronald,27,0,45,18
1653299173816,MAE 191,A01,090409,Qi; Huihui,25,0,32,7
1653299174349,MATH 2,A01,089123,Hammock; Frances H,0,0,0,0
1653299174349,MATH 2,B01,089126,Hammock; Frances H,0,0,0,0
1653299174349,MATH 2,C01,089129,Hammock; Frances H,0,0,0,0
1653299174349,MATH 2,D01,094201,Harel; Guershon,0,0,0,0
1653299174889,MATH 3C,A01,089132,Bowers; Adam R.,0,0,0,0
1653299174889,MATH 3C,A02,089133,Bowers; Adam R.,0,0,0,0
1653299174889,MATH 3C,A03,089134,Bowers; Adam R.,0,0,0,0
1653299174889,MATH 3C,A04,089135,Bowers; Adam R.,0,0,0,0
1653299174889,MATH 3C,A05,089136,Bowers; Adam R.,0,0,0,0
1653299174889,MATH 3C,A06,089137,Bowers; Adam R.,0,0,0,0
1653299174889,MATH 3C,A07,089138,Bowers; Adam R.,0,0,0,0
1653299174889,MATH 3C,A08,089139,Bowers; Adam R.,0,0,0,0
1653299174889,MATH 3C,A09,089140,Bowers; Adam R.,0,0,0,0
1653299174889,MATH 3C,A10,089141,Bowers; Adam R.,0,0,0,0
1653299174889,MATH 3C,A11,089142,Bowers; Adam R.,0,0,0,0
1653299174889,MATH 3C,A12,089143,Bowers; Adam R.,0,0,0,0
1653299174889,MATH 3C,A13,089144,Bowers; Adam R.,0,0,0,0
1653299174889,MATH 3C,A14,089145,Bowers; Adam R.,0,0,0,0
1653299174889,MATH 3C,A15,089146,Bowers; Adam R.,0,0,0,0
1653299174889,MATH 3C,A16,089147,Bowers; Adam R.,0,0,0,0
1653299174889,MATH 3C,A17,089148,Bowers; Adam R.,0,0,0,0
1653299174889,MATH 3C,A18,089149,Bowers; Adam R.,0,0,0,0
1653299174889,MATH 3C,A19,089150,Bowers; Adam R.,0,0,0,0
1653299174889,MATH 3C,A20,089151,Bowers; Adam R.,0,0,0,0
1653299174889,MATH 3C,A21,089152,Bowers; Adam R.,0,0,0,0
1653299174889,MATH 3C,A22,089153,Bowers; Adam R.,0,0,0,0
1653299174889,MATH 3C,A23,089154,Bowers; Adam R.,0,0,0,0
1653299174889,MATH 3C,A24,089155,Bowers; Adam R.,0,0,0,0
1653299174889,MATH 3C,B01,089158,Staff,0,0,0,0
1653299174889,MATH 3C,B02,089159,Staff,0,0,0,0
1653299174889,MATH 3C,B03,089160,Staff,0,0,0,0
1653299174889,MATH 3C,B04,089161,Staff,0,0,0,0
1653299174889,MATH 3C,C01,094244,Staff,0,0,0,0
1653299174889,MATH 3C,C02,094245,Staff,0,0,0,0
1653299174889,MATH 3C,C03,094246,Staff,0,0,0,0
1653299174889,MATH 3C,C04,094247,Staff,0,0,0,0
1653299175413,MATH 4C,A01,089164,Staff,0,0,0,0
1653299175413,MATH 4C,A02,089165,Staff,0,0,0,0
1653299175413,MATH 4C,A03,089166,Staff,0,0,0,0
1653299175413,MATH 4C,B01,089169,Ganzberger; Geoffrey Michael,0,0,0,0
1653299175413,MATH 4C,B02,089170,Ganzberger; Geoffrey Michael,0,0,0,0
1653299175413,MATH 4C,B03,089171,Ganzberger; Geoffrey Michael,0,0,0,0
1653299175413,MATH 4C,C01,089174,Ganzberger; Geoffrey Michael,0,0,0,0
1653299175413,MATH 4C,C02,089175,Ganzberger; Geoffrey Michael,0,0,0,0
1653299175413,MATH 4C,C03,089176,Ganzberger; Geoffrey Michael,0,0,0,0
1653299175413,MATH 4C,D01,094249,Ganzberger; Geoffrey Michael,0,0,0,0
1653299175413,MATH 4C,D02,094250,Ganzberger; Geoffrey Michael,0,0,0,0
1653299175413,MATH 4C,D03,094251,Ganzberger; Geoffrey Michael,0,0,0,0
1653299175942,MATH 10A,A01,089179,Jin; Muzhi,5,0,5,0
1653299175942,MATH 10A,A02,089180,Jin; Muzhi,5,0,5,0
1653299175942,MATH 10A,A03,089181,Jin; Muzhi,4,0,5,1
1653299175942,MATH 10A,A04,089182,Jin; Muzhi,4,0,5,1
1653299175942,MATH 10A,A05,089183,Jin; Muzhi,5,0,5,0
1653299175942,MATH 10A,A06,089184,Jin; Muzhi,5,0,5,0
1653299175942,MATH 10A,A07,089185,Jin; Muzhi,5,0,5,0
1653299175942,MATH 10A,A08,089186,Jin; Muzhi,5,0,5,0
1653299175942,MATH 10A,B01,089188,Stevens; Laura Jeanne,1,0,5,4
1653299175942,MATH 10A,B02,089189,Stevens; Laura Jeanne,4,0,5,1
1653299175942,MATH 10A,B03,089190,Stevens; Laura Jeanne,4,0,5,1
1653299175942,MATH 10A,B04,089191,Stevens; Laura Jeanne,5,0,5,0
1653299175942,MATH 10A,B05,089192,Stevens; Laura Jeanne,4,0,5,1
1653299175942,MATH 10A,B06,089193,Stevens; Laura Jeanne,5,0,5,0
1653299175942,MATH 10A,B07,089194,Stevens; Laura Jeanne,5,0,5,0
1653299175942,MATH 10A,B08,089195,Stevens; Laura Jeanne,4,0,5,1
1653299175942,MATH 10A,C01,089197,Jin; Muzhi,1,0,5,4
1653299175942,MATH 10A,C02,089198,Jin; Muzhi,5,0,5,0
1653299175942,MATH 10A,C03,089199,Jin; Muzhi,5,0,5,0
1653299175942,MATH 10A,C04,089200,Jin; Muzhi,5,0,5,0
1653299175942,MATH 10A,C05,089201,Jin; Muzhi,5,0,5,0
1653299175942,MATH 10A,C06,089202,Jin; Muzhi,5,0,5,0
1653299175942,MATH 10A,D01,089204,Upton; James Thomas,4,0,5,1
1653299175942,MATH 10A,D02,089205,Upton; James Thomas,5,0,5,0
1653299175942,MATH 10A,D03,089206,Upton; James Thomas,5,0,5,0
1653299175942,MATH 10A,D04,089207,Upton; James Thomas,5,0,5,0
1653299175942,MATH 10A,E01,089211,Greenfeld; Be'Eri,5,0,5,0
1653299175942,MATH 10A,E02,089212,Greenfeld; Be'Eri,3,0,5,2
1653299175942,MATH 10A,E03,089213,Greenfeld; Be'Eri,4,0,5,1
1653299175942,MATH 10A,E04,089214,Greenfeld; Be'Eri,5,0,5,0
1653299175942,MATH 10A,E05,089215,Greenfeld; Be'Eri,5,0,5,0
1653299175942,MATH 10A,E06,089216,Greenfeld; Be'Eri,5,0,5,0
1653299176467,MATH 10B,A01,089218,Stevens; Laura Jeanne,7,0,8,1
1653299176467,MATH 10B,A02,089219,Stevens; Laura Jeanne,7,0,8,1
1653299176467,MATH 10B,A03,089220,Stevens; Laura Jeanne,8,0,8,0
1653299176467,MATH 10B,A04,089221,Stevens; Laura Jeanne,6,0,8,2
1653299176467,MATH 10B,A05,089222,Stevens; Laura Jeanne,2,0,8,6
1653299176467,MATH 10B,A06,089223,Stevens; Laura Jeanne,0,0,8,8
1653299176467,MATH 10B,A07,089224,Stevens; Laura Jeanne,6,0,8,2
1653299176467,MATH 10B,A08,089225,Stevens; Laura Jeanne,4,0,8,4
1653299176467,MATH 10B,B01,089227,Staff,8,0,8,0
1653299176467,MATH 10B,B02,089228,Staff,8,0,8,0
1653299176467,MATH 10B,B03,089229,Staff,7,0,8,1
1653299176467,MATH 10B,B04,089230,Staff,8,0,8,0
1653299176467,MATH 10B,B05,089231,Staff,8,0,8,0
1653299176467,MATH 10B,B06,089232,Staff,8,0,8,0
1653299176467,MATH 10B,B07,089233,Staff,8,0,8,0
1653299176467,MATH 10B,B08,089234,Staff,8,0,8,0
1653299176467,MATH 10B,C01,089236,McKinley; Gweneth Anne,4,0,8,4
1653299176467,MATH 10B,C02,089237,McKinley; Gweneth Anne,8,0,8,0
1653299176467,MATH 10B,C03,089238,McKinley; Gweneth Anne,8,0,8,0
1653299176467,MATH 10B,C04,089239,McKinley; Gweneth Anne,8,0,8,0
1653299176467,MATH 10B,C05,089240,McKinley; Gweneth Anne,8,0,8,0
1653299176467,MATH 10B,C06,089241,McKinley; Gweneth Anne,8,0,8,0
1653299176998,MATH 10C,A01,089243,Staff,13,0,20,7
1653299176998,MATH 10C,A02,089244,Staff,20,0,20,0
1653299176998,MATH 10C,A03,089245,Staff,18,0,20,2
1653299176998,MATH 10C,A04,089246,Staff,20,0,20,0
1653299176998,MATH 10C,A05,089247,Staff,19,0,20,1
1653299176998,MATH 10C,A06,089248,Staff,20,0,20,0
1653299176998,MATH 10C,A07,094505,Staff,20,0,20,0
1653299176998,MATH 10C,A08,094506,Staff,20,0,20,0
1653299176998,MATH 10C,B01,089250,Staff,19,0,20,1
1653299176998,MATH 10C,B02,089251,Staff,19,0,20,1
1653299176998,MATH 10C,B03,089252,Staff,14,0,20,6
1653299176998,MATH 10C,B04,089253,Staff,20,0,20,0
1653299176998,MATH 10C,B05,089254,Staff,20,0,20,0
1653299176998,MATH 10C,B06,089255,Staff,18,0,20,2
1653299177530,MATH 11,A01,089258,Rava; Denise,1,0,15,14
1653299177530,MATH 11,A02,089260,Rava; Denise,9,0,15,6
1653299177530,MATH 11,A03,089263,Rava; Denise,10,0,15,5
1653299177530,MATH 11,A04,089265,Rava; Denise,13,0,15,2
1653299177530,MATH 11,A05,089267,Rava; Denise,10,0,15,5
1653299177530,MATH 11,A06,089269,Rava; Denise,14,0,15,1
1653299177530,MATH 11,A07,089271,Rava; Denise,14,0,15,1
1653299177530,MATH 11,A08,089273,Rava; Denise,13,0,15,2
1653299177530,MATH 11,B01,089279,Staff,4,0,15,11
1653299177530,MATH 11,B02,089281,Staff,14,0,15,1
1653299177530,MATH 11,B03,089283,Staff,14,0,15,1
1653299177530,MATH 11,B04,089284,Staff,15,0,15,0
1653299177530,MATH 11,B05,089286,Staff,14,0,15,1
1653299177530,MATH 11,B06,089288,Staff,15,0,15,0
1653299177530,MATH 11,B07,089289,Staff,14,0,15,1
1653299177530,MATH 11,B08,089290,Staff,14,0,15,1
1653299178066,MATH 18,A01,089303,Anzaldo; Leesa B,5,0,10,5
1653299178066,MATH 18,A02,089304,Anzaldo; Leesa B,6,0,10,4
1653299178066,MATH 18,A03,089305,Anzaldo; Leesa B,10,0,10,0
1653299178066,MATH 18,A04,089306,Anzaldo; Leesa B,8,0,10,2
1653299178066,MATH 18,A05,089307,Anzaldo; Leesa B,10,0,10,0
1653299178066,MATH 18,A06,089308,Anzaldo; Leesa B,9,0,10,1
1653299178066,MATH 18,A07,089309,Anzaldo; Leesa B,10,0,10,0
1653299178066,MATH 18,A08,089310,Anzaldo; Leesa B,10,0,10,0
1653299178066,MATH 18,A09,089311,Anzaldo; Leesa B,10,0,10,0
1653299178066,MATH 18,A10,089312,Anzaldo; Leesa B,10,0,10,0
1653299178066,MATH 18,A11,089313,Anzaldo; Leesa B,9,0,10,1
1653299178066,MATH 18,A12,089314,Anzaldo; Leesa B,10,0,10,0
1653299178066,MATH 18,A13,089315,Anzaldo; Leesa B,9,0,10,1
1653299178066,MATH 18,A14,089316,Anzaldo; Leesa B,10,0,10,0
1653299178066,MATH 18,A15,089317,Anzaldo; Leesa B,9,0,10,1
1653299178066,MATH 18,A16,089318,Anzaldo; Leesa B,10,0,10,0
1653299178066,MATH 18,A17,089319,Anzaldo; Leesa B,9,0,10,1
1653299178066,MATH 18,A18,089320,Anzaldo; Leesa B,10,0,10,0
1653299178066,MATH 18,A19,089321,Anzaldo; Leesa B,0,0,0,0
1653299178066,MATH 18,A20,089322,Anzaldo; Leesa B,0,0,0,0
1653299178066,MATH 18,A21,089323,Anzaldo; Leesa B,9,0,10,1
1653299178066,MATH 18,A22,089324,Anzaldo; Leesa B,7,0,10,3
1653299178066,MATH 18,A23,089325,Anzaldo; Leesa B,10,0,10,0
1653299178066,MATH 18,A24,089326,Anzaldo; Leesa B,9,0,10,1
1653299178066,MATH 18,B01,089329,Staff,13,0,13,0
1653299178066,MATH 18,B02,089330,Staff,12,0,13,1
1653299178066,MATH 18,B03,089331,Staff,12,0,13,1
1653299178066,MATH 18,B04,089332,Staff,13,0,13,0
1653299178066,MATH 18,B05,089333,Staff,12,0,13,1
1653299178066,MATH 18,C01,089336,Staff,13,0,13,0
1653299178066,MATH 18,C02,089337,Staff,11,0,13,2
1653299178066,MATH 18,C03,089338,Staff,0,0,0,0
1653299178066,MATH 18,C04,089339,Staff,0,0,0,0
1653299178066,MATH 18,C05,089340,Staff,0,0,0,1
1653299178066,MATH 18,D01,094194,Staff,0,0,0,0
1653299178066,MATH 18,D02,094195,Staff,0,0,0,0
1653299178066,MATH 18,D03,094196,Staff,0,0,0,0
1653299178066,MATH 18,D04,094197,Staff,0,0,0,0
1653299178066,MATH 18,D05,094198,Staff,0,0,0,0
1653299178593,MATH 20A,A01,089343,Staff,5,0,5,0
1653299178593,MATH 20A,A02,089344,Staff,5,0,5,0
1653299178593,MATH 20A,A03,089345,Staff,5,0,5,0
1653299178593,MATH 20A,B01,089347,Suk; Andrew Hoon,2,0,3,1
1653299178593,MATH 20A,B02,089348,Suk; Andrew Hoon,3,0,3,0
1653299178593,MATH 20A,B03,089349,Suk; Andrew Hoon,3,0,3,0
1653299178593,MATH 20A,B04,089350,Suk; Andrew Hoon,3,0,3,0
1653299178593,MATH 20A,B05,089351,Suk; Andrew Hoon,3,0,3,0
1653299178593,MATH 20A,B06,089352,Suk; Andrew Hoon,2,0,3,1
1653299178593,MATH 20A,B07,089353,Suk; Andrew Hoon,3,0,3,0
1653299178593,MATH 20A,B08,089354,Suk; Andrew Hoon,3,0,3,0
1653299178593,MATH 20A,B09,089355,Suk; Andrew Hoon,3,0,3,0
1653299178593,MATH 20A,B10,089356,Suk; Andrew Hoon,3,0,3,0
1653299178593,MATH 20A,B11,089357,Suk; Andrew Hoon,3,0,3,0
1653299178593,MATH 20A,B12,089358,Suk; Andrew Hoon,3,0,3,0
1653299178593,MATH 20A,B13,089359,Suk; Andrew Hoon,2,0,3,1
1653299178593,MATH 20A,B14,089360,Suk; Andrew Hoon,3,0,3,0
1653299178593,MATH 20A,B15,089361,Suk; Andrew Hoon,3,0,3,0
1653299178593,MATH 20A,B16,089362,Suk; Andrew Hoon,3,0,3,0
1653299178593,MATH 20A,B17,089363,Suk; Andrew Hoon,3,0,3,0
1653299178593,MATH 20A,B18,089364,Suk; Andrew Hoon,0,0,0,0
1653299178593,MATH 20A,B19,089365,Suk; Andrew Hoon,3,0,3,0
1653299178593,MATH 20A,B20,089366,Suk; Andrew Hoon,3,0,3,0
1653299178593,MATH 20A,B21,089367,Suk; Andrew Hoon,3,0,3,0
1653299178593,MATH 20A,B22,089368,Suk; Andrew Hoon,3,0,3,0
1653299178593,MATH 20A,B23,089369,Suk; Andrew Hoon,3,0,3,0
1653299178593,MATH 20A,B24,089370,Suk; Andrew Hoon,3,0,3,0
1653299179129,MATH 20B,A01,089372,Quarfoot; David James,8,0,8,0
1653299179129,MATH 20B,A02,089373,Quarfoot; David James,8,0,8,0
1653299179129,MATH 20B,A03,089374,Quarfoot; David James,7,0,8,1
1653299179129,MATH 20B,A04,089375,Quarfoot; David James,7,0,8,1
1653299179129,MATH 20B,A05,089376,Quarfoot; David James,0,0,0,0
1653299179129,MATH 20B,A06,089377,Quarfoot; David James,0,0,0,0
1653299179129,MATH 20B,A07,089378,Quarfoot; David James,0,0,0,0
1653299179129,MATH 20B,A08,089379,Quarfoot; David James,0,0,0,0
1653299179129,MATH 20B,A09,089380,Quarfoot; David James,0,0,0,0
1653299179129,MATH 20B,A10,089381,Quarfoot; David James,0,0,0,0
1653299179129,MATH 20B,A11,089382,Quarfoot; David James,0,0,0,0
1653299179129,MATH 20B,A12,089383,Quarfoot; David James,0,0,0,0
1653299179129,MATH 20B,A13,089384,Quarfoot; David James,0,0,0,0
1653299179129,MATH 20B,A14,089385,Quarfoot; David James,0,0,0,0
1653299179129,MATH 20B,A15,089386,Quarfoot; David James,0,0,0,0
1653299179129,MATH 20B,A16,089387,Quarfoot; David James,0,0,0,0
1653299179129,MATH 20B,A17,089388,Quarfoot; David James,8,0,8,0
1653299179129,MATH 20B,A18,089389,Quarfoot; David James,8,0,8,0
1653299179129,MATH 20B,A19,089390,Quarfoot; David James,8,0,8,0
1653299179129,MATH 20B,A20,089391,Quarfoot; David James,8,0,8,0
1653299179129,MATH 20B,A21,089392,Quarfoot; David James,8,0,8,0
1653299179129,MATH 20B,A22,089393,Quarfoot; David James,7,0,8,1
1653299179129,MATH 20B,A23,089394,Quarfoot; David James,7,0,8,1
1653299179129,MATH 20B,A24,089395,Quarfoot; David James,8,0,8,0
1653299179129,MATH 20B,B01,089397,Lahiri; Aranya,7,0,10,3
1653299179129,MATH 20B,B02,089398,Lahiri; Aranya,10,0,10,0
1653299179129,MATH 20B,B03,089399,Lahiri; Aranya,10,0,10,0
1653299179129,MATH 20B,B04,089400,Lahiri; Aranya,10,0,10,0
1653299179129,MATH 20B,B05,089401,Lahiri; Aranya,10,0,10,0
1653299179129,MATH 20B,C01,089403,Lahiri; Aranya,0,0,0,0
1653299179129,MATH 20B,C02,089404,Lahiri; Aranya,8,0,10,2
1653299179129,MATH 20B,C03,089405,Lahiri; Aranya,10,0,10,0
1653299179129,MATH 20B,C04,089406,Lahiri; Aranya,9,0,10,1
1653299179129,MATH 20B,C05,089407,Lahiri; Aranya,9,0,10,1
1653299179668,MATH 20C,A01,089409,Um; Ko Woon,10,0,10,0
1653299179668,MATH 20C,A02,089410,Um; Ko Woon,10,0,10,0
1653299179668,MATH 20C,A03,089411,Um; Ko Woon,9,0,10,1
1653299179668,MATH 20C,A04,089412,Um; Ko Woon,9,0,10,1
1653299179668,MATH 20C,A05,089413,Um; Ko Woon,10,0,10,0
1653299179668,MATH 20C,A06,089414,Um; Ko Woon,9,0,10,1
1653299179668,MATH 20C,A07,094270,Um; Ko Woon,10,0,10,0
1653299179668,MATH 20C,A08,094271,Um; Ko Woon,10,0,10,0
1653299179668,MATH 20C,A09,094272,Um; Ko Woon,7,0,10,3
1653299179668,MATH 20C,A10,094273,Um; Ko Woon,10,0,10,0
1653299179668,MATH 20C,A11,094274,Um; Ko Woon,10,0,10,0
1653299179668,MATH 20C,A12,094275,Um; Ko Woon,8,0,10,2
1653299179668,MATH 20C,A13,094276,Um; Ko Woon,10,0,10,0
1653299179668,MATH 20C,A14,094277,Um; Ko Woon,10,0,10,0
1653299179668,MATH 20C,A15,094278,Um; Ko Woon,10,0,10,0
1653299179668,MATH 20C,A16,094279,Um; Ko Woon,10,0,10,0
1653299179668,MATH 20C,B03,089418,Zhang; Ming,7,0,15,8
1653299179668,MATH 20C,B04,089419,Zhang; Ming,13,0,15,2
1653299179668,MATH 20C,B05,089420,Zhang; Ming,13,0,15,2
1653299179668,MATH 20C,C01,089423,Staff,15,0,15,0
1653299179668,MATH 20C,C02,089424,Staff,15,0,15,0
1653299179668,MATH 20C,C03,089425,Staff,15,0,15,0
1653299179668,MATH 20C,C04,089426,Staff,15,0,15,0
1653299179668,MATH 20C,C05,089427,Staff,15,0,15,0
1653299179668,MATH 20C,D04,089433,Zhang; Ming,13,0,15,2
1653299179668,MATH 20C,D05,089434,Zhang; Ming,15,0,15,0
1653299179668,MATH 20C,E01,089439,Staff,15,0,15,0
1653299179668,MATH 20C,E02,089440,Staff,15,0,15,0
1653299179668,MATH 20C,E03,089441,Staff,15,0,15,0
1653299179668,MATH 20C,E04,089442,Staff,15,0,15,0
1653299179668,MATH 20C,E05,089443,Staff,15,0,15,0
1653299179668,MATH 20C,E06,089444,Staff,15,0,15,0
1653299179668,MATH 20C,A17,094280,Um; Ko Woon,0,0,0,0
1653299179668,MATH 20C,A18,094281,Um; Ko Woon,0,0,0,0
1653299179668,MATH 20C,A19,094282,Um; Ko Woon,0,0,0,0
1653299179668,MATH 20C,A20,094283,Um; Ko Woon,0,0,0,0
1653299179668,MATH 20C,A21,094284,Um; Ko Woon,0,0,0,0
1653299179668,MATH 20C,A22,094285,Um; Ko Woon,0,0,0,0
1653299179668,MATH 20C,A23,094286,Um; Ko Woon,0,0,0,0
1653299179668,MATH 20C,A24,094287,Um; Ko Woon,0,0,0,0
1653299179668,MATH 20C,B01,089416,Zhang; Ming,0,0,0,0
1653299179668,MATH 20C,B02,089417,Zhang; Ming,0,0,0,0
1653299179668,MATH 20C,D01,089430,Zhang; Ming,0,0,0,0
1653299179668,MATH 20C,D02,089431,Zhang; Ming,0,0,0,0
1653299179668,MATH 20C,D03,089432,Zhang; Ming,0,0,0,0
1653299180194,MATH 20D,A01,089455,Lee; Kisun,11,0,25,14
1653299180194,MATH 20D,A02,089456,Lee; Kisun,24,0,25,1
1653299180194,MATH 20D,A03,089457,Lee; Kisun,24,0,25,1
1653299180194,MATH 20D,A04,089458,Lee; Kisun,25,0,25,0
1653299180194,MATH 20D,A05,089459,Lee; Kisun,25,0,25,0
1653299180194,MATH 20D,A06,089460,Lee; Kisun,25,0,25,0
1653299180194,MATH 20D,B01,089463,Lee; Kisun,20,0,25,5
1653299180194,MATH 20D,B02,089464,Lee; Kisun,25,0,25,0
1653299180194,MATH 20D,B03,089465,Lee; Kisun,24,0,25,1
1653299180194,MATH 20D,B04,089466,Lee; Kisun,25,0,25,0
1653299180194,MATH 20D,B05,089467,Lee; Kisun,23,0,25,2
1653299180194,MATH 20D,B06,089468,Lee; Kisun,24,0,25,1
1653299180194,MATH 20D,C01,089471,Staff,23,0,25,2
1653299180194,MATH 20D,C02,089472,Staff,25,0,25,0
1653299180194,MATH 20D,C03,089473,Staff,25,0,25,0
1653299180194,MATH 20D,C04,089474,Staff,25,0,25,0
1653299180194,MATH 20D,C05,089475,Staff,25,0,25,0
1653299180194,MATH 20D,C06,089476,Staff,25,0,25,0
1653299180720,MATH 20E,A01,089479,Eggers; John Dietrich,17,0,24,7
1653299180720,MATH 20E,A02,089480,Eggers; John Dietrich,24,0,25,1
1653299180720,MATH 20E,A03,089481,Eggers; John Dietrich,25,0,25,0
1653299180720,MATH 20E,A04,089482,Eggers; John Dietrich,25,0,25,0
1653299180720,MATH 20E,A05,089483,Eggers; John Dietrich,19,0,25,6
1653299180720,MATH 20E,A06,089484,Eggers; John Dietrich,25,0,25,0
1653299180720,MATH 20E,A07,089485,Eggers; John Dietrich,24,0,25,1
1653299180720,MATH 20E,A08,089486,Eggers; John Dietrich,24,0,25,1
1653299180720,MATH 20E,B01,089488,Staff,15,0,25,10
1653299180720,MATH 20E,B02,089489,Staff,21,0,25,4
1653299180720,MATH 20E,B03,089490,Staff,25,0,25,0
1653299180720,MATH 20E,B04,089491,Staff,25,0,25,0
1653299180720,MATH 20E,B05,089492,Staff,24,0,25,1
1653299180720,MATH 20E,B06,089493,Staff,24,0,25,1
1653299180720,MATH 20E,B07,089494,Staff,25,0,25,0
1653299180720,MATH 20E,B08,089495,Staff,25,0,25,0
1653299180720,MATH 20E,C01,089497,Staff,23,0,25,2
1653299180720,MATH 20E,C02,089498,Staff,25,0,25,0
1653299180720,MATH 20E,C03,089499,Staff,25,0,25,0
1653299180720,MATH 20E,C04,089500,Staff,25,0,25,0
1653299180720,MATH 20E,C05,089501,Staff,25,0,25,0
1653299180720,MATH 20E,C06,089502,Staff,25,0,25,0
1653299180720,MATH 20E,C07,089503,Staff,25,0,25,0
1653299180720,MATH 20E,C08,089504,Staff,25,0,25,0
1653299181256,MATH 31AH,A01,089506,Rabin; Jeffrey Mark,35,0,35,0
1653299181256,MATH 31AH,A02,089507,Rabin; Jeffrey Mark,35,0,35,0
1653299181780,MATH 87,A00,094827,Meyer; David A.,20,0,20,0
1653299182303,MATH 96,A00,094836,Kane; Daniel Mertz,11,0,30,19
1653299182828,MATH 100A,A01,089509,Kedlaya; Kiran S.,23,0,30,7
1653299182828,MATH 100A,A02,089510,Kedlaya; Kiran S.,28,0,30,2
1653299182828,MATH 100A,B01,089512,Greenfeld; Be'Eri,24,0,30,6
1653299182828,MATH 100A,B02,089513,Greenfeld; Be'Eri,30,0,30,0
1653299183353,MATH 102,A01,089515,Hodges; Reuven Moses,25,0,30,5
1653299183353,MATH 102,A02,089516,Hodges; Reuven Moses,30,0,30,0
1653299183353,MATH 102,A03,089517,Hodges; Reuven Moses,30,0,30,0
1653299183353,MATH 102,A04,089518,Hodges; Reuven Moses,29,0,30,1
1653299183353,MATH 102,B01,089520,Hodges; Reuven Moses,29,0,30,1
1653299183353,MATH 102,B02,089521,Hodges; Reuven Moses,29,0,30,1
1653299183353,MATH 102,B03,089522,Hodges; Reuven Moses,29,0,30,1
1653299183353,MATH 102,B04,089523,Hodges; Reuven Moses,30,0,30,0
1653299183884,MATH 103A,A01,089525,Staff,27,0,30,3
1653299183884,MATH 103A,A02,089526,Staff,30,0,30,0
1653299183884,MATH 103A,B01,089528,Seward; Brandon M.,9,0,30,21
1653299183884,MATH 103A,B02,089529,Seward; Brandon M.,22,0,30,8
1653299183884,MATH 103A,C01,089531,Staff,27,0,30,3
1653299183884,MATH 103A,C02,089532,Staff,28,0,30,2
1653299183884,MATH 103A,D01,089534,Staff,28,0,30,2
1653299183884,MATH 103A,D02,089535,Staff,28,0,30,2
1653299184417,MATH 109,A01,089537,Chung; Kwun,9,0,10,1
1653299184417,MATH 109,A02,089538,Chung; Kwun,10,0,10,0
1653299184417,MATH 109,B01,089540,Belmont; Eva Kinoshita,9,0,10,1
1653299184417,MATH 109,B02,089541,Belmont; Eva Kinoshita,6,0,10,4
1653299184417,MATH 109,C01,089543,Chow; Bennett,8,0,10,2
1653299184417,MATH 109,C02,089544,Chow; Bennett,10,0,10,0
1653299184417,MATH 109,D01,089546,Chung; Kwun,9,0,10,1
1653299184417,MATH 109,D02,089547,Chung; Kwun,9,0,10,1
1653299184417,MATH 109,E01,089549,Schweinsberg; Jason,6,0,10,4
1653299184417,MATH 109,E02,089550,Schweinsberg; Jason,10,0,10,0
1653299184941,MATH 110,A01,089552,Wenzl; Hans G,27,0,35,8
1653299184941,MATH 110,A02,089553,Wenzl; Hans G,33,0,35,2
1653299185464,MATH 111A,A01,089555,Meyer; David A.,0,0,0,1
1653299185988,MATH 120A,A01,089557,Manners; Frederick,30,0,35,5
1653299185988,MATH 120A,A02,089558,Manners; Frederick,33,0,35,2
1653299186517,MATH 140A,A01,089560,Seward; Brandon M.,25,0,30,5
1653299186517,MATH 140A,A02,089561,Seward; Brandon M.,29,0,30,1
1653299186517,MATH 140A,B01,089563,Chan; Pak Yeung,30,0,30,0
1653299186517,MATH 140A,B02,089564,Chan; Pak Yeung,22,0,30,8
1653299187048,MATH 142A,A01,089566,Staff,29,0,30,1
1653299187048,MATH 142A,A02,089567,Staff,29,0,30,1
1653299187048,MATH 142A,B01,089569,Staff,30,0,30,0
1653299187048,MATH 142A,B02,089570,Staff,29,0,30,1
1653299187048,MATH 142A,C01,089572,Staff,26,0,30,4
1653299187048,MATH 142A,C02,089573,Staff,29,0,30,1
1653299187048,MATH 142A,D01,089575,Eggers; John Dietrich,15,0,30,15
1653299187048,MATH 142A,D02,089576,Eggers; John Dietrich,27,0,30,3
1653299187571,MATH 144,A01,089578,Bejenaru; Ioan,29,0,30,1
1653299188095,MATH 150A,A01,089580,Chow; Bennett,29,0,35,6
1653299188095,MATH 150A,A02,089581,Chow; Bennett,34,0,35,1
1653299189153,MATH 153,A01,094204,Harel; Guershon,33,0,35,2
1653299189684,MATH 154,A01,089590,Verstraete; Jacques Allan,3,0,30,27
1653299189684,MATH 154,A02,089591,Verstraete; Jacques Allan,23,0,30,7
1653299189684,MATH 154,A03,089592,Verstraete; Jacques Allan,28,0,30,2
1653299189684,MATH 154,A04,089593,Verstraete; Jacques Allan,26,0,30,4
1653299190210,MATH 155A,A01,089595,Buss; Samuel R,22,0,35,13
1653299190210,MATH 155A,A02,089596,Buss; Samuel R,32,0,35,3
1653299190736,MATH 160A,A01,089598,Manners; Frederick,28,0,35,7
1653299190736,MATH 160A,A02,094207,Manners; Frederick,34,0,35,1
1653299191266,MATH 170A,A01,089600,Liu; Shuang,24,0,25,1
1653299191266,MATH 170A,A02,089601,Liu; Shuang,24,0,25,1
1653299191266,MATH 170A,A03,089602,Liu; Shuang,24,0,25,1
1653299191266,MATH 170A,A04,089603,Liu; Shuang,23,0,25,2
1653299191266,MATH 170A,B01,089605,Dumitriu; Ioana,8,0,25,17
1653299191266,MATH 170A,B02,089606,Dumitriu; Ioana,20,0,25,5
1653299191266,MATH 170A,B03,089607,Dumitriu; Ioana,21,0,25,4
1653299191266,MATH 170A,B04,089608,Dumitriu; Ioana,25,0,25,0
1653299191797,MATH 173A,A01,089610,Cloninger; Alexander,0,0,35,35
1653299191797,MATH 173A,A02,089611,Cloninger; Alexander,2,0,35,33
1653299191797,MATH 173A,A03,089612,Cloninger; Alexander,20,0,35,15
1653299192323,MATH 174,A01,089614,Cheng; Li-Tien,23,0,25,2
1653299192323,MATH 174,A02,089615,Cheng; Li-Tien,25,0,25,0
1653299192854,MATH 180A,A01,089617,Jekel; David Andrew,0,0,25,25
1653299192854,MATH 180A,A02,089618,Jekel; David Andrew,23,0,25,2
1653299192854,MATH 180A,A03,089619,Jekel; David Andrew,22,0,25,3
1653299192854,MATH 180A,A04,089620,Jekel; David Andrew,22,0,25,3
1653299192854,MATH 180A,A05,089621,Jekel; David Andrew,24,0,25,1
1653299192854,MATH 180A,A06,089622,Jekel; David Andrew,23,0,25,2
1653299192854,MATH 180A,B01,089624,Agarwal; Pooja,23,0,25,2
1653299192854,MATH 180A,B02,089625,Agarwal; Pooja,24,0,25,1
1653299192854,MATH 180A,B03,089626,Agarwal; Pooja,22,0,25,3
1653299192854,MATH 180A,B04,089627,Agarwal; Pooja,25,0,25,0
1653299192854,MATH 180A,B05,089628,Agarwal; Pooja,24,0,25,1
1653299192854,MATH 180A,B06,089629,Agarwal; Pooja,25,0,25,0
1653299192854,MATH 180A,C01,089631,Staff,22,0,25,3
1653299192854,MATH 180A,C02,089632,Staff,25,0,25,0
1653299192854,MATH 180A,C03,089633,Staff,25,0,25,0
1653299192854,MATH 180A,C04,089634,Staff,25,0,25,0
1653299193380,MATH 180C,A01,089636,Fitzsimmons; Patrick J,4,0,25,21
1653299193380,MATH 180C,A02,089637,Fitzsimmons; Patrick J,21,0,25,4
1653299193905,MATH 181B,A01,089639,Rava; Denise,31,0,35,4
1653299193905,MATH 181B,A02,089640,Rava; Denise,34,0,35,1
1653299193905,MATH 181B,A03,089641,Rava; Denise,31,0,35,4
1653299193905,MATH 181B,A04,089642,Rava; Denise,35,0,35,0
1653299194429,MATH 183,A01,089644,Staff,10,0,25,15
1653299194429,MATH 183,A02,089645,Staff,23,0,25,2
1653299194429,MATH 183,A03,089646,Staff,23,0,25,2
1653299194429,MATH 183,A04,089647,Staff,25,0,25,0
1653299194429,MATH 183,A05,089648,Staff,19,0,25,6
1653299194429,MATH 183,A06,089649,Staff,22,0,25,3
1653299194429,MATH 183,A07,089650,Staff,25,0,25,0
1653299194429,MATH 183,A08,089651,Staff,25,0,25,0
1653299194957,MATH 184,A01,089653,Kane; Daniel Mertz,24,0,30,6
1653299194957,MATH 184,A02,089654,Kane; Daniel Mertz,30,0,30,0
1653299194957,MATH 184,A03,089655,Kane; Daniel Mertz,30,0,30,0
1653299194957,MATH 184,A04,089656,Kane; Daniel Mertz,30,0,30,0
1653299195482,MATH 187A,A01,089658,Bucur; Alina Ioana,0,0,25,25
1653299195482,MATH 187A,A02,089659,Bucur; Alina Ioana,12,0,25,13
1653299195482,MATH 187A,A03,089660,Bucur; Alina Ioana,0,0,25,25
1653299195482,MATH 187A,A04,089661,Bucur; Alina Ioana,17,0,25,8
1653299196005,MATH 187B,A01,089663,Bucur; Alina Ioana,28,0,35,7
1653299196005,MATH 187B,A02,089664,Bucur; Alina Ioana,34,0,35,1
1653299196530,MATH 188,A01,094817,Sam; Steven V,33,0,35,2
1653299197059,MATH 190A,A01,089666,Sam; Steven V,21,0,35,14
1653299197582,MATH 196,A00,089667,Spolaor; Luca,33,0,45,12
1653299198112,MCWP 40,004,093486,Wastal; Carrie King,0,0,3,3
1653299198112,MCWP 40,005,093487,Wastal; Carrie King,0,0,3,3
1653299198112,MCWP 40,006,093488,Wastal; Carrie King,3,0,3,0
1653299198112,MCWP 40,007,093489,Wastal; Carrie King,3,0,3,0
1653299198112,MCWP 40,008,093490,Wastal; Carrie King,2,0,3,1
1653299198112,MCWP 40,009,093491,Wastal; Carrie King,2,0,3,1
1653299198112,MCWP 40,013,093495,Wastal; Carrie King,3,0,3,0
1653299198112,MCWP 40,014,093496,Wastal; Carrie King,0,0,3,3
1653299198112,MCWP 40,015,093497,Wastal; Carrie King,3,0,3,0
1653299198112,MCWP 40,016,093498,Wastal; Carrie King,3,0,3,0
1653299198112,MCWP 40,017,093499,Wastal; Carrie King,3,0,3,0
1653299198112,MCWP 40,018,093500,Wastal; Carrie King,1,0,3,2
1653299198112,MCWP 40,020,093502,Wastal; Carrie King,0,0,0,0
1653299198112,MCWP 40,021,093503,Wastal; Carrie King,3,0,3,0
1653299198112,MCWP 40,022,093504,Wastal; Carrie King,2,0,3,1
1653299198112,MCWP 40,023,093505,Wastal; Carrie King,2,0,3,1
1653299198112,MCWP 40,024,093506,Wastal; Carrie King,2,0,3,1
1653299198112,MCWP 40,026,093508,Wastal; Carrie King,3,0,3,0
1653299198112,MCWP 40,027,093509,Wastal; Carrie King,3,0,3,0
1653299198112,MCWP 40,028,093510,Wastal; Carrie King,3,0,3,0
1653299198112,MCWP 40,029,093511,Wastal; Carrie King,3,0,3,0
1653299198112,MCWP 40,030,093512,Wastal; Carrie King,2,0,3,1
1653299198112,MCWP 40,032,093514,Wastal; Carrie King,2,0,3,1
1653299198112,MCWP 40,033,093515,Wastal; Carrie King,3,0,3,0
1653299198112,MCWP 40,034,093516,Wastal; Carrie King,3,0,3,0
1653299198112,MCWP 40,035,093517,Wastal; Carrie King,3,0,3,0
1653299198112,MCWP 40,038,093520,Wastal; Carrie King,2,0,3,1
1653299198112,MCWP 40,039,093521,Wastal; Carrie King,3,0,3,0
1653299198112,MCWP 40,041,093523,Wastal; Carrie King,2,0,3,1
1653299198112,MCWP 40,042,093524,Wastal; Carrie King,3,0,3,0
1653299198112,MCWP 40,043,093525,Wastal; Carrie King,0,0,0,0
1653299198112,MCWP 40,049,093531,Wastal; Carrie King,2,0,3,1
1653299198112,MCWP 40,050,093532,Wastal; Carrie King,3,0,3,0
1653299198112,MCWP 40,051,093533,Wastal; Carrie King,3,0,3,0
1653299198643,MCWP 50,001,093534,Wastal; Carrie King,0,0,0,0
1653299198643,MCWP 50,002,093535,Wastal; Carrie King,0,0,3,3
1653299198643,MCWP 50,003,093536,Wastal; Carrie King,0,0,3,3
1653299198643,MCWP 50,004,093537,Wastal; Carrie King,0,0,3,3
1653299198643,MCWP 50,005,093538,Wastal; Carrie King,0,0,3,3
1653299198643,MCWP 50,006,093539,Wastal; Carrie King,2,0,3,1
1653299198643,MCWP 50,007,093540,Wastal; Carrie King,0,0,3,3
1653299198643,MCWP 50,008,093541,Wastal; Carrie King,0,0,3,3
1653299198643,MCWP 50,009,093542,Wastal; Carrie King,0,0,3,3
1653299198643,MCWP 50,010,093543,Wastal; Carrie King,0,0,3,3
1653299198643,MCWP 50,013,093546,Wastal; Carrie King,1,0,3,2
1653299198643,MCWP 50,014,093547,Wastal; Carrie King,0,0,3,3
1653299198643,MCWP 50,015,093548,Wastal; Carrie King,0,0,3,3
1653299198643,MCWP 50,016,093549,Wastal; Carrie King,0,0,0,0
1653299199170,MCWP 125,A00,093550,Wilson; Marion E.,3,0,3,0
1653299199170,MCWP 125,B00,093551,Guillen; Melinda,3,0,3,0
1653299199170,MCWP 125,C00,093552,Guillen; Melinda,3,0,3,0
1653299199170,MCWP 125,D00,093553,Guillen; Melinda,3,0,3,0
1653299199170,MCWP 125,E00,093554,Miller; Elizabeth Deen,3,0,3,0
1653299199170,MCWP 125,F00,093555,Miller; Elizabeth Deen,3,0,3,0
1653299199170,MCWP 125,G00,093556,Miller; Elizabeth Deen,3,0,3,0
1653299199694,MGT 3,A00,087704,Wagner; Timothy Ryan,90,0,90,0
1653299200220,MGT 4,A01,087706,Levkoff; Steven B.,2,0,3,1
1653299200220,MGT 4,A02,087707,Levkoff; Steven B.,3,0,3,0
1653299200220,MGT 4,A03,092659,Levkoff; Steven B.,1,0,4,3
1653299200744,MGT 5,A00,087708,Houskeeper; Robert,194,0,196,2
1653299201275,MGT 12,A00,087709,Pecore; Joseph P.,91,0,100,9
1653299201275,MGT 12,B00,087710,Lindenberger; Wade Douglas,91,0,100,9
1653299201804,MGT 16,A00,087711,Campbell; Robert Harold,108,0,110,2
1653299201804,MGT 16,B00,087712,Campbell; Robert Harold,110,0,110,0
1653299201804,MGT 16,C00,087713,Lindenberger; Wade Douglas,100,0,110,10
1653299201804,MGT 16,D00,087714,Lindenberger; Wade Douglas,107,0,110,3
1653299201804,MGT 16,E00,094819,Buchanan; Harold G,99,0,100,1
1653299202334,MGT 18,A00,087715,McKay; Michael J,88,0,90,2
1653299202334,MGT 18,B00,087716,McKay; Michael J,90,0,90,0
1653299202334,MGT 18,C00,087717,McKay; Michael J,88,0,90,2
1653299202334,MGT 18,D00,087718,McKay; Mary A,90,0,90,0
1653299202334,MGT 18,E00,087719,McKay; Mary A,87,0,90,3
1653299202950,MGT 45,A00,087720,Pecore; Joseph P.,136,0,150,14
1653299202950,MGT 45,B00,087721,Pecore; Joseph P.,140,0,150,10
1653299203477,MGT 52,A00,087722,Deal; Jennifer Jean,83,0,90,7
1653299204000,MGT 71,A00,087723,August; Terrence,60,0,90,30
1653299205050,MGT 103,A00,087726,Ehrich; Kristine R,86,0,90,4
1653299205050,MGT 103,B00,087727,Ehrich; Kristine R,89,0,90,1
1653299205050,MGT 103,C00,087728,Eberhard; Craig A,89,0,90,1
1653299205050,MGT 103,D00,087729,Eberhard; Craig A,88,0,90,2
1653299205050,MGT 103,E00,087730,Demill; Burritt,75,0,90,15
1653299205050,MGT 103,F00,087731,Bates; Kenneth Walter,81,0,90,9
1653299205050,MGT 103,G00,087732,Bates; Kenneth Walter,88,0,90,2
1653299205572,MGT 105,A00,087733,Campbell; Robert Harold,102,0,120,18
1653299206099,MGT 106,A00,087734,Eberhard; Craig A,81,0,90,9
1653299206627,MGT 108R,A00,087735,Amir; On,84,0,90,6
1653299207149,MGT 109,A00,087736,Staff,77,0,90,13
1653299207674,MGT 112,A00,087737,Somasundaram; Tyagarajan,89,0,90,1
1653299207674,MGT 112,B00,087738,Somasundaram; Tyagarajan,86,0,90,4
1653299207674,MGT 112,C00,087739,Ehrich; Kristine R,86,0,90,4
1653299207674,MGT 112,D00,087740,Zimmermann; Carsten,65,0,90,25
1653299208203,MGT 121A,A00,087741,Wang; Helen Shan,65,0,70,5
1653299208203,MGT 121A,B00,087742,Wang; Helen Shan,64,0,70,6
1653299208726,MGT 131A,A00,087743,Houskeeper; Robert,146,0,150,4
1653299209251,MGT 132,A00,087744,Blakley; Bruce,88,0,90,2
1653299209774,MGT 134,A00,087745,Houskeeper; Robert,84,0,90,6
1653299210301,MGT 135,A00,087746,Anderson; John Charles,83,0,90,7
1653299210827,MGT 139,A00,087747,Perols; Johan Lars,88,0,90,2
1653299211368,MGT 153,A00,087748,Perols; Johan Lars,82,0,90,8
1653299211368,MGT 153,B00,087749,Phiroz; Zal Navroze,76,0,90,14
1653299211368,MGT 153,C00,087750,Phiroz; Zal Navroze,87,0,90,3
1653299211896,MGT 162R,A00,087751,Gneezy; Uri,64,0,90,26
1653299212424,MGT 164,A00,087752,McKay; Mary A,90,0,90,0
1653299212424,MGT 164,B00,087753,Meyer; Alison Bloomfield,0,0,0,0
1653299212424,MGT 164,C00,087754,Smith; Pamela Karen,82,0,90,8
1653299212955,MGT 166,A00,087755,Moran; Cathleen L.,89,0,90,1
1653299212955,MGT 166,B00,087756,Moran; Cathleen L.,90,0,90,0
1653299212955,MGT 166,C00,087757,Moran; Cathleen L.,90,0,90,0
1653299212955,MGT 166,D00,087758,Demill; Burritt,56,0,90,34
1653299213484,MGT 167,A00,087759,Klaas; Jeffrey David,88,0,90,2
1653299213484,MGT 167,B00,087760,Jacob; Jo Dee C,83,0,90,7
1653299214016,MGT 171,A00,087761,Phiroz; Zal Navroze,85,0,90,5
1653299214544,MGT 172,A00,087762,Hedges; Kathleen & Royal; Rebecca,96,0,100,4
1653299214544,MGT 172,B00,087763,Hedges; Kathleen,79,0,90,11
1653299214544,MGT 172,C00,087764,Zimmermann; Carsten,90,0,90,0
1653299215070,MGT 172R,A00,094888,Erat; Sanjiv,90,0,90,0
1653299215611,MGT 173,A00,087765,Hayes; Sherry Lorine,80,0,100,20
1653299216137,MGT 175,A00,087766,Gopal; Christopher S.,84,0,90,6
1653299216660,MGT 181,A00,087767,Buchanan; Harold G,114,0,120,6
1653299216660,MGT 181,B00,087768,Buchanan; Harold G,110,0,120,10
1653299216660,MGT 181,C00,087769,Bliss; Barbara Ann,109,0,120,11
1653299217712,MGT 185,A00,087771,Dunn; Louis Jean,84,0,90,6
1653299218239,MGT 187,A00,087772,Dunn; Louis Jean,138,0,146,8
1653299218765,MMW 11,A01,086931,duBois; Page Ann,4,0,4,0
1653299218765,MMW 11,A02,086932,duBois; Page Ann,4,0,4,0
1653299218765,MMW 11,A03,086933,duBois; Page Ann,3,0,4,1
1653299218765,MMW 11,A04,086934,duBois; Page Ann,3,0,4,1
1653299218765,MMW 11,A05,086935,duBois; Page Ann,4,0,4,0
1653299218765,MMW 11,A06,086936,duBois; Page Ann,3,0,4,1
1653299218765,MMW 11,A07,086937,duBois; Page Ann,4,0,4,0
1653299218765,MMW 11,A08,086938,duBois; Page Ann,4,0,4,0
1653299218765,MMW 11,A09,086939,duBois; Page Ann,4,0,4,0
1653299218765,MMW 11,A10,086940,duBois; Page Ann,4,0,4,0
1653299218765,MMW 11,A11,086941,duBois; Page Ann,4,0,4,0
1653299218765,MMW 11,A12,093877,duBois; Page Ann,3,0,4,1
1653299219291,MMW 11R,A01,093852,Herbst; Matthew,4,0,4,0
1653299219291,MMW 11R,A02,093853,Herbst; Matthew,4,0,4,0
1653299219291,MMW 11R,A03,093854,Herbst; Matthew,4,0,4,0
1653299219291,MMW 11R,A04,093855,Herbst; Matthew,4,0,4,0
1653299219291,MMW 11R,A05,093856,Herbst; Matthew,4,0,4,0
1653299219291,MMW 11R,A06,093857,Herbst; Matthew,4,0,4,0
1653299219291,MMW 11R,A07,093858,Herbst; Matthew,4,0,4,0
1653299219291,MMW 11R,A08,093859,Herbst; Matthew,4,0,4,0
1653299219291,MMW 11R,A09,093860,Herbst; Matthew,4,0,4,0
1653299219291,MMW 11R,A10,093861,Herbst; Matthew,4,0,4,0
1653299219291,MMW 11R,A11,093862,Herbst; Matthew,4,0,4,0
1653299219291,MMW 11R,A12,093863,Herbst; Matthew,4,0,4,0
1653299219291,MMW 11R,B01,093865,Herbst; Matthew,4,0,4,0
1653299219291,MMW 11R,B02,093866,Herbst; Matthew,4,0,4,0
1653299219291,MMW 11R,B03,093867,Herbst; Matthew,4,0,4,0
1653299219291,MMW 11R,B04,093868,Herbst; Matthew,4,0,4,0
1653299219291,MMW 11R,B05,093869,Herbst; Matthew,4,0,4,0
1653299219291,MMW 11R,B06,093870,Herbst; Matthew,4,0,4,0
1653299219291,MMW 11R,B07,093871,Herbst; Matthew,4,0,4,0
1653299219291,MMW 11R,B08,093872,Herbst; Matthew,4,0,4,0
1653299219291,MMW 11R,B09,093873,Herbst; Matthew,4,0,4,0
1653299219291,MMW 11R,B10,093874,Herbst; Matthew,4,0,4,0
1653299219291,MMW 11R,B11,093875,Herbst; Matthew,4,0,4,0
1653299219291,MMW 11R,B12,093876,Herbst; Matthew,4,0,4,0
1653299219823,MMW 14,A01,086968,Chang; Edmond Yi-Teh,28,0,28,0
1653299219823,MMW 14,A02,086969,Chang; Edmond Yi-Teh,27,0,28,1
1653299219823,MMW 14,A03,086970,Chang; Edmond Yi-Teh,21,0,28,7
1653299219823,MMW 14,A04,086971,Chang; Edmond Yi-Teh,27,0,28,1
1653299219823,MMW 14,A05,086972,Chang; Edmond Yi-Teh,26,0,28,2
1653299219823,MMW 14,A06,086973,Chang; Edmond Yi-Teh,28,0,28,0
1653299219823,MMW 14,A07,086974,Chang; Edmond Yi-Teh,27,0,28,1
1653299219823,MMW 14,A08,086975,Chang; Edmond Yi-Teh,25,0,28,3
1653299219823,MMW 14,A09,086976,Chang; Edmond Yi-Teh,0,0,0,0
1653299219823,MMW 14,A10,086977,Chang; Edmond Yi-Teh,27,0,28,1
1653299219823,MMW 14,A11,086978,Chang; Edmond Yi-Teh,26,0,28,2
1653299219823,MMW 14,A12,086979,Chang; Edmond Yi-Teh,27,0,28,1
1653299219823,MMW 14,A13,086980,Chang; Edmond Yi-Teh,28,0,28,0
1653299220351,MMW 121,A01,086982,Chang; Edmond Yi-Teh,0,0,0,0
1653299220351,MMW 121,A02,086983,Chang; Edmond Yi-Teh,0,0,0,0
1653299220351,MMW 121,A03,086984,Chang; Edmond Yi-Teh,2,0,4,2
1653299220351,MMW 121,A04,086985,Chang; Edmond Yi-Teh,4,0,4,0
1653299220351,MMW 121,A05,086986,Chang; Edmond Yi-Teh,4,0,4,0
1653299220351,MMW 121,A06,086987,Chang; Edmond Yi-Teh,4,0,4,0
1653299220351,MMW 121,A07,086988,Chang; Edmond Yi-Teh,4,0,4,0
1653299220351,MMW 121,A08,086989,Chang; Edmond Yi-Teh,4,0,4,0
1653299220351,MMW 121,B01,086991,Patterson; Patrick H.,4,0,4,0
1653299220351,MMW 121,B02,086992,Patterson; Patrick H.,4,0,4,0
1653299220351,MMW 121,B03,086993,Patterson; Patrick H.,4,0,4,0
1653299220351,MMW 121,B04,086994,Patterson; Patrick H.,3,0,4,1
1653299220351,MMW 121,B05,086995,Patterson; Patrick H.,4,0,4,0
1653299220351,MMW 121,B06,086996,Patterson; Patrick H.,4,0,4,0
1653299220351,MMW 121,B07,086997,Patterson; Patrick H.,4,0,4,0
1653299220351,MMW 121,B08,086998,Patterson; Patrick H.,4,0,4,0
1653299220351,MMW 121,B09,086999,Patterson; Patrick H.,4,0,4,0
1653299220351,MMW 121,B10,087000,Patterson; Patrick H.,4,0,4,0
1653299220351,MMW 121,B11,087001,Patterson; Patrick H.,0,0,0,0
1653299220351,MMW 121,B12,087002,Patterson; Patrick H.,0,0,0,0
1653299220881,MUS 1A,A01,090497,Staff,19,0,20,1
1653299220881,MUS 1A,A02,090498,Staff,13,0,20,7
1653299220881,MUS 1A,A03,090499,Staff,18,0,20,2
1653299220881,MUS 1A,A04,090500,Staff,19,0,20,1
1653299220881,MUS 1A,A05,090501,Staff,20,0,20,0
1653299220881,MUS 1A,A06,090502,Staff,20,0,20,0
1653299220881,MUS 1A,B01,090504,Staff,18,0,20,2
1653299220881,MUS 1A,B02,090505,Staff,20,0,20,0
1653299220881,MUS 1A,B03,090506,Staff,18,0,20,2
1653299220881,MUS 1A,B04,090507,Staff,18,0,20,2
1653299220881,MUS 1A,B05,090508,Staff,16,0,20,4
1653299220881,MUS 1A,B06,090509,Staff,20,0,20,0
1653299221409,MUS 2A,A01,090511,Carlson; Erik Norman,19,0,20,1
1653299221933,MUS 2AK,A00,090512,Ohnishi; Takae,24,0,25,1
1653299221933,MUS 2AK,B00,090513,Ohnishi; Takae,15,0,15,0
1653299222456,MUS 4,A01,090515,Staff,24,0,25,1
1653299222456,MUS 4,A02,090516,Staff,24,0,25,1
1653299222456,MUS 4,A03,090517,Staff,22,0,25,3
1653299222456,MUS 4,A04,090518,Staff,24,0,25,1
1653299222456,MUS 4,A05,090519,Staff,25,0,25,0
1653299222456,MUS 4,A06,090520,Staff,25,0,25,0
1653299222456,MUS 4,A07,090521,Staff,24,0,25,1
1653299222456,MUS 4,A08,090522,Staff,24,0,25,1
1653299222979,MUS 5,A01,090524,Staff,20,0,20,0
1653299222979,MUS 5,A02,090525,Staff,18,0,20,2
1653299222979,MUS 5,A03,090526,Staff,20,0,20,0
1653299222979,MUS 5,A04,090527,Staff,20,0,20,0
1653299222979,MUS 5,A05,090528,Staff,19,0,20,1
1653299223516,MUS 6,A01,090530,Staff,22,0,25,3
1653299223516,MUS 6,A02,090531,Staff,25,0,25,0
1653299223516,MUS 6,A03,090532,Staff,25,0,25,0
1653299223516,MUS 6,A04,090533,Staff,23,0,25,2
1653299224041,MUS 8,A01,090535,Kenyatta; Kamau,17,0,25,8
1653299224041,MUS 8,A02,090536,Kenyatta; Kamau,19,0,25,6
1653299224041,MUS 8,A03,090537,Kenyatta; Kamau,17,0,25,8
1653299224041,MUS 8,A04,090538,Kenyatta; Kamau,21,0,25,4
1653299224565,MUS 12,A01,090540,Narucki; Susan M,20,0,20,0
1653299224565,MUS 12,A02,090541,Narucki; Susan M,20,0,20,0
1653299224565,MUS 12,A03,090542,Narucki; Susan M,17,0,20,3
1653299225091,MUS 15,A01,090544,Staff,21,0,25,4
1653299225091,MUS 15,A02,090545,Staff,23,0,25,2
1653299225091,MUS 15,A03,090546,Staff,24,0,25,1
1653299225091,MUS 15,A04,090547,Staff,22,0,25,3
1653299225091,MUS 15,A05,090548,Staff,25,0,25,0
1653299225091,MUS 15,A06,090549,Staff,24,0,25,1
1653299225616,MUS 19R,A01,090551,Britt; King James,17,0,20,3
1653299225616,MUS 19R,A02,090552,Britt; King James,19,0,20,1
1653299225616,MUS 19R,A03,090553,Britt; King James,20,0,20,0
1653299225616,MUS 19R,A04,090554,Britt; King James,19,0,20,1
1653299225616,MUS 19R,A05,090555,Britt; King James,20,0,20,0
1653299225616,MUS 19R,A06,090556,Britt; King James,18,0,20,2
1653299225616,MUS 19R,A07,090557,Britt; King James,19,0,20,1
1653299225616,MUS 19R,A08,090558,Britt; King James,19,0,20,1
1653299225616,MUS 19R,A09,090559,Britt; King James,20,0,20,0
1653299225616,MUS 19R,A10,090560,Britt; King James,20,0,20,0
1653299225616,MUS 19R,B01,090562,Britt; King James,10,0,10,0
1653299225616,MUS 19R,B02,090563,Britt; King James,10,0,10,0
1653299225616,MUS 19R,B03,090564,Britt; King James,10,0,10,0
1653299225616,MUS 19R,B04,090565,Britt; King James,10,0,10,0
1653299225616,MUS 19R,B05,090566,Britt; King James,10,0,10,0
1653299225616,MUS 19R,B06,090567,Britt; King James,10,0,10,0
1653299225616,MUS 19R,B07,090568,Britt; King James,10,0,10,0
1653299225616,MUS 19R,B08,090569,Britt; King James,10,0,10,0
1653299225616,MUS 19R,B09,090570,Britt; King James,10,0,10,0
1653299225616,MUS 19R,B10,090571,Britt; King James,10,0,10,0
1653299226147,MUS 20,A01,090573,Borgo; David Garcia,12,0,15,3
1653299226147,MUS 20,A02,090574,Borgo; David Garcia,14,0,15,1
1653299226147,MUS 20,A03,090575,Borgo; David Garcia,13,0,15,2
1653299226674,MUS 32,001,094074,Staff,10,0,10,0
1653299226674,MUS 32,002,094075,Kenyatta; Kamau,10,0,10,0
1653299226674,MUS 32,003,094076,Curtis; Charles Rector,10,0,10,0
1653299226674,MUS 32,005,094078,Terrazas Perez; Wilfrido D,10,0,10,0
1653299226674,MUS 32,006,094079,Ohnishi; Takae,10,0,10,0
1653299226674,MUS 32,007,094080,Burr; Anthony I,10,0,10,0
1653299226674,MUS 32,008,094081,Carlson; Erik Norman,10,0,10,0
1653299226674,MUS 32,009,094082,Dresser; Mark Stuart,10,0,10,0
1653299226674,MUS 32,011,094084,Richards; Stephanie F,10,0,10,0
1653299226674,MUS 32,012,094085,Borgo; David Garcia,10,0,10,0
1653299226674,MUS 32,013,094086,Paganos Koukakis; Dimitrios,10,0,10,0
1653299226674,MUS 32,014,094087,Jones; Michael David,10,0,10,0
1653299227197,MUS 32V,A00,094355,Zazueta Cervera; Miguel Angel,10,0,10,0
1653299227197,MUS 32V,B00,094089,Flores; Mariana,10,0,10,0
1653299227720,MUS 32VM,A00,094090,Zazueta Cervera; Miguel Angel,15,0,15,0
1653299228246,MUS 33A,A00,090576,Liang; Lei,24,0,25,1
1653299228769,MUS 43,A00,090577,Burr; Anthony I,92,0,100,8
1653299229290,MUS 95C,B00,094829,Staff,28,0,30,2
1653299229821,MUS 95D,A00,090579,Staff,30,0,30,0
1653299230346,MUS 95E,A00,090580,Staff,30,0,30,0
1653299230870,MUS 95G,A00,090581,Anderson; Kenneth,384,0,395,11
1653299230870,MUS 95G,B00,090582,Anderson; Kenneth,393,0,395,2
1653299231393,MUS 95JC,A00,090583,Kenyatta; Kamau,35,0,35,0
1653299231918,MUS 95L,A00,090584,Staff,30,0,30,0
1653299232441,MUS 95W,A00,090585,Seshadri; Kartik,60,0,60,0
1653299232441,MUS 95W,B00,090586,Seshadri; Kartik,30,0,30,0
1653299232964,MUS 101A,A01,090588,Staff,29,0,30,1
1653299233489,MUS 103A,A00,090589,Ung; Chinary,15,0,15,0
1653299234015,MUS 107,A00,090590,Terrazas Perez; Wilfrido D,30,0,30,0
1653299234544,MUS 111,A00,090591,Yadegari; Shahrokh D,124,0,130,6
1653299235071,MUS 114,A00,090592,Curtis; Charles Rector,117,0,125,8
1653299235599,MUS 120A,A01,090594,Cimini; Amy Marie,29,0,30,1
1653299236122,MUS 126R,A00,090595,Borgo; David Garcia,106,0,115,9
1653299236648,MUS 130,A00,090596,Ohnishi; Takae,30,0,30,0
1653299237184,MUS 132,001,094091,Nourai; Keyarash,10,0,10,0
1653299237184,MUS 132,002,094093,Kenyatta; Kamau,10,0,10,0
1653299237184,MUS 132,003,094094,Curtis; Charles Rector,10,0,10,0
1653299237184,MUS 132,005,094096,Terrazas Perez; Wilfrido D,10,0,10,0
1653299237184,MUS 132,006,094097,Ohnishi; Takae,10,0,10,0
1653299237184,MUS 132,007,094098,Burr; Anthony I,10,0,10,0
1653299237184,MUS 132,008,094099,Carlson; Erik Norman,10,0,10,0
1653299237184,MUS 132,009,094100,Dresser; Mark Stuart,10,0,10,0
1653299237184,MUS 132,011,094102,Richards; Stephanie F,10,0,10,0
1653299237184,MUS 132,012,094103,Borgo; David Garcia,10,0,10,0
1653299237184,MUS 132,013,094104,Jones; Michael David,10,0,10,0
1653299237184,MUS 132,014,094105,Staff,10,0,10,0
1653299237709,MUS 132V,A00,094106,Narucki; Susan M,15,0,15,0
1653299238231,MUS 134,A00,090597,Staff,30,0,30,0
1653299238763,MUS 137A,A00,090598,Kenyatta; Kamau,30,0,30,0
1653299239288,MUS 143,A00,090599,Staff,26,0,30,4
1653299240337,MUS 173,A00,090600,Britt; King James,19,0,30,11
1653299240861,MUS 174A,A00,090601,Staff,8,0,15,7
1653299241918,NANO 4,A01,088199,Vazquez Mena; Oscar,20,0,20,0
1653299241918,NANO 4,B01,088201,Vazquez Mena; Oscar,20,0,20,0
1653299241918,NANO 4,C01,088203,Vazquez Mena; Oscar,20,0,20,0
1653299242446,NANO 15,A01,088205,Lubarda; Vlado,50,0,50,0
1653299242446,NANO 15,B01,088207,Lubarda; Vlado,50,0,50,0
1653299242977,NANO 20L,A00,088208,Sirbuly; Donald,27,0,30,3
1653299242977,NANO 20L,B00,088209,Sirbuly; Donald,29,0,30,1
1653299243508,NANO 100L,A00,088210,Vecchio; Kenneth S,24,0,30,6
1653299244033,NANO 102,A00,088211,Tao; Andrea Rae,94,0,100,6
1653299244558,NANO 110,A00,088212,Pascal; Tod A,99,0,100,1
1653299245083,NANO 111,A00,088213,Fenning; David,45,0,50,5
1653299245607,NANO 117,A00,088214,Cubukcu; Ertugrul,71,0,75,4
1653299246129,NANO 119,A00,088215,Vazquez Mena; Oscar,50,0,50,0
1653299246654,NANO 159,A00,088216,Wang; Joseph,33,0,40,7
1653299247175,NANO 181,A01,088218,Ong; Shyue Ping,22,0,25,3
1653299247702,PHIL 1,A00,090815,Sher; Gila,57,0,60,3
1653299248228,PHIL 10,A01,090817,Grush; Rick Scott,37,0,40,3
1653299248228,PHIL 10,A02,090818,Grush; Rick Scott,37,0,40,3
1653299248228,PHIL 10,A03,090819,Grush; Rick Scott,38,0,40,2
1653299248228,PHIL 10,A04,090820,Grush; Rick Scott,40,0,40,0
1653299248228,PHIL 10,A05,090821,Grush; Rick Scott,38,0,40,2
1653299248228,PHIL 10,A06,090822,Grush; Rick Scott,39,0,40,1
1653299248759,PHIL 12,A01,090824,Bechtel; William,20,0,25,5
1653299248759,PHIL 12,A02,090825,Bechtel; William,24,0,25,1
1653299248759,PHIL 12,A03,090826,Bechtel; William,25,0,25,0
1653299248759,PHIL 12,A04,090827,Bechtel; William,25,0,25,0
1653299249285,PHIL 13,A01,090829,Wonderly; Monique L.,25,0,25,0
1653299249285,PHIL 13,A02,090830,Wonderly; Monique L.,24,0,25,1
1653299249285,PHIL 13,A03,090831,Wonderly; Monique L.,24,0,25,1
1653299249285,PHIL 13,A04,090832,Wonderly; Monique L.,25,0,25,0
1653299249809,PHIL 27,A01,090834,Harrell; Maralee Mae,23,0,35,12
1653299249809,PHIL 27,A02,090835,Harrell; Maralee Mae,35,0,35,0
1653299249809,PHIL 27,A03,090836,Harrell; Maralee Mae,33,0,35,2
1653299249809,PHIL 27,A04,090837,Harrell; Maralee Mae,33,0,35,2
1653299249809,PHIL 27,A05,090838,Harrell; Maralee Mae,35,0,35,0
1653299249809,PHIL 27,A06,090839,Harrell; Maralee Mae,35,0,35,0
1653299250335,PHIL 28,A01,090841,Bazargan-Forward; Saba,31,0,35,4
1653299250335,PHIL 28,A02,090842,Bazargan-Forward; Saba,31,0,35,4
1653299250335,PHIL 28,A03,090843,Bazargan-Forward; Saba,35,0,35,0
1653299250335,PHIL 28,A04,090844,Bazargan-Forward; Saba,30,0,35,5
1653299250335,PHIL 28,A05,090845,Bazargan-Forward; Saba,33,0,35,2
1653299250335,PHIL 28,A06,090846,Bazargan-Forward; Saba,34,0,35,1
1653299250335,PHIL 28,A07,090847,Bazargan-Forward; Saba,32,0,35,3
1653299250335,PHIL 28,A08,090848,Bazargan-Forward; Saba,33,0,35,2
1653299250862,PHIL 31,A00,090849,Johnson; Monte,59,0,60,1
1653299251389,PHIL 100,A00,090852,Nelkin; Dana Kay,28,0,35,7
1653299251916,PHIL 110,A00,090853,Johnson; Monte,29,0,30,1
1653299252443,PHIL 120,A00,090854,Rickless; Samuel Charles,23,0,35,12
1653299252965,PHIL 123,A00,090855,Sher; Gila,38,0,40,2
1653299253491,PHIL 131,A00,090856,Cohen; Jonathan David,34,0,35,1
1653299254013,PHIL 132,A00,090857,Carr; Jennifer Rose,33,0,35,2
1653299254538,PHIL 138,A00,090858,Brink; David O.,34,0,40,6
1653299255062,PHIL 147,A00,090860,Fulkerson; Matthew Todd,33,0,35,2
1653299255586,PHIL 150,A00,090861,Bechtel; William,36,0,40,4
1653299256180,PHIL 155,A00,090862,Vargas; Manuel Rogelio,38,0,40,2
1653299256707,PHIL 165,A00,090863,Rickless; Samuel Charles,59,0,70,11
1653299257232,PHIL 172,A00,090864,Bazargan-Forward; Saba,37,0,40,3
1653299257755,PHIL 173,A00,090865,Wonderly; Monique L.,33,0,40,7
1653299258279,PHYS 1A,A00,088555,Koslover; Elena F,354,0,362,8
1653299258279,PHYS 1A,B00,088556,Koslover; Elena F,343,0,362,19
1653299258279,PHYS 1A,C00,088557,Shpyrko; Oleg,326,0,362,36
1653299258806,PHYS 1AL,001,088558,Tsai; Philbert S,30,0,30,0
1653299258806,PHYS 1AL,002,088559,Tsai; Philbert S,30,0,30,0
1653299258806,PHYS 1AL,003,088560,Tsai; Philbert S,23,0,30,7
1653299258806,PHYS 1AL,004,088561,Tsai; Philbert S,26,0,30,4
1653299258806,PHYS 1AL,005,088562,Tsai; Philbert S,24,0,30,6
1653299258806,PHYS 1AL,006,088563,Tsai; Philbert S,30,0,30,0
1653299258806,PHYS 1AL,007,088564,Tsai; Philbert S,26,0,30,4
1653299258806,PHYS 1AL,008,088565,Tsai; Philbert S,29,0,30,1
1653299258806,PHYS 1AL,009,088566,Tsai; Philbert S,28,0,30,2
1653299258806,PHYS 1AL,010,088567,Tsai; Philbert S,30,0,30,0
1653299258806,PHYS 1AL,011,088568,Tsai; Philbert S,29,0,30,1
1653299258806,PHYS 1AL,012,088569,Tsai; Philbert S,29,0,30,1
1653299258806,PHYS 1AL,013,088570,Tsai; Philbert S,30,0,30,0
1653299258806,PHYS 1AL,014,088571,Tsai; Philbert S,29,0,30,1
1653299258806,PHYS 1AL,015,088572,Tsai; Philbert S,23,0,30,7
1653299258806,PHYS 1AL,016,088573,Tsai; Philbert S,28,0,30,2
1653299258806,PHYS 1AL,017,088574,Tsai; Philbert S,29,0,30,1
1653299258806,PHYS 1AL,018,088575,Tsai; Philbert S,28,0,30,2
1653299258806,PHYS 1AL,019,088576,Tsai; Philbert S,26,0,30,4
1653299258806,PHYS 1AL,020,088577,Tsai; Philbert S,29,0,30,1
1653299258806,PHYS 1AL,021,088578,Tsai; Philbert S,30,0,30,0
1653299258806,PHYS 1AL,022,088579,Tsai; Philbert S,30,0,30,0
1653299258806,PHYS 1AL,023,088580,Tsai; Philbert S,30,0,30,0
1653299258806,PHYS 1AL,024,088581,Tsai; Philbert S,30,0,30,0
1653299258806,PHYS 1AL,025,088582,Tsai; Philbert S,26,0,30,4
1653299258806,PHYS 1AL,026,088583,Tsai; Philbert S,29,0,30,1
1653299258806,PHYS 1AL,027,088584,Tsai; Philbert S,28,0,30,2
1653299258806,PHYS 1AL,028,088585,Tsai; Philbert S,30,0,30,0
1653299258806,PHYS 1AL,029,088586,Tsai; Philbert S,27,0,30,3
1653299258806,PHYS 1AL,030,088587,Tsai; Philbert S,29,0,30,1
1653299258806,PHYS 1AL,031,088588,Tsai; Philbert S,30,0,30,0
1653299258806,PHYS 1AL,032,088589,Tsai; Philbert S,30,0,30,0
1653299258806,PHYS 1AL,033,088590,Tsai; Philbert S,30,0,30,0
1653299258806,PHYS 1AL,034,088591,Tsai; Philbert S,30,0,30,0
1653299258806,PHYS 1AL,035,088592,Tsai; Philbert S,29,0,30,1
1653299258806,PHYS 1AL,036,088593,Tsai; Philbert S,30,0,30,0
1653299259335,PHYS 1B,A00,088594,Groisman; Alexander,351,0,360,9
1653299259863,PHYS 1BL,001,088595,Tsai; Philbert S,30,0,30,0
1653299259863,PHYS 1BL,002,088596,Tsai; Philbert S,25,0,30,5
1653299259863,PHYS 1BL,003,088597,Tsai; Philbert S,27,0,30,3
1653299259863,PHYS 1BL,004,088598,Tsai; Philbert S,30,0,30,0
1653299259863,PHYS 1BL,005,088599,Tsai; Philbert S,29,0,30,1
1653299259863,PHYS 1BL,006,088600,Tsai; Philbert S,25,0,30,5
1653299259863,PHYS 1BL,007,088601,Tsai; Philbert S,30,0,30,0
1653299259863,PHYS 1BL,008,088602,Tsai; Philbert S,29,0,30,1
1653299259863,PHYS 1BL,009,088603,Tsai; Philbert S,30,0,30,0
1653299259863,PHYS 1BL,010,088604,Tsai; Philbert S,30,0,30,0
1653299259863,PHYS 1BL,011,088605,Tsai; Philbert S,28,0,30,2
1653299259863,PHYS 1BL,012,088606,Tsai; Philbert S,26,0,30,4
1653299260391,PHYS 1C,A00,088607,Tsai; Philbert S,334,0,360,26
1653299260919,PHYS 1CL,001,088608,Tsai; Philbert S,30,0,30,0
1653299260919,PHYS 1CL,002,088609,Tsai; Philbert S,24,0,30,6
1653299260919,PHYS 1CL,003,088610,Tsai; Philbert S,24,0,30,6
1653299260919,PHYS 1CL,004,088611,Tsai; Philbert S,29,0,30,1
1653299260919,PHYS 1CL,005,088612,Tsai; Philbert S,17,0,30,13
1653299260919,PHYS 1CL,006,088613,Tsai; Philbert S,19,0,30,11
1653299260919,PHYS 1CL,007,088614,Tsai; Philbert S,30,0,30,0
1653299260919,PHYS 1CL,008,088615,Tsai; Philbert S,26,0,30,4
1653299260919,PHYS 1CL,009,088616,Tsai; Philbert S,27,0,30,3
1653299260919,PHYS 1CL,010,088617,Tsai; Philbert S,29,0,30,1
1653299260919,PHYS 1CL,011,088618,Tsai; Philbert S,27,0,30,3
1653299260919,PHYS 1CL,012,088619,Tsai; Philbert S,24,0,30,6
1653299261443,PHYS 2A,A01,092602,Meyertholen; Andrew D.,26,0,30,4
1653299261443,PHYS 2A,A02,092603,Meyertholen; Andrew D.,28,0,30,2
1653299261443,PHYS 2A,A03,092604,Meyertholen; Andrew D.,29,0,30,1
1653299261443,PHYS 2A,A04,092605,Meyertholen; Andrew D.,30,0,30,0
1653299261443,PHYS 2A,A05,092606,Meyertholen; Andrew D.,29,0,30,1
1653299261443,PHYS 2A,A06,092607,Meyertholen; Andrew D.,29,0,30,1
1653299261443,PHYS 2A,A07,092608,Meyertholen; Andrew D.,30,0,30,0
1653299261443,PHYS 2A,A08,092609,Meyertholen; Andrew D.,30,0,30,0
1653299261443,PHYS 2A,A09,092610,Meyertholen; Andrew D.,27,0,30,3
1653299261443,PHYS 2A,A10,092611,Meyertholen; Andrew D.,30,0,30,0
1653299261443,PHYS 2A,A11,092612,Meyertholen; Andrew D.,30,0,30,0
1653299261443,PHYS 2A,A12,094499,Meyertholen; Andrew D.,27,0,30,3
1653299261971,PHYS 2B,A01,092613,Branson; James G,28,0,30,2
1653299261971,PHYS 2B,A02,092614,Branson; James G,29,0,30,1
1653299261971,PHYS 2B,A03,092615,Branson; James G,30,0,30,0
1653299261971,PHYS 2B,A04,092616,Branson; James G,30,0,30,0
1653299261971,PHYS 2B,A05,092617,Branson; James G,29,0,30,1
1653299261971,PHYS 2B,A06,092618,Branson; James G,29,0,30,1
1653299261971,PHYS 2B,A07,092619,Branson; James G,29,0,30,1
1653299261971,PHYS 2B,A08,092620,Branson; James G,0,0,0,0
1653299261971,PHYS 2B,A09,092621,Branson; James G,0,0,0,0
1653299261971,PHYS 2B,A10,092622,Branson; James G,0,0,0,0
1653299261971,PHYS 2B,A11,092623,Branson; James G,0,0,0,0
1653299261971,PHYS 2B,A12,092624,Branson; James G,30,0,30,0
1653299262498,PHYS 2C,A01,092625,Barreiro Guerrero; Julio,27,0,30,3
1653299262498,PHYS 2C,A02,092626,Barreiro Guerrero; Julio,28,0,30,2
1653299262498,PHYS 2C,A03,092627,Barreiro Guerrero; Julio,29,0,30,1
1653299262498,PHYS 2C,A04,092628,Barreiro Guerrero; Julio,29,0,30,1
1653299262498,PHYS 2C,A05,092629,Barreiro Guerrero; Julio,30,0,30,0
1653299262498,PHYS 2C,A06,092630,Barreiro Guerrero; Julio,30,0,30,0
1653299262498,PHYS 2C,A07,092631,Barreiro Guerrero; Julio,30,0,30,0
1653299262498,PHYS 2C,A08,092632,Barreiro Guerrero; Julio,30,0,30,0
1653299262498,PHYS 2C,A09,092633,Barreiro Guerrero; Julio,29,0,30,1
1653299262498,PHYS 2C,A10,092634,Barreiro Guerrero; Julio,29,0,30,1
1653299262498,PHYS 2C,A11,092635,Barreiro Guerrero; Julio,27,0,30,3
1653299262498,PHYS 2C,A12,092636,Barreiro Guerrero; Julio,29,0,30,1
1653299262498,PHYS 2C,B01,092637,Barreiro Guerrero; Julio,29,0,30,1
1653299262498,PHYS 2C,B02,092638,Barreiro Guerrero; Julio,30,0,30,0
1653299262498,PHYS 2C,B03,092639,Barreiro Guerrero; Julio,28,0,30,2
1653299262498,PHYS 2C,B04,092640,Barreiro Guerrero; Julio,29,0,30,1
1653299262498,PHYS 2C,B05,092641,Barreiro Guerrero; Julio,26,0,30,4
1653299262498,PHYS 2C,B06,092642,Barreiro Guerrero; Julio,28,0,30,2
1653299262498,PHYS 2C,B07,092643,Barreiro Guerrero; Julio,29,0,30,1
1653299262498,PHYS 2C,B08,092644,Barreiro Guerrero; Julio,30,0,30,0
1653299262498,PHYS 2C,B09,092645,Barreiro Guerrero; Julio,29,0,30,1
1653299262498,PHYS 2C,B10,092646,Barreiro Guerrero; Julio,29,0,30,1
1653299262498,PHYS 2C,B11,092647,Barreiro Guerrero; Julio,30,0,30,0
1653299262498,PHYS 2C,B12,092648,Barreiro Guerrero; Julio,30,0,30,0
1653299263024,PHYS 2CL,A01,088625,Du; Chunhui,26,0,30,4
1653299263024,PHYS 2CL,A02,088626,Du; Chunhui,29,0,30,1
1653299263024,PHYS 2CL,A03,088627,Du; Chunhui,21,0,30,9
1653299263024,PHYS 2CL,A04,088628,Du; Chunhui,30,0,30,0
1653299263024,PHYS 2CL,A05,088629,Du; Chunhui,29,0,30,1
1653299263024,PHYS 2CL,A06,088630,Du; Chunhui,24,0,30,6
1653299263024,PHYS 2CL,A07,088631,Du; Chunhui,28,0,30,2
1653299263024,PHYS 2CL,A08,088632,Du; Chunhui,28,0,30,2
1653299263024,PHYS 2CL,A09,088633,Du; Chunhui,24,0,30,6
1653299263024,PHYS 2CL,A10,088634,Du; Chunhui,29,0,30,1
1653299263024,PHYS 2CL,A11,088635,Du; Chunhui,27,0,30,3
1653299263024,PHYS 2CL,A12,088636,Du; Chunhui,30,0,30,0
1653299263549,PHYS 2D,A01,092649,Hirsch; Jorge Eduardo,30,0,30,0
1653299263549,PHYS 2D,A02,092650,Hirsch; Jorge Eduardo,28,0,30,2
1653299263549,PHYS 2D,A03,092651,Hirsch; Jorge Eduardo,30,0,30,0
1653299263549,PHYS 2D,A04,092652,Hirsch; Jorge Eduardo,30,0,30,0
1653299263549,PHYS 2D,A05,092653,Hirsch; Jorge Eduardo,30,0,30,0
1653299263549,PHYS 2D,A06,092654,Hirsch; Jorge Eduardo,30,0,30,0
1653299264074,PHYS 2DL,A01,088639,Butov; Leonid,7,0,16,9
1653299264074,PHYS 2DL,A02,088640,Butov; Leonid,13,0,16,3
1653299264074,PHYS 2DL,A03,094501,Butov; Leonid,13,0,16,3
1653299264074,PHYS 2DL,A04,094502,Butov; Leonid,16,0,16,0
1653299264600,PHYS 4C,A01,092655,Averitt; Richard Douglas,28,0,30,2
1653299264600,PHYS 4C,A02,092656,Averitt; Richard Douglas,30,0,30,0
1653299264600,PHYS 4C,A03,092657,Averitt; Richard Douglas,30,0,30,0
1653299264600,PHYS 4C,A04,092658,Staff,30,0,30,0
1653299265124,PHYS 5,A01,092662,Konopacky; Quinn Morgan,197,0,200,3
1653299265648,PHYS 10,A01,092663,Tytler; David Robert,191,0,192,1
1653299266170,PHYS 100A,A01,092660,Shpyrko; Oleg,114,0,120,6
1653299266694,PHYS 110A,A01,092664,Arovas; Daniel P,116,0,120,4
1653299267217,PHYS 122,A01,088647,Yang; Liang,30,0,40,10
1653299267741,PHYS 130B,A01,092661,Grover; Tarun,106,0,120,14
1653299268265,PHYS 139,A00,088649,Kuti; Julius,19,0,20,1
1653299268789,PHYS 140A,A01,092665,Shotwell; Brian,105,0,120,15
1653299269317,PHYS 161,A01,092666,Fuller; George Michael,46,0,65,19
1653299269842,PHYS 163,A01,092667,Keres; Dusan,48,0,50,2
1653299270365,PHYS 175,A00,088653,Dudko; Olga,18,0,20,2
1653299270888,PHYS 191,A00,088654,Shpyrko; Oleg,26,0,30,4
1653299271411,POLI 11D,A01,090896,Ferree; Karen E,29,0,30,1
1653299271411,POLI 11D,A02,090897,Ferree; Karen E,28,0,30,2
1653299271411,POLI 11D,A03,090899,Ferree; Karen E,28,0,30,2
1653299271411,POLI 11D,A04,090900,Ferree; Karen E,29,0,30,1
1653299271935,POLI 12D,A01,090902,Roeder; Philip G,26,0,30,4
1653299271935,POLI 12D,A02,090903,Roeder; Philip G,27,0,30,3
1653299271935,POLI 12D,A05,090906,Roeder; Philip G,28,0,30,2
1653299271935,POLI 12D,A06,090907,Roeder; Philip G,30,0,30,0
1653299272460,POLI 13DR,A01,090909,Forman; Fonna,26,0,30,4
1653299272460,POLI 13DR,A02,090910,Forman; Fonna,30,0,30,0
1653299272460,POLI 13DR,A03,090911,Forman; Fonna,28,0,30,2
1653299272460,POLI 13DR,A04,090912,Forman; Fonna,30,0,30,0
1653299272460,POLI 13DR,A05,090913,Forman; Fonna,28,0,30,2
1653299272460,POLI 13DR,A06,090914,Forman; Fonna,34,0,34,0
1653299272993,POLI 27,A01,090916,Elgin; Samuel Zincke,23,0,30,7
1653299272993,POLI 27,A02,090917,Elgin; Samuel Zincke,26,0,30,4
1653299272993,POLI 27,A03,090918,Elgin; Samuel Zincke,30,0,30,0
1653299272993,POLI 27,A04,090919,Elgin; Samuel Zincke,28,0,30,2
1653299272993,POLI 27,A05,090920,Elgin; Samuel Zincke,24,0,30,6
1653299272993,POLI 27,A06,090921,Elgin; Samuel Zincke,29,0,30,1
1653299273520,POLI 28,A01,090923,Elgin; Samuel Zincke,23,0,30,7
1653299273520,POLI 28,A02,090924,Elgin; Samuel Zincke,26,0,30,4
1653299273520,POLI 28,A05,090927,Elgin; Samuel Zincke,23,0,30,7
1653299273520,POLI 28,A06,090928,Elgin; Samuel Zincke,23,0,30,7
1653299274049,POLI 30D,A01,090930,Desposato; Scott,22,0,24,2
1653299274049,POLI 30D,A02,090931,Desposato; Scott,22,0,24,2
1653299274049,POLI 30D,A03,090932,Desposato; Scott,23,0,24,1
1653299274049,POLI 30D,A04,090933,Desposato; Scott,24,0,24,0
1653299274049,POLI 30D,A05,090934,Desposato; Scott,23,0,24,1
1653299274049,POLI 30D,A06,090935,Desposato; Scott,24,0,24,0
1653299274576,POLI 100G,A00,090936,Fletcher; Nathan,199,0,208,9
1653299275101,POLI 100V,A00,090937,Gause; LaGina,111,0,115,4
1653299275624,POLI 100W,A00,090938,Paglayan; Agustina,161,0,165,4
1653299276154,POLI 104A,A00,090940,Smith; Glenn Chatmas,186,0,195,9
1653299276681,POLI 104F,A00,090941,Smith; Glenn Chatmas,11,0,19,8
1653299277202,POLI 104M,A00,090942,Stephens; Mattheus E,156,0,165,9
1653299277727,POLI 110A,A00,090943,Wiens; David,39,0,44,5
1653299278249,POLI 110F,A00,090944,Elgin; Samuel Zincke,50,0,50,0
1653299278776,POLI 113A,A00,090945,Magagna; Victor Valentine,469,0,475,6
1653299278776,POLI 113A,B00,090946,Magagna; Victor Valentine,467,0,475,8
1653299279302,POLI 117R,A00,090947,Forman; Fonna,16,0,40,24
1653299279831,POLI 120E,A00,090948,Strom; Kaare,47,0,50,3
1653299280355,POLI 120G,A00,090949,Fisk; David Lee,110,0,115,5
1653299280880,POLI 120H,A00,090950,Fisk; David Lee,111,0,115,4
1653299281405,POLI 133A,A00,090951,Naoi; Megumi,156,0,165,9
1653299281929,POLI 135,A00,090952,Fisk; David Lee,111,0,115,4
1653299282453,POLI 142J,A00,090953,Slantchev; Branislav,45,0,50,5
1653299282978,POLI 143,A00,090954,Gartzke; Erik,111,0,115,4
1653299283505,POLI 149,A00,090955,Joseph; Michael F,152,0,165,13
1653299284029,POLI 151,A00,090956,Schneider; Christina,92,0,100,8
1653299284556,POLI 165,A00,090957,Warren; Scott,45,0,50,5
1653299285084,POLI 178,A00,090958,Joseph; Michael F,34,0,50,16
1653299285610,POLI 191A,A00,090959,Forman; Fonna & Hoston; Germaine,25,0,25,0
1653299286136,POLI 194,A00,090960,Hill; Seth J,9999,0,9999,0
1653299286662,POLI 194SD,A00,090961,Nichter; Maysa,9999,0,9999,0
1653299287185,POLI 197SD,001,090962,Nichter; Maysa,9999,0,9999,0
1653299287713,PSYC 1,A00,088391,Ferreira; Victor,194,0,200,6
1653299288239,PSYC 2,A00,093916,Moranton; Nirelia Melbina-,192,0,195,3
1653299288768,PSYC 3,A00,088392,Pilegard; Celeste Cristine,221,0,225,4
1653299289290,PSYC 6,A00,088393,McCullough; Michael E,198,0,200,2
1653299289816,PSYC 7,A00,088394,Powell; Lindsey Jane,196,0,200,4
1653299290343,PSYC 60,A01,088397,Lowe; Angela Beth,12,0,25,13
1653299290343,PSYC 60,A02,088398,Lowe; Angela Beth,25,0,25,0
1653299290343,PSYC 60,A03,088399,Lowe; Angela Beth,24,0,25,1
1653299290343,PSYC 60,A04,088400,Lowe; Angela Beth,23,0,25,2
1653299290343,PSYC 60,A05,088401,Lowe; Angela Beth,24,0,25,1
1653299290343,PSYC 60,A06,088402,Lowe; Angela Beth,25,0,25,0
1653299290343,PSYC 60,A07,088403,Lowe; Angela Beth,24,0,25,1
1653299290343,PSYC 60,B01,088405,Rickard; Timothy C.,25,0,25,0
1653299290343,PSYC 60,B02,088406,Rickard; Timothy C.,25,0,25,0
1653299290343,PSYC 60,B03,088407,Rickard; Timothy C.,25,0,25,0
1653299290343,PSYC 60,B04,088408,Rickard; Timothy C.,23,0,25,2
1653299290343,PSYC 60,B05,088410,Rickard; Timothy C.,24,0,25,1
1653299290343,PSYC 60,B06,088411,Rickard; Timothy C.,24,0,25,1
1653299290343,PSYC 60,B07,088412,Rickard; Timothy C.,24,0,25,1
1653299290866,PSYC 70,A01,088414,Pilegard; Celeste Cristine,17,0,25,8
1653299290866,PSYC 70,A02,088415,Pilegard; Celeste Cristine,24,0,25,1
1653299290866,PSYC 70,A03,088416,Pilegard; Celeste Cristine,25,0,25,0
1653299290866,PSYC 70,A04,088417,Pilegard; Celeste Cristine,25,0,25,0
1653299290866,PSYC 70,A05,088418,Pilegard; Celeste Cristine,22,0,25,3
1653299290866,PSYC 70,A06,088419,Pilegard; Celeste Cristine,19,0,25,6
1653299291403,PSYC 71,A01,088421,Lowe; Angela Beth,15,0,25,10
1653299291403,PSYC 71,A02,088422,Lowe; Angela Beth,21,0,25,4
1653299291403,PSYC 71,B01,088424,Steiner; Eric Tomas,20,0,25,5
1653299291403,PSYC 71,B02,088425,Steiner; Eric Tomas,23,0,25,2
1653299291926,PSYC 87,A00,093915,Gorman; Michael R.,20,0,20,0
1653299292454,PSYC 88,A00,088426,Dobkins; Karen R.,61,0,65,4
1653299292977,PSYC 100,A00,088428,Chapman; Eddie Nathaniel,125,0,170,45
1653299293516,PSYC 101,A00,088429,Heyman; Gail D.,148,0,170,22
1653299294051,PSYC 102,A00,093917,Moranton; Nirelia Melbina-,162,0,170,8
1653299294576,PSYC 104,A00,088430,Fine; Rachel,163,0,175,12
1653299295098,PSYC 116A,A01,088433,Lang; Ariel,25,0,25,0
1653299295623,PSYC 122,A00,088434,Miller; Cory T.,103,0,115,12
1653299296146,PSYC 125,A00,088436,Rose; Fred E.,90,0,120,30
1653299296680,PSYC 134,A00,088437,Kaye; Walter H.,235,0,250,15
1653299297220,PSYC 137,A00,088438,Fine; Rachel,210,0,216,6
1653299297751,PSYC 145,A00,093918,Staff,73,0,90,17
1653299298275,PSYC 147,A00,088441,Wong; Lauren Hitomi,120,0,146,26
1653299298797,PSYC 154,A00,093919,Lacefield; Katharine I,270,0,295,25
1653299299323,PSYC 158,A00,088443,Willis; Jarryd Thomas,250,0,295,45
1653299299850,PSYC 162,A00,088444,Wixted; John T,210,0,225,15
1653299300374,PSYC 167,A00,088445,Walker; Caren Michelle,0,0,30,30
1653299300896,PSYC 168,A00,088446,Chapman; Eddie Nathaniel,222,0,250,28
1653299301420,PSYC 171,A00,088447,Mukku; Dhananjaya,66,0,75,9
1653299301944,PSYC 178,A00,088448,Glaser; Dale,105,0,120,15
1653299302467,PSYC 179,A00,088449,Lacefield; Katharine I,193,0,250,57
1653299302991,PSYC 181,A00,088450,Anagnostaras; Stephan,284,0,300,16
1653299303519,PSYC 189,A00,088451,Gentner; Tim,19,0,31,12
1653299304041,PSYC 193,A00,088452,Gremel; Christina M,19,0,20,1
1653299304041,PSYC 193,B00,088453,Staff,19,0,20,1
1653299304571,PSYC 193L,A01,088455,Staff,33,0,35,2
1653299305093,PSYC 194A,A01,088461,Heyman; Gail D.,35,0,35,0
1653299305617,RELI 1,A01,086478,Kalleres; Dayna,20,0,20,0
1653299305617,RELI 1,A02,086479,Kalleres; Dayna,19,0,20,1
1653299306143,RELI 147,A00,088409,Caciola; Nancy A,0,0,0,0
1653299306666,REV 1,A01,092308,Leigh; Brian,24,0,24,0
1653299306666,REV 1,A02,092310,Leigh; Brian,24,0,24,0
1653299306666,REV 1,A03,092312,Leigh; Brian,24,0,24,0
1653299306666,REV 1,A04,092314,Leigh; Brian,24,0,24,0
1653299306666,REV 1,A05,092316,Leigh; Brian,24,0,24,0
1653299307188,REV 2,A01,092318,Staff,28,0,28,0
1653299307188,REV 2,A02,092319,Staff,28,0,28,0
1653299307712,REV 20,A00,092320,Staff,40,0,40,0
1653299308237,REV 87,A00,092321,Lyon; Antony J.,20,0,20,0
1653299308761,SE 1,A01,088674,Van Den Einde; Yael Dahlia,48,0,48,0
1653299308761,SE 1,A02,088675,Van Den Einde; Yael Dahlia,47,0,48,1
1653299308761,SE 1,A03,088676,Van Den Einde; Yael Dahlia,46,0,48,2
1653299309377,SE 101A,A00,088677,Morrison; Machel Leigh,191,0,200,9
1653299309905,SE 101C,A00,088678,Zhu; Qiang,137,0,145,8
1653299310430,SE 125,A00,088679,Conte; Joel P,143,0,145,2
1653299310957,SE 130A,A00,088680,Loh; Kenneth J. H.,110,0,115,5
1653299311482,SE 131B,A00,088681,Krysl; Petr,84,0,115,31
1653299312005,SE 142,A01,088683,Staff,11,0,18,7
1653299312005,SE 142,A02,088684,Staff,13,0,18,5
1653299312529,SE 164,A01,088686,Loh; Kenneth J. H.,14,0,16,2
1653299313052,SE 180,A00,088687,Elgamal; Ahmed,66,0,75,9
1653299313580,SE 181,A01,088689,McCartney; John Scott,25,0,30,5
1653299313580,SE 181,A02,088690,McCartney; John Scott,14,0,30,16
1653299313580,SE 181,A03,088691,McCartney; John Scott,25,0,25,0
1653299313580,SE 181,A04,088692,McCartney; John Scott,25,0,25,0
1653299314104,SIO 12,A00,088342,Staff,141,0,146,5
1653299314628,SIO 15,A00,088343,Laske; Gabi,333,0,340,7
1653299315156,SIO 30,A01,092382,Castillo; Paterno R.,28,0,35,7
1653299315156,SIO 30,A02,092383,Castillo; Paterno R.,32,0,35,3
1653299315156,SIO 30,A03,092384,Castillo; Paterno R.,35,0,35,0
1653299315156,SIO 30,A04,092385,Castillo; Paterno R.,35,0,35,0
1653299315679,SIO 40,A00,088345,Barbeau; Katherine,144,0,146,2
1653299316202,SIO 50,A01,088347,Cook; Geoffrey W,11,0,14,3
1653299316202,SIO 50,A02,088348,Cook; Geoffrey W,11,0,14,3
1653299316731,SIO 87,A00,088350,Cook; Geoffrey W,20,0,20,0
1653299316731,SIO 87,B00,088351,Cook; Geoffrey W,20,0,20,0
1653299316731,SIO 87,C00,094017,Gilbert; Jack Anthony,20,0,20,0
1653299316731,SIO 87,D00,094018,Gerwick; William Henry,20,0,20,0
1653299317256,SIO 90,A00,088352,Staff,56,0,60,4
1653299317779,SIO 100,A00,088354,Norris; Richard D. & Gee; Jeffrey S,10,0,20,10
1653299318303,SIO 101,A01,088356,Aluwihare; Lihini & Decima; Moira R.,1,0,30,29
1653299318303,SIO 101,A02,088357,Aluwihare; Lihini & Decima; Moira R.,15,0,30,15
1653299318827,SIO 103,A01,088359,Parnell-Turner; Ross Ernes,21,0,25,4
1653299319353,SIO 105,A00,088360,Driscoll; Neal W.,18,0,20,2
1653299319879,SIO 108,A01,088363,Teranes; Jane,15,0,20,5
1653299320404,SIO 109R,A00,088364,Forman; Fonna,27,0,40,13
1653299320927,SIO 110,A01,088366,Staff,8,0,29,21
1653299321450,SIO 117,A01,088368,Keeling; Ralph F.,31,0,36,5
1653299321977,SIO 123,A00,088369,Allen; Andrew Ellis,61,0,70,9
1653299322507,SIO 132,A01,092386,Hechinger; Ryan F. & Kacev; David,17,0,28,11
1653299322507,SIO 132,A02,092387,Hechinger; Ryan F. & Kacev; David,26,0,28,2
1653299322507,SIO 132,A03,092388,Hechinger; Ryan F. & Kacev; David,28,0,28,0
1653299322507,SIO 132,A04,092389,Hechinger; Ryan F. & Kacev; David,23,0,28,5
1653299322507,SIO 132,A05,092390,Hechinger; Ryan F. & Kacev; David,27,0,28,1
1653299322507,SIO 132,A06,092391,Hechinger; Ryan F. & Kacev; David,27,0,28,1
1653299323038,SIO 136,A01,088373,Kacev; David & Bowman; Jeff Shovlowsky,0,0,5,7
1653299323038,SIO 136,B01,088376,Kacev; David & Bowman; Jeff Shovlowsky,0,0,5,5
1653299323562,SIO 155,A01,088379,Day; James M.D.,1,0,5,4
1653299324086,SIO 170,A00,088380,Cook; Geoffrey W,29,0,30,1
1653299324612,SIO 171,A01,088382,Rudnick; Daniel Lars,37,0,40,3
1653299325137,SIO 175,A01,088384,Merrifield; Mark A,22,0,25,3
1653299325661,SIO 177,A00,088385,Becker; Janet Maria,15,0,20,5
1653299326186,SIO 179,A01,088387,Martz; Todd R.,7,0,15,8
1653299327236,SIO 189,A00,088390,Hamdoun; Amr,35,0,60,25
1653299327760,SIO 194,A00,091602,Hill; Seth J,9999,0,9999,0
1653299328283,SOCE 194,A00,091601,Hill; Seth J,9999,0,9999,0
1653299328808,SOCI 1,A01,093704,Skrentny; John David,19,0,20,1
1653299328808,SOCI 1,A02,093705,Skrentny; John David,20,0,20,0
1653299328808,SOCI 1,A03,093706,Skrentny; John David,18,0,20,2
1653299328808,SOCI 1,A04,093707,Skrentny; John David,19,0,20,1
1653299328808,SOCI 1,A05,093708,Skrentny; John David,17,0,20,3
1653299328808,SOCI 1,A06,093709,Skrentny; John David,20,0,20,0
1653299328808,SOCI 1,A07,093710,Skrentny; John David,20,0,20,0
1653299328808,SOCI 1,A08,093711,Skrentny; John David,20,0,20,0
1653299328808,SOCI 1,A09,093712,Skrentny; John David,20,0,20,0
1653299328808,SOCI 1,A10,093713,Skrentny; John David,20,0,20,0
1653299328808,SOCI 1,A11,093714,Skrentny; John David,20,0,20,0
1653299329336,SOCI 30,A01,093716,Staff,30,0,30,0
1653299329336,SOCI 30,A02,093717,Staff,30,0,30,0
1653299329859,SOCI 60,A01,093719,Staff,17,0,20,3
1653299329859,SOCI 60,A02,093720,Staff,18,0,20,2
1653299329859,SOCI 60,A03,093721,Staff,20,0,20,0
1653299329859,SOCI 60,A04,093722,Staff,20,0,20,0
1653299330383,SOCI 87,A00,093819,Blair-Loy; Mary,20,0,20,0
1653299330910,SOCI 100,A01,093724,Estefan; Michel,15,0,20,5
1653299330910,SOCI 100,A02,093725,Estefan; Michel,5,0,20,15
1653299331437,SOCI 104,A00,093728,Gong; Neil M,22,0,25,3
1653299331963,SOCI 104Q,A00,093729,Staff,23,0,25,2
1653299332490,SOCI 106,A00,093730,Staff,25,0,25,0
1653299333016,SOCI 109,A00,093731,Staff,21,0,25,4
1653299333544,SOCI 110,A00,093732,Binder; Amy,24,0,25,1
1653299335131,SOCI 117,A01,091568,Chung; Luz Marina,29,0,35,6
1653299335131,SOCI 117,A02,091569,Chung; Luz Marina,35,0,35,0
1653299335655,SOCI 118,A00,093735,Staff,0,0,0,0
1653299336186,SOCI 120T,A00,093736,Lampland; Martha,50,0,50,0
1653299336186,SOCI 120T,B00,094832,Staff,69,0,70,1
1653299336715,SOCI 122,A00,093737,Lewis; Kevin Michael,62,0,70,8
1653299337240,SOCI 123,A00,094831,Staff,57,0,65,8
1653299337766,SOCI 125,A00,093738,Staff,115,0,120,5
1653299338289,SOCI 127,A00,094894,Staff,54,0,56,2
1653299338813,SOCI 132,A00,093739,Blair-Loy; Mary,51,0,60,9
1653299339862,SOCI 136F,A00,094830,Staff,45,0,56,11
1653299340391,SOCI 138,A00,093741,Navon; Daniel,117,0,120,3
1653299340915,SOCI 140A,A00,093743,Gong; Neil M,53,0,60,7
1653299341443,SOCI 141,A00,093744,Summers; Valerie R.,111,0,120,9
1653299342491,SOCI 144,A00,093746,Staff,0,0,0,0
1653299344586,SOCI 159,A00,094902,Staff,49,0,50,1
1653299345113,SOCI 160,A00,093750,Staff,0,0,0,0
1653299345636,SOCI 165,A00,093751,Rona-Tas; Akos,43,0,48,5
1653299346159,SOCI 165A,A00,094206,Hallin; Daniel C,3,0,4,1
1653299346682,SOCI 166,A00,093752,Lampland; Martha,52,0,56,4
1653299347206,SOCI 176,A00,093753,Turner; Christena L.,44,0,48,4
1653299347730,SOCI 180,A00,094901,Staff,56,0,56,0
1653299348253,SOCI 185,A00,094903,Staff,55,0,56,1
1653299348780,SOCI 196A,A00,093754,Shafir; Gershon,20,0,20,0
1653299349302,SXTH 1,A01,092351,Bronstein; Phoebe Malan,18,0,18,0
1653299349302,SXTH 1,A02,092352,Bronstein; Phoebe Malan,18,0,18,0
1653299349302,SXTH 1,A03,092353,Bronstein; Phoebe Malan,18,0,18,0
1653299349829,SXTH 20A,A00,092355,Chilukuri; Lakshmi N,56,0,56,0
1653299350374,SYN 2,001,091487,Gladstein; Jill M,13,0,15,2
1653299350374,SYN 2,002,091488,Gladstein; Jill M,14,0,15,1
1653299350374,SYN 2,003,091490,Gladstein; Jill M,12,0,15,3
1653299350374,SYN 2,004,091491,Gladstein; Jill M,15,0,15,0
1653299350374,SYN 2,005,091493,Gladstein; Jill M,15,0,15,0
1653299350374,SYN 2,006,091495,Gladstein; Jill M,15,0,15,0
1653299350374,SYN 2,007,091496,Gladstein; Jill M,15,0,15,0
1653299350374,SYN 2,008,091497,Gladstein; Jill M,14,0,15,1
1653299350374,SYN 2,009,091499,Gladstein; Jill M,13,0,15,2
1653299350374,SYN 2,010,091501,Gladstein; Jill M,13,0,15,2
1653299350374,SYN 2,011,091502,Gladstein; Jill M,13,0,15,2
1653299350374,SYN 2,012,091503,Gladstein; Jill M,15,0,15,0
1653299350374,SYN 2,013,091505,Gladstein; Jill M,13,0,15,2
1653299350374,SYN 2,014,091506,Gladstein; Jill M,12,0,15,3
1653299350374,SYN 2,015,091508,Gladstein; Jill M,14,0,15,1
1653299350374,SYN 2,016,091509,Gladstein; Jill M,12,0,15,3
1653299350374,SYN 2,017,091510,Gladstein; Jill M,14,0,15,1
1653299350374,SYN 2,018,091512,Gladstein; Jill M,15,0,15,0
1653299350374,SYN 2,019,091513,Gladstein; Jill M,15,0,15,0
1653299350374,SYN 2,020,091514,Gladstein; Jill M,15,0,15,0
1653299350374,SYN 2,021,091516,Gladstein; Jill M,12,0,15,3
1653299350374,SYN 2,022,091517,Gladstein; Jill M,13,0,15,2
1653299350374,SYN 2,023,091518,Gladstein; Jill M,15,0,15,0
1653299350374,SYN 2,024,091519,Gladstein; Jill M,15,0,15,0
1653299350374,SYN 2,025,091520,Gladstein; Jill M,11,0,15,4
1653299350374,SYN 2,026,091521,Gladstein; Jill M,15,0,15,0
1653299350374,SYN 2,027,091522,Gladstein; Jill M,0,0,0,0
1653299350374,SYN 2,028,091523,Gladstein; Jill M,0,0,0,0
1653299350374,SYN 2,029,091524,Gladstein; Jill M,0,0,0,0
1653299350374,SYN 2,030,091525,Gladstein; Jill M,0,0,0,0
1653299350374,SYN 2,031,091526,Gladstein; Jill M,14,0,15,1
1653299350374,SYN 2,032,091527,Gladstein; Jill M,15,0,15,0
1653299350374,SYN 2,033,091528,Gladstein; Jill M,0,0,0,0
1653299350374,SYN 2,034,091529,Gladstein; Jill M,15,0,15,0
1653299350374,SYN 2,035,091530,Gladstein; Jill M,15,0,15,0
1653299350374,SYN 2,036,091531,Gladstein; Jill M,15,0,15,0
1653299350374,SYN 2,037,091532,Gladstein; Jill M,15,0,15,0
1653299350374,SYN 2,038,091533,Gladstein; Jill M,15,0,15,0
1653299350374,SYN 2,039,091534,Gladstein; Jill M,15,0,15,0
1653299350374,SYN 2,040,091535,Gladstein; Jill M,15,0,15,0
1653299350901,SYN 100,A01,091537,Gladstein; Jill M,26,0,30,4
1653299350901,SYN 100,B01,091539,Gladstein; Jill M,26,0,30,4
1653299350901,SYN 100,C01,091541,Gladstein; Jill M,26,0,30,4
1653299350901,SYN 100,D01,091543,Gladstein; Jill M,25,0,30,5
1653299350901,SYN 100,E01,091545,Gladstein; Jill M,28,0,30,2
1653299351437,TDAC 1,A00,088922,Walsh; Kim C.,10,0,10,0
1653299351437,TDAC 1,B00,088923,Walsh; Kim C.,8,0,10,2
1653299351437,TDAC 1,C00,088924,Walsh; Kim C.,0,0,10,10
1653299351437,TDAC 1,D00,088925,Walsh; Kim C.,7,0,10,3
1653299351437,TDAC 1,E00,088926,Walsh; Kim C.,2,0,10,8
1653299351437,TDAC 1,F00,088927,Walsh; Kim C.,9,0,10,1
1653299351962,TDAC 101,A00,088972,Harting; Carla Kelso,9,0,10,1
1653299351962,TDAC 101,B00,088973,Salovey; Todd,8,0,10,2
1653299351962,TDAC 101,C00,088974,Walsh; Kim C.,6,0,10,4
1653299352497,TDAC 102,A00,088975,Basso; Beatrice,9,0,10,1
1653299352497,TDAC 102,B00,088976,Basso; Beatrice,7,0,10,3
1653299353027,TDAC 103A,A00,094044,Castro; Robert Jess,32,0,35,3
1653299353555,TDAC 108,A00,088977,Staff,20,0,20,0
1653299354089,TDAC 109,A00,088978,Blair; Kyle Adam,20,0,20,0
1653299354629,TDAC 115,A00,088979,Newcomb; James,20,0,20,0
1653299355154,TDAC 122,A00,088981,Staff,30,0,30,0
1653299355693,TDAC 123,A00,088982,Staff,30,0,30,0
1653299356225,TDDE 1,A01,088929,Benzoni; Elisa,9,0,11,2
1653299356225,TDDE 1,A02,088930,Benzoni; Elisa,11,0,11,0
1653299356225,TDDE 1,A03,088931,Benzoni; Elisa,11,0,11,0
1653299356225,TDDE 1,A04,088932,Benzoni; Elisa,10,0,11,1
1653299356225,TDDE 1,A05,088933,Benzoni; Elisa,11,0,11,0
1653299356758,TDDE 130,A00,088983,Staff,20,0,20,0
1653299357303,TDDE 132,A00,094263,Staff,20,0,20,0
1653299357833,TDDE 169A,A00,094046,Petrovich; Victoria A.,18,0,20,2
1653299358357,TDDM 1,A00,088934,Snaith; Yolande,6,0,10,4
1653299358888,TDDM 5,A00,088935,Smith; Alison D,30,0,30,0
1653299359412,TDDR 101,A00,088986,Powell; Lora,34,0,35,1
1653299359938,TDDR 111,A00,088987,Stalling; Vanessa,24,0,30,6
1653299359938,TDDR 111,B00,094045,Castro; Robert Jess,14,0,16,2
1653299360461,TDDR 190,A00,088988,Stalling; Vanessa,10,0,10,0
1653299360984,TDGE 1,A01,088937,Salovey; Todd,12,0,12,0
1653299360984,TDGE 1,A02,088938,Salovey; Todd,10,0,12,2
1653299360984,TDGE 1,A03,088939,Salovey; Todd,8,0,12,4
1653299360984,TDGE 1,A04,088940,Salovey; Todd,12,0,12,0
1653299360984,TDGE 1,A05,088941,Salovey; Todd,11,0,12,1
1653299360984,TDGE 1,A06,088942,Salovey; Todd,12,0,12,0
1653299361509,TDGE 10,A00,088943,Havis; Allan,191,0,200,9
1653299362034,TDGE 11,A00,088944,Staff,200,0,200,0
1653299362638,TDGE 25,A00,088945,Harting; Carla Kelso,19,0,20,1
1653299362638,TDGE 25,B00,088946,Harting; Carla Kelso,19,0,20,1
1653299362638,TDGE 25,C00,088947,Harting; Carla Kelso,20,0,20,0
1653299362638,TDGE 25,D00,088948,Harting; Carla Kelso,19,0,20,1
1653299362638,TDGE 25,E00,088949,Harting; Carla Kelso,20,0,20,0
1653299362638,TDGE 25,F00,088950,Harting; Carla Kelso,19,0,20,1
1653299362638,TDGE 25,G00,088951,Harting; Carla Kelso,19,0,20,1
1653299363170,TDGE 127,A00,088990,Havis; Allan,188,0,200,12
1653299363717,TDHD 21,A00,088952,Jun; Grace Shin Hae,20,0,20,0
1653299364241,TDHT 10,A00,088953,Power; Jade Yukana,14,0,14,0
1653299364241,TDHT 10,B00,088954,Power; Jade Yukana,13,0,14,1
1653299364769,TDHT 21,A01,088956,Power; Jade Yukana,17,0,18,1
1653299364769,TDHT 21,A02,088957,Power; Jade Yukana,7,0,11,4
1653299364769,TDHT 21,A03,088958,Power; Jade Yukana,11,0,11,0
1653299365298,TDHT 101,A00,088994,Burelle; Julie Sara Veronique,21,0,25,4
1653299365824,TDHT 114,A00,094208,Williams; Madison Mae,47,0,50,3
1653299366347,TDHT 119,A00,094299,Burelle; Julie Sara Veronique,25,0,25,0
1653299366872,TDMV 1,A00,088959,Weinberg; Sadie,23,0,30,7
1653299367413,TDMV 2,A00,088960,Sammartano; Tonnie,27,0,30,3
1653299367413,TDMV 2,B00,094043,Duran; Marcos Antonio,29,0,30,1
1653299367939,TDMV 3,A00,088961,Arcidiacono; Kristin,27,0,30,3
1653299368469,TDMV 110,A00,088995,Wilson; Terry A.,0,0,0,0
1653299368995,TDMV 120,A00,088996,Smith; Alison D,17,0,20,3
1653299369542,TDMV 122,A00,088997,Chaleff; Rebecca,28,0,30,2
1653299370079,TDMV 130,A00,094042,Rincon; Alicia,30,0,30,0
1653299370603,TDMV 138,A00,088998,Jun; Grace Shin Hae,12,0,40,28
1653299371132,TDMV 142,A00,088999,Caligagan; Tony,28,0,40,12
1653299371658,TDMV 143,A00,094041,Foster-King; Sandra,37,0,40,3
1653299372194,TDMV 146,A00,089000,Caligagan; Tony,39,0,40,1
1653299372721,TDPF 160,A00,094264,Snaith; Yolande,30,0,30,0
1653299372721,TDPF 160,B00,094265,Smith; Alison D,30,0,30,0
1653299372721,TDPF 160,C00,094266,Weinberg; Sadie,30,0,30,0
1653299373247,TDPR 6,A01,088963,Benzoni; Elisa,25,0,25,0
1653299373247,TDPR 6,A02,088964,Benzoni; Elisa,25,0,25,0
1653299373777,TDPR 102,A00,089003,Staff,15,0,15,0
1653299374300,TDPR 104,A00,089004,Powell; Lora,15,0,15,0
1653299374826,TDPW 1,A00,088965,Staff,10,0,10,0
1653299374826,TDPW 1,B00,088966,Staff,10,0,10,0
1653299374826,TDPW 1,C00,088967,Staff,9,0,10,1
1653299374826,TDPW 1,D00,088968,Staff,9,0,10,1
1653299374826,TDPW 1,E00,088969,Staff,10,0,10,0
1653299374826,TDPW 1,F00,088970,Staff,9,0,10,1
1653299375349,TDTR 10,A00,088971,Wilson; Terry A.,22,0,25,3
1653299375877,TMC 2,A01,092358,Carver; Leslie J.,20,0,20,0
1653299375877,TMC 2,A02,092359,Carver; Leslie J.,20,0,20,0
1653299375877,TMC 2,A03,092360,Carver; Leslie J.,20,0,20,0
1653299375877,TMC 2,A04,092361,Carver; Leslie J.,20,0,20,0
1653299375877,TMC 2,A05,092362,Carver; Leslie J.,20,0,20,0
1653299375877,TMC 2,A06,092363,Carver; Leslie J.,20,0,20,0
1653299376405,TMC 15,A00,092364,Atkinson; Arthur Laird,20,0,20,0
1653299376928,TMC 20,A00,092365,Carver; Leslie J.,20,0,20,0
1653299377465,TMC 90,A00,092366,Mell; Loren K.,20,0,20,0
1653299377997,TMC 120,A01,092368,Staff,20,0,20,0
1653299378521,USP 1,A01,087520,Kwak; Nancy,19,0,20,1
1653299378521,USP 1,A02,087521,Kwak; Nancy,17,0,20,3
1653299378521,USP 1,A03,087522,Kwak; Nancy,16,0,20,4
1653299378521,USP 1,A04,087523,Kwak; Nancy,19,0,20,1
1653299379044,USP 2,A01,087525,Lerner; Amy M,29,0,30,1
1653299379044,USP 2,A02,087526,Lerner; Amy M,29,0,30,1
1653299379569,USP 4,A00,094267,Polat; Soydan Alihan,16,0,20,4
1653299379569,USP 4,B00,094268,Staff,20,0,20,0
1653299380096,USP 5,A01,087532,Staff,26,0,30,4
1653299380096,USP 5,A02,087533,Staff,27,0,30,3
1653299380622,USP 6,A01,094322,Shvartzberg Carrio; Manuel,20,0,20,0
1653299380622,USP 6,A02,094323,Shvartzberg Carrio; Manuel,20,0,20,0
1653299381148,USP 15,A01,087535,Anderson; William Raymond,20,0,25,5
1653299381148,USP 15,A02,087536,Anderson; William Raymond,23,0,25,2
1653299381673,USP 25,A00,087537,Staff,0,0,7,7
1653299382200,USP 50,A00,087538,Martin; Isaac,38,0,40,2
1653299382727,USP 124,A00,087539,Bussell; Mirle Rabinowitz,26,0,35,9
1653299383250,USP 125,A00,087540,Staff,17,0,23,6
1653299383773,USP 136,A00,087541,Staff,23,0,25,2
1653299384310,USP 144,A00,087542,Staff,136,0,146,10
1653299384842,USP 151,A00,087543,Boomhower; Matthew Charles,18,0,20,2
1653299385367,USP 152,A01,087545,Moeder; Nathan L,17,0,20,3
1653299385367,USP 152,A02,087546,Moeder; Nathan L,20,0,20,0
1653299385894,USP 153,A00,087547,Moden; Kelly Kjestine,27,0,30,3
1653299386419,USP 161,A00,094854,Wartell; Julie Dara,25,0,25,0
1653299386956,USP 169,A00,087548,Bajaj; Ravi Siddharth,30,0,35,5
1653299387486,USP 170,A00,087549,Hinds; Juli Beth,30,0,35,5
1653299388013,USP 171,A00,087550,Lerner; Amy M,38,0,50,12
1653299388537,USP 176,A00,094853,Staff,24,0,25,1
1653299389062,USP 177A,A00,087551,Peerson; Susan,20,0,22,2
1653299389586,USP 184,A00,094324,Shvartzberg Carrio; Manuel,24,0,25,1
1653299390111,USP 185A,A01,087553,Norr; Alex Vaughn,28,0,30,2
1653299390111,USP 185A,B01,087555,Boomhower; Matthew Charles,26,0,30,4
1653299390639,USP 186,A01,087557,Pezzoli; Keith,22,0,25,3
1653299390639,USP 186,A02,087558,Pezzoli; Keith,20,0,25,5
1653299391692,USP 191A,A00,087561,Rothberg; Scott Jacob,18,0,20,2
1653299392232,USP 194,A00,091599,Hill; Seth J,9999,0,9999,0
1653299392759,VIS 1,A01,088809,Tonies; Joshua Vanjaymes,10,0,10,0
1653299392759,VIS 1,A02,088810,Tonies; Joshua Vanjaymes,10,0,10,0
1653299392759,VIS 1,A03,088811,Tonies; Joshua Vanjaymes,3,0,10,7
1653299392759,VIS 1,A04,088812,Tonies; Joshua Vanjaymes,8,0,10,2
1653299392759,VIS 1,A05,088813,Tonies; Joshua Vanjaymes,4,0,10,6
1653299392759,VIS 1,A06,088814,Tonies; Joshua Vanjaymes,6,0,10,4
1653299392759,VIS 1,A07,088815,Tonies; Joshua Vanjaymes,6,0,10,4
1653299392759,VIS 1,A08,088816,Tonies; Joshua Vanjaymes,9,0,10,1
1653299392759,VIS 1,A09,088817,Tonies; Joshua Vanjaymes,8,0,10,2
1653299392759,VIS 1,A10,088818,Tonies; Joshua Vanjaymes,8,0,10,2
1653299392759,VIS 1,A11,088819,Tonies; Joshua Vanjaymes,3,0,10,7
1653299392759,VIS 1,A12,088820,Tonies; Joshua Vanjaymes,6,0,10,4
1653299392759,VIS 1,A13,088821,Tonies; Joshua Vanjaymes,6,0,10,4
1653299392759,VIS 1,A14,088822,Tonies; Joshua Vanjaymes,7,0,10,3
1653299392759,VIS 1,A15,088823,Tonies; Joshua Vanjaymes,7,0,10,3
1653299392759,VIS 1,A16,088824,Tonies; Joshua Vanjaymes,8,0,10,2
1653299393284,VIS 20,A01,088826,Woods; Ann,19,0,20,1
1653299393284,VIS 20,A02,088827,Woods; Ann,20,0,20,0
1653299393284,VIS 20,A03,088828,Woods; Ann,18,0,20,2
1653299393284,VIS 20,A04,088829,Woods; Ann,17,0,20,3
1653299393284,VIS 20,A05,088830,Woods; Ann,20,0,20,0
1653299393284,VIS 20,A06,088831,Woods; Ann,20,0,20,0
1653299393284,VIS 20,A07,088832,Woods; Ann,20,0,20,0
1653299393284,VIS 20,A08,088833,Woods; Ann,20,0,20,0
1653299393284,VIS 20,A09,088834,Woods; Ann,18,0,20,2
1653299393284,VIS 20,A10,088835,Woods; Ann,19,0,20,1
1653299393284,VIS 20,A11,088836,Woods; Ann,20,0,20,0
1653299393284,VIS 20,A12,088837,Woods; Ann,20,0,20,0
1653299393809,VIS 23,A00,088838,Rose; Jordan M,3,0,3,0
1653299394336,VIS 30,A01,088840,Stone; Patricia,11,0,11,0
1653299394336,VIS 30,A02,088841,Stone; Patricia,7,0,11,4
1653299394336,VIS 30,A03,094821,Stone; Patricia,8,0,11,3
1653299394336,VIS 30,A04,094822,Stone; Patricia,11,0,11,0
1653299394860,VIS 41,A01,088844,D'Elena-Tweed; Jessica Erin,9,0,10,1
1653299394860,VIS 41,A02,088845,D'Elena-Tweed; Jessica Erin,9,0,10,1
1653299394860,VIS 41,A03,088846,D'Elena-Tweed; Jessica Erin,9,0,10,1
1653299394860,VIS 41,A04,088847,D'Elena-Tweed; Jessica Erin,9,0,10,1
1653299394860,VIS 41,A05,088848,D'Elena-Tweed; Jessica Erin,10,0,10,0
1653299394860,VIS 41,A06,088849,D'Elena-Tweed; Jessica Erin,10,0,10,0
1653299394860,VIS 41,A07,088850,D'Elena-Tweed; Jessica Erin,10,0,10,0
1653299394860,VIS 41,A08,088851,D'Elena-Tweed; Jessica Erin,10,0,10,0
1653299395395,VIS 60,A01,088853,Sepuya; Paul Mpagi,9,0,10,1
1653299395395,VIS 60,A02,088854,Sepuya; Paul Mpagi,10,0,10,0
1653299395395,VIS 60,A03,088855,Sepuya; Paul Mpagi,10,0,10,0
1653299395395,VIS 60,A04,088856,Sepuya; Paul Mpagi,10,0,10,0
1653299395395,VIS 60,A05,088857,Sepuya; Paul Mpagi,10,0,10,0
1653299395395,VIS 60,A06,088858,Sepuya; Paul Mpagi,10,0,10,0
1653299395395,VIS 60,A07,088859,Sepuya; Paul Mpagi,9,0,10,1
1653299395395,VIS 60,A08,093932,Sepuya; Paul Mpagi,10,0,10,0
1653299395944,VIS 70N,A01,088861,Segade; Alexandro Abraham,8,0,8,0
1653299395944,VIS 70N,A02,088862,Segade; Alexandro Abraham,8,0,8,0
1653299395944,VIS 70N,A03,088863,Segade; Alexandro Abraham,8,0,8,0
1653299395944,VIS 70N,A04,088864,Segade; Alexandro Abraham,8,0,8,0
1653299395944,VIS 70N,A05,088865,Segade; Alexandro Abraham,7,0,8,1
1653299395944,VIS 70N,A06,088866,Segade; Alexandro Abraham,8,0,8,0
1653299396468,VIS 80,A01,088868,Adler; Amy,9,0,10,1
1653299396468,VIS 80,A02,088869,Adler; Amy,8,0,10,2
1653299396468,VIS 80,A03,088870,Adler; Amy,9,0,10,1
1653299396468,VIS 80,A04,088871,Adler; Amy,8,0,10,2
1653299396468,VIS 80,A05,088872,Adler; Amy,10,0,10,0
1653299396468,VIS 80,A06,088873,Adler; Amy,7,0,10,3
1653299397003,VIS 100,A00,088874,Cruz; Edwin Teddy,65,0,75,10
1653299397554,VIS 105A,A00,088875,Tonies; Joshua Vanjaymes,26,0,30,4
1653299398088,VIS 105B,A00,088876,Staff,25,0,30,5
1653299398619,VIS 106A,A00,088877,Tobe; Geoffroy,21,0,25,4
1653299399144,VIS 106B,A00,088878,Staff,21,0,25,4
1653299399671,VIS 106C,A00,088879,Staff,9,0,15,6
1653299400195,VIS 107B,A00,088880,Gallaccio; Anya,24,0,25,1
1653299400717,VIS 108,A00,093894,Gallaccio; Anya,5,0,15,10
1653299401245,VIS 110A,A00,093895,Dean; Danielle Adobi,15,0,15,0
1653299401770,VIS 110B,A00,088881,Adler; Amy,14,0,15,1
1653299402322,VIS 125E,A00,093896,Welchman; John C.,75,0,75,0
1653299402853,VIS 126HN,A00,088882,Newsome; Elizabeth Ann,74,0,75,1
1653299403384,VIS 126P,A00,088883,Wardwell; Mariana Razo,72,0,75,3
1653299403909,VIS 128E,A00,088884,Staff,68,0,75,7
1653299404436,VIS 132,A00,088885,Miller; Nicole L,15,0,15,0
1653299404961,VIS 133,A01,094348,D'Elena-Tweed; Jessica Erin,34,0,34,0
1653299404961,VIS 133,A02,094492,D'Elena-Tweed; Jessica Erin,33,0,34,1
1653299405511,VIS 142,A01,088887,Stalbaum; Brett,14,0,15,1
1653299405511,VIS 142,A02,088888,Stalbaum; Brett,10,0,15,5
1653299405511,VIS 142,A03,088889,Stalbaum; Brett,15,0,15,0
1653299405511,VIS 142,A04,088890,Stalbaum; Brett,8,0,15,7
1653299405511,VIS 142,A05,088891,Stalbaum; Brett,14,0,15,1
1653299405511,VIS 142,A06,094828,Stalbaum; Brett,15,0,15,0
1653299406032,VIS 143,A00,088892,Akten; Mehmet,11,0,22,11
1653299406557,VIS 147A,A01,088894,Stalbaum; Brett,20,0,22,2
1653299406557,VIS 147A,A02,088895,Stalbaum; Brett,17,0,22,5
1653299407081,VIS 149,A00,088896,Akten; Mehmet,11,0,15,4
1653299407604,VIS 150,A00,093893,Tufenkian; Armand Yervant,24,0,30,6
1653299408135,VIS 151A,A00,088897,Williams; Alena J,13,0,15,2
1653299408663,VIS 163,A00,088901,Bratton; Benjamin H.,75,0,75,0
1653299409184,VIS 164,A00,088902,Nakayama; Yue,22,0,22,0
1653299409708,VIS 165A,A00,093892,Cross; Brian R,19,0,22,3
1653299410239,VIS 167,A00,088903,Ortiz-Torres; Ruben,19,0,22,3
1653299410764,VIS 174,A00,088905,Staff,21,0,22,1
1653299410764,VIS 174,B00,088906,Kauffmann; Casey,22,0,22,0
1653299411287,VIS 175,A00,093891,Staff,18,0,22,4
1653299411814,VIS 177,A00,088907,Segade; Alexandro Abraham,20,0,22,2
1653299412339,VIS 178,A00,093890,Staff,17,0,22,5
1653299412863,VIS 179,A00,093889,Kauffmann; Casey,21,0,22,1
1653299413389,VIS 180A,A00,093888,Nakayama; Yue,16,0,22,6
1653299413912,VIS 180B,A00,088908,Miller; Nicole L,21,0,22,1
1653299414437,VIS 183A,A00,088909,Sepuya; Paul Mpagi,20,0,22,2
1653299414971,WCWP 10A,001,086588,Gagnon; Jeffrey C,15,0,15,0
1653299414971,WCWP 10A,002,086589,Gagnon; Jeffrey C,14,0,15,1
1653299414971,WCWP 10A,003,086590,Gagnon; Jeffrey C,15,0,15,0
1653299414971,WCWP 10A,004,086591,Gagnon; Jeffrey C,15,0,15,0
1653299414971,WCWP 10A,005,086592,Gagnon; Jeffrey C,15,0,15,0
1653299414971,WCWP 10A,006,086593,Gagnon; Jeffrey C,15,0,15,0
1653299414971,WCWP 10A,007,086594,Gagnon; Jeffrey C,15,0,15,0
1653299414971,WCWP 10A,008,086595,Gagnon; Jeffrey C,15,0,15,0
1653299414971,WCWP 10A,009,086596,Gagnon; Jeffrey C,15,0,15,0
1653299414971,WCWP 10A,010,086597,Gagnon; Jeffrey C,15,0,15,0
1653299414971,WCWP 10A,011,086598,Gagnon; Jeffrey C,20,0,20,0
1653299414971,WCWP 10A,012,086599,Gagnon; Jeffrey C,20,0,20,0
1653299414971,WCWP 10A,013,086600,Gagnon; Jeffrey C,20,0,20,0
1653299414971,WCWP 10A,014,086601,Gagnon; Jeffrey C,20,0,20,0
1653299414971,WCWP 10A,015,086602,Gagnon; Jeffrey C,20,0,20,0
1653299414971,WCWP 10A,016,086603,Gagnon; Jeffrey C,20,0,20,0
1653299414971,WCWP 10A,017,086604,Gagnon; Jeffrey C,20,0,20,0
1653299414971,WCWP 10A,018,086605,Gagnon; Jeffrey C,19,0,20,1
1653299414971,WCWP 10A,019,086606,Gagnon; Jeffrey C,19,0,20,1
1653299414971,WCWP 10A,020,086607,Gagnon; Jeffrey C,20,0,20,0
1653299414971,WCWP 10A,021,086608,Gagnon; Jeffrey C,20,0,20,0
1653299414971,WCWP 10A,022,086609,Gagnon; Jeffrey C,20,0,20,0
1653299414971,WCWP 10A,023,086610,Gagnon; Jeffrey C,19,0,20,1
1653299414971,WCWP 10A,024,086611,Gagnon; Jeffrey C,20,0,20,0
1653299414971,WCWP 10A,025,086612,Gagnon; Jeffrey C,0,0,0,0
1653299414971,WCWP 10A,026,086613,Gagnon; Jeffrey C,0,0,0,0
1653299414971,WCWP 10A,027,086614,Gagnon; Jeffrey C,0,0,0,0
1653299414971,WCWP 10A,028,086615,Gagnon; Jeffrey C,0,0,0,0
1653299414971,WCWP 10A,029,086616,Gagnon; Jeffrey C,0,0,0,0
1653299414971,WCWP 10A,030,086617,Gagnon; Jeffrey C,15,0,15,0
1653299414971,WCWP 10A,031,086618,Gagnon; Jeffrey C,15,0,15,0
1653299414971,WCWP 10A,032,093687,Gagnon; Jeffrey C,15,0,15,0
1653299414971,WCWP 10A,033,093688,Gagnon; Jeffrey C,15,0,15,0
1653299414971,WCWP 10A,034,093689,Gagnon; Jeffrey C,0,0,0,0
1653299414971,WCWP 10A,035,093690,Gagnon; Jeffrey C,0,0,0,0
1653299415497,WCWP 10B,003,086621,Gagnon; Jeffrey C,0,0,0,0
1653299415497,WCWP 10B,004,086622,Gagnon; Jeffrey C,16,0,20,4
1653299415497,WCWP 10B,005,086623,Gagnon; Jeffrey C,18,0,20,2
1653299415497,WCWP 10B,006,086624,Gagnon; Jeffrey C,20,0,20,0
1653299415497,WCWP 10B,007,086625,Gagnon; Jeffrey C,0,0,0,0
1653299416104,WCWP 100,A00,086626,McCleary; Keith Long,20,0,20,0
1653299416104,WCWP 100,B00,086627,McCleary; Keith Long,20,0,20,0
1653299416104,WCWP 100,C00,086628,McCleary; Keith Long,18,0,20,2
1653299416104,WCWP 100,D00,086629,Twohig; Niall Ivan,17,0,20,3
1653299416104,WCWP 100,E00,086630,Twohig; Niall Ivan,17,0,20,3
1653299416104,WCWP 100,F00,086631,Twohig; Niall Ivan,18,0,20,2
1653299416104,WCWP 100,G00,086632,Young; Mark T,20,0,20,0
1653299416104,WCWP 100,H00,086633,Young; Mark T,20,0,20,0
1653299474579,AAS 10,A01,085689,Butler; Elizabeth Annette,28,0,34,6
1653299474579,AAS 10,A02,085690,Butler; Elizabeth Annette,34,0,34,0
1653299475104,AAS 170,A00,085691,Butler; Elizabeth Annette,30,0,32,2
1653299475629,AIP 197,001,085683,Staff,100,0,100,0
1653299475629,AIP 197,002,085684,Rao; Ramesh R,50,0,50,0
1653299476153,AIP 197DC,001,085696,Anderson; Patrick W.,27,0,27,0
1653299476675,AIP 197T,A00,085685,Anderson; Patrick W.,15,0,15,0
1653299477228,ANAR 100,A00,094326,Fortier; Jana,22,0,25,3
1653299477751,ANAR 104,A01,085846,Staff,13,0,15,2
1653299478277,ANAR 120,A00,085847,Staff,15,0,15,0
1653299478804,ANAR 143,A00,094288,Staff,31,0,32,1
1653299479331,ANBI 100,A00,085849,Marchetto; Maria Carolina,31,0,34,3
1653299479866,ANBI 112,A00,085850,Marchetto; Maria Carolina,21,0,28,7
1653299480392,ANBI 118,A00,085851,Fox; Patrick Keolu Ozer,32,0,32,0
1653299480916,ANBI 136,A00,085852,Semendeferi; Ekaterini,20,0,22,2
1653299481451,ANBI 141,A00,085854,Gagneux; Pascal,186,0,192,6
1653299481975,ANBI 145,A00,085855,Staff,30,0,32,2
1653299482511,ANBI 175,A00,085857,Staff,30,0,32,2
1653299483036,ANSC 104,A00,094290,Yeh; Rihan Wen Xin,40,0,46,6
1653299483567,ANSC 105,A00,085859,Olivas Hernandez; Olga Lid,36,0,37,1
1653299484092,ANSC 120,A00,085860,Jassal; Aftab,51,0,56,5
1653299484619,ANSC 121,A00,085861,Staff,29,0,32,3
1653299485677,ANSC 148,A00,085866,Staff,71,0,73,2
1653299486211,ANSC 169,A00,085869,Fortier; Jana,23,0,25,2
1653299486735,ANSC 175,A00,085871,Pedersen; David,28,0,32,4
1653299487262,ANTH 1,A00,085803,Varma; Saiba,146,0,146,0
1653299487785,ANTH 2,A01,085805,Staff,43,0,44,1
1653299487785,ANTH 2,A02,085806,Staff,42,0,44,2
1653299487785,ANTH 2,A03,085807,Staff,44,0,44,0
1653299487785,ANTH 2,A04,085808,Staff,44,0,44,0
1653299487785,ANTH 2,A05,085809,Staff,40,0,40,0
1653299488324,ANTH 4,A01,085811,Yeh; Rihan Wen Xin,32,0,32,0
1653299488324,ANTH 4,A02,095113,Yeh; Rihan Wen Xin,32,0,32,0
1653299488324,ANTH 4,A03,095114,Yeh; Rihan Wen Xin,32,0,32,0
1653299488324,ANTH 4,A04,095115,Yeh; Rihan Wen Xin,34,0,34,0
1653299488853,ANTH 10,A00,085814,Stewart; Alexander B,215,0,216,1
1653299489384,ANTH 21,A01,085816,Kang; Byung Chu,35,0,35,0
1653299489384,ANTH 21,A02,085817,Kang; Byung Chu,35,0,35,0
1653299489384,ANTH 21,A03,085818,Kang; Byung Chu,35,0,35,0
1653299489384,ANTH 21,A04,085819,Kang; Byung Chu,35,0,35,0
1653299489384,ANTH 21,A05,085820,Kang; Byung Chu,33,0,35,2
1653299489384,ANTH 21,A06,085821,Kang; Byung Chu,33,0,35,2
1653299489384,ANTH 21,A07,085822,Kang; Byung Chu,35,0,35,0
1653299489384,ANTH 21,A08,085823,Kang; Byung Chu,35,0,35,0
1653299489384,ANTH 21,A09,085824,Kang; Byung Chu,0,0,0,0
1653299489384,ANTH 21,A10,085825,Kang; Byung Chu,0,0,0,0
1653299489384,ANTH 21,A11,095111,Kang; Byung Chu,30,0,30,0
1653299489384,ANTH 21,A12,095112,Kang; Byung Chu,30,0,30,0
1653299489384,ANTH 21,B01,085827,Staff,36,0,36,0
1653299489384,ANTH 21,B02,085828,Staff,36,0,36,0
1653299489384,ANTH 21,B03,085829,Staff,36,0,36,0
1653299489384,ANTH 21,B04,085830,Staff,38,0,38,0
1653299489909,ANTH 23,A01,085832,Stewart; Alexander B,31,0,31,0
1653299489909,ANTH 23,A02,085833,Stewart; Alexander B,31,0,31,0
1653299489909,ANTH 23,A03,085834,Stewart; Alexander B,31,0,31,0
1653299489909,ANTH 23,A04,085835,Stewart; Alexander B,31,0,31,0
1653299489909,ANTH 23,A05,085836,Stewart; Alexander B,31,0,31,0
1653299489909,ANTH 23,A06,085837,Stewart; Alexander B,0,0,0,0
1653299489909,ANTH 23,A07,085838,Stewart; Alexander B,0,0,0,0
1653299490431,ANTH 87,A00,085842,Staff,20,0,20,0
1653299490431,ANTH 87,B00,085843,Staff,20,0,20,0
1653299490961,ANTH 101,A01,085873,Goldstein; Paul S,33,0,36,3
1653299490961,ANTH 101,A02,085874,Goldstein; Paul S,33,0,36,3
1653299490961,ANTH 101,A03,085875,Goldstein; Paul S,36,0,36,0
1653299490961,ANTH 101,A04,085876,Goldstein; Paul S,36,0,38,2
1653299491485,ANTH 105,A00,085877,Staff,39,0,40,1
1653299492008,ANTH 108,A00,085878,Staff,31,0,32,1
1653299492534,ANTH 192,A00,094234,Kaiser; Bronwyn Nicole & Non; Amy L,20,0,20,0
1653299493060,ANTH 196A,A00,085879,Varma; Saiba,20,0,20,0
1653299493606,AWP 3,001,085697,Staff,13,0,13,0
1653299493606,AWP 3,002,085698,Staff,13,0,13,0
1653299493606,AWP 3,003,085699,Staff,13,0,13,0
1653299493606,AWP 3,004,085700,Staff,0,0,0,0
1653299493606,AWP 3,005,085701,Staff,0,0,0,0
1653299493606,AWP 3,006,085703,Staff,0,0,0,0
1653299493606,AWP 3,007,085704,Staff,13,0,13,0
1653299493606,AWP 3,008,085707,Staff,0,0,0,0
1653299493606,AWP 3,009,085709,Staff,13,0,13,0
1653299493606,AWP 3,010,085710,Staff,13,0,13,0
1653299493606,AWP 3,011,085711,Staff,0,0,0,0
1653299493606,AWP 3,012,085712,Staff,0,0,0,0
1653299493606,AWP 3,013,085713,Staff,13,0,13,0
1653299493606,AWP 3,014,085715,Staff,13,0,13,0
1653299493606,AWP 3,015,085717,Staff,13,0,13,0
1653299493606,AWP 3,016,085719,Staff,13,0,13,0
1653299493606,AWP 3,017,085720,Staff,13,0,13,0
1653299493606,AWP 3,018,085721,Staff,13,0,13,0
1653299493606,AWP 3,019,085722,Staff,13,0,13,0
1653299493606,AWP 3,020,085723,Staff,13,0,13,0
1653299493606,AWP 3,021,085724,Staff,13,0,13,0
1653299493606,AWP 3,022,085725,Staff,13,0,13,0
1653299493606,AWP 3,023,085726,Staff,13,0,13,0
1653299493606,AWP 3,024,085727,Staff,13,0,13,0
1653299493606,AWP 3,025,085728,Staff,13,0,13,0
1653299493606,AWP 3,026,085729,Staff,13,0,13,0
1653299493606,AWP 3,027,085730,Staff,13,0,13,0
1653299493606,AWP 3,028,085731,Staff,13,0,13,0
1653299493606,AWP 3,029,085732,Staff,13,0,13,0
1653299493606,AWP 3,030,085733,Staff,13,0,13,0
1653299493606,AWP 3,031,085734,Staff,13,0,13,0
1653299493606,AWP 3,032,085735,Staff,13,0,13,0
1653299493606,AWP 3,033,085736,Staff,13,0,13,0
1653299493606,AWP 3,034,085737,Staff,13,0,13,0
1653299493606,AWP 3,035,085738,Staff,13,0,13,0
1653299493606,AWP 3,036,085739,Staff,13,0,13,0
1653299493606,AWP 3,037,085740,Staff,13,0,13,0
1653299493606,AWP 3,038,085741,Staff,13,0,13,0
1653299493606,AWP 3,039,085742,Staff,13,0,13,0
1653299493606,AWP 3,040,085743,Staff,13,0,13,0
1653299493606,AWP 3,041,085744,Staff,13,0,13,0
1653299493606,AWP 3,042,085745,Staff,13,0,13,0
1653299493606,AWP 3,043,085746,Staff,13,0,13,0
1653299493606,AWP 3,044,085747,Staff,13,0,13,0
1653299493606,AWP 3,045,085748,Staff,13,0,13,0
1653299493606,AWP 3,046,085749,Staff,13,0,13,0
1653299493606,AWP 3,047,085750,Staff,13,0,13,0
1653299493606,AWP 3,048,085751,Staff,13,0,13,0
1653299493606,AWP 3,049,085752,Staff,13,0,13,0
1653299493606,AWP 3,050,085753,Staff,13,0,13,0
1653299493606,AWP 3,051,085754,Staff,13,0,13,0
1653299493606,AWP 3,052,085755,Staff,0,0,0,0
1653299493606,AWP 3,053,085756,Staff,13,0,13,0
1653299493606,AWP 3,054,085757,Staff,0,0,0,0
1653299493606,AWP 3,055,085758,Staff,13,0,13,0
1653299493606,AWP 3,056,085759,Staff,13,0,13,0
1653299493606,AWP 3,057,085760,Staff,13,0,13,0
1653299493606,AWP 3,058,085761,Staff,13,0,13,0
1653299493606,AWP 3,059,085762,Staff,13,0,13,0
1653299493606,AWP 3,060,085763,Staff,13,0,13,0
1653299493606,AWP 3,061,085764,Staff,13,0,13,0
1653299493606,AWP 3,062,085765,Staff,13,0,13,0
1653299493606,AWP 3,063,085766,Staff,13,0,13,0
1653299493606,AWP 3,064,085767,Staff,13,0,13,0
1653299493606,AWP 3,065,085768,Staff,13,0,13,0
1653299493606,AWP 3,066,085769,Staff,0,0,0,0
1653299494143,AWP 4A,001,085770,Staff,0,0,0,0
1653299494143,AWP 4A,002,085771,Staff,13,0,13,0
1653299494143,AWP 4A,003,085772,Staff,13,0,13,0
1653299494143,AWP 4A,004,085773,Staff,13,0,13,0
1653299494143,AWP 4A,005,085774,Staff,0,0,0,0
1653299494143,AWP 4A,006,085775,Staff,13,0,13,0
1653299494143,AWP 4A,007,085776,Staff,0,0,0,0
1653299494143,AWP 4A,008,085777,Staff,0,0,0,0
1653299494143,AWP 4A,009,085778,Staff,0,0,0,0
1653299494143,AWP 4A,010,085779,Staff,13,0,13,0
1653299494143,AWP 4A,011,085780,Staff,13,0,13,0
1653299494143,AWP 4A,012,085781,Staff,0,0,0,0
1653299494143,AWP 4A,013,085782,Staff,13,0,13,0
1653299494143,AWP 4A,014,085783,Staff,13,0,13,0
1653299494143,AWP 4A,015,085784,Staff,13,0,13,0
1653299494143,AWP 4A,016,085785,Staff,13,0,13,0
1653299494143,AWP 4A,017,085786,Staff,13,0,13,0
1653299494143,AWP 4A,018,085787,Staff,0,0,0,0
1653299494143,AWP 4A,019,085788,Staff,13,0,13,0
1653299494143,AWP 4A,020,085789,Staff,13,0,13,0
1653299494143,AWP 4A,021,085790,Staff,0,0,0,0
1653299494143,AWP 4A,022,085791,Staff,13,0,13,0
1653299494143,AWP 4A,023,085792,Staff,0,0,0,0
1653299494143,AWP 4A,024,085793,Staff,0,0,0,0
1653299494143,AWP 4A,025,085794,Staff,13,0,13,0
1653299494143,AWP 4A,026,085795,Staff,13,0,13,0
1653299494143,AWP 4A,027,085796,Staff,13,0,13,0
1653299494143,AWP 4A,028,085797,Staff,13,0,13,0
1653299494143,AWP 4A,029,085798,Staff,0,0,0,0
1653299494143,AWP 4A,030,085799,Staff,0,0,0,0
1653299494143,AWP 4A,031,093835,Staff,0,0,0,0
1653299494665,AWP 4B,001,085800,Staff,0,0,0,0
1653299494665,AWP 4B,002,085801,Staff,0,0,0,0
1653299495199,BENG 2,A00,085936,Wheeler; Bruce Christopher,28,0,30,2
1653299495723,BENG 110,A01,085939,Mc Culloch; Andrew Douglas,20,0,30,10
1653299495723,BENG 110,A02,085940,Mc Culloch; Andrew Douglas,18,0,30,12
1653299495723,BENG 110,A03,085941,Mc Culloch; Andrew Douglas,27,0,30,3
1653299496245,BENG 119A,A01,085943,Wheeler; Bruce Christopher,29,0,30,1
1653299496769,BENG 122A,A01,085945,Cauwenberghs; Gert,18,0,25,7
1653299496769,BENG 122A,A02,085946,Cauwenberghs; Gert,22,0,25,3
1653299496769,BENG 122A,A03,085947,Cauwenberghs; Gert,22,0,25,3
1653299497292,BENG 126A,A01,085949,Wheeler; Bruce Christopher,30,0,30,0
1653299497818,BENG 127A,A01,085951,Wheeler; Bruce Christopher,28,0,30,2
1653299498341,BENG 128A,A01,085953,Wheeler; Bruce Christopher,29,0,30,1
1653299498869,BENG 134,A01,085955,Smarr; Benjamin,0,0,0,0
1653299499391,BENG 135,A00,085956,Wheeler; Bruce Christopher,23,0,30,7
1653299499919,BENG 141,A00,085958,Lal; Ratnesh,20,0,30,10
1653299500453,BENG 147A,A01,085963,Wheeler; Bruce Christopher,30,0,30,0
1653299500976,BENG 148A,A01,085967,Wheeler; Bruce Christopher,30,0,30,0
1653299501503,BENG 149A,A01,085969,Wheeler; Bruce Christopher,30,0,30,0
1653299502027,BENG 161A,A01,085971,Fraley; Stephanie I.,20,0,25,5
1653299502027,BENG 161A,A02,085972,Fraley; Stephanie I.,13,0,25,12
1653299502027,BENG 161A,A03,085973,Fraley; Stephanie I.,9,0,25,16
1653299502551,BENG 162,A01,085975,Mali; Prashant Gulab Ram,0,0,35,35
1653299502551,BENG 162,A02,085976,Mali; Prashant Gulab Ram,26,0,35,9
1653299503102,BENG 166A,A00,085977,Sah; Robert Lie-Yuan,0,0,0,0
1653299503624,BENG 169A,A01,085982,Wheeler; Bruce Christopher,28,0,30,2
1653299504151,BENG 179A,A01,085984,Wheeler; Bruce Christopher,30,0,30,0
1653299504710,BENG 183,A01,085986,Zhong; Sheng,13,0,30,17
1653299504710,BENG 183,A02,085987,Zhong; Sheng,15,0,30,15
1653299504710,BENG 183,A03,085988,Zhong; Sheng,20,0,30,10
1653299505240,BENG 187B,A00,085989,Wheeler; Bruce Christopher,105,0,170,65
1653299505764,BENG 196,001,094047,Engler; Adam J.,9999,0,9999,0
1653299506299,BIBC 100,A01,092918,Huffaker; Alisa,0,0,19,19
1653299506299,BIBC 100,A02,092919,Huffaker; Alisa,19,0,19,0
1653299506299,BIBC 100,A03,092920,Huffaker; Alisa,18,0,19,1
1653299506299,BIBC 100,A04,092921,Huffaker; Alisa,18,0,19,1
1653299506299,BIBC 100,A05,092922,Huffaker; Alisa,19,0,19,0
1653299506299,BIBC 100,A06,092923,Huffaker; Alisa,18,0,19,1
1653299506299,BIBC 100,A07,092924,Huffaker; Alisa,10,0,19,9
1653299506299,BIBC 100,A08,092925,Huffaker; Alisa,17,0,19,2
1653299506299,BIBC 100,A09,092926,Huffaker; Alisa,19,0,19,0
1653299506299,BIBC 100,A10,092927,Huffaker; Alisa,11,0,19,8
1653299506824,BIBC 102,A01,092997,Schmelz; Eric Alexander,16,0,19,3
1653299506824,BIBC 102,A02,092998,Schmelz; Eric Alexander,5,0,19,14
1653299506824,BIBC 102,A03,092999,Schmelz; Eric Alexander,1,0,19,18
1653299506824,BIBC 102,A04,093000,Schmelz; Eric Alexander,17,0,19,2
1653299506824,BIBC 102,A05,093001,Schmelz; Eric Alexander,9,0,19,10
1653299506824,BIBC 102,A06,093002,Schmelz; Eric Alexander,16,0,19,3
1653299506824,BIBC 102,A07,093003,Schmelz; Eric Alexander,19,0,19,0
1653299506824,BIBC 102,A08,093004,Schmelz; Eric Alexander,19,0,19,0
1653299506824,BIBC 102,A09,093005,Schmelz; Eric Alexander,14,0,19,5
1653299506824,BIBC 102,B01,093064,Coleman; Aaron B.,19,0,19,0
1653299506824,BIBC 102,B02,093065,Coleman; Aaron B.,17,0,19,2
1653299506824,BIBC 102,B03,093066,Coleman; Aaron B.,16,0,19,3
1653299506824,BIBC 102,B04,093067,Coleman; Aaron B.,11,0,19,8
1653299506824,BIBC 102,B05,093068,Coleman; Aaron B.,18,0,19,1
1653299506824,BIBC 102,B06,093069,Coleman; Aaron B.,16,0,19,3
1653299506824,BIBC 102,B07,093070,Coleman; Aaron B.,19,0,19,0
1653299506824,BIBC 102,B08,093071,Coleman; Aaron B.,15,0,19,4
1653299506824,BIBC 102,B09,093072,Coleman; Aaron B.,17,0,19,2
1653299507353,BIBC 103,A01,089887,Bozinovic; Goran,19,0,24,5
1653299507353,BIBC 103,A02,089888,Bozinovic; Goran,23,0,24,1
1653299507353,BIBC 103,B01,089890,Burg; Michael,2,0,24,22
1653299507353,BIBC 103,B02,089891,Burg; Michael,20,0,24,4
1653299507353,BIBC 103,C01,089893,Beyhan; Sinem,14,0,24,10
1653299507353,BIBC 103,C02,089894,Beyhan; Sinem,22,0,24,2
1653299507353,BIBC 103,D01,089896,Coleman; Aaron B.,10,0,24,14
1653299507353,BIBC 103,D02,089897,Coleman; Aaron B.,22,0,24,2
1653299507875,BIBC 194,A00,089898,Hui; Enfu,16,0,27,11
1653299508401,BICD 100,A01,092396,Smith; Laurie,21,0,22,1
1653299508401,BICD 100,A02,092397,Smith; Laurie,22,0,22,0
1653299508401,BICD 100,A03,092398,Smith; Laurie,21,0,22,1
1653299508401,BICD 100,A04,092399,Smith; Laurie,22,0,22,0
1653299508401,BICD 100,A05,092400,Smith; Laurie,21,0,22,1
1653299508401,BICD 100,A06,092401,Smith; Laurie,22,0,22,0
1653299508401,BICD 100,A07,092402,Smith; Laurie,22,0,22,0
1653299508401,BICD 100,A08,092403,Smith; Laurie,22,0,22,0
1653299508401,BICD 100,B01,093073,Mueller; Liam O'Connor,21,0,22,1
1653299508401,BICD 100,B02,093074,Mueller; Liam O'Connor,22,0,22,0
1653299508401,BICD 100,B03,093075,Mueller; Liam O'Connor,22,0,22,0
1653299508401,BICD 100,B04,093076,Mueller; Liam O'Connor,22,0,22,0
1653299508401,BICD 100,B05,093077,Mueller; Liam O'Connor,22,0,22,0
1653299508401,BICD 100,B06,093078,Mueller; Liam O'Connor,22,0,22,0
1653299508401,BICD 100,B07,093079,Mueller; Liam O'Connor,21,0,22,1
1653299508401,BICD 100,B08,093080,Mueller; Liam O'Connor,22,0,22,0
1653299508401,BICD 100,C01,093021,McDonnell; Lisa Marie,21,0,22,1
1653299508401,BICD 100,C02,093022,McDonnell; Lisa Marie,20,0,22,2
1653299508401,BICD 100,C03,093023,McDonnell; Lisa Marie,22,0,22,0
1653299508401,BICD 100,C04,093024,McDonnell; Lisa Marie,22,0,22,0
1653299508401,BICD 100,C05,093025,McDonnell; Lisa Marie,22,0,22,0
1653299508401,BICD 100,C06,093026,McDonnell; Lisa Marie,22,0,22,0
1653299508401,BICD 100,C07,093027,McDonnell; Lisa Marie,20,0,22,2
1653299508401,BICD 100,C08,093028,McDonnell; Lisa Marie,22,0,22,0
1653299508401,BICD 100,D01,093081,Day; Christopher D,22,0,22,0
1653299508401,BICD 100,D02,093082,Day; Christopher D,17,0,22,5
1653299508401,BICD 100,D03,093083,Day; Christopher D,21,0,22,1
1653299508401,BICD 100,D04,093084,Day; Christopher D,19,0,22,3
1653299508401,BICD 100,D05,093085,Day; Christopher D,22,0,22,0
1653299508401,BICD 100,D06,093086,Day; Christopher D,20,0,22,2
1653299508401,BICD 100,D07,093087,Day; Christopher D,19,0,22,3
1653299508401,BICD 100,D08,093088,Day; Christopher D,20,0,22,2
1653299508948,BICD 110,A01,093089,Kiger; Amy,29,0,32,3
1653299508948,BICD 110,A02,093091,Kiger; Amy,32,0,32,0
1653299508948,BICD 110,A03,093092,Kiger; Amy,31,0,32,1
1653299508948,BICD 110,A04,093093,Kiger; Amy,31,0,32,1
1653299508948,BICD 110,A05,093094,Kiger; Amy,26,0,32,6
1653299508948,BICD 110,A06,093095,Kiger; Amy,31,0,32,1
1653299508948,BICD 110,A07,093096,Kiger; Amy,31,0,32,1
1653299508948,BICD 110,B01,093029,Grossman; Emily N,21,0,32,11
1653299508948,BICD 110,B02,093030,Grossman; Emily N,28,0,32,4
1653299508948,BICD 110,B03,093031,Grossman; Emily N,32,0,32,0
1653299508948,BICD 110,B04,093032,Grossman; Emily N,28,0,32,4
1653299508948,BICD 110,B05,093033,Grossman; Emily N,26,0,32,6
1653299508948,BICD 110,B06,093034,Grossman; Emily N,19,0,32,13
1653299508948,BICD 110,B07,093035,Grossman; Emily N,20,0,32,12
1653299509474,BICD 140,A01,093097,Zuniga; Elina I,19,0,32,13
1653299509474,BICD 140,A02,093098,Zuniga; Elina I,17,0,32,15
1653299509474,BICD 140,A03,093099,Zuniga; Elina I,30,0,32,2
1653299509474,BICD 140,A04,093100,Zuniga; Elina I,32,0,32,0
1653299509474,BICD 140,A05,093101,Zuniga; Elina I,29,0,32,3
1653299509474,BICD 140,A06,093102,Zuniga; Elina I,27,0,32,5
1653299510000,BIEB 102,A01,092528,Butler; Shannon Rhey,22,0,27,5
1653299510000,BIEB 102,A02,092529,Butler; Shannon Rhey,17,0,27,10
1653299510000,BIEB 102,A03,092530,Butler; Shannon Rhey,24,0,27,3
1653299510000,BIEB 102,A04,092531,Butler; Shannon Rhey,26,0,27,1
1653299510000,BIEB 102,A05,092532,Butler; Shannon Rhey,25,0,27,2
1653299510000,BIEB 102,A06,092533,Butler; Shannon Rhey,24,0,27,3
1653299510000,BIEB 102,A07,092534,Butler; Shannon Rhey,23,0,27,4
1653299510525,BIEB 121,A00,089907,Holway; David A.,0,0,32,32
1653299511057,BIEB 126,A01,092974,Kohn; Joshua R,24,0,27,3
1653299511057,BIEB 126,A02,092975,Kohn; Joshua R,26,0,27,1
1653299511057,BIEB 126,A03,092976,Kohn; Joshua R,23,0,27,4
1653299511057,BIEB 126,A04,092977,Kohn; Joshua R,25,0,27,2
1653299511057,BIEB 126,A05,092978,Kohn; Joshua R,27,0,27,0
1653299511581,BIEB 146,A01,093054,Petrie; Katherine Lynn,1,0,27,26
1653299511581,BIEB 146,A02,093055,Petrie; Katherine Lynn,4,0,27,23
1653299511581,BIEB 146,A03,093056,Petrie; Katherine Lynn,0,0,27,27
1653299511581,BIEB 146,A04,093057,Petrie; Katherine Lynn,0,0,27,27
1653299511581,BIEB 146,A05,093058,Petrie; Katherine Lynn,20,0,27,7
1653299511581,BIEB 146,A06,093059,Petrie; Katherine Lynn,26,0,27,1
1653299511581,BIEB 146,A07,093060,Petrie; Katherine Lynn,16,0,27,11
1653299511581,BIEB 146,A08,093061,Petrie; Katherine Lynn,25,0,27,2
1653299511581,BIEB 146,A09,093062,Petrie; Katherine Lynn,17,0,27,10
1653299512103,BIEB 150,A01,093103,Rennison; Diana,16,0,27,11
1653299512103,BIEB 150,A02,093104,Rennison; Diana,21,0,27,6
1653299512103,BIEB 150,A03,093105,Rennison; Diana,26,0,27,1
1653299512103,BIEB 150,A04,093106,Rennison; Diana,24,0,27,3
1653299512103,BIEB 150,A05,093107,Rennison; Diana,25,0,27,2
1653299512103,BIEB 150,A06,093108,Rennison; Diana,27,0,27,0
1653299512627,BIEB 158,A01,094057,Reese; Aspen Taylor & Jackrel; Sara,31,0,32,1
1653299512627,BIEB 158,A02,094058,Reese; Aspen Taylor & Jackrel; Sara,28,0,32,4
1653299512627,BIEB 158,A03,094059,Reese; Aspen Taylor & Jackrel; Sara,31,0,32,1
1653299512627,BIEB 158,A04,094060,Reese; Aspen Taylor & Jackrel; Sara,32,0,32,0
1653299513151,BIEB 174,A01,092465,Cleland; Elsa Eleanor & Barton; Andrew David,27,0,27,0
1653299513151,BIEB 174,A02,092466,Cleland; Elsa Eleanor & Barton; Andrew David,27,0,27,0
1653299513151,BIEB 174,A03,092467,Cleland; Elsa Eleanor & Barton; Andrew David,23,0,27,4
1653299513151,BIEB 174,A04,092468,Cleland; Elsa Eleanor & Barton; Andrew David,20,0,27,7
1653299513151,BIEB 174,A05,092469,Cleland; Elsa Eleanor & Barton; Andrew David,25,0,27,2
1653299513151,BIEB 174,A06,092470,Cleland; Elsa Eleanor & Barton; Andrew David,27,0,27,0
1653299513151,BIEB 174,A07,092471,Cleland; Elsa Eleanor & Barton; Andrew David,25,0,27,2
1653299513687,BILD 1,A01,092884,Pickett; Brooke Elizabeth,16,0,19,3
1653299513687,BILD 1,A02,092885,Pickett; Brooke Elizabeth,19,0,19,0
1653299513687,BILD 1,A03,092886,Pickett; Brooke Elizabeth,19,0,19,0
1653299513687,BILD 1,A04,092887,Pickett; Brooke Elizabeth,18,0,19,1
1653299513687,BILD 1,A05,092888,Pickett; Brooke Elizabeth,19,0,19,0
1653299513687,BILD 1,A06,092889,Pickett; Brooke Elizabeth,19,0,19,0
1653299513687,BILD 1,A07,092890,Pickett; Brooke Elizabeth,17,0,19,2
1653299513687,BILD 1,B01,092891,Pekkurnaz Banghart; Gulcin,19,0,19,0
1653299513687,BILD 1,B02,092892,Pekkurnaz Banghart; Gulcin,16,0,19,3
1653299513687,BILD 1,B03,092893,Pekkurnaz Banghart; Gulcin,19,0,19,0
1653299513687,BILD 1,B04,092894,Pekkurnaz Banghart; Gulcin,19,0,19,0
1653299513687,BILD 1,B05,092895,Pekkurnaz Banghart; Gulcin,17,0,19,2
1653299513687,BILD 1,B06,092896,Pekkurnaz Banghart; Gulcin,19,0,19,0
1653299513687,BILD 1,B07,092897,Pekkurnaz Banghart; Gulcin,19,0,19,0
1653299513687,BILD 1,C01,092421,Meaders; Clara Leigh,18,0,19,1
1653299513687,BILD 1,C02,092422,Meaders; Clara Leigh,18,0,19,1
1653299513687,BILD 1,C03,092423,Meaders; Clara Leigh,17,0,19,2
1653299513687,BILD 1,C04,092424,Meaders; Clara Leigh,16,0,19,3
1653299513687,BILD 1,C05,092425,Meaders; Clara Leigh,19,0,19,0
1653299513687,BILD 1,C06,092426,Meaders; Clara Leigh,19,0,19,0
1653299513687,BILD 1,C07,092427,Meaders; Clara Leigh,19,0,19,0
1653299513687,BILD 1,D01,092428,Meaders; Clara Leigh,14,0,19,5
1653299513687,BILD 1,D02,092429,Meaders; Clara Leigh,19,0,19,0
1653299513687,BILD 1,D03,092430,Meaders; Clara Leigh,19,0,19,0
1653299513687,BILD 1,D04,092431,Meaders; Clara Leigh,19,0,19,0
1653299513687,BILD 1,D05,092432,Meaders; Clara Leigh,19,0,19,0
1653299513687,BILD 1,D06,092433,Meaders; Clara Leigh,19,0,19,0
1653299513687,BILD 1,D07,092434,Meaders; Clara Leigh,19,0,19,0
1653299513687,BILD 1,E01,092445,Cooper; Andrew Michael,19,0,19,0
1653299513687,BILD 1,E02,092446,Cooper; Andrew Michael,19,0,19,0
1653299513687,BILD 1,E03,092447,Cooper; Andrew Michael,19,0,19,0
1653299513687,BILD 1,E04,092448,Cooper; Andrew Michael,19,0,19,0
1653299513687,BILD 1,E05,092449,Cooper; Andrew Michael,17,0,19,2
1653299513687,BILD 1,E06,092450,Cooper; Andrew Michael,19,0,19,0
1653299513687,BILD 1,E07,092451,Cooper; Andrew Michael,19,0,19,0
1653299514212,BILD 2,A01,092822,Glasgow; Stacey Marie,25,0,25,0
1653299514212,BILD 2,A02,092823,Glasgow; Stacey Marie,24,0,25,1
1653299514212,BILD 2,A03,092824,Glasgow; Stacey Marie,24,0,25,1
1653299514212,BILD 2,A04,092825,Glasgow; Stacey Marie,25,0,25,0
1653299514212,BILD 2,A05,092826,Glasgow; Stacey Marie,25,0,25,0
1653299514212,BILD 2,A06,092827,Glasgow; Stacey Marie,25,0,25,0
1653299514212,BILD 2,A07,092828,Glasgow; Stacey Marie,25,0,25,0
1653299514212,BILD 2,B01,092830,Owens; Melinda Tsao-Ying,25,0,25,0
1653299514212,BILD 2,B02,092831,Owens; Melinda Tsao-Ying,21,0,25,4
1653299514212,BILD 2,B03,092832,Owens; Melinda Tsao-Ying,23,0,25,2
1653299514212,BILD 2,B04,092833,Owens; Melinda Tsao-Ying,25,0,25,0
1653299514212,BILD 2,B05,092834,Owens; Melinda Tsao-Ying,24,0,25,1
1653299514212,BILD 2,B06,092835,Owens; Melinda Tsao-Ying,21,0,25,4
1653299514212,BILD 2,B07,092836,Owens; Melinda Tsao-Ying,25,0,25,0
1653299514212,BILD 2,C01,092668,Owens; Melinda Tsao-Ying,24,0,25,1
1653299514212,BILD 2,C02,092669,Owens; Melinda Tsao-Ying,23,0,25,2
1653299514212,BILD 2,C03,092670,Owens; Melinda Tsao-Ying,22,0,25,3
1653299514212,BILD 2,C04,092671,Owens; Melinda Tsao-Ying,25,0,25,0
1653299514212,BILD 2,C05,092672,Owens; Melinda Tsao-Ying,25,0,25,0
1653299514212,BILD 2,C06,092673,Owens; Melinda Tsao-Ying,24,0,25,1
1653299514212,BILD 2,C07,092674,Owens; Melinda Tsao-Ying,25,0,25,0
1653299514739,BILD 3,A01,092454,Stockwell; Sarah R,17,0,19,2
1653299514739,BILD 3,A02,092455,Stockwell; Sarah R,17,0,19,2
1653299514739,BILD 3,A03,092456,Stockwell; Sarah R,18,0,19,1
1653299514739,BILD 3,A04,092457,Stockwell; Sarah R,19,0,19,0
1653299514739,BILD 3,A05,092458,Stockwell; Sarah R,19,0,19,0
1653299514739,BILD 3,A06,092459,Stockwell; Sarah R,18,0,19,1
1653299514739,BILD 3,A07,092460,Stockwell; Sarah R,18,0,19,1
1653299514739,BILD 3,A08,092461,Stockwell; Sarah R,19,0,19,0
1653299514739,BILD 3,A09,092462,Stockwell; Sarah R,19,0,19,0
1653299514739,BILD 3,B01,092479,Stockwell; Sarah R,19,0,19,0
1653299514739,BILD 3,B02,092480,Stockwell; Sarah R,18,0,19,1
1653299514739,BILD 3,B03,092481,Stockwell; Sarah R,18,0,19,1
1653299514739,BILD 3,B04,092482,Stockwell; Sarah R,19,0,19,0
1653299514739,BILD 3,B05,092483,Stockwell; Sarah R,19,0,19,0
1653299514739,BILD 3,B06,092484,Stockwell; Sarah R,19,0,19,0
1653299514739,BILD 3,B07,092485,Stockwell; Sarah R,19,0,19,0
1653299514739,BILD 3,B08,092486,Stockwell; Sarah R,18,0,19,1
1653299514739,BILD 3,B09,092487,Stockwell; Sarah R,18,0,19,1
1653299514739,BILD 3,C01,092412,Butler; Shannon Rhey,18,0,19,1
1653299514739,BILD 3,C02,092413,Butler; Shannon Rhey,15,0,19,4
1653299514739,BILD 3,C03,092414,Butler; Shannon Rhey,19,0,19,0
1653299514739,BILD 3,C04,092415,Butler; Shannon Rhey,19,0,19,0
1653299514739,BILD 3,C05,092416,Butler; Shannon Rhey,19,0,19,0
1653299514739,BILD 3,C06,092417,Butler; Shannon Rhey,19,0,19,0
1653299514739,BILD 3,C07,092418,Butler; Shannon Rhey,19,0,19,0
1653299514739,BILD 3,C08,092419,Butler; Shannon Rhey,19,0,19,0
1653299514739,BILD 3,C09,092420,Butler; Shannon Rhey,19,0,19,0
1653299514739,BILD 3,D01,092898,Reuther; Keefe,18,0,19,1
1653299514739,BILD 3,D02,092899,Reuther; Keefe,19,0,19,0
1653299514739,BILD 3,D03,092900,Reuther; Keefe,19,0,19,0
1653299514739,BILD 3,D04,092901,Reuther; Keefe,19,0,19,0
1653299514739,BILD 3,D05,092902,Reuther; Keefe,19,0,19,0
1653299514739,BILD 3,D06,092903,Reuther; Keefe,19,0,19,0
1653299514739,BILD 3,D07,092904,Reuther; Keefe,18,0,19,1
1653299514739,BILD 3,D08,092905,Reuther; Keefe,19,0,19,0
1653299514739,BILD 3,D09,092906,Reuther; Keefe,19,0,19,0
1653299515277,BILD 4,A01,089840,Mel; Stephanie,0,0,0,0
1653299515277,BILD 4,A02,089841,Mel; Stephanie,0,0,0,0
1653299515277,BILD 4,A03,089842,Mel; Stephanie,0,0,0,0
1653299515277,BILD 4,A04,089843,Mel; Stephanie,0,0,0,0
1653299515277,BILD 4,A05,089844,Mel; Stephanie,0,0,0,0
1653299515277,BILD 4,A06,089845,Mel; Stephanie,0,0,0,0
1653299515277,BILD 4,A07,089846,Mel; Stephanie,0,0,0,0
1653299515277,BILD 4,A08,089847,Mel; Stephanie,0,0,0,0
1653299515277,BILD 4,A09,089848,Mel; Stephanie,0,0,0,0
1653299515277,BILD 4,A10,089849,Mel; Stephanie,0,0,0,0
1653299515277,BILD 4,A11,089850,Mel; Stephanie,0,0,0,0
1653299515277,BILD 4,A12,089851,Mel; Stephanie,0,0,0,0
1653299515277,BILD 4,A13,089852,Mel; Stephanie,0,0,0,0
1653299515277,BILD 4,A14,089853,Mel; Stephanie,0,0,0,0
1653299515277,BILD 4,A15,089854,Mel; Stephanie,0,0,0,0
1653299515277,BILD 4,A16,089855,Mel; Stephanie,0,0,0,0
1653299515277,BILD 4,B01,089857,Lo; Stanley M.,0,0,0,0
1653299515277,BILD 4,B02,089858,Lo; Stanley M.,0,0,0,0
1653299515277,BILD 4,B03,089859,Lo; Stanley M.,0,0,0,0
1653299515277,BILD 4,B04,089860,Lo; Stanley M.,0,0,0,0
1653299515277,BILD 4,B05,089861,Lo; Stanley M.,0,0,0,0
1653299515277,BILD 4,B06,089862,Lo; Stanley M.,0,0,0,0
1653299515277,BILD 4,B07,089863,Lo; Stanley M.,0,0,0,0
1653299515277,BILD 4,B08,089864,Lo; Stanley M.,0,0,0,0
1653299515277,BILD 4,B09,089865,Lo; Stanley M.,0,0,0,0
1653299515277,BILD 4,B10,089866,Lo; Stanley M.,0,0,0,0
1653299515277,BILD 4,B11,089867,Lo; Stanley M.,0,0,0,0
1653299515277,BILD 4,B12,089868,Lo; Stanley M.,0,0,0,0
1653299515277,BILD 4,B13,089869,Lo; Stanley M.,0,0,0,0
1653299515277,BILD 4,B14,089870,Lo; Stanley M.,0,0,0,0
1653299515277,BILD 4,B15,089871,Lo; Stanley M.,0,0,0,0
1653299515277,BILD 4,B16,089872,Lo; Stanley M.,0,0,0,0
1653299515815,BILD 5,A01,092907,Reuther; Keefe,31,0,32,1
1653299515815,BILD 5,A02,092908,Reuther; Keefe,30,0,32,2
1653299516344,BILD 10,A01,092909,Gustafson-Brown; Cindy,27,0,27,0
1653299516344,BILD 10,A02,092910,Gustafson-Brown; Cindy,27,0,27,0
1653299516344,BILD 10,A03,092911,Gustafson-Brown; Cindy,27,0,27,0
1653299516344,BILD 10,A04,092912,Gustafson-Brown; Cindy,27,0,27,0
1653299516344,BILD 10,A05,092913,Gustafson-Brown; Cindy,25,0,27,2
1653299516344,BILD 10,A06,092914,Gustafson-Brown; Cindy,26,0,27,1
1653299516344,BILD 10,A07,092915,Gustafson-Brown; Cindy,27,0,27,0
1653299516344,BILD 10,A08,092916,Gustafson-Brown; Cindy,27,0,27,0
1653299516344,BILD 10,A09,092917,Gustafson-Brown; Cindy,27,0,27,0
1653299516874,BILD 20,A01,092956,Rana; Brinda Kanti,24,0,27,3
1653299516874,BILD 20,A02,092957,Rana; Brinda Kanti,24,0,27,3
1653299516874,BILD 20,A03,092958,Rana; Brinda Kanti,27,0,27,0
1653299516874,BILD 20,A04,092959,Rana; Brinda Kanti,27,0,27,0
1653299517416,BILD 32,A01,092990,Burg; Michael,27,0,27,0
1653299517416,BILD 32,A02,092991,Burg; Michael,26,0,27,1
1653299517416,BILD 32,A03,092992,Burg; Michael,27,0,27,0
1653299517416,BILD 32,A04,092993,Burg; Michael,26,0,27,1
1653299517416,BILD 32,A05,092994,Burg; Michael,27,0,27,0
1653299517416,BILD 32,A06,092995,Burg; Michael,27,0,27,0
1653299517416,BILD 32,A07,092996,Burg; Michael,27,0,27,0
1653299517941,BILD 60,A01,092392,Hammond; LaTisha Marie,24,0,24,0
1653299517941,BILD 60,A02,092393,Hammond; LaTisha Marie,24,0,24,0
1653299517941,BILD 60,B01,092394,Macagno; Eduardo R.,23,0,24,1
1653299517941,BILD 60,B02,092395,Macagno; Eduardo R.,24,0,24,0
1653299518470,BILD 62,A01,092949,Aljadeff; Johnatan,31,0,32,1
1653299518470,BILD 62,A02,092950,Aljadeff; Johnatan,32,0,32,0
1653299518470,BILD 62,A03,092951,Aljadeff; Johnatan,32,0,32,0
1653299519007,BILD 80,A00,089880,Pogliano; Joseph,27,0,30,3
1653299519539,BIMM 100,A01,092435,Pasquinelli; Amy,32,0,32,0
1653299519539,BIMM 100,A02,092436,Pasquinelli; Amy,30,0,32,2
1653299519539,BIMM 100,A03,092437,Pasquinelli; Amy,32,0,32,0
1653299519539,BIMM 100,A04,092438,Pasquinelli; Amy,31,0,32,1
1653299519539,BIMM 100,A05,092439,Pasquinelli; Amy,32,0,32,0
1653299519539,BIMM 100,A06,092440,Pasquinelli; Amy,32,0,32,0
1653299519539,BIMM 100,A07,092441,Pasquinelli; Amy,32,0,32,0
1653299519539,BIMM 100,A08,092442,Pasquinelli; Amy,32,0,32,0
1653299519539,BIMM 100,A09,092443,Pasquinelli; Amy,32,0,32,0
1653299519539,BIMM 100,A10,092444,Pasquinelli; Amy,32,0,32,0
1653299519539,BIMM 100,B01,092518,Pruneda-Paz; Jose L.,26,0,32,6
1653299519539,BIMM 100,B02,092519,Pruneda-Paz; Jose L.,19,0,32,13
1653299519539,BIMM 100,B03,092520,Pruneda-Paz; Jose L.,20,0,32,12
1653299519539,BIMM 100,B04,092521,Pruneda-Paz; Jose L.,24,0,32,8
1653299519539,BIMM 100,B05,092522,Pruneda-Paz; Jose L.,23,0,32,9
1653299519539,BIMM 100,B06,092523,Pruneda-Paz; Jose L.,24,0,32,8
1653299519539,BIMM 100,B07,092524,Pruneda-Paz; Jose L.,28,0,32,4
1653299519539,BIMM 100,B08,092525,Pruneda-Paz; Jose L.,25,0,32,7
1653299519539,BIMM 100,B09,092526,Pruneda-Paz; Jose L.,26,0,32,6
1653299519539,BIMM 100,B10,092527,Pruneda-Paz; Jose L.,24,0,32,8
1653299520063,BIMM 101,A01,089915,Rusert; Jessica Marie,22,0,24,2
1653299520063,BIMM 101,A02,089916,Rusert; Jessica Marie,21,0,24,3
1653299520063,BIMM 101,A03,089917,Rusert; Jessica Marie,21,0,24,3
1653299520063,BIMM 101,A04,089918,Rusert; Jessica Marie,20,0,24,4
1653299520063,BIMM 101,B01,089920,Grossman; Emily N,0,0,24,24
1653299520063,BIMM 101,B02,089921,Grossman; Emily N,1,0,24,23
1653299520063,BIMM 101,C01,089923,Day; Christopher D,0,0,24,24
1653299520063,BIMM 101,C02,089924,Day; Christopher D,0,0,24,24
1653299520063,BIMM 101,D01,089926,Cooper; Andrew Michael,18,0,24,6
1653299520063,BIMM 101,D02,089927,Cooper; Andrew Michael,24,0,24,0
1653299520063,BIMM 101,E01,089929,McDonnell; Lisa Marie,1,0,24,23
1653299520063,BIMM 101,E02,089930,McDonnell; Lisa Marie,12,0,24,12
1653299520594,BIMM 110,A01,092472,Tour; Ella,26,0,32,6
1653299520594,BIMM 110,A02,092473,Tour; Ella,23,0,32,9
1653299520594,BIMM 110,A03,092474,Tour; Ella,29,0,32,3
1653299520594,BIMM 110,A04,092475,Tour; Ella,27,0,32,5
1653299520594,BIMM 110,A05,092476,Tour; Ella,32,0,32,0
1653299520594,BIMM 110,A06,092477,Tour; Ella,30,0,32,2
1653299520594,BIMM 110,A07,092478,Tour; Ella,29,0,32,3
1653299521146,BIMM 120,A01,092979,Allen; Eric,28,0,32,4
1653299521146,BIMM 120,A02,092980,Allen; Eric,1,0,32,31
1653299521146,BIMM 120,A03,092981,Allen; Eric,14,0,32,18
1653299521146,BIMM 120,A04,092982,Allen; Eric,27,0,32,5
1653299521146,BIMM 120,A05,092983,Allen; Eric,30,0,32,2
1653299521146,BIMM 120,A06,092984,Allen; Eric,29,0,32,3
1653299521146,BIMM 120,A07,092985,Allen; Eric,20,0,32,12
1653299521146,BIMM 120,A08,092986,Allen; Eric,30,0,32,2
1653299521146,BIMM 120,A09,092987,Allen; Eric,30,0,32,2
1653299521146,BIMM 120,A10,092988,Allen; Eric,30,0,32,2
1653299521146,BIMM 120,A11,092989,Allen; Eric,32,0,32,0
1653299521680,BIMM 121,A01,089934,Petrie; Katherine Lynn,0,0,24,24
1653299521680,BIMM 121,A02,089935,Petrie; Katherine Lynn,0,0,24,24
1653299521680,BIMM 121,B01,089937,Pickett; Brooke Elizabeth,0,0,24,24
1653299521680,BIMM 121,B02,089938,Pickett; Brooke Elizabeth,0,0,24,24
1653299521680,BIMM 121,C01,089940,Pirino; Giorgia,0,0,24,24
1653299521680,BIMM 121,C02,089941,Pirino; Giorgia,0,0,24,24
1653299521680,BIMM 121,C03,089942,Pirino; Giorgia,0,0,24,24
1653299521680,BIMM 121,C04,089943,Pirino; Giorgia,0,0,24,24
1653299522219,BIMM 122,A01,093006,Russell; Alistair B,18,0,32,14
1653299522219,BIMM 122,A02,093007,Russell; Alistair B,16,0,32,16
1653299522219,BIMM 122,A03,093008,Russell; Alistair B,26,0,32,6
1653299522219,BIMM 122,A04,093009,Russell; Alistair B,32,0,32,0
1653299522219,BIMM 122,A05,093010,Russell; Alistair B,30,0,32,2
1653299522747,BIMM 124,A01,092404,Gustafson-Brown; Cindy,26,0,32,6
1653299522747,BIMM 124,A02,092405,Gustafson-Brown; Cindy,29,0,32,3
1653299522747,BIMM 124,A03,092406,Gustafson-Brown; Cindy,30,0,32,2
1653299522747,BIMM 124,A04,092407,Gustafson-Brown; Cindy,32,0,32,0
1653299522747,BIMM 124,A05,092408,Gustafson-Brown; Cindy,28,0,32,4
1653299522747,BIMM 124,A06,092409,Gustafson-Brown; Cindy,31,0,32,1
1653299522747,BIMM 124,A07,092410,Gustafson-Brown; Cindy,32,0,32,0
1653299523277,BIMM 140,A01,089947,Suel; Gurol Mehmet & Hao; Nan,16,0,27,11
1653299523277,BIMM 140,A02,089948,Suel; Gurol Mehmet & Hao; Nan,24,0,27,3
1653299523277,BIMM 140,A03,089949,Suel; Gurol Mehmet & Hao; Nan,21,0,27,6
1653299523277,BIMM 140,A04,089950,Suel; Gurol Mehmet & Hao; Nan,25,0,27,2
1653299523277,BIMM 140,A05,089951,Suel; Gurol Mehmet & Hao; Nan,24,0,27,3
1653299523812,BIMM 143,A01,089953,Grant; Barry J,0,0,40,40
1653299523812,BIMM 143,B01,089955,Fan; Chun Chieh,39,0,40,1
1653299523812,BIMM 143,C01,089957,Bozinovic; Goran,29,0,40,11
1653299524414,BIMM 194,A00,089958,Hasty; Jeff M,15,0,27,12
1653299524414,BIMM 194,B00,089959,Golden; James W,19,0,27,8
1653299524414,BIMM 194,C00,089960,Lykke-Andersen; Jens,2,0,27,25
1653299524414,BIMM 194,D00,094317,Golden; Susan S.,25,0,27,2
1653299524939,BIPN 100,A01,093011,Cooke; James Edward,7,0,19,12
1653299524939,BIPN 100,A02,093012,Cooke; James Edward,10,0,19,9
1653299524939,BIPN 100,A03,093013,Cooke; James Edward,8,0,19,11
1653299524939,BIPN 100,A04,093014,Cooke; James Edward,12,0,19,7
1653299524939,BIPN 100,A05,093015,Cooke; James Edward,17,0,19,2
1653299524939,BIPN 100,A06,093016,Cooke; James Edward,12,0,19,7
1653299524939,BIPN 100,A07,093017,Cooke; James Edward,12,0,19,7
1653299524939,BIPN 100,A08,093018,Cooke; James Edward,18,0,19,1
1653299524939,BIPN 100,A09,093019,Cooke; James Edward,17,0,19,2
1653299524939,BIPN 100,A10,093020,Cooke; James Edward,18,0,19,1
1653299524939,BIPN 100,B01,093036,Reyes Gonzalez; Catalina,17,0,19,2
1653299524939,BIPN 100,B02,093037,Reyes Gonzalez; Catalina,14,0,19,5
1653299524939,BIPN 100,B03,093038,Reyes Gonzalez; Catalina,16,0,19,3
1653299524939,BIPN 100,B04,093039,Reyes Gonzalez; Catalina,19,0,19,0
1653299524939,BIPN 100,B05,093040,Reyes Gonzalez; Catalina,19,0,19,0
1653299524939,BIPN 100,B06,093041,Reyes Gonzalez; Catalina,19,0,19,0
1653299524939,BIPN 100,B07,093042,Reyes Gonzalez; Catalina,14,0,19,5
1653299524939,BIPN 100,B08,093043,Reyes Gonzalez; Catalina,16,0,19,3
1653299524939,BIPN 100,B09,093044,Reyes Gonzalez; Catalina,19,0,19,0
1653299524939,BIPN 100,B10,093045,Reyes Gonzalez; Catalina,19,0,19,0
1653299525476,BIPN 102,A01,093046,Reyes Gonzalez; Catalina,28,0,32,4
1653299525476,BIPN 102,A02,093047,Reyes Gonzalez; Catalina,17,0,32,15
1653299525476,BIPN 102,A05,093050,Reyes Gonzalez; Catalina,29,0,32,3
1653299525476,BIPN 102,A06,093051,Reyes Gonzalez; Catalina,15,0,32,17
1653299525476,BIPN 102,A07,093052,Reyes Gonzalez; Catalina,29,0,32,3
1653299525476,BIPN 102,A08,093053,Reyes Gonzalez; Catalina,31,0,32,1
1653299526012,BIPN 105,A01,089966,Armour; Jon Christopher,0,0,21,21
1653299526012,BIPN 105,A02,089967,Armour; Jon Christopher,0,0,21,21
1653299526012,BIPN 105,A03,089968,Armour; Jon Christopher,3,0,21,18
1653299526012,BIPN 105,A04,089969,Armour; Jon Christopher,10,0,21,11
1653299526537,BIPN 140,A01,092514,Spitzer; Nicholas & Su; Chih-Ying,9,0,19,10
1653299526537,BIPN 140,A02,092515,Spitzer; Nicholas & Su; Chih-Ying,12,0,19,7
1653299526537,BIPN 140,A03,092516,Spitzer; Nicholas & Su; Chih-Ying,11,0,19,8
1653299526537,BIPN 140,A04,092517,Spitzer; Nicholas & Su; Chih-Ying,15,0,19,4
1653299526537,BIPN 140,B01,092952,Banghart; Matthew Ryan,12,0,19,7
1653299526537,BIPN 140,B02,092953,Banghart; Matthew Ryan,19,0,19,0
1653299526537,BIPN 140,B03,092954,Banghart; Matthew Ryan,19,0,19,0
1653299526537,BIPN 140,B04,092955,Banghart; Matthew Ryan,19,0,19,0
1653299527060,BIPN 145,A01,089973,Marino; Marc J,35,0,42,7
1653299527060,BIPN 145,A02,089974,Marino; Marc J,36,0,42,6
1653299527060,BIPN 145,B01,089976,Juavinett; Ashley Lauren,0,0,42,42
1653299527609,BIPN 148,A01,092960,Leutgeb; Jill K.,31,0,32,1
1653299527609,BIPN 148,A02,092961,Leutgeb; Jill K.,25,0,32,7
1653299527609,BIPN 148,A03,092962,Leutgeb; Jill K.,29,0,31,2
1653299527609,BIPN 148,A04,092963,Leutgeb; Jill K.,31,0,31,0
1653299527609,BIPN 148,A05,092964,Leutgeb; Jill K.,31,0,31,0
1653299527609,BIPN 148,A06,094351,Leutgeb; Jill K.,26,0,31,5
1653299527609,BIPN 148,A07,092966,Leutgeb; Jill K.,26,0,31,5
1653299527609,BIPN 148,A08,092967,Leutgeb; Jill K.,26,0,31,5
1653299528144,BIPN 189,A00,090665,Gentner; Tim,0,0,25,25
1653299528667,BIPN 194,A00,089978,Pekkurnaz Banghart; Gulcin,17,0,27,10
1653299528667,BIPN 194,B00,089979,Leutgeb; Stefan,24,0,27,3
1653299529193,BISP 194,A00,089980,Wertheim; Joel Okrent,8,0,27,19
1653299529722,CAT 1,A01,086671,Bronstein; Phoebe Malan,17,0,17,0
1653299529722,CAT 1,A02,086672,Bronstein; Phoebe Malan,13,0,17,4
1653299529722,CAT 1,A03,086673,Bronstein; Phoebe Malan,17,0,17,0
1653299529722,CAT 1,A04,086674,Bronstein; Phoebe Malan,15,0,17,2
1653299529722,CAT 1,A05,086675,Bronstein; Phoebe Malan,17,0,17,0
1653299529722,CAT 1,A06,086676,Bronstein; Phoebe Malan,17,0,17,0
1653299529722,CAT 1,A07,086677,Bronstein; Phoebe Malan,16,0,17,1
1653299529722,CAT 1,A08,086678,Bronstein; Phoebe Malan,17,0,17,0
1653299529722,CAT 1,A09,086679,Bronstein; Phoebe Malan,16,0,17,1
1653299529722,CAT 1,A10,086680,Bronstein; Phoebe Malan,17,0,17,0
1653299529722,CAT 1,A11,086681,Bronstein; Phoebe Malan,16,0,17,1
1653299529722,CAT 1,A12,086682,Bronstein; Phoebe Malan,17,0,17,0
1653299529722,CAT 1,A13,086683,Bronstein; Phoebe Malan,17,0,17,0
1653299529722,CAT 1,A14,086684,Bronstein; Phoebe Malan,17,0,17,0
1653299529722,CAT 1,A15,086685,Bronstein; Phoebe Malan,17,0,17,0
1653299529722,CAT 1,A16,086686,Bronstein; Phoebe Malan,17,0,17,0
1653299529722,CAT 1,B01,086688,Bigham; David Joseph,17,0,17,0
1653299529722,CAT 1,B02,086689,Bigham; David Joseph,16,0,17,1
1653299529722,CAT 1,B03,086690,Bigham; David Joseph,17,0,17,0
1653299529722,CAT 1,B04,086691,Bigham; David Joseph,17,0,17,0
1653299529722,CAT 1,B05,086692,Bigham; David Joseph,16,0,17,1
1653299529722,CAT 1,B06,086693,Bigham; David Joseph,17,0,17,0
1653299529722,CAT 1,B07,086694,Bigham; David Joseph,17,0,17,0
1653299529722,CAT 1,B08,086695,Bigham; David Joseph,17,0,17,0
1653299529722,CAT 1,B09,086696,Bigham; David Joseph,17,0,17,0
1653299529722,CAT 1,B10,086697,Bigham; David Joseph,17,0,17,0
1653299529722,CAT 1,B11,086698,Bigham; David Joseph,17,0,17,0
1653299529722,CAT 1,B12,086699,Bigham; David Joseph,17,0,17,0
1653299529722,CAT 1,B13,086700,Bigham; David Joseph,15,0,17,2
1653299529722,CAT 1,B14,086701,Bigham; David Joseph,17,0,17,0
1653299529722,CAT 1,C01,086703,Algaze; Guillermo,17,0,17,0
1653299529722,CAT 1,C02,086704,Algaze; Guillermo,17,0,17,0
1653299529722,CAT 1,C03,086705,Algaze; Guillermo,17,0,17,0
1653299529722,CAT 1,C04,086706,Algaze; Guillermo,17,0,17,0
1653299529722,CAT 1,C05,086707,Algaze; Guillermo,17,0,17,0
1653299529722,CAT 1,C06,086708,Algaze; Guillermo,17,0,17,0
1653299529722,CAT 1,C07,086709,Algaze; Guillermo,17,0,17,0
1653299529722,CAT 1,C08,086710,Algaze; Guillermo,17,0,17,0
1653299529722,CAT 1,C09,086711,Algaze; Guillermo,17,0,17,0
1653299529722,CAT 1,C10,086712,Algaze; Guillermo,17,0,17,0
1653299529722,CAT 1,C11,086713,Algaze; Guillermo,17,0,17,0
1653299529722,CAT 1,C12,086714,Algaze; Guillermo,17,0,17,0
1653299529722,CAT 1,C13,086715,Algaze; Guillermo,17,0,17,0
1653299529722,CAT 1,C14,086716,Algaze; Guillermo,16,0,17,1
1653299529722,CAT 1,C15,086717,Algaze; Guillermo,17,0,17,0
1653299529722,CAT 1,C16,086718,Algaze; Guillermo,16,0,17,1
1653299529722,CAT 1,D01,086720,Staff,17,0,17,0
1653299529722,CAT 1,D02,086721,Staff,17,0,17,0
1653299529722,CAT 1,D03,086722,Staff,17,0,17,0
1653299529722,CAT 1,D04,086723,Staff,17,0,17,0
1653299529722,CAT 1,D05,086724,Staff,16,0,17,1
1653299529722,CAT 1,D06,086725,Staff,16,0,17,1
1653299529722,CAT 1,D07,086726,Staff,17,0,17,0
1653299529722,CAT 1,D08,086727,Staff,17,0,17,0
1653299529722,CAT 1,D09,086728,Staff,16,0,17,1
1653299529722,CAT 1,D10,086729,Staff,17,0,17,0
1653299529722,CAT 1,D11,086730,Staff,17,0,17,0
1653299529722,CAT 1,D12,086731,Staff,17,0,17,0
1653299529722,CAT 1,D13,086732,Staff,17,0,17,0
1653299529722,CAT 1,D14,086733,Staff,17,0,17,0
1653299530246,CAT 3,A01,086735,Gumm; Elizabeth Ashley,14,0,15,1
1653299530246,CAT 3,A02,086736,Gumm; Elizabeth Ashley,14,0,15,1
1653299530246,CAT 3,A03,086737,Gumm; Elizabeth Ashley,15,0,15,0
1653299530246,CAT 3,A04,086738,Gumm; Elizabeth Ashley,15,0,15,0
1653299530246,CAT 3,A05,086739,Gumm; Elizabeth Ashley,15,0,15,0
1653299530246,CAT 3,A06,086740,Gumm; Elizabeth Ashley,15,0,15,0
1653299530771,CAT 124,A01,086742,Staff,15,0,15,0
1653299531295,CAT 125R,A01,094882,Staff,14,0,16,2
1653299531295,CAT 125R,A02,086745,Staff,16,0,16,0
1653299531295,CAT 125R,A03,086746,Staff,14,0,16,2
1653299531295,CAT 125R,A04,086747,Staff,13,0,16,3
1653299531295,CAT 125R,A05,086748,Staff,15,0,16,1
1653299531295,CAT 125R,A06,086749,Staff,12,0,16,4
1653299531295,CAT 125R,A07,086750,Staff,14,0,16,2
1653299531295,CAT 125R,A08,094883,Staff,14,0,16,2
1653299531295,CAT 125R,A09,094884,Staff,16,0,16,0
1653299531295,CAT 125R,A10,094885,Staff,15,0,16,1
1653299531295,CAT 125R,A14,086761,Staff,15,0,16,1
1653299531295,CAT 125R,A15,086762,Staff,16,0,16,0
1653299531295,CAT 125R,A16,086763,Staff,13,0,16,3
1653299531295,CAT 125R,A17,086764,Staff,14,0,16,2
1653299531295,CAT 125R,A18,086765,Staff,14,0,16,2
1653299531295,CAT 125R,A19,086766,Staff,14,0,16,2
1653299531820,CCS 101,A00,088353,Staff,29,0,35,6
1653299532344,CENG 4,A01,086204,Bae; Jinhye,30,0,30,0
1653299532344,CENG 4,A02,086205,Bae; Jinhye,30,0,30,0
1653299532344,CENG 4,B01,086207,Drews; Aaron,30,0,30,0
1653299532344,CENG 4,B02,086208,Drews; Aaron,30,0,30,0
1653299532877,CENG 15,A01,086210,Lubarda; Vlado,63,0,65,2
1653299532877,CENG 15,B01,086212,Lubarda; Vlado,65,0,65,0
1653299533400,CENG 100,A00,086213,Chen; Zheng,147,0,150,3
1653299533928,CENG 101A,A00,086214,Bae; Jinhye,142,0,150,8
1653299534450,CENG 120,A00,086215,Opatkiewicz; Justin Paul,125,0,150,25
1653299534973,CENG 122,A00,086216,Opatkiewicz; Justin Paul,137,0,150,13
1653299535508,CGS 2A,A01,086271,Shelby; Karen Lee,12,0,15,3
1653299535508,CGS 2A,A02,086272,Shelby; Karen Lee,13,0,15,2
1653299535508,CGS 2A,A03,086273,Shelby; Karen Lee,14,0,15,1
1653299535508,CGS 2A,A04,086274,Shelby; Karen Lee,15,0,15,0
1653299536030,CGS 100A,A00,086275,Perez; Roy,26,0,32,6
1653299536558,CGS 101,A00,086276,Shelby; Karen Lee,30,0,30,0
1653299537080,CGS 106,A00,086277,Shelby; Karen Lee,24,0,30,6
1653299537626,CGS 119,A00,086279,Nguyen; Hoang Tan,27,0,30,3
1653299538173,CGS 121,A00,086280,Martin Sandino; Amanda Maria Yoland,19,0,20,1
1653299538697,CGS 122,A00,086281,Whitley; Leila Marie,20,0,20,0
1653299539218,CGS 123,A00,086282,Staff,0,0,0,0
1653299539742,CGS 127,A00,086283,Whitley; Leila Marie,15,0,15,0
1653299540267,CGS 130,A00,086284,Martin Sandino; Amanda Maria Yoland,15,0,15,0
1653299540793,CGS 187,A00,086285,Perez; Roy,15,0,16,1
1653299541315,CGS 190,A00,086286,Staff,5,0,5,0
1653299541854,CHEM 4,A01,089669,Bussey; Thomas J,40,0,40,0
1653299541854,CHEM 4,A02,089670,Bussey; Thomas J,42,0,42,0
1653299541854,CHEM 4,A03,089671,Bussey; Thomas J,40,0,42,2
1653299541854,CHEM 4,A04,089672,Bussey; Thomas J,42,0,42,0
1653299541854,CHEM 4,A05,089673,Bussey; Thomas J,40,0,42,2
1653299541854,CHEM 4,A06,089674,Bussey; Thomas J,40,0,42,2
1653299541854,CHEM 4,A07,089675,Bussey; Thomas J,42,0,42,0
1653299541854,CHEM 4,A08,089676,Bussey; Thomas J,42,0,42,0
1653299541854,CHEM 4,A09,089677,Bussey; Thomas J,41,0,41,0
1653299541854,CHEM 4,A10,089678,Bussey; Thomas J,40,0,40,0
1653299542448,CHEM 6A,A01,092734,Pomeroy; Robert S.,4,0,4,0
1653299542448,CHEM 6A,A02,092735,Pomeroy; Robert S.,4,0,4,0
1653299542448,CHEM 6A,A03,092736,Pomeroy; Robert S.,4,0,4,0
1653299542448,CHEM 6A,A04,092737,Pomeroy; Robert S.,4,0,4,0
1653299542448,CHEM 6A,A05,092738,Pomeroy; Robert S.,4,0,4,0
1653299542448,CHEM 6A,A06,092739,Pomeroy; Robert S.,4,0,4,0
1653299542448,CHEM 6A,A07,092740,Pomeroy; Robert S.,4,0,4,0
1653299542448,CHEM 6A,A08,092741,Pomeroy; Robert S.,4,0,4,0
1653299542448,CHEM 6A,A09,092742,Pomeroy; Robert S.,0,0,0,0
1653299542448,CHEM 6A,B01,092744,Schurmeier; Kimberly,4,0,4,0
1653299542448,CHEM 6A,B02,092746,Schurmeier; Kimberly,4,0,4,0
1653299542448,CHEM 6A,B03,092749,Schurmeier; Kimberly,4,0,4,0
1653299542448,CHEM 6A,B04,092751,Schurmeier; Kimberly,4,0,4,0
1653299542448,CHEM 6A,B05,092753,Schurmeier; Kimberly,4,0,4,0
1653299542448,CHEM 6A,B06,092755,Schurmeier; Kimberly,3,0,4,1
1653299542448,CHEM 6A,B07,092756,Schurmeier; Kimberly,4,0,4,0
1653299542448,CHEM 6A,B08,092757,Schurmeier; Kimberly,4,0,4,0
1653299542448,CHEM 6A,B09,092758,Schurmeier; Kimberly,0,0,0,0
1653299542448,CHEM 6A,C01,092805,Schurmeier; Kimberly,4,0,4,0
1653299542448,CHEM 6A,C02,092806,Schurmeier; Kimberly,4,0,4,0
1653299542448,CHEM 6A,C03,092807,Schurmeier; Kimberly,4,0,4,0
1653299542448,CHEM 6A,C04,092808,Schurmeier; Kimberly,4,0,4,0
1653299542448,CHEM 6A,C05,092809,Schurmeier; Kimberly,4,0,4,0
1653299542448,CHEM 6A,C06,092810,Schurmeier; Kimberly,4,0,4,0
1653299542448,CHEM 6A,C07,092811,Schurmeier; Kimberly,4,0,4,0
1653299542448,CHEM 6A,C08,092812,Schurmeier; Kimberly,4,0,4,0
1653299542448,CHEM 6A,C09,092813,Schurmeier; Kimberly,0,0,0,0
1653299542448,CHEM 6A,D01,092837,Stallings; Dontarie M,4,0,4,0
1653299542448,CHEM 6A,D02,092838,Stallings; Dontarie M,4,0,4,0
1653299542448,CHEM 6A,D03,092839,Stallings; Dontarie M,4,0,4,0
1653299542448,CHEM 6A,D04,092840,Stallings; Dontarie M,4,0,4,0
1653299542448,CHEM 6A,D05,092841,Stallings; Dontarie M,4,0,4,0
1653299542448,CHEM 6A,D06,092842,Stallings; Dontarie M,4,0,4,0
1653299542448,CHEM 6A,D07,092843,Stallings; Dontarie M,4,0,4,0
1653299542448,CHEM 6A,D08,092844,Stallings; Dontarie M,4,0,4,0
1653299542448,CHEM 6A,D09,092845,Stallings; Dontarie M,0,0,0,0
1653299542448,CHEM 6A,E01,092796,Brydges; Stacey,4,0,4,0
1653299542448,CHEM 6A,E02,092797,Brydges; Stacey,3,0,4,1
1653299542448,CHEM 6A,E03,092798,Brydges; Stacey,4,0,4,0
1653299542448,CHEM 6A,E04,092799,Brydges; Stacey,3,0,4,1
1653299542448,CHEM 6A,E05,092800,Brydges; Stacey,4,0,4,0
1653299542448,CHEM 6A,E06,092801,Brydges; Stacey,4,0,4,0
1653299542448,CHEM 6A,E07,092802,Brydges; Stacey,4,0,4,0
1653299542448,CHEM 6A,E08,092803,Brydges; Stacey,4,0,4,0
1653299542448,CHEM 6A,E09,092804,Brydges; Stacey,0,0,0,0
1653299542448,CHEM 6A,F01,092759,Brydges; Stacey,4,0,4,0
1653299542448,CHEM 6A,F02,092760,Brydges; Stacey,4,0,4,0
1653299542448,CHEM 6A,F03,092761,Brydges; Stacey,3,0,4,1
1653299542448,CHEM 6A,F04,092762,Brydges; Stacey,4,0,4,0
1653299542448,CHEM 6A,F05,092763,Brydges; Stacey,4,0,4,0
1653299542448,CHEM 6A,F06,092764,Brydges; Stacey,4,0,4,0
1653299542448,CHEM 6A,F07,092765,Brydges; Stacey,4,0,4,0
1653299542448,CHEM 6A,F08,092766,Brydges; Stacey,4,0,4,0
1653299542448,CHEM 6A,F09,092767,Brydges; Stacey,0,0,0,0
1653299542448,CHEM 6A,G01,092774,Zid; Brian M,0,0,4,4
1653299542448,CHEM 6A,G02,092775,Zid; Brian M,2,0,4,2
1653299542448,CHEM 6A,G03,092776,Zid; Brian M,2,0,4,2
1653299542448,CHEM 6A,G04,092777,Zid; Brian M,2,0,4,2
1653299542448,CHEM 6A,G05,092778,Zid; Brian M,4,0,4,0
1653299542448,CHEM 6A,G06,092779,Zid; Brian M,4,0,4,0
1653299542448,CHEM 6A,G07,092780,Zid; Brian M,3,0,4,1
1653299542448,CHEM 6A,G08,092781,Zid; Brian M,3,0,4,1
1653299542448,CHEM 6A,G09,092782,Zid; Brian M,0,0,0,0
1653299542448,CHEM 6A,H01,092846,Stallings; Dontarie M,4,0,4,0
1653299542448,CHEM 6A,H02,092847,Stallings; Dontarie M,3,0,4,1
1653299542448,CHEM 6A,H03,092848,Stallings; Dontarie M,4,0,4,0
1653299542448,CHEM 6A,H04,092849,Stallings; Dontarie M,4,0,4,0
1653299542448,CHEM 6A,H05,092850,Stallings; Dontarie M,4,0,4,0
1653299542448,CHEM 6A,H06,092851,Stallings; Dontarie M,3,0,4,1
1653299542448,CHEM 6A,H07,092852,Stallings; Dontarie M,4,0,4,0
1653299542448,CHEM 6A,H08,092853,Stallings; Dontarie M,3,0,4,1
1653299542448,CHEM 6A,H09,092854,Stallings; Dontarie M,0,0,0,0
1653299542448,CHEM 6A,I01,092814,Staff,0,0,0,0
1653299542448,CHEM 6A,I02,092815,Staff,0,0,0,0
1653299542448,CHEM 6A,I04,092816,Staff,0,0,0,0
1653299542448,CHEM 6A,I05,092817,Staff,0,0,0,0
1653299542448,CHEM 6A,I06,092818,Staff,0,0,0,0
1653299542448,CHEM 6A,I07,092819,Staff,0,0,0,0
1653299542448,CHEM 6A,I08,092820,Staff,0,0,0,0
1653299542448,CHEM 6A,I09,092821,Staff,0,0,0,0
1653299542974,CHEM 6AH,A01,092793,Paesani; Francesco,15,0,16,1
1653299542974,CHEM 6AH,A02,092794,Paesani; Francesco,16,0,16,0
1653299542974,CHEM 6AH,A03,092795,Paesani; Francesco,16,0,16,0
1653299543497,CHEM 6B,A01,092691,Hopkins; Patrycja Anna,21,0,25,4
1653299543497,CHEM 6B,A02,092692,Hopkins; Patrycja Anna,23,0,25,2
1653299543497,CHEM 6B,A03,092693,Hopkins; Patrycja Anna,25,0,25,0
1653299543497,CHEM 6B,A04,092694,Hopkins; Patrycja Anna,0,0,0,0
1653299543497,CHEM 6B,A05,092695,Hopkins; Patrycja Anna,24,0,25,1
1653299543497,CHEM 6B,A06,092696,Hopkins; Patrycja Anna,22,0,25,3
1653299543497,CHEM 6B,A07,092697,Hopkins; Patrycja Anna,24,0,25,1
1653299544027,CHEM 6C,A01,092708,Albizati; Kim F.,31,0,38,7
1653299544027,CHEM 6C,A02,092709,Albizati; Kim F.,32,0,38,6
1653299544027,CHEM 6C,A03,092710,Albizati; Kim F.,37,0,38,1
1653299544027,CHEM 6C,A04,092711,Albizati; Kim F.,36,0,38,2
1653299544027,CHEM 6C,A05,092712,Albizati; Kim F.,0,0,0,0
1653299544027,CHEM 6C,A06,092714,Albizati; Kim F.,33,0,38,5
1653299544027,CHEM 6C,A07,092715,Albizati; Kim F.,32,0,38,6
1653299544027,CHEM 6C,A08,092716,Albizati; Kim F.,37,0,38,1
1653299544027,CHEM 6C,A09,092717,Albizati; Kim F.,38,0,38,0
1653299544570,CHEM 7L,A01,089692,Leigh; Brian,11,0,19,8
1653299544570,CHEM 7L,A02,089693,Leigh; Brian,23,0,24,1
1653299544570,CHEM 7L,A03,089694,Leigh; Brian,24,0,24,0
1653299544570,CHEM 7L,A04,089695,Leigh; Brian,24,0,24,0
1653299544570,CHEM 7L,A05,089696,Leigh; Brian,23,0,24,1
1653299544570,CHEM 7L,A06,089697,Leigh; Brian,22,0,24,2
1653299544570,CHEM 7L,A07,089698,Leigh; Brian,21,0,21,0
1653299544570,CHEM 7L,A08,089699,Leigh; Brian,17,0,24,7
1653299544570,CHEM 7L,A09,089700,Leigh; Brian,23,0,24,1
1653299544570,CHEM 7L,A10,089701,Leigh; Brian,0,0,0,0
1653299544570,CHEM 7L,B01,089703,Leigh; Brian,18,0,24,6
1653299544570,CHEM 7L,B02,089704,Leigh; Brian,18,0,24,6
1653299544570,CHEM 7L,B03,089705,Leigh; Brian,23,0,24,1
1653299544570,CHEM 7L,B04,089706,Leigh; Brian,20,0,21,1
1653299544570,CHEM 7L,B05,089707,Leigh; Brian,17,0,24,7
1653299544570,CHEM 7L,B06,089708,Leigh; Brian,17,0,24,7
1653299544570,CHEM 7L,B07,089709,Leigh; Brian,17,0,24,7
1653299544570,CHEM 7L,B08,089710,Leigh; Brian,21,0,24,3
1653299544570,CHEM 7L,B09,089711,Leigh; Brian,21,0,24,3
1653299544570,CHEM 7L,B10,089712,Leigh; Brian,0,0,0,0
1653299544570,CHEM 7L,C01,089714,Staff,23,0,24,1
1653299544570,CHEM 7L,C02,089715,Staff,22,0,24,2
1653299544570,CHEM 7L,C03,089716,Staff,23,0,24,1
1653299544570,CHEM 7L,C04,089717,Staff,24,0,24,0
1653299544570,CHEM 7L,C05,089718,Staff,21,0,24,3
1653299544570,CHEM 7L,C06,089719,Staff,22,0,24,2
1653299544570,CHEM 7L,C07,089720,Staff,23,0,24,1
1653299544570,CHEM 7L,C08,089721,Staff,24,0,24,0
1653299544570,CHEM 7L,C09,089722,Staff,24,0,24,0
1653299544570,CHEM 7L,C10,089723,Staff,0,0,0,0
1653299545096,CHEM 40A,A01,092871,Schmidt; Valerie A,31,0,31,0
1653299545096,CHEM 40A,A02,092872,Schmidt; Valerie A,31,0,31,0
1653299545096,CHEM 40A,A03,092873,Schmidt; Valerie A,31,0,31,0
1653299545096,CHEM 40A,A04,092874,Schmidt; Valerie A,0,0,0,0
1653299545096,CHEM 40A,A05,092875,Schmidt; Valerie A,31,0,31,0
1653299545096,CHEM 40A,A06,092876,Schmidt; Valerie A,29,0,31,2
1653299545096,CHEM 40A,A07,092877,Schmidt; Valerie A,31,0,31,0
1653299545096,CHEM 40A,A08,092878,Schmidt; Valerie A,28,0,28,0
1653299545096,CHEM 40A,B01,089726,Lam; Tin Yiu,31,0,31,0
1653299545096,CHEM 40A,B02,089727,Lam; Tin Yiu,31,0,31,0
1653299545096,CHEM 40A,B03,089728,Lam; Tin Yiu,31,0,31,0
1653299545096,CHEM 40A,B04,089729,Lam; Tin Yiu,30,0,31,1
1653299545096,CHEM 40A,B05,089730,Lam; Tin Yiu,31,0,31,0
1653299545096,CHEM 40A,B06,089731,Lam; Tin Yiu,30,0,31,1
1653299545096,CHEM 40A,B07,089732,Lam; Tin Yiu,29,0,31,2
1653299545096,CHEM 40A,B08,089733,Lam; Tin Yiu,0,0,0,0
1653299545096,CHEM 40A,C01,092718,Albizati; Kim F.,17,0,31,14
1653299545096,CHEM 40A,C02,092719,Albizati; Kim F.,24,0,31,7
1653299545096,CHEM 40A,C03,092720,Albizati; Kim F.,12,0,31,19
1653299545096,CHEM 40A,C04,092721,Albizati; Kim F.,24,0,31,7
1653299545096,CHEM 40A,C05,092722,Albizati; Kim F.,21,0,31,10
1653299545096,CHEM 40A,C06,092723,Albizati; Kim F.,24,0,31,7
1653299545096,CHEM 40A,C07,092724,Albizati; Kim F.,30,0,31,1
1653299545096,CHEM 40A,C08,092725,Albizati; Kim F.,0,0,0,0
1653299545096,CHEM 40A,D01,092863,Yang; Jerry,28,0,31,3
1653299545096,CHEM 40A,D02,092864,Yang; Jerry,28,0,31,3
1653299545096,CHEM 40A,D03,092865,Yang; Jerry,31,0,31,0
1653299545096,CHEM 40A,D04,092866,Yang; Jerry,31,0,31,0
1653299545096,CHEM 40A,D05,092867,Yang; Jerry,0,0,0,0
1653299545096,CHEM 40A,D06,092868,Yang; Jerry,31,0,31,0
1653299545096,CHEM 40A,D07,092869,Yang; Jerry,31,0,31,0
1653299545096,CHEM 40A,D08,092870,Yang; Jerry,31,0,31,0
1653299545642,CHEM 40B,A01,092698,Oconnor; Joseph M.,24,0,34,10
1653299545642,CHEM 40B,A02,092699,Oconnor; Joseph M.,34,0,34,0
1653299545642,CHEM 40B,A03,092700,Oconnor; Joseph M.,0,0,0,0
1653299545642,CHEM 40B,A04,092701,Oconnor; Joseph M.,30,0,34,4
1653299545642,CHEM 40B,A05,092702,Oconnor; Joseph M.,33,0,34,1
1653299545642,CHEM 40B,A06,092703,Oconnor; Joseph M.,34,0,34,0
1653299545642,CHEM 40B,A07,092704,Oconnor; Joseph M.,32,0,34,2
1653299545642,CHEM 40B,A08,092705,Oconnor; Joseph M.,33,0,34,1
1653299545642,CHEM 40B,A09,092706,Oconnor; Joseph M.,34,0,34,0
1653299546167,CHEM 40C,A01,089739,Lam; Tin Yiu,0,0,0,0
1653299546167,CHEM 40C,A02,089740,Lam; Tin Yiu,0,0,0,0
1653299546167,CHEM 40C,A03,089741,Lam; Tin Yiu,0,0,0,0
1653299546167,CHEM 40C,A04,089742,Lam; Tin Yiu,13,0,34,21
1653299546167,CHEM 40C,A05,089743,Lam; Tin Yiu,32,0,34,2
1653299546167,CHEM 40C,A06,089744,Lam; Tin Yiu,31,0,34,3
1653299546696,CHEM 41A,A01,093840,Ternansky; Robert J.,29,0,33,4
1653299546696,CHEM 41A,A02,093841,Ternansky; Robert J.,32,0,33,1
1653299546696,CHEM 41A,A03,093842,Ternansky; Robert J.,33,0,33,0
1653299546696,CHEM 41A,A04,093843,Ternansky; Robert J.,30,0,33,3
1653299546696,CHEM 41A,A05,093844,Ternansky; Robert J.,31,0,33,2
1653299546696,CHEM 41A,A06,093845,Ternansky; Robert J.,27,0,27,0
1653299546696,CHEM 41A,A07,093846,Ternansky; Robert J.,32,0,33,1
1653299546696,CHEM 41A,A08,093847,Ternansky; Robert J.,33,0,33,0
1653299547224,CHEM 43A,A01,089746,Klosterman; Jeremy K,11,0,24,13
1653299547224,CHEM 43A,A02,089747,Klosterman; Jeremy K,16,0,24,8
1653299547224,CHEM 43A,A03,089748,Klosterman; Jeremy K,21,0,24,3
1653299547224,CHEM 43A,A04,089749,Klosterman; Jeremy K,22,0,24,2
1653299547224,CHEM 43A,A05,089750,Klosterman; Jeremy K,23,0,24,1
1653299547224,CHEM 43A,A06,089751,Klosterman; Jeremy K,9,0,24,15
1653299547224,CHEM 43A,A07,089752,Klosterman; Jeremy K,17,0,24,7
1653299547224,CHEM 43A,A08,089753,Klosterman; Jeremy K,16,0,24,8
1653299547224,CHEM 43A,A09,089754,Klosterman; Jeremy K,21,0,24,3
1653299547224,CHEM 43A,A10,089755,Klosterman; Jeremy K,21,0,24,3
1653299547224,CHEM 43A,A11,089756,Klosterman; Jeremy K,0,0,0,0
1653299547224,CHEM 43A,A12,089757,Klosterman; Jeremy K,0,0,0,0
1653299547224,CHEM 43A,A13,089758,Klosterman; Jeremy K,0,0,0,0
1653299547224,CHEM 43A,B01,089760,Klosterman; Jeremy K,0,0,0,0
1653299547224,CHEM 43A,B02,089761,Klosterman; Jeremy K,0,0,0,0
1653299547224,CHEM 43A,B03,089762,Klosterman; Jeremy K,16,0,24,8
1653299547224,CHEM 43A,B04,089763,Klosterman; Jeremy K,22,0,24,2
1653299547224,CHEM 43A,B05,089764,Klosterman; Jeremy K,23,0,24,1
1653299547224,CHEM 43A,B06,089765,Klosterman; Jeremy K,23,0,24,1
1653299547224,CHEM 43A,B07,089766,Klosterman; Jeremy K,17,0,24,7
1653299547224,CHEM 43A,B08,089767,Klosterman; Jeremy K,23,0,24,1
1653299547224,CHEM 43A,B09,089768,Klosterman; Jeremy K,24,0,24,0
1653299547224,CHEM 43A,B10,089769,Klosterman; Jeremy K,23,0,24,1
1653299547224,CHEM 43A,B11,089770,Klosterman; Jeremy K,22,0,24,2
1653299547224,CHEM 43A,B12,089771,Klosterman; Jeremy K,21,0,24,3
1653299547774,CHEM 87,A00,089772,Bussey; Thomas J,20,0,20,0
1653299548302,CHEM 96,A00,089773,Bussey; Thomas J,20,0,25,5
1653299548837,CHEM 100A,A01,089775,Pomeroy; Robert S.,22,0,24,2
1653299548837,CHEM 100A,A02,089776,Pomeroy; Robert S.,19,0,24,5
1653299548837,CHEM 100A,A03,089777,Pomeroy; Robert S.,13,0,24,11
1653299548837,CHEM 100A,A04,089778,Pomeroy; Robert S.,18,0,24,6
1653299548837,CHEM 100A,A05,089779,Pomeroy; Robert S.,19,0,24,5
1653299548837,CHEM 100A,A06,089780,Pomeroy; Robert S.,24,0,24,0
1653299548837,CHEM 100A,A07,089781,Pomeroy; Robert S.,0,0,0,0
1653299549398,CHEM 105A,A01,089783,Young; Mark,0,0,39,39
1653299549398,CHEM 105A,B01,089785,Young; Mark,26,0,39,13
1653299549937,CHEM 108,A01,089787,Ghosh; Gourisankar,1,0,22,21
1653299549937,CHEM 108,A02,089788,Ghosh; Gourisankar,6,0,22,16
1653299549937,CHEM 108,B01,089790,Ghosh; Gourisankar,13,0,22,9
1653299549937,CHEM 108,B02,089791,Ghosh; Gourisankar,20,0,22,2
1653299550469,CHEM 109,A01,089793,Hamaoka; Brent Y,4,0,22,18
1653299550469,CHEM 109,A02,089794,Hamaoka; Brent Y,10,0,22,12
1653299550469,CHEM 109,B01,089796,Hamaoka; Brent Y,6,0,22,16
1653299550469,CHEM 109,B02,089797,Hamaoka; Brent Y,18,0,22,4
1653299550993,CHEM 114A,A01,092855,Toor; Navtej,21,0,25,4
1653299550993,CHEM 114A,A02,092856,Toor; Navtej,25,0,25,0
1653299550993,CHEM 114A,A03,092857,Toor; Navtej,19,0,25,6
1653299550993,CHEM 114A,A04,092858,Toor; Navtej,24,0,25,1
1653299550993,CHEM 114A,A05,092859,Toor; Navtej,0,0,0,0
1653299550993,CHEM 114A,A06,092860,Toor; Navtej,14,0,25,11
1653299550993,CHEM 114A,A07,092861,Toor; Navtej,24,0,25,1
1653299550993,CHEM 114A,A08,092862,Toor; Navtej,24,0,25,1
1653299551520,CHEM 116,A01,092707,Ferguson; Fleur,7,0,35,28
1653299551520,CHEM 116,A02,094887,Ferguson; Fleur,31,0,35,4
1653299552044,CHEM 120A,A01,092785,Schimpf; Alina M,16,0,28,12
1653299552044,CHEM 120A,A02,092786,Schimpf; Alina M,26,0,28,2
1653299552044,CHEM 120A,A03,092787,Schimpf; Alina M,20,0,28,8
1653299552044,CHEM 120A,A04,092788,Schimpf; Alina M,27,0,28,1
1653299552044,CHEM 120A,A05,092789,Schimpf; Alina M,27,0,28,1
1653299552044,CHEM 120A,A06,092790,Schimpf; Alina M,0,0,0,0
1653299552044,CHEM 120A,A07,092791,Schimpf; Alina M,15,0,28,13
1653299552044,CHEM 120A,A08,092792,Schimpf; Alina M,0,0,0,0
1653299552594,CHEM 126A,A01,092768,Schoeneberg; Johannes,16,0,35,19
1653299552594,CHEM 126A,A02,092769,Schoeneberg; Johannes,35,0,35,0
1653299552594,CHEM 126A,A03,092770,Schoeneberg; Johannes,29,0,35,6
1653299552594,CHEM 126A,A04,092771,Schoeneberg; Johannes,0,0,0,0
1653299552594,CHEM 126A,A05,092772,Schoeneberg; Johannes,30,0,35,5
1653299552594,CHEM 126A,A06,092773,Schoeneberg; Johannes,33,0,35,2
1653299553119,CHEM 130,A01,092685,Sinha; Amitabha,28,0,38,10
1653299553119,CHEM 130,A02,092686,Sinha; Amitabha,31,0,38,7
1653299553119,CHEM 130,A03,092687,Sinha; Amitabha,34,0,38,4
1653299553644,CHEM 142,A00,089803,Esko; Jeffrey D. & Godula; Kamil,9,0,46,37
1653299554173,CHEM 143C,A01,089805,Ternansky; Robert J.,17,0,22,5
1653299554173,CHEM 143C,A02,089806,Ternansky; Robert J.,18,0,22,4
1653299554173,CHEM 143C,A03,089807,Ternansky; Robert J.,19,0,22,3
1653299554173,CHEM 143C,A04,089808,Ternansky; Robert J.,20,0,22,2
1653299554698,CHEM 152,A00,089809,Romero; Nathan A & Schmidt; Valerie A,35,0,40,5
1653299555231,CHEM 171,A01,092688,Slade; Jonathan,35,0,45,10
1653299555231,CHEM 171,A02,092689,Slade; Jonathan,44,0,45,1
1653299555231,CHEM 171,A03,092690,Slade; Jonathan,45,0,45,0
1653299555754,CHEM 186,A00,089811,Paesani; Francesco,9,0,15,6
1653299556295,CHIN 10AD,A01,086223,Staff,13,0,13,0
1653299556295,CHIN 10AD,A02,086224,Staff,12,0,13,1
1653299556295,CHIN 10AD,B01,086227,Staff,14,0,15,1
1653299556839,CHIN 10AM,A01,086230,Chen; Pei-Chia,16,0,16,0
1653299556839,CHIN 10AM,A02,086231,Chen; Pei-Chia,16,0,16,0
1653299557372,CHIN 10AN,A01,086234,Xu; Li,14,0,14,0
1653299557372,CHIN 10AN,A02,086235,Xu; Li,14,0,14,0
1653299557372,CHIN 10AN,B01,086240,Xu; Li,14,0,14,0
1653299557372,CHIN 10AN,B02,086242,Xu; Li,0,0,0,0
1653299557372,CHIN 10AN,C01,086245,Xu; Li,14,0,14,0
1653299557372,CHIN 10AN,C02,086246,Xu; Li,14,0,14,0
1653299557896,CHIN 20AD,A01,086248,Wang; Xiao,14,0,14,0
1653299557896,CHIN 20AD,A02,086249,Wang; Xiao,14,0,14,0
1653299557896,CHIN 20AD,B01,086251,Wang; Xiao,13,0,14,1
1653299557896,CHIN 20AD,B02,086252,Wang; Xiao,14,0,14,0
1653299558424,CHIN 20AM,A01,086254,Wang; Xiao,11,0,14,3
1653299558424,CHIN 20AM,A02,086255,Wang; Xiao,13,0,14,1
1653299558424,CHIN 20AM,B01,086257,Staff,15,0,15,0
1653299558960,CHIN 20AN,A01,086259,Anderson; Qin-Hong,11,0,12,1
1653299558960,CHIN 20AN,A02,086260,Anderson; Qin-Hong,12,0,12,0
1653299558960,CHIN 20AN,A03,086261,Anderson; Qin-Hong,0,0,0,0
1653299558960,CHIN 20AN,B01,086263,Anderson; Qin-Hong,12,0,13,1
1653299558960,CHIN 20AN,B02,086264,Anderson; Qin-Hong,13,0,13,0
1653299559485,CHIN 100AM,A00,086265,Anderson; Qin-Hong,20,0,20,0
1653299560012,CHIN 100AN,A00,086266,Chen; Pei-Chia,17,0,20,3
1653299560548,CHIN 185A,A00,086268,Staff,20,0,20,0
1653299561081,COGS 1,A01,087834,Barrera; Steven James,57,0,60,3
1653299561081,COGS 1,A02,087835,Barrera; Steven James,52,0,60,8
1653299561081,COGS 1,A03,087836,Barrera; Steven James,57,0,60,3
1653299561081,COGS 1,A04,087837,Barrera; Steven James,59,0,60,1
1653299561081,COGS 1,A05,087838,Barrera; Steven James,60,0,60,0
1653299561081,COGS 1,A06,087839,Barrera; Steven James,59,0,60,1
1653299561081,COGS 1,A07,087840,Barrera; Steven James,54,0,57,3
1653299561604,COGS 2,A01,087842,Boyle; Mary E. T.,64,0,64,0
1653299561604,COGS 2,A02,087843,Boyle; Mary E. T.,61,0,64,3
1653299561604,COGS 2,A03,087844,Boyle; Mary E. T.,64,0,64,0
1653299562128,COGS 3,A01,094312,Boyle; Mary E. T.,30,0,35,5
1653299562128,COGS 3,A02,094313,Boyle; Mary E. T.,33,0,35,2
1653299562128,COGS 3,A03,094314,Boyle; Mary E. T.,35,0,35,0
1653299562128,COGS 3,A04,094315,Boyle; Mary E. T.,35,0,35,0
1653299562128,COGS 3,A05,094316,Boyle; Mary E. T.,35,0,35,0
1653299562670,COGS 8,A01,087846,Staff,35,0,35,0
1653299563201,COGS 10,A01,094357,Hollan; James D.,53,0,60,7
1653299563201,COGS 10,A02,094358,Hollan; James D.,58,0,60,2
1653299563201,COGS 10,A03,094359,Hollan; James D.,59,0,60,1
1653299563201,COGS 10,A04,094360,Hollan; James D.,60,0,60,0
1653299563201,COGS 10,A05,094361,Hollan; James D.,60,0,60,0
1653299563728,COGS 11,A01,087848,Boyle; Mary E. T.,46,0,47,1
1653299563728,COGS 11,A02,087849,Boyle; Mary E. T.,44,0,47,3
1653299563728,COGS 11,A03,087850,Boyle; Mary E. T.,46,0,46,0
1653299564259,COGS 13,A01,087852,Davis; Joshua Daniel,56,0,60,4
1653299564259,COGS 13,A02,087853,Davis; Joshua Daniel,55,0,60,5
1653299564259,COGS 13,A03,087854,Davis; Joshua Daniel,57,0,60,3
1653299564259,COGS 13,A04,087855,Davis; Joshua Daniel,58,0,60,2
1653299564783,COGS 14A,A01,087857,Creel; Sarah,58,0,65,7
1653299564783,COGS 14A,A02,087858,Creel; Sarah,62,0,65,3
1653299564783,COGS 14A,A03,087859,Creel; Sarah,63,0,65,2
1653299564783,COGS 14A,A04,087860,Creel; Sarah,63,0,65,2
1653299565314,COGS 14B,A01,087862,Hoffman; Drew Ellen,56,0,60,4
1653299565314,COGS 14B,A02,087863,Hoffman; Drew Ellen,53,0,60,7
1653299565314,COGS 14B,A03,087864,Hoffman; Drew Ellen,60,0,60,0
1653299565839,COGS 15,A01,087866,Bergen; Benjamin,60,0,60,0
1653299565839,COGS 15,A02,087867,Bergen; Benjamin,59,0,60,1
1653299566362,COGS 17,A01,087869,Johnson; Christine M.,55,0,60,5
1653299566362,COGS 17,A02,087870,Johnson; Christine M.,58,0,60,2
1653299566362,COGS 17,A03,087871,Johnson; Christine M.,55,0,60,5
1653299566362,COGS 17,A04,087872,Johnson; Christine M.,60,0,60,0
1653299566362,COGS 17,A05,087873,Johnson; Christine M.,59,0,60,1
1653299566362,COGS 17,A06,087874,Johnson; Christine M.,60,0,60,0
1653299566888,COGS 18,A01,087876,Fleischer; Jason G,22,0,35,13
1653299566888,COGS 18,A02,087877,Fleischer; Jason G,31,0,35,4
1653299566888,COGS 18,A03,087878,Fleischer; Jason G,33,0,35,2
1653299566888,COGS 18,A04,087879,Fleischer; Jason G,33,0,35,2
1653299566888,COGS 18,A05,087880,Fleischer; Jason G,28,0,35,7
1653299566888,COGS 18,A06,087881,Fleischer; Jason G,34,0,35,1
1653299566888,COGS 18,A07,087882,Fleischer; Jason G,33,0,35,2
1653299566888,COGS 18,A08,087883,Fleischer; Jason G,31,0,35,4
1653299566888,COGS 18,A09,087884,Fleischer; Jason G,33,0,35,2
1653299567421,COGS 20,A01,090761,Borgo; David Garcia,5,0,5,0
1653299567421,COGS 20,A02,090762,Borgo; David Garcia,5,0,5,0
1653299567421,COGS 20,A03,090763,Borgo; David Garcia,5,0,5,0
1653299567962,COGS 87,A00,087885,Deak; Gedeon O.,20,0,20,0
1653299567962,COGS 87,B00,087886,Fleischer; Jason G,20,0,20,0
1653299568508,COGS 100,A01,087892,Kirsh; David Joel,56,0,60,4
1653299568508,COGS 100,A02,087893,Kirsh; David Joel,54,0,60,6
1653299568508,COGS 100,A03,087894,Kirsh; David Joel,54,0,60,6
1653299568508,COGS 100,A04,087895,Kirsh; David Joel,51,0,60,9
1653299568508,COGS 100,A05,087896,Kirsh; David Joel,48,0,60,12
1653299569043,COGS 101A,A01,087898,Hoffman; Drew Ellen,48,0,60,12
1653299569043,COGS 101A,A02,087899,Hoffman; Drew Ellen,58,0,60,2
1653299569043,COGS 101A,A03,087900,Hoffman; Drew Ellen,55,0,60,5
1653299569043,COGS 101A,A04,087901,Hoffman; Drew Ellen,58,0,60,2
1653299569043,COGS 101A,A05,087902,Hoffman; Drew Ellen,59,0,60,1
1653299569043,COGS 101A,A06,087903,Hoffman; Drew Ellen,56,0,60,4
1653299569566,COGS 101B,A01,087905,Barrera; Steven James,30,0,60,30
1653299569566,COGS 101B,A02,087906,Barrera; Steven James,52,0,60,8
1653299569566,COGS 101B,A03,087907,Barrera; Steven James,54,0,60,6
1653299570101,COGS 101C,A01,094240,Cooperrider; Kensy A,70,0,75,5
1653299570101,COGS 101C,A02,094241,Cooperrider; Kensy A,73,0,75,2
1653299570624,COGS 102A,A01,087909,Scott; Taylor Jackson,58,0,60,2
1653299570624,COGS 102A,A02,087910,Scott; Taylor Jackson,51,0,60,9
1653299571151,COGS 107A,A01,087912,Rangel; Lara M,51,0,60,9
1653299571151,COGS 107A,A02,087913,Rangel; Lara M,54,0,60,6
1653299571151,COGS 107A,A03,087914,Rangel; Lara M,47,0,60,13
1653299571151,COGS 107A,A04,087915,Rangel; Lara M,53,0,60,7
1653299571151,COGS 107A,A05,087916,Rangel; Lara M,55,0,60,5
1653299571151,COGS 107A,A06,087917,Rangel; Lara M,50,0,60,10
1653299571697,COGS 108,A01,087919,Fleischer; Jason G,14,0,60,46
1653299571697,COGS 108,A02,087920,Fleischer; Jason G,25,0,60,35
1653299571697,COGS 108,A03,087921,Fleischer; Jason G,40,0,60,20
1653299571697,COGS 108,A04,087922,Fleischer; Jason G,40,0,60,20
1653299571697,COGS 108,A05,087923,Fleischer; Jason G,48,0,60,12
1653299571697,COGS 108,A06,087924,Fleischer; Jason G,55,0,60,5
1653299571697,COGS 108,A07,087925,Fleischer; Jason G,42,0,57,15
1653299572230,COGS 110,A01,087927,Deak; Gedeon O.,30,0,35,5
1653299572230,COGS 110,A02,087928,Deak; Gedeon O.,33,0,35,2
1653299572779,COGS 116,A01,094228,Greene; Deanna Jacquelyn,51,0,52,1
1653299572779,COGS 116,A02,094229,Greene; Deanna Jacquelyn,52,0,52,0
1653299572779,COGS 116,A03,094230,Greene; Deanna Jacquelyn,50,0,52,2
1653299573310,COGS 118B,A01,087930,De Sa; Virginia,24,0,35,11
1653299573310,COGS 118B,A02,087931,De Sa; Virginia,28,0,35,7
1653299573310,COGS 118B,A03,087932,De Sa; Virginia,18,0,35,17
1653299573310,COGS 118B,A04,087933,De Sa; Virginia,29,0,35,6
1653299573310,COGS 118B,A05,087934,De Sa; Virginia,27,0,35,8
1653299573310,COGS 118B,A06,087935,De Sa; Virginia,27,0,35,8
1653299573834,COGS 120,A01,087937,Xia; Haijun,38,0,50,12
1653299573834,COGS 120,A02,087938,Xia; Haijun,32,0,50,18
1653299573834,COGS 120,A03,087939,Xia; Haijun,26,0,50,24
1653299573834,COGS 120,A04,087940,Xia; Haijun,1,0,50,49
1653299574359,COGS 128,A01,087944,Scott; Taylor Jackson,11,0,56,45
1653299574883,COGS 143,A01,087947,Johnson; Christine M.,23,0,40,17
1653299575406,COGS 153,A00,087949,Davis; Joshua Daniel,46,0,75,29
1653299575945,COGS 160,A00,087950,Deak; Gedeon O.,20,0,20,0
1653299575945,COGS 160,B00,094232,Saygin; Ayse P,40,0,40,0
1653299576479,COGS 175,A01,094238,Staff,27,0,40,13
1653299577020,COGS 187A,A01,087958,Kirsh; David Joel,22,0,50,28
1653299577020,COGS 187A,A02,087959,Kirsh; David Joel,30,0,50,20
1653299577020,COGS 187A,A03,087960,Kirsh; David Joel,34,0,45,11
1653299577544,COGS 190A,A00,087961,Staff,9999,0,9999,0
1653299578183,COGS 194,A00,087962,Hill; Seth J,9999,0,9999,0
1653299578709,COMM 10,A02,090628,Schmidt; Thomas Rainer,1,0,5,4
1653299578709,COMM 10,A03,090629,Schmidt; Thomas Rainer,3,0,5,2
1653299578709,COMM 10,A04,090630,Schmidt; Thomas Rainer,4,0,5,1
1653299578709,COMM 10,A05,090631,Schmidt; Thomas Rainer,4,0,5,1
1653299578709,COMM 10,A06,090632,Schmidt; Thomas Rainer,5,0,5,0
1653299578709,COMM 10,A07,090633,Schmidt; Thomas Rainer,5,0,5,0
1653299578709,COMM 10,A08,090634,Schmidt; Thomas Rainer,5,0,5,0
1653299578709,COMM 10,A09,090635,Schmidt; Thomas Rainer,5,0,5,0
1653299578709,COMM 10,A10,090636,Schmidt; Thomas Rainer,2,0,5,3
1653299578709,COMM 10,A11,090637,Schmidt; Thomas Rainer,4,0,5,1
1653299578709,COMM 10,A12,094013,Schmidt; Thomas Rainer,2,0,5,3
1653299578709,COMM 10,A13,094014,Schmidt; Thomas Rainer,5,0,5,0
1653299578709,COMM 10,A14,094015,Schmidt; Thomas Rainer,4,0,5,1
1653299578709,COMM 10,A15,094016,Schmidt; Thomas Rainer,5,0,5,0
1653299579250,COMM 100A,A01,090639,Irani; Lilly C,5,0,5,0
1653299579250,COMM 100A,A02,090640,Irani; Lilly C,4,0,5,1
1653299579250,COMM 100A,A03,090641,Irani; Lilly C,5,0,5,0
1653299579250,COMM 100A,A04,090642,Irani; Lilly C,3,0,5,2
1653299579250,COMM 100A,A05,090643,Irani; Lilly C,3,0,5,2
1653299579250,COMM 100A,A06,090644,Irani; Lilly C,4,0,5,1
1653299579250,COMM 100A,A07,090645,Irani; Lilly C,5,0,5,0
1653299579250,COMM 100A,A08,090646,Irani; Lilly C,5,0,5,0
1653299579250,COMM 100A,A09,090647,Irani; Lilly C,5,0,5,0
1653299579250,COMM 100A,A10,090648,Irani; Lilly C,5,0,5,0
1653299579250,COMM 100A,A11,090649,Irani; Lilly C,3,0,5,2
1653299579250,COMM 100A,A12,090650,Irani; Lilly C,5,0,5,0
1653299579773,COMM 101,A01,090652,Halm; Gavin Patrick,14,0,15,1
1653299579773,COMM 101,A02,090653,Halm; Gavin Patrick,14,0,15,1
1653299579773,COMM 101,A03,090654,Halm; Gavin Patrick,12,0,15,3
1653299579773,COMM 101,A04,090655,Halm; Gavin Patrick,13,0,15,2
1653299580302,COMM 101D,A00,090656,Halm; Gavin Patrick,14,0,15,1
1653299580825,COMM 101K,A00,090657,Ahn; Patricia Jeehyun,16,0,20,4
1653299581351,COMM 101T,A00,093701,Staff,20,0,20,0
1653299581904,COMM 102C,A01,090660,Staff,4,0,6,2
1653299581904,COMM 102C,A02,090661,Staff,6,0,6,0
1653299581904,COMM 102C,A03,090662,Staff,4,0,6,2
1653299582453,COMM 103D,A00,090663,Davis; Zeinabu I.,38,0,40,2
1653299582982,COMM 106E,A00,090667,Geiger; Richard Stuart,26,0,30,4
1653299583507,COMM 106G,A00,090668,Cordoba Azcarate; Matilde,25,0,30,5
1653299584033,COMM 108G,A00,090670,Walkover; Lillian B,30,0,30,0
1653299584556,COMM 109I,A00,090671,Tanaka; Stefan A.,30,0,30,0
1653299585089,COMM 109N,A00,094205,Hallin; Daniel C,25,0,30,5
1653299585623,COMM 110G,A00,090672,Whitworth-Smith; Andrew C,45,0,50,5
1653299586160,COMM 111P,A00,090673,Conner; Thomas Hartnell,27,0,30,3
1653299586684,COMM 111T,A00,090674,Iatarola; Briana Marie,27,0,30,3
1653299587206,COMM 124A,A00,090677,Sims; Christopher O,79,0,80,1
1653299587744,COMM 131,A00,090678,Fields; Gary,22,0,25,3
1653299588269,COMM 134,A00,090679,Kidman; Shawna F,16,0,25,9
1653299588803,COMM 146,A00,090680,Staff,22,0,25,3
1653299589327,COMM 166,A00,094493,Staff,24,0,25,1
1653299589860,COMM 172,A00,094066,Staff,23,0,25,2
1653299590385,COMM 182,A00,094063,Staff,25,0,25,0
1653299590931,COMM 190,A00,090686,Kidman; Shawna F,17,0,23,6
1653299590931,COMM 190,B00,090687,Irani; Lilly C,0,0,0,0
1653299590931,COMM 190,C00,090688,Keith; Kerry,21,0,23,2
1653299590931,COMM 190,D00,090689,Zilberg; Elana,23,0,23,0
1653299591455,COMM 194,A00,091600,Hill; Seth J,9999,0,9999,0
1653299591993,COMM 196A,A00,090690,Schmidt; Thomas Rainer,0,0,0,0
1653299592524,COMM 198,001,091397,Ahn; Patricia Jeehyun,9999,0,9999,0
1653299592524,COMM 198,002,091398,Alac; Morana,9999,0,9999,0
1653299592524,COMM 198,003,091399,Anderson; Patrick W.,9999,0,9999,0
1653299592524,COMM 198,004,091400,Boateng; Boatema,9999,0,9999,0
1653299592524,COMM 198,005,091401,Booker; Angela N,9999,0,9999,0
1653299592524,COMM 198,008,091402,Cordoba Azcarate; Matilde,9999,0,9999,0
1653299592524,COMM 198,009,091403,Davis; Zeinabu I.,9999,0,9999,0
1653299592524,COMM 198,010,091404,Dewaard; Andrew Michael,9999,0,9999,0
1653299592524,COMM 198,011,091405,Dominguez Rubio; Fernando,9999,0,9999,0
1653299592524,COMM 198,012,091406,Fattal; Alexander Leor,9999,0,9999,0
1653299592524,COMM 198,013,091407,Fields; Gary,9999,0,9999,0
1653299592524,COMM 198,014,091408,Gates; Kelly,9999,0,9999,0
1653299592524,COMM 198,015,091409,Goldfarb; Brian,9999,0,9999,0
1653299592524,COMM 198,018,091410,Hill; Erin Truesdell,9999,0,9999,0
1653299592524,COMM 198,019,091411,Horwitz; Robert B,9999,0,9999,0
1653299592524,COMM 198,021,091412,Irani; Lilly C,9999,0,9999,0
1653299592524,COMM 198,022,091413,Jack; Caroline Sarah,9999,0,9999,0
1653299592524,COMM 198,023,091414,Kidman; Shawna F,9999,0,9999,0
1653299592524,COMM 198,024,091415,Martinico; Daniel J,9999,0,9999,0
1653299592524,COMM 198,026,091416,Schmidt; Thomas Rainer,9999,0,9999,0
1653299592524,COMM 198,027,091417,Serlin; David,9999,0,9999,0
1653299592524,COMM 198,028,091418,Sims; Christopher O,9999,0,9999,0
1653299592524,COMM 198,029,091419,Tanaka; Stefan A.,9999,0,9999,0
1653299592524,COMM 198,030,091420,Zilberg; Elana,9999,0,9999,0
1653299592524,COMM 198,031,091421,Walkover; Lillian B,9999,0,9999,0
1653299592524,COMM 198,032,091422,Geiger; Richard Stuart,9999,0,9999,0
1653299593051,CSE 8A,A50,089985,Soosai Raj; Adalbert Geral,7,0,10,3
1653299593051,CSE 8A,A51,089986,Soosai Raj; Adalbert Geral,1,0,10,9
1653299593051,CSE 8A,A52,089987,Soosai Raj; Adalbert Geral,5,0,10,5
1653299593051,CSE 8A,A53,089988,Soosai Raj; Adalbert Geral,9,0,10,1
1653299593051,CSE 8A,B50,089990,Soosai Raj; Adalbert Geral,0,0,10,10
1653299593051,CSE 8A,B51,089991,Soosai Raj; Adalbert Geral,5,0,10,5
1653299593051,CSE 8A,B52,089992,Soosai Raj; Adalbert Geral,5,0,10,5
1653299593051,CSE 8A,B53,089993,Soosai Raj; Adalbert Geral,9,0,10,1
1653299593051,CSE 8A,C50,089995,Lerner; Sorin,0,0,10,10
1653299593051,CSE 8A,C51,089996,Lerner; Sorin,6,0,10,4
1653299593051,CSE 8A,C52,089997,Lerner; Sorin,9,0,10,1
1653299593051,CSE 8A,C53,089998,Lerner; Sorin,8,0,10,2
1653299593579,CSE 8B,A01,090000,Ochoa; Benjamin Lawrence,94,0,100,6
1653299594107,CSE 11,A01,090002,Cao; Yingjun,39,0,49,10
1653299594107,CSE 11,B01,090004,Cao; Yingjun,45,0,49,4
1653299594107,CSE 11,C01,090006,Cao; Yingjun,35,0,49,14
1653299594634,CSE 12,A01,090008,Staff,73,0,73,0
1653299594634,CSE 12,B01,090010,Staff,67,0,73,6
1653299594634,CSE 12,C01,090012,Staff,60,0,73,13
1653299595170,CSE 15L,A01,090014,Politz; Joseph Gibbs,4,0,10,6
1653299595170,CSE 15L,A02,090015,Politz; Joseph Gibbs,7,0,10,3
1653299595170,CSE 15L,A03,090016,Politz; Joseph Gibbs,9,0,10,1
1653299595170,CSE 15L,A04,090017,Politz; Joseph Gibbs,9,0,10,1
1653299595170,CSE 15L,A05,090018,Politz; Joseph Gibbs,9,0,10,1
1653299595170,CSE 15L,B01,090020,Politz; Joseph Gibbs,8,0,10,2
1653299595170,CSE 15L,B02,090021,Politz; Joseph Gibbs,6,0,10,4
1653299595170,CSE 15L,B03,090022,Politz; Joseph Gibbs,7,0,10,3
1653299595170,CSE 15L,B04,090023,Politz; Joseph Gibbs,7,0,10,3
1653299595170,CSE 15L,B05,090024,Politz; Joseph Gibbs,7,0,10,3
1653299595698,CSE 20,A01,090026,Staff,204,0,210,6
1653299596223,CSE 21,A01,090028,Impagliazzo; Russell,0,0,0,0
1653299596223,CSE 21,A02,094488,Impagliazzo; Russell,0,0,0,0
1653299596223,CSE 21,A03,094489,Impagliazzo; Russell,0,0,0,0
1653299596746,CSE 30,A01,092463,Muller; P Keith,73,0,100,27
1653299596746,CSE 30,A02,092464,Staff,97,0,100,3
1653299597272,CSE 87,A00,094193,Moshiri; Alexander Niema,20,0,20,0
1653299597800,CSE 95,A00,090030,Minnes Kemp; Mor Mia,35,0,35,0
1653299597800,CSE 95,B00,093883,Minnes Kemp; Mor Mia,35,0,35,0
1653299597800,CSE 95,C00,093885,Minnes Kemp; Mor Mia,35,0,35,0
1653299598322,CSE 100,A01,090033,Moshiri; Alexander Niema,68,0,114,46
1653299598848,CSE 100R,A01,093837,Moshiri; Alexander Niema,334,0,350,16
1653299599371,CSE 101,A01,090035,Saha; Barna,152,0,237,85
1653299599894,CSE 103,A01,090037,Freund; Yoav,60,0,75,15
1653299600421,CSE 105,A01,090039,Lovett; Shachar,201,0,225,24
1653299600946,CSE 106,A50,090042,Paturi; Ramamohan,11,0,30,19
1653299601483,CSE 107,A01,090044,Bellare; Mihir,94,0,120,26
1653299602010,CSE 110,A50,090047,Powell; Thomas Allan,39,0,50,11
1653299602010,CSE 110,A51,090048,Powell; Thomas Allan,39,0,50,11
1653299602010,CSE 110,A52,090049,Powell; Thomas Allan,48,0,50,2
1653299602010,CSE 110,A53,090050,Powell; Thomas Allan,49,0,50,1
1653299602010,CSE 110,A54,090051,Powell; Thomas Allan,45,0,50,5
1653299602010,CSE 110,A55,090052,Powell; Thomas Allan,50,0,50,0
1653299602010,CSE 110,A56,090053,Powell; Thomas Allan,49,0,50,1
1653299602010,CSE 110,A57,090054,Powell; Thomas Allan,41,0,45,4
1653299602560,CSE 118,A00,094897,Weibel; Nadir,0,0,0,0
1653299603087,CSE 120,A01,090056,Voelker; Geoffrey M.,226,0,300,74
1653299603611,CSE 124,A01,090058,Porter; George M,123,0,189,66
1653299604134,CSE 127,A01,090060,Savage; Stefan,46,0,189,143
1653299604663,CSE 130,A01,090062,Polikarpova; Nadezhda,171,0,189,18
1653299605203,CSE 132A,A01,090064,Deutsch; Alin Bernard,46,0,189,143
1653299605730,CSE 140,A01,090068,Eldon; John,169,0,196,27
1653299605730,CSE 140,B01,090070,Orailoglu; Alex,48,0,49,1
1653299606253,CSE 140L,A01,090072,Eldon; John,161,0,192,31
1653299606253,CSE 140L,B01,090075,Orailoglu; Alex,44,0,49,5
1653299606776,CSE 142,A01,090078,Porter; Leonard Emerson,86,0,146,60
1653299606776,CSE 142,B01,090080,Porter; Leonard Emerson,107,0,146,39
1653299607300,CSE 142L,A01,090082,Swanson; Steven James,48,0,146,98
1653299607300,CSE 142L,B01,090084,Swanson; Steven James,120,0,146,26
1653299607824,CSE 151B,A01,090088,Cottrell; Garrison W,258,0,328,70
1653299608347,CSE 152A,A01,090090,Chandraker; Manmohan Krishna,153,0,189,36
1653299608886,CSE 158,A01,090092,McAuley; Julian John,84,0,197,113
1653299609412,CSE 158R,A01,090094,McAuley; Julian John,306,0,353,47
1653299609948,CSE 167,A01,090096,Chern; Albert Ren-Haur,165,0,189,24
1653299610473,CSE 170,A01,090098,Vaccaro; Kristen Marie,20,0,20,0
1653299610473,CSE 170,A02,090099,Vaccaro; Kristen Marie,14,0,20,6
1653299610473,CSE 170,A03,090100,Vaccaro; Kristen Marie,14,0,20,6
1653299610473,CSE 170,A04,090101,Vaccaro; Kristen Marie,14,0,20,6
1653299610473,CSE 170,A05,090102,Vaccaro; Kristen Marie,18,0,20,2
1653299610996,CSE 190,A00,090103,Shalev; Aaron D,40,0,40,0
1653299610996,CSE 190,B00,090104,Vaccaro; Kristen Marie,100,0,100,0
1653299610996,CSE 190,C00,090105,Pannuto; Patrick William,25,0,25,0
1653299611522,CSE 191,A00,093848,Minnes Kemp; Mor Mia,9999,0,9999,0
1653299612048,CSE 193,A01,090107,Elsherif; May Elhussein,49,0,49,0
1653299612572,CSE 194,A01,090109,Munyaka; Imani N. S.,20,0,49,29
1653299613101,CSS 1,A01,086486,Staff,22,0,24,2
1653299613101,CSS 1,A02,086487,Staff,21,0,24,3
1653299613101,CSS 1,A03,086488,Staff,20,0,24,4
1653299613101,CSS 1,A04,086489,Staff,23,0,24,1
1653299613671,DOC 1,A01,086773,Solomon; Amanda Lee Albaniel,0,0,0,0
1653299613671,DOC 1,A02,086774,Solomon; Amanda Lee Albaniel,0,0,0,0
1653299613671,DOC 1,A03,086775,Solomon; Amanda Lee Albaniel,5,0,6,1
1653299613671,DOC 1,A04,086776,Solomon; Amanda Lee Albaniel,6,0,6,0
1653299613671,DOC 1,A05,086777,Solomon; Amanda Lee Albaniel,6,0,6,0
1653299613671,DOC 1,A06,086778,Solomon; Amanda Lee Albaniel,6,0,6,0
1653299613671,DOC 1,A07,086779,Solomon; Amanda Lee Albaniel,5,0,6,1
1653299613671,DOC 1,A08,086849,Solomon; Amanda Lee Albaniel,6,0,6,0
1653299613671,DOC 1,A09,086780,Solomon; Amanda Lee Albaniel,6,0,6,0
1653299613671,DOC 1,A10,086781,Solomon; Amanda Lee Albaniel,6,0,6,0
1653299613671,DOC 1,A11,086782,Solomon; Amanda Lee Albaniel,5,0,6,1
1653299613671,DOC 1,A12,086783,Solomon; Amanda Lee Albaniel,6,0,6,0
1653299613671,DOC 1,A13,086784,Solomon; Amanda Lee Albaniel,6,0,6,0
1653299613671,DOC 1,A14,086785,Solomon; Amanda Lee Albaniel,6,0,6,0
1653299613671,DOC 1,A15,086786,Solomon; Amanda Lee Albaniel,6,0,6,0
1653299613671,DOC 1,A16,086787,Solomon; Amanda Lee Albaniel,6,0,6,0
1653299613671,DOC 1,A17,086788,Solomon; Amanda Lee Albaniel,0,0,0,0
1653299613671,DOC 1,A18,086789,Solomon; Amanda Lee Albaniel,0,0,0,0
1653299613671,DOC 1,B01,086791,Solomon; Amanda Lee Albaniel,6,0,6,0
1653299613671,DOC 1,B02,086792,Solomon; Amanda Lee Albaniel,6,0,6,0
1653299613671,DOC 1,B03,086793,Solomon; Amanda Lee Albaniel,6,0,6,0
1653299613671,DOC 1,B04,086794,Solomon; Amanda Lee Albaniel,6,0,6,0
1653299613671,DOC 1,B05,086795,Solomon; Amanda Lee Albaniel,3,0,6,3
1653299613671,DOC 1,B06,086796,Solomon; Amanda Lee Albaniel,6,0,6,0
1653299613671,DOC 1,B07,086797,Solomon; Amanda Lee Albaniel,6,0,6,0
1653299613671,DOC 1,B08,086798,Solomon; Amanda Lee Albaniel,6,0,6,0
1653299613671,DOC 1,B09,086799,Solomon; Amanda Lee Albaniel,6,0,6,0
1653299613671,DOC 1,B10,086800,Solomon; Amanda Lee Albaniel,6,0,6,0
1653299613671,DOC 1,B11,086801,Solomon; Amanda Lee Albaniel,5,0,6,1
1653299613671,DOC 1,B12,086802,Solomon; Amanda Lee Albaniel,6,0,6,0
1653299613671,DOC 1,B13,086803,Solomon; Amanda Lee Albaniel,6,0,6,0
1653299613671,DOC 1,B14,086804,Solomon; Amanda Lee Albaniel,6,0,6,0
1653299613671,DOC 1,B15,086805,Solomon; Amanda Lee Albaniel,5,0,6,1
1653299613671,DOC 1,B16,086806,Solomon; Amanda Lee Albaniel,6,0,6,0
1653299613671,DOC 1,B17,086807,Solomon; Amanda Lee Albaniel,0,0,0,0
1653299613671,DOC 1,B18,086808,Solomon; Amanda Lee Albaniel,0,0,0,0
1653299613671,DOC 1,C01,086810,Strom; Megan C.,6,0,6,0
1653299613671,DOC 1,C02,086811,Strom; Megan C.,5,0,6,1
1653299613671,DOC 1,C03,086812,Strom; Megan C.,6,0,6,0
1653299613671,DOC 1,C04,086813,Strom; Megan C.,5,0,6,1
1653299613671,DOC 1,C05,086814,Strom; Megan C.,5,0,6,1
1653299613671,DOC 1,C06,086815,Strom; Megan C.,6,0,6,0
1653299613671,DOC 1,C07,086816,Strom; Megan C.,6,0,6,0
1653299613671,DOC 1,C08,086817,Strom; Megan C.,6,0,6,0
1653299613671,DOC 1,C09,086818,Strom; Megan C.,6,0,6,0
1653299613671,DOC 1,C10,086819,Strom; Megan C.,6,0,6,0
1653299613671,DOC 1,C11,086820,Strom; Megan C.,6,0,6,0
1653299613671,DOC 1,C12,086821,Strom; Megan C.,6,0,6,0
1653299613671,DOC 1,C13,086822,Strom; Megan C.,6,0,6,0
1653299613671,DOC 1,C14,086823,Strom; Megan C.,6,0,6,0
1653299613671,DOC 1,C15,086824,Strom; Megan C.,6,0,6,0
1653299613671,DOC 1,C16,086825,Strom; Megan C.,6,0,6,0
1653299613671,DOC 1,C17,086826,Strom; Megan C.,0,0,0,0
1653299613671,DOC 1,C18,086827,Strom; Megan C.,0,0,0,0
1653299613671,DOC 1,D01,086829,Strom; Megan C.,6,0,6,0
1653299613671,DOC 1,D02,086830,Strom; Megan C.,6,0,6,0
1653299613671,DOC 1,D03,086831,Strom; Megan C.,5,0,6,1
1653299613671,DOC 1,D04,086832,Strom; Megan C.,6,0,6,0
1653299613671,DOC 1,D05,086833,Strom; Megan C.,6,0,6,0
1653299613671,DOC 1,D06,086834,Strom; Megan C.,6,0,6,0
1653299613671,DOC 1,D07,086835,Strom; Megan C.,6,0,6,0
1653299613671,DOC 1,D08,086836,Strom; Megan C.,6,0,6,0
1653299613671,DOC 1,D09,086837,Strom; Megan C.,0,0,0,0
1653299613671,DOC 1,D10,086838,Strom; Megan C.,0,0,0,0
1653299613671,DOC 1,D11,086839,Strom; Megan C.,6,0,6,0
1653299613671,DOC 1,D12,086840,Strom; Megan C.,6,0,6,0
1653299613671,DOC 1,D13,086841,Strom; Megan C.,6,0,6,0
1653299613671,DOC 1,D14,086842,Strom; Megan C.,5,0,6,1
1653299613671,DOC 1,D15,086843,Strom; Megan C.,6,0,6,0
1653299613671,DOC 1,D16,086844,Strom; Megan C.,5,0,6,1
1653299614201,DOC 100D,A00,086845,Pass; Natalye Joann,0,0,0,0
1653299614201,DOC 100D,B00,086846,Pass; Natalye Joann,21,0,25,4
1653299614201,DOC 100D,C00,086847,Pass; Natalye Joann,23,0,25,2
1653299614730,DSC 10,A01,088092,Tiefenbruck; Janine LoBue,13,0,15,2
1653299614730,DSC 10,B01,088095,Tiefenbruck; Janine LoBue,9,0,15,6
1653299614730,DSC 10,C01,088098,Rampure; Suraj,0,0,15,15
1653299615260,DSC 20,A01,088101,Langlois; Marina,148,0,150,2
1653299615787,DSC 30,A01,088105,Langlois; Marina,74,0,75,1
1653299616313,DSC 40A,A01,088107,Rampure; Suraj,97,0,100,3
1653299616313,DSC 40A,B01,088109,Rampure; Suraj,99,0,100,1
1653299616838,DSC 40B,A01,088111,Eldridge; Justin Matthew,73,0,75,2
1653299616838,DSC 40B,B01,088113,Wang; Yusu,75,0,75,0
1653299617369,DSC 80,A01,088115,Eldridge; Justin Matthew,95,0,100,5
1653299617898,DSC 95,A01,088117,Langlois; Marina,20,0,20,0
1653299618424,DSC 96,A00,088118,Liao; Soohyun Nam,50,0,50,0
1653299618950,DSC 100,A01,088120,Salimi; Babak,164,0,175,11
1653299619482,DSC 102,A01,094320,Kumar; Arun Kumar,77,0,125,48
1653299620020,DSC 180A,A01,088124,Fraenkel; Aaron Mcmillan,0,0,0,0
1653299620020,DSC 180A,A02,088125,Fraenkel; Aaron Mcmillan,0,0,0,0
1653299620020,DSC 180A,A03,088126,Fraenkel; Aaron Mcmillan,0,0,0,0
1653299620020,DSC 180A,A04,088127,Fraenkel; Aaron Mcmillan,0,0,0,0
1653299620020,DSC 180A,A05,088128,Fraenkel; Aaron Mcmillan,0,0,0,0
1653299620020,DSC 180A,A06,088129,Fraenkel; Aaron Mcmillan,0,0,0,0
1653299620020,DSC 180A,A07,088130,Fraenkel; Aaron Mcmillan,0,0,0,0
1653299620020,DSC 180A,A08,088131,Fraenkel; Aaron Mcmillan,0,0,0,0
1653299620020,DSC 180A,A09,088132,Fraenkel; Aaron Mcmillan,0,0,0,0
1653299620020,DSC 180A,A10,088133,Fraenkel; Aaron Mcmillan,0,0,0,0
1653299620020,DSC 180A,A11,088134,Fraenkel; Aaron Mcmillan,0,0,0,0
1653299620020,DSC 180A,A12,088135,Fraenkel; Aaron Mcmillan,0,0,0,0
1653299620020,DSC 180A,A13,088136,Fraenkel; Aaron Mcmillan,0,0,0,0
1653299620020,DSC 180A,A14,088137,Fraenkel; Aaron Mcmillan,0,0,0,0
1653299620020,DSC 180A,A15,088138,Fraenkel; Aaron Mcmillan,0,0,0,0
1653299620020,DSC 180A,B01,088141,Fraenkel; Aaron Mcmillan,0,0,0,0
1653299620020,DSC 180A,B02,088142,Fraenkel; Aaron Mcmillan,0,0,0,0
1653299620020,DSC 180A,B03,088143,Fraenkel; Aaron Mcmillan,0,0,0,0
1653299620020,DSC 180A,B04,088144,Fraenkel; Aaron Mcmillan,0,0,0,0
1653299620020,DSC 180A,B05,088145,Fraenkel; Aaron Mcmillan,0,0,0,0
1653299620020,DSC 180A,B06,088146,Fraenkel; Aaron Mcmillan,0,0,0,0
1653299620020,DSC 180A,B07,088147,Fraenkel; Aaron Mcmillan,0,0,0,0
1653299620020,DSC 180A,B08,088148,Fraenkel; Aaron Mcmillan,0,0,0,0
1653299620020,DSC 180A,B09,088149,Fraenkel; Aaron Mcmillan,0,0,0,0
1653299620020,DSC 180A,B10,088150,Fraenkel; Aaron Mcmillan,0,0,0,0
1653299620020,DSC 180A,B11,088151,Fraenkel; Aaron Mcmillan,0,0,0,0
1653299620020,DSC 180A,B12,088152,Fraenkel; Aaron Mcmillan,0,0,0,0
1653299620020,DSC 180A,B13,088153,Fraenkel; Aaron Mcmillan,0,0,0,0
1653299620020,DSC 180A,B14,088154,Fraenkel; Aaron Mcmillan,0,0,0,0
1653299620020,DSC 180A,B15,088155,Fraenkel; Aaron Mcmillan,0,0,0,0
1653299620544,DSC 190,A01,088158,Mishne; Gal,48,0,50,2
1653299620544,DSC 190,B01,088160,Silberman; Jack,16,0,21,5
1653299621083,DSC 197,001,088161,Eldridge; Justin Matthew,9999,0,9999,0
1653299621607,DSGN 1,A01,087888,Meyer; Michael Wayne,49,0,53,4
1653299621607,DSGN 1,A02,087889,Meyer; Michael Wayne,47,0,53,6
1653299621607,DSGN 1,A03,087890,Meyer; Michael Wayne,43,0,53,10
1653299622130,DSGN 100,A01,087983,Dow; Steven P,39,0,40,1
1653299622130,DSGN 100,A02,087984,Dow; Steven P,40,0,40,0
1653299622130,DSGN 100,A03,087985,Dow; Steven P,34,0,40,6
1653299622657,DSGN 118,A01,087987,Xia; Haijun,55,0,60,5
1653299622657,DSGN 118,A02,087988,Xia; Haijun,56,0,60,4
1653299623180,DSGN 119,A00,087989,Staff,51,0,70,19
1653299623712,ECE 5,A01,090699,Morris; Karcher William,0,0,0,0
1653299623712,ECE 5,A02,090700,Morris; Karcher William,0,0,0,0
1653299623712,ECE 5,A03,090701,Morris; Karcher William,0,0,0,0
1653299623712,ECE 5,A04,090702,Morris; Karcher William,0,0,0,0
1653299623712,ECE 5,A05,090703,Morris; Karcher William,0,0,0,0
1653299623712,ECE 5,A06,090704,Morris; Karcher William,0,0,0,0
1653299624235,ECE 15,A01,090706,Schurgers; Curt,0,0,0,0
1653299624235,ECE 15,A02,090707,Schurgers; Curt,0,0,0,0
1653299624766,ECE 16,A01,090709,Khoshabeh; Ramsin,24,0,30,6
1653299625306,ECE 17,A01,090711,Gilja; Vikash,55,0,60,5
1653299625835,ECE 25,A50,090714,Liu; Zhaowei,0,0,0,0
1653299625835,ECE 25,A51,090715,Liu; Zhaowei,0,0,0,0
1653299625835,ECE 25,A52,090716,Liu; Zhaowei,0,0,0,0
1653299626379,ECE 30,A50,094300,Mir Arabbaygi; Siavash,25,0,30,5
1653299626379,ECE 30,A51,094301,Mir Arabbaygi; Siavash,29,0,30,1
1653299626379,ECE 30,A52,094302,Mir Arabbaygi; Siavash,27,0,30,3
1653299626379,ECE 30,A53,094303,Mir Arabbaygi; Siavash,29,0,30,1
1653299626379,ECE 30,A54,094304,Mir Arabbaygi; Siavash,25,0,25,0
1653299626913,ECE 35,A50,090720,Schurgers; Curt,0,0,0,0
1653299626913,ECE 35,A51,090721,Schurgers; Curt,0,0,0,0
1653299626913,ECE 35,A52,090722,Schurgers; Curt,0,0,0,0
1653299626913,ECE 35,A53,090723,Schurgers; Curt,0,0,0,0
1653299626913,ECE 35,A54,090724,Schurgers; Curt,0,0,0,0
1653299626913,ECE 35,A55,090725,Schurgers; Curt,0,0,0,0
1653299626913,ECE 35,B50,090729,Schurgers; Curt,0,0,0,0
1653299626913,ECE 35,B51,090730,Schurgers; Curt,0,0,0,0
1653299626913,ECE 35,B52,090731,Schurgers; Curt,0,0,0,0
1653299626913,ECE 35,B53,090732,Schurgers; Curt,0,0,0,0
1653299626913,ECE 35,B54,090733,Schurgers; Curt,0,0,0,0
1653299626913,ECE 35,B55,090734,Schurgers; Curt,0,0,0,0
1653299627441,ECE 45,A01,090736,Franceschetti; Massimo,56,0,57,1
1653299627441,ECE 45,A02,090737,Franceschetti; Massimo,50,0,58,8
1653299627968,ECE 65,A50,090741,Baghdadchi; Saharnaz,13,0,15,2
1653299627968,ECE 65,A51,090742,Baghdadchi; Saharnaz,5,0,10,5
1653299627968,ECE 65,A52,090743,Baghdadchi; Saharnaz,14,0,15,1
1653299627968,ECE 65,A53,090744,Baghdadchi; Saharnaz,8,0,10,2
1653299627968,ECE 65,A54,094865,Baghdadchi; Saharnaz,14,0,15,1
1653299627968,ECE 65,A55,094866,Baghdadchi; Saharnaz,9,0,10,1
1653299627968,ECE 65,A56,094867,Baghdadchi; Saharnaz,14,0,15,1
1653299627968,ECE 65,A57,094868,Baghdadchi; Saharnaz,15,0,15,0
1653299627968,ECE 65,A58,094869,Baghdadchi; Saharnaz,10,0,10,0
1653299628509,ECE 100,A01,090746,Baghdadchi; Saharnaz,16,0,20,4
1653299628509,ECE 100,A02,090747,Baghdadchi; Saharnaz,20,0,20,0
1653299628509,ECE 100,A03,090748,Baghdadchi; Saharnaz,18,0,20,2
1653299628509,ECE 100,A04,090749,Baghdadchi; Saharnaz,20,0,20,0
1653299628509,ECE 100,A05,090750,Baghdadchi; Saharnaz,18,0,20,2
1653299628509,ECE 100,A06,090751,Baghdadchi; Saharnaz,18,0,20,2
1653299628509,ECE 100,A07,090752,Baghdadchi; Saharnaz,20,0,20,0
1653299629037,ECE 101,A01,090754,Siegel; Paul H.,62,0,75,13
1653299629037,ECE 101,A02,090755,Siegel; Paul H.,71,0,75,4
1653299629563,ECE 102,A00,090756,Hsueh; Tzu-Chien,57,0,75,18
1653299630099,ECE 103,A01,090767,Lo; Yu-Hwa,45,0,50,5
1653299630647,ECE 107,A01,090769,Lomakin; Vitaliy,72,0,75,3
1653299631170,ECE 109,A01,090771,Zeger; Kenneth A.,176,0,180,4
1653299631771,ECE 111,A01,090774,Koushanfar; Farinaz,100,0,120,20
1653299632300,ECE 121A,A50,090777,Esmaili; Gholamreza,17,0,24,7
1653299632300,ECE 121A,A51,090778,Esmaili; Gholamreza,9,0,24,15
1653299632300,ECE 121A,A52,090779,Esmaili; Gholamreza,22,0,24,2
1653299632823,ECE 128A,A00,090780,Staff,40,0,70,30
1653299633351,ECE 135A,A00,090781,Kuzum; Duygu,30,0,30,0
1653299633887,ECE 143,A00,090782,Unpingco; Jose H.,0,0,0,2
1653299634411,ECE 148,A01,090784,Staff,32,0,32,0
1653299634937,ECE 155,A01,090786,Milstein; Laurence B.,16,0,20,4
1653299635460,ECE 158A,A01,090788,Franceschetti; Massimo,56,0,65,9
1653299635984,ECE 161A,A01,090790,Rao; Bhaskar D.,103,0,115,12
1653299636509,ECE 164,A00,090791,Hall; Drew A.,87,0,115,28
1653299637048,ECE 166,A50,090796,Rebeiz; Gabriel,6,0,12,6
1653299637048,ECE 166,A51,090797,Rebeiz; Gabriel,9,0,12,3
1653299637048,ECE 166,A52,090799,Rebeiz; Gabriel,1,0,12,11
1653299637048,ECE 166,A53,090800,Rebeiz; Gabriel,6,0,12,6
1653299637048,ECE 166,A54,094335,Rebeiz; Gabriel,11,0,12,1
1653299637048,ECE 166,A55,094336,Rebeiz; Gabriel,12,0,12,0
1653299637048,ECE 166,A56,094349,Rebeiz; Gabriel,13,0,15,2
1653299637048,ECE 166,A57,094350,Rebeiz; Gabriel,14,0,15,1
1653299637575,ECE 171A,A01,090802,Atanasov; Nikolay A.,45,0,60,15
1653299638098,ECE 171B,A01,090804,Shi; Yuanyuan,44,0,50,6
1653299638625,ECE 174,A01,090806,Pal; Piya,125,0,146,21
1653299639148,ECE 182,A01,090808,Lomakin; Vitaliy,23,0,23,0
1653299639678,ECE 187,A00,090809,Liu; Zhaowei,19,0,20,1
1653299640218,ECE 196,A00,090812,Morris; Karcher William,19,0,24,5
1653299640218,ECE 196,B00,094833,Morris; Karcher William,24,0,24,0
1653299640743,ECE 197,001,090813,Sievenpiper; Daniel F.,9999,0,9999,0
1653299641279,ECON 1,A01,092535,Staff,0,0,0,0
1653299641279,ECON 1,A02,092536,Staff,0,0,0,0
1653299641279,ECON 1,A03,092537,Staff,0,0,0,0
1653299641279,ECON 1,A04,092538,Staff,0,0,0,0
1653299641279,ECON 1,A05,092539,Staff,0,0,0,0
1653299641279,ECON 1,B01,092540,Ma; Alyson Chan,42,0,45,3
1653299641279,ECON 1,B02,092541,Ma; Alyson Chan,45,0,45,0
1653299641279,ECON 1,B03,092542,Ma; Alyson Chan,45,0,45,0
1653299641279,ECON 1,B04,092543,Ma; Alyson Chan,40,0,40,0
1653299641279,ECON 1,B05,092544,Ma; Alyson Chan,40,0,40,0
1653299641279,ECON 1,C01,092545,Tocoian; Oana,0,0,0,0
1653299641279,ECON 1,C02,092546,Tocoian; Oana,0,0,0,0
1653299641279,ECON 1,C03,092547,Tocoian; Oana,0,0,0,0
1653299641279,ECON 1,C04,092548,Tocoian; Oana,0,0,0,0
1653299641279,ECON 1,D01,094253,Levkoff; Steven B.,41,0,45,4
1653299641279,ECON 1,D02,094254,Levkoff; Steven B.,44,0,45,1
1653299641279,ECON 1,D03,094255,Levkoff; Steven B.,45,0,45,0
1653299641279,ECON 1,D04,094256,Levkoff; Steven B.,36,0,40,4
1653299641279,ECON 1,D05,094257,Levkoff; Steven B.,40,0,40,0
1653299641804,ECON 2,A01,092549,Staff,0,0,0,0
1653299641804,ECON 2,A02,092550,Staff,0,0,0,0
1653299641804,ECON 2,A03,092551,Staff,0,0,0,0
1653299642339,ECON 4,A01,092554,Levkoff; Steven B.,29,0,30,1
1653299642339,ECON 4,A02,092555,Levkoff; Steven B.,27,0,30,3
1653299642339,ECON 4,A03,092556,Levkoff; Steven B.,30,0,30,0
1653299642875,ECON 100A,A01,092557,Newhouse; Herbert S,23,0,30,7
1653299642875,ECON 100A,A02,092558,Newhouse; Herbert S,28,0,30,2
1653299642875,ECON 100A,A03,092559,Newhouse; Herbert S,29,0,30,1
1653299642875,ECON 100A,A04,092560,Newhouse; Herbert S,35,0,35,0
1653299642875,ECON 100A,B01,092561,Newhouse; Herbert S,20,0,30,10
1653299642875,ECON 100A,B02,092562,Newhouse; Herbert S,28,0,30,2
1653299642875,ECON 100A,B03,092563,Newhouse; Herbert S,15,0,30,15
1653299642875,ECON 100A,B04,092564,Newhouse; Herbert S,35,0,35,0
1653299643409,ECON 100B,A01,092565,Galperti; Simone,27,0,30,3
1653299643409,ECON 100B,A02,092566,Galperti; Simone,18,0,20,2
1653299643409,ECON 100B,A03,094496,Staff,27,0,30,3
1653299643409,ECON 100B,A04,094497,Staff,16,0,20,4
1653299643409,ECON 100B,B01,092567,Galperti; Simone,16,0,25,9
1653299643940,ECON 100C,A01,092569,Du; Songzi,62,0,75,13
1653299643940,ECON 100C,B01,092570,Du; Songzi,70,0,75,5
1653299643940,ECON 100C,B02,094258,Du; Songzi,75,0,75,0
1653299644476,ECON 100CH,A00,088284,Andreoni; James,20,0,20,0
1653299645006,ECON 109,A01,092572,Watson; Joel Christopher,68,0,75,7
1653299645006,ECON 109,B01,092573,Watson; Joel Christopher,68,0,75,7
1653299645535,ECON 110A,A01,092574,Alon; Titan Michael,12,0,25,13
1653299645535,ECON 110A,A02,092575,Alon; Titan Michael,24,0,25,1
1653299645535,ECON 110A,B01,092576,Alon; Titan Michael,24,0,25,1
1653299645535,ECON 110A,B02,092577,Alon; Titan Michael,25,0,25,0
1653299646068,ECON 110B,A01,092578,Trottner; Fabian Gunter We,16,0,25,9
1653299646068,ECON 110B,A02,094054,Trottner; Fabian Gunter We,23,0,25,2
1653299646068,ECON 110B,B01,092579,Trottner; Fabian Gunter We,7,0,25,18
1653299646068,ECON 110B,B02,094055,Trottner; Fabian Gunter We,24,0,25,1
1653299646605,ECON 116,A00,088291,Lowes; Sara Rachel,58,0,70,12
1653299647148,ECON 120A,A01,092580,Elliott; Graham,18,0,25,7
1653299647148,ECON 120A,A02,092581,Elliott; Graham,22,0,25,3
1653299647148,ECON 120A,B01,092582,Elliott; Graham,18,0,25,7
1653299647148,ECON 120A,B02,092583,Elliott; Graham,20,0,25,5
1653299647148,ECON 120A,C01,092584,Tocoian; Oana,27,0,30,3
1653299647148,ECON 120A,C02,092585,Tocoian; Oana,28,0,30,2
1653299647148,ECON 120A,C03,092586,Tocoian; Oana,40,0,40,0
1653299647688,ECON 120B,A01,092587,Candido; Maria Teresa,58,0,70,12
1653299647688,ECON 120B,A02,092588,Candido; Maria Teresa,51,0,60,9
1653299647688,ECON 120B,A03,092589,Candido; Maria Teresa,56,0,60,4
1653299648220,ECON 120C,A01,092590,Candido; Maria Teresa,48,0,60,12
1653299648220,ECON 120C,A02,092591,Candido; Maria Teresa,59,0,60,1
1653299648220,ECON 120C,A03,094310,Candido; Maria Teresa,73,0,75,2
1653299648742,ECON 121,A00,088298,Vogl; Tom Saul,36,0,50,14
1653299649273,ECON 130,A00,088299,Staff,59,0,75,16
1653299649805,ECON 131,A00,088300,Jacobsen; Mark,129,0,150,21
1653299649805,ECON 131,B00,088301,Jacobsen; Mark,15,0,30,15
1653299650331,ECON 152,A00,088302,Fadlon; Yizhak,34,0,50,16
1653299650331,ECON 152,B00,088303,Fadlon; Yizhak,49,0,50,1
1653299650856,ECON 168,A00,088304,Staff,54,0,60,6
1653299651379,ECON 191B,A00,088312,Galperti; Simone,20,0,20,0
1653299651908,EDS 25,A01,087581,Staff,9,0,10,1
1653299651908,EDS 25,A02,087582,Staff,10,0,10,0
1653299651908,EDS 25,A03,087583,Staff,7,0,10,3
1653299651908,EDS 25,A04,087584,Staff,10,0,10,0
1653299652460,EDS 31,A00,087585,Bussey; Thomas J,9,0,10,1
1653299652988,EDS 110R,A01,087597,Cohen; Shana R,43,0,50,7
1653299652988,EDS 110R,B01,093579,Cohen; Shana R,10,0,10,0
1653299653532,EDS 113,A00,087598,Staff,45,0,50,5
1653299654054,EDS 114,A01,088091,Eguchi; Emi,17,0,20,3
1653299654054,EDS 114,A02,087600,Eguchi; Emi,19,0,20,1
1653299654607,EDS 117,A01,087603,Chung; Luz Marina,25,0,35,10
1653299654607,EDS 117,A02,087604,Chung; Luz Marina,34,0,35,1
1653299655147,EDS 124AR,A01,087606,Simon; Elizabeth A,0,0,19,19
1653299655147,EDS 124AR,A02,087607,Simon; Elizabeth A,13,0,19,6
1653299655147,EDS 124AR,A03,087608,Simon; Elizabeth A,15,0,19,4
1653299655147,EDS 124AR,A04,087609,Simon; Elizabeth A,4,0,19,15
1653299655147,EDS 124AR,B01,087611,Simon; Elizabeth A,14,0,19,5
1653299655147,EDS 124AR,B02,087612,Simon; Elizabeth A,18,0,19,1
1653299655147,EDS 124AR,B03,087613,Simon; Elizabeth A,18,0,19,1
1653299655147,EDS 124AR,B04,087614,Simon; Elizabeth A,19,0,19,0
1653299655147,EDS 124AR,C01,094210,Simon; Elizabeth A,6,0,6,0
1653299655147,EDS 124AR,C02,094211,Simon; Elizabeth A,6,0,6,0
1653299655147,EDS 124AR,C03,094212,Simon; Elizabeth A,6,0,6,0
1653299655147,EDS 124AR,C04,094213,Simon; Elizabeth A,6,0,6,0
1653299655147,EDS 124AR,D01,094215,Simon; Elizabeth A,6,0,6,0
1653299655147,EDS 124AR,D02,094216,Simon; Elizabeth A,6,0,6,0
1653299655147,EDS 124AR,D03,094217,Simon; Elizabeth A,6,0,6,0
1653299655147,EDS 124AR,D04,094218,Simon; Elizabeth A,6,0,6,0
1653299655699,EDS 124BR,A00,087615,Eguchi; Emi,65,0,75,10
1653299655699,EDS 124BR,B00,093580,Eguchi; Emi,25,0,25,0
1653299656224,EDS 125,A00,087616,Jones; Gabrielle Anastasia,51,0,60,9
1653299656755,EDS 129A,A01,087618,Heinzman; Erica M.,43,0,50,7
1653299657282,EDS 130,A01,087620,Holtzman; Caren Lynn,17,0,20,3
1653299657282,EDS 130,A02,087621,Holtzman; Caren Lynn,20,0,20,0
1653299657282,EDS 130,A03,087622,Holtzman; Caren Lynn,20,0,20,0
1653299657814,EDS 131,A01,087624,Wishard Guerra; Alison G.,37,0,40,3
1653299658341,EDS 133,A01,087627,Bintliff; Amy S.V.,17,0,20,3
1653299658341,EDS 133,A02,087628,Bintliff; Amy S.V.,19,0,20,1
1653299658866,EDS 139,A00,087629,Holtzman; Caren Lynn,55,0,60,5
1653299658866,EDS 139,B00,087630,Heinzman; Erica M.,51,0,60,9
1653299658866,EDS 139,C00,087631,Bintliff; Amy S.V.,57,0,60,3
1653299658866,EDS 139,D00,087632,Wishard Guerra; Alison G.,58,0,60,2
1653299658866,EDS 139,E00,087633,Holtzman; Caren Lynn,30,0,30,0
1653299658866,EDS 139,F00,094886,Staff,25,0,25,0
1653299659392,EDS 146,A01,094220,Staff,25,0,25,0
1653299659915,EDS 164R,A01,087644,Wishard Guerra; Alison G.,37,0,40,3
1653299659915,EDS 164R,B01,093582,Wishard Guerra; Alison G.,20,0,20,0
1653299660440,EDS 190,A00,087645,Bresser; Bernard George,20,0,20,0
1653299660440,EDS 190,B00,087646,Pappas; Elizabeth,20,0,20,0
1653299660440,EDS 190,C00,087647,Scharton; Susan Michelle,20,0,20,0
1653299660440,EDS 190,E00,087648,Staff,20,0,20,0
1653299660963,ENG 10,A00,086288,Staff,30,0,30,0
1653299660963,ENG 10,B00,086289,Staff,30,0,30,0
1653299661490,ENG 15,A01,086291,Staff,35,0,35,0
1653299662011,ENG 20,A00,086292,Evdokimenko; Ekaterina,33,0,35,2
1653299662539,ENG 100D,A00,086293,Ngo; Anh-Thu T.,45,0,50,5
1653299662539,ENG 100D,B00,094309,Staff,46,0,50,4
1653299663065,ENG 100L,A00,086295,Kleissl; Jan,6,0,6,0
1653299663065,ENG 100L,B00,086296,Bratton; Maryann,8,0,8,0
1653299663065,ENG 100L,C00,086297,Nguyen; Truong Quang,10,0,10,0
1653299663065,ENG 100L,E00,086299,de Oliveira; Mauricio,8,0,8,0
1653299663065,ENG 100L,F00,086300,Goldberg; Charles G.,6,0,6,0
1653299663065,ENG 100L,G00,086301,Bratton; Maryann,6,0,6,0
1653299663065,ENG 100L,H00,086302,Staff,6,0,6,0
1653299663589,ENVR 30,A01,093565,Staff,29,0,30,1
1653299663589,ENVR 30,A02,093567,Staff,28,0,30,2
1653299663589,ENVR 30,A03,093568,Staff,25,0,30,5
1653299663589,ENVR 30,A04,093569,Staff,30,0,30,0
1653299663589,ENVR 30,A05,093570,Staff,29,0,30,1
1653299663589,ENVR 30,A06,093566,Staff,29,0,30,1
1653299664112,ENVR 102,A00,093571,Daly; Heather Marie,25,0,30,5
1653299665168,ERC 1,A01,092328,Herbst; Matthew,20,0,20,0
1653299665168,ERC 1,A02,092330,Herbst; Matthew,20,0,20,0
1653299665168,ERC 1,A03,092331,Herbst; Matthew,20,0,20,0
1653299665168,ERC 1,A04,092332,Herbst; Matthew,20,0,20,0
1653299665168,ERC 1,A05,092333,Herbst; Matthew,20,0,20,0
1653299665168,ERC 1,A06,092334,Herbst; Matthew,20,0,20,0
1653299665698,ERC 2,A01,092336,Rahimi; Babak,20,0,20,0
1653299665698,ERC 2,A02,092337,Rahimi; Babak,20,0,20,0
1653299665698,ERC 2,A03,092338,Rahimi; Babak,20,0,20,0
1653299665698,ERC 2,A04,092339,Rahimi; Babak,20,0,20,0
1653299666231,ERC 20,A00,092340,Evans; Ivan T,30,0,30,0
1653299666231,ERC 20,B00,092341,Evans; Ivan T,30,0,30,0
1653299666764,ERC 87,A00,093850,Herbst; Matthew,20,0,20,0
1653299667297,ERC 92,A00,092342,Staff,1,0,1,0
1653299667297,ERC 92,B00,092343,Staff,1,0,1,0
1653299667297,ERC 92,C00,092344,Staff,1,0,1,0
1653299667297,ERC 92,D00,092345,Staff,1,0,1,0
1653299667297,ERC 92,E00,092346,Staff,1,0,1,0
1653299667297,ERC 92,F00,092347,Staff,1,0,1,0
1653299667821,ESYS 90,A00,086303,Teranes; Jane,12,0,12,0
1653299668345,ESYS 101,A01,086305,Taylor; Jennifer Rebecca & Diaz; Julia Michelle,25,0,27,2
1653299668345,ESYS 101,A02,086306,Taylor; Jennifer Rebecca & Diaz; Julia Michelle,15,0,27,12
1653299668345,ESYS 101,A03,086307,Taylor; Jennifer Rebecca & Diaz; Julia Michelle,21,0,27,6
1653299668345,ESYS 101,A04,086308,Taylor; Jennifer Rebecca & Diaz; Julia Michelle,27,0,27,0
1653299668869,ESYS 187A,A01,086310,Teranes; Jane,38,0,40,2
1653299668869,ESYS 187A,B01,086312,Teranes; Jane,30,0,40,10
1653299669394,ETHN 1,A01,086314,Frank; Ross H.,15,0,15,0
1653299669394,ETHN 1,A02,086315,Frank; Ross H.,15,0,15,0
1653299669394,ETHN 1,A03,086316,Frank; Ross H.,14,0,15,1
1653299669394,ETHN 1,A04,086317,Frank; Ross H.,15,0,15,0
1653299669394,ETHN 1,A05,086318,Frank; Ross H.,15,0,15,0
1653299669394,ETHN 1,A06,086319,Frank; Ross H.,13,0,15,2
1653299669394,ETHN 1,A07,086320,Frank; Ross H.,15,0,15,0
1653299669394,ETHN 1,A08,086321,Frank; Ross H.,14,0,15,1
1653299669394,ETHN 1,A09,086322,Frank; Ross H.,15,0,15,0
1653299669394,ETHN 1,A10,086323,Frank; Ross H.,15,0,15,0
1653299669394,ETHN 1,A11,086324,Frank; Ross H.,15,0,15,0
1653299669394,ETHN 1,A12,086325,Frank; Ross H.,15,0,15,0
1653299669394,ETHN 1,A13,086326,Frank; Ross H.,15,0,15,0
1653299669394,ETHN 1,A14,086327,Frank; Ross H.,15,0,15,0
1653299669394,ETHN 1,A15,086328,Frank; Ross H.,15,0,15,0
1653299669394,ETHN 1,A16,086329,Frank; Ross H.,15,0,15,0
1653299669921,ETHN 100A,A00,086330,Patel; Shaista,41,0,48,7
1653299670448,ETHN 103,A00,086331,Perreira; Christopher Michael,63,0,70,7
1653299670979,ETHN 104,A00,086332,Staff,0,0,0,0
1653299671503,ETHN 106,A00,086333,Staff,0,0,0,0
1653299672026,ETHN 121,A00,086341,Sasaki; Christen T,20,0,28,8
1653299672559,ETHN 139,A00,086342,Ruiz; Ariana,16,0,20,4
1653299673092,ETHN 144M,A00,086343,Jolivette; Andrew J,66,0,70,4
1653299673615,ETHN 159,A00,088427,Graham; Jessica Lynn,0,0,0,0
1653299674139,ETHN 163E,A00,086344,Patel; Shaista,37,0,40,3
1653299674664,ETHN 178R,A00,090798,Borgo; David Garcia,15,0,20,5
1653299675188,ETHN 187,A00,086345,Perez; Roy,14,0,16,2
1653299675715,EXPR 100,A00,085686,Staff,9999,0,9999,0
1653299676243,FMPH 40,A00,086370,Emory; Kristen,70,0,75,5
1653299676243,FMPH 40,B00,086371,Romero; Sally Ann Dominick,71,0,75,4
1653299676776,FMPH 101,A00,086372,Brouwer; Kimberly,43,0,55,12
1653299677304,FMPH 102,A50,094498,Rana; Brinda Kanti,42,0,55,13
1653299677828,FMPH 110,A00,086374,Zoumas-Morse; Christine E.,61,0,65,4
1653299678355,FMPH 120,A00,086375,Nguyen-Grozavu; France T.,45,0,65,20
1653299678355,FMPH 120,B00,086376,Nguyen-Grozavu; France T.,60,0,65,5
1653299678881,FMPH 130,A00,086377,Staff,48,0,65,17
1653299679929,FMPH 161,A00,086379,Zoumas-Morse; Christine E.,58,0,65,7
1653299680464,FMPH 191,A00,086380,Harrell; Maralee Mae,58,0,60,2
1653299680990,FMPH 196A,A00,086381,Binkin; Nancy Jeanne,0,0,0,0
1653299681539,GLBH 20,A00,086407,Walkover; Lillian B,85,0,90,5
1653299682067,GLBH 100,A00,086408,Staff,55,0,56,1
1653299682067,GLBH 100,B00,086409,Wu; Hua,52,0,56,4
1653299682067,GLBH 100,D00,086411,Staff,38,0,40,2
1653299682598,GLBH 103,A00,086412,Hannah; Seth Donal,48,0,50,2
1653299683125,GLBH 105,A00,086413,Olivas Hernandez; Olga Lid,36,0,38,2
1653299683652,GLBH 106,A00,086414,Kayser; Georgia Lyn,40,0,40,0
1653299684175,GLBH 111,A01,094330,Burgos; Jose L.,0,0,0,0
1653299684175,GLBH 111,B01,094332,Burgos; Jose L.,0,0,0,0
1653299684710,GLBH 148,A00,086415,Staff,69,0,73,4
1653299685334,GLBH 181,A00,086417,Burgos; Jose L.,144,0,146,2
1653299685858,GSS 20,A00,094269,Staff,73,0,75,2
1653299686386,HDS 1,A01,086423,Staff,24,0,25,1
1653299686386,HDS 1,A02,086424,Staff,24,0,25,1
1653299686386,HDS 1,A03,086425,Staff,23,0,25,2
1653299686386,HDS 1,A04,086426,Staff,25,0,25,0
1653299686386,HDS 1,A05,086427,Staff,24,0,25,1
1653299686386,HDS 1,A06,086428,Staff,25,0,25,0
1653299686386,HDS 1,A07,086429,Staff,30,0,30,0
1653299686913,HDS 60,A01,086431,Staff,23,0,25,2
1653299687437,HDS 111,A00,086432,Staff,73,0,80,7
1653299687960,HDS 121,A01,086434,Deak; Gedeon O.,11,0,15,4
1653299687960,HDS 121,A02,086435,Deak; Gedeon O.,13,0,15,2
1653299688484,HDS 150,A00,086436,Staff,25,0,25,0
1653299688484,HDS 150,B00,086437,Staff,25,0,25,0
1653299689009,HDS 173,A00,086439,Staff,27,0,30,3
1653299689537,HDS 181,A01,086441,Staff,30,0,30,0
1653299690060,HDS 191,A01,086443,Staff,25,0,25,0
1653299690593,HIEA 129,A00,088057,Schneewind; Sarah,0,0,0,0
1653299691119,HIEA 137,A00,088058,Lu; Weijing,53,0,55,2
1653299691645,HIEA 144,A00,088059,Henry; Todd A.,44,0,45,1
1653299692169,HIEA 171,A00,088060,Lu; Weijing,15,0,15,0
1653299692701,HIEU 102,A00,088061,Watts; Edward J.,0,0,0,0
1653299693224,HIEU 107,A00,088062,Caciola; Nancy A,0,0,0,0
1653299693747,HIEU 108,A00,088063,Balberg; Mira,53,0,60,7
1653299694274,HIEU 128,A00,088064,Neuheiser; Joerg,0,0,0,0
1653299694798,HIEU 144,A00,094327,Staff,48,0,50,2
1653299695324,HIEU 149,A00,088065,Devereux; Andrew W,38,0,45,7
1653299695847,HIEU 154,A00,088066,Biess; Frank Peter,58,0,65,7
1653299696371,HIGL 114,A00,088067,Edington; Claire Ellen,53,0,55,2
1653299696895,HILA 119,A00,088068,Vitz; Matthew,49,0,51,2
1653299697419,HILA 122,A00,088069,Widener; Daniel,61,0,65,4
1653299697943,HILD 2A,A01,088024,Hanna; Mark G.,28,0,28,0
1653299697943,HILD 2A,A02,088025,Hanna; Mark G.,25,0,25,0
1653299697943,HILD 2A,A03,088026,Hanna; Mark G.,27,0,28,1
1653299697943,HILD 2A,A04,088027,Hanna; Mark G.,28,0,28,0
1653299697943,HILD 2A,A05,088028,Hanna; Mark G.,28,0,28,0
1653299697943,HILD 2A,A06,088029,Hanna; Mark G.,28,0,28,0
1653299698472,HILD 7A,A01,088031,Graham; Jessica Lynn,28,0,28,0
1653299698472,HILD 7A,A02,088032,Graham; Jessica Lynn,27,0,28,1
1653299698472,HILD 7A,A03,088033,Graham; Jessica Lynn,27,0,28,1
1653299698472,HILD 7A,A04,088034,Graham; Jessica Lynn,26,0,28,2
1653299698472,HILD 7A,A05,088035,Graham; Jessica Lynn,26,0,28,2
1653299698472,HILD 7A,A06,088037,Graham; Jessica Lynn,22,0,28,6
1653299698472,HILD 7A,A07,088038,Graham; Jessica Lynn,28,0,28,0
1653299698472,HILD 7A,A08,088039,Graham; Jessica Lynn,28,0,28,0
1653299698472,HILD 7A,A09,088040,Graham; Jessica Lynn,27,0,28,1
1653299698472,HILD 7A,A10,088041,Graham; Jessica Lynn,28,0,28,0
1653299698472,HILD 7A,A11,088042,Graham; Jessica Lynn,28,0,28,0
1653299698472,HILD 7A,A12,088043,Graham; Jessica Lynn,28,0,28,0
1653299699003,HILD 10,A01,088045,Muscolino; Micah S,27,0,28,1
1653299699003,HILD 10,A02,088046,Muscolino; Micah S,27,0,28,1
1653299699003,HILD 10,A03,088047,Muscolino; Micah S,28,0,28,0
1653299699003,HILD 10,A04,088048,Muscolino; Micah S,27,0,28,1
1653299699003,HILD 10,A05,088049,Muscolino; Micah S,28,0,28,0
1653299699003,HILD 10,A06,088050,Muscolino; Micah S,27,0,28,1
1653299699529,HILD 30,A01,088052,Edington; Claire Ellen,24,0,28,4
1653299699529,HILD 30,A02,088053,Edington; Claire Ellen,28,0,28,0
1653299700067,HILD 41,A01,088055,Devereux; Andrew W,28,0,28,0
1653299700067,HILD 41,A02,088056,Devereux; Andrew W,28,0,28,0
1653299700593,HINE 116,A00,088070,Kayali; Hasan,47,0,50,3
1653299701141,HINE 144,A00,088071,Provence; Michael,40,0,45,5
1653299701674,HISC 106,A00,088072,Pineda De Avila; Nydia,47,0,50,3
1653299702198,HISC 115,A00,088073,Gere; Catherina M.,103,0,110,7
1653299702730,HITO 87,A00,094352,Patterson; Patrick H.,20,0,20,0
1653299702730,HITO 87,C00,094354,Patterson; Patrick H.,20,0,20,0
1653299702730,HITO 87,B00,094353,Hanna; Mark G.,20,0,20,0
1653299703257,HITO 100,A00,088074,Hanna; Mark G.,8,0,12,4
1653299703786,HITO 193,A00,091603,Hill; Seth J,9999,0,9999,0
1653299704318,HITO 196,A00,088075,Hendrickson; Gerald M.,20,0,20,0
1653299704842,HIUS 108B,A00,088076,Klann; Mary Cameron,48,0,51,3
1653299705367,HIUS 112,A00,088077,Plant; Rebecca Jo,144,0,148,4
1653299705892,HIUS 152A,A00,088078,Vandevelde; Kenneth Joseph,40,0,45,5
1653299706416,HIUS 155,A00,088079,Alvarez; Luis A,37,0,45,8
1653299706952,HIUS 183,A00,088080,Graham; Jessica Lynn,19,0,20,1
1653299707490,HUM 3,A01,087224,West; Geoffrey Scott,27,0,28,1
1653299707490,HUM 3,A02,087225,West; Geoffrey Scott,28,0,28,0
1653299707490,HUM 3,A03,087226,West; Geoffrey Scott,26,0,28,2
1653299707490,HUM 3,A04,087227,West; Geoffrey Scott,27,0,28,1
1653299707490,HUM 3,A05,087228,West; Geoffrey Scott,27,0,28,1
1653299707490,HUM 3,A06,087229,West; Geoffrey Scott,24,0,28,4
1653299707490,HUM 3,A07,087230,West; Geoffrey Scott,27,0,28,1
1653299707490,HUM 3,A08,087231,West; Geoffrey Scott,28,0,28,0
1653299707490,HUM 3,B01,087233,Staff,28,0,28,0
1653299707490,HUM 3,B02,087234,Staff,28,0,28,0
1653299707490,HUM 3,B03,087235,Staff,28,0,28,0
1653299707490,HUM 3,B04,087236,Staff,28,0,28,0
1653299707490,HUM 3,B05,087237,Staff,28,0,28,0
1653299707490,HUM 3,B06,087238,Staff,28,0,28,0
1653299707490,HUM 3,B07,087239,Staff,0,0,0,0
1653299707490,HUM 3,B08,087240,Staff,0,0,0,0
1653299707490,HUM 3,B09,087241,Staff,30,0,30,0
1653299707490,HUM 3,B10,087242,Staff,28,0,30,2
1653299707490,HUM 3,C01,087244,Patterson; Patrick H.,0,0,0,0
1653299707490,HUM 3,C02,087245,Patterson; Patrick H.,0,0,0,0
1653299707490,HUM 3,C03,087246,Patterson; Patrick H.,23,0,28,5
1653299707490,HUM 3,C04,087247,Patterson; Patrick H.,28,0,28,0
1653299707490,HUM 3,C05,087248,Patterson; Patrick H.,27,0,28,1
1653299707490,HUM 3,C06,087249,Patterson; Patrick H.,25,0,28,3
1653299707490,HUM 3,C07,087250,Patterson; Patrick H.,27,0,28,1
1653299707490,HUM 3,C08,087251,Patterson; Patrick H.,28,0,28,0
1653299707490,HUM 3,C09,087252,Patterson; Patrick H.,28,0,28,0
1653299707490,HUM 3,C10,087253,Patterson; Patrick H.,27,0,28,1
1653299707490,HUM 3,D01,087255,Lyon; Antony J.,24,0,28,4
1653299707490,HUM 3,D02,087256,Lyon; Antony J.,28,0,28,0
1653299707490,HUM 3,D03,087257,Lyon; Antony J.,0,0,0,0
1653299707490,HUM 3,D04,087258,Lyon; Antony J.,0,0,0,0
1653299707490,HUM 3,D05,087259,Lyon; Antony J.,27,0,28,1
1653299707490,HUM 3,D06,087260,Lyon; Antony J.,28,0,28,0
1653299707490,HUM 3,D07,087261,Lyon; Antony J.,21,0,28,7
1653299707490,HUM 3,D08,087262,Lyon; Antony J.,20,0,28,8
1653299707490,HUM 3,D09,087263,Lyon; Antony J.,28,0,28,0
1653299707490,HUM 3,D10,087264,Lyon; Antony J.,27,0,28,1
1653299707490,HUM 3,D11,087265,Lyon; Antony J.,30,0,30,0
1653299707490,HUM 3,D12,087266,Lyon; Antony J.,30,0,30,0
1653299707490,HUM 3,D13,087267,Lyon; Antony J.,26,0,28,2
1653299707490,HUM 3,D14,087268,Lyon; Antony J.,25,0,28,3
1653299708016,INTL 101,A01,088176,Day; Joel Keith,19,0,20,1
1653299708016,INTL 101,A02,088177,Day; Joel Keith,20,0,20,0
1653299708016,INTL 101,A03,088178,Day; Joel Keith,17,0,20,3
1653299708016,INTL 101,A04,088179,Day; Joel Keith,19,0,20,1
1653299708016,INTL 101,A05,088180,Day; Joel Keith,19,0,20,1
1653299708016,INTL 101,A06,088181,Day; Joel Keith,18,0,20,2
1653299708540,INTL 102,A01,088183,Walter; Barbara Florence,19,0,20,1
1653299708540,INTL 102,A02,088184,Walter; Barbara Florence,19,0,20,1
1653299708540,INTL 102,A03,088185,Walter; Barbara Florence,18,0,20,2
1653299708540,INTL 102,A04,088186,Walter; Barbara Florence,16,0,20,4
1653299708540,INTL 102,A05,088187,Walter; Barbara Florence,19,0,20,1
1653299708540,INTL 102,A06,088188,Walter; Barbara Florence,19,0,20,1
1653299709074,INTL 190,A00,088189,Auerbach; Bradford C,0,0,0,0
1653299709074,INTL 190,B00,088190,Auerbach; Bradford C,0,0,0,0
1653299709074,INTL 190,C00,088191,Fortier; Jana,0,0,0,0
1653299709074,INTL 190,D00,088192,Kshatriya; Krista C,0,0,0,0
1653299709074,INTL 190,E00,088193,Nadkarni; Vidya,0,0,0,0
1653299709074,INTL 190,F00,088194,Scott; Jeffrey F,0,0,0,0
1653299709074,INTL 190,G00,088195,Segui; Alan S,0,0,0,0
1653299709074,INTL 190,H00,088196,Segui; Alan S,0,0,0,0
1653299709607,INTL 190H,A00,088197,Gibson; Clark C,0,0,0,0
1653299710185,JAPN 10A,A01,086851,Maruyama; Rie,15,0,15,0
1653299710185,JAPN 10A,A02,086852,Maruyama; Rie,15,0,15,0
1653299710185,JAPN 10A,B01,086854,Staff,13,0,13,0
1653299710185,JAPN 10A,B02,086855,Staff,13,0,13,0
1653299710185,JAPN 10A,C01,086857,McKee; Mayumi Mochizuki,13,0,13,0
1653299710185,JAPN 10A,C02,086858,McKee; Mayumi Mochizuki,11,0,13,2
1653299710185,JAPN 10A,D01,086860,Sato; Kyoko,13,0,13,0
1653299710185,JAPN 10A,D02,086861,Sato; Kyoko,13,0,13,0
1653299710185,JAPN 10A,E01,086863,Kamioka; Sachiko,12,0,13,1
1653299710185,JAPN 10A,E02,086864,Kamioka; Sachiko,12,0,13,1
1653299710185,JAPN 10A,F01,086866,Sato; Kyoko,13,0,13,0
1653299710185,JAPN 10A,F02,086867,Sato; Kyoko,13,0,13,0
1653299710185,JAPN 10A,G01,086869,Maruyama; Rie,8,0,13,5
1653299710185,JAPN 10A,G02,086870,Maruyama; Rie,13,0,13,0
1653299710185,JAPN 10A,H01,086872,Kamioka; Sachiko,12,0,13,1
1653299710185,JAPN 10A,H02,086873,Kamioka; Sachiko,11,0,13,2
1653299710185,JAPN 10A,I01,086875,Staff,12,0,13,1
1653299710185,JAPN 10A,I02,086876,Staff,13,0,13,0
1653299710185,JAPN 10A,J01,086878,McKee; Mayumi Mochizuki,12,0,13,1
1653299710185,JAPN 10A,J02,086879,McKee; Mayumi Mochizuki,13,0,13,0
1653299710185,JAPN 10A,K01,086881,Inada; Minori,13,0,13,0
1653299710185,JAPN 10A,K02,086882,Inada; Minori,12,0,13,1
1653299710185,JAPN 10A,L01,086884,Tipton; Yuko,13,0,13,0
1653299710185,JAPN 10A,L02,086885,Tipton; Yuko,13,0,13,0
1653299710185,JAPN 10A,M01,086887,Inada; Minori,12,0,13,1
1653299710185,JAPN 10A,M02,086888,Inada; Minori,13,0,13,0
1653299710185,JAPN 10A,N01,086890,McKee; Mayumi Mochizuki,13,0,13,0
1653299710185,JAPN 10A,N02,086891,McKee; Mayumi Mochizuki,11,0,13,2
1653299710185,JAPN 10A,O01,086893,Staff,13,0,13,0
1653299710185,JAPN 10A,O02,086894,Staff,12,0,13,1
1653299710185,JAPN 10A,P01,086896,Tipton; Yuko,15,0,15,0
1653299710185,JAPN 10A,P02,086897,Tipton; Yuko,15,0,15,0
1653299710712,JAPN 20A,A01,086899,Simpson; Junko Tokuda,11,0,13,2
1653299710712,JAPN 20A,A02,086900,Simpson; Junko Tokuda,12,0,13,1
1653299710712,JAPN 20A,B01,086902,Takeda; Izumi,11,0,13,2
1653299710712,JAPN 20A,B02,086903,Takeda; Izumi,12,0,13,1
1653299710712,JAPN 20A,C01,086905,Ross; Kayoko F,12,0,13,1
1653299710712,JAPN 20A,C02,086906,Ross; Kayoko F,12,0,13,1
1653299710712,JAPN 20A,D01,086908,Takeda; Izumi,10,0,13,3
1653299710712,JAPN 20A,D02,086909,Takeda; Izumi,13,0,13,0
1653299710712,JAPN 20A,E01,086911,Maruyama; Rie,11,0,13,2
1653299710712,JAPN 20A,E02,086912,Maruyama; Rie,11,0,13,2
1653299710712,JAPN 20A,F01,086914,Kamioka; Sachiko,7,0,13,6
1653299710712,JAPN 20A,F02,086915,Kamioka; Sachiko,9,0,13,4
1653299710712,JAPN 20A,G01,086917,Ross; Kayoko F,13,0,13,0
1653299710712,JAPN 20A,G02,086918,Ross; Kayoko F,12,0,13,1
1653299711237,JAPN 130A,A01,086920,Simpson; Junko Tokuda,6,0,10,4
1653299711237,JAPN 130A,A02,086921,Simpson; Junko Tokuda,5,0,10,5
1653299711237,JAPN 130A,B01,086923,Ross; Kayoko F,9,0,10,1
1653299711237,JAPN 130A,B02,086924,Ross; Kayoko F,9,0,10,1
1653299711764,JAPN 135A,A00,086925,Inada; Minori,14,0,15,1
1653299711764,JAPN 135A,B00,086926,Takeda; Izumi,15,0,15,0
1653299712287,JAPN 140A,A00,086927,Sato; Kyoko,19,0,20,1
1653299712815,JWSP 1,A01,086445,Shuster; Alana,15,0,15,0
1653299712815,JWSP 1,A02,086446,Shuster; Alana,15,0,15,0
1653299713339,JWSP 104,A01,086448,Shuster; Alana,15,0,15,0
1653299713864,LATI 10,A01,093588,Kennemore; Amy Michelle,31,0,32,1
1653299713864,LATI 10,A02,093589,Kennemore; Amy Michelle,32,0,32,0
1653299713864,LATI 10,A03,093590,Kennemore; Amy Michelle,32,0,32,0
1653299714393,LATI 50,A01,093592,Kokinis; Troy Andreas,32,0,32,0
1653299714393,LATI 50,A02,093593,Kokinis; Troy Andreas,31,0,32,1
1653299714393,LATI 50,A03,093595,Kokinis; Troy Andreas,32,0,32,0
1653299714929,LATI 122A,A00,093649,Andrews; Abigail Leslie,0,0,0,0
1653299715455,LATI 180,A00,093597,Staff,36,0,40,4
1653299715986,LIAB 1A,A00,087085,Saab; Dima,13,0,14,1
1653299715986,LIAB 1A,B00,087086,Saab; Dima,13,0,14,1
1653299715986,LIAB 1A,C00,087087,Saab; Dima,14,0,14,0
1653299715986,LIAB 1A,D00,087088,El Cheddadi; Youniss,14,0,14,0
1653299716532,LIAB 1AX,A00,087089,Akjeje; Abdelhak,28,0,28,0
1653299716532,LIAB 1AX,B00,087091,Akjeje; Abdelhak,28,0,28,0
1653299717059,LIAB 1D,A00,087093,El Cheddadi; Youniss,13,0,14,1
1653299717059,LIAB 1D,B00,087094,El Cheddadi; Youniss,12,0,14,2
1653299717598,LIAB 1DX,A00,087095,Akjeje; Abdelhak,27,0,28,1
1653299718121,LIDS 19,001,095098,Goodall; Grant Todd,9999,0,9999,0
1653299718121,LIDS 19,002,095099,Goodall; Grant Todd,9999,0,9999,0
1653299718121,LIDS 19,003,095100,Goodall; Grant Todd,9999,0,9999,0
1653299718121,LIDS 19,004,095101,Goodall; Grant Todd,9999,0,9999,0
1653299718121,LIDS 19,005,095102,Goodall; Grant Todd,9999,0,9999,0
1653299718121,LIDS 19,006,095103,Goodall; Grant Todd,9999,0,9999,0
1653299718121,LIDS 19,007,095104,Goodall; Grant Todd,9999,0,9999,0
1653299718121,LIDS 19,008,095105,Goodall; Grant Todd,9999,0,9999,0
1653299718121,LIDS 19,009,095106,Goodall; Grant Todd,9999,0,9999,0
1653299718121,LIDS 19,010,095107,Goodall; Grant Todd,9999,0,9999,0
1653299718121,LIDS 19,011,095108,Goodall; Grant Todd,9999,0,9999,0
1653299718121,LIDS 19,012,095109,Goodall; Grant Todd,9999,0,9999,0
1653299718671,LIFR 1A,A00,087097,Goodall; Grant Todd,13,0,14,1
1653299718671,LIFR 1A,B00,087098,Goodall; Grant Todd,13,0,14,1
1653299718671,LIFR 1A,C00,087099,Goodall; Grant Todd,12,0,14,2
1653299718671,LIFR 1A,D00,087100,Goodall; Grant Todd,12,0,14,2
1653299718671,LIFR 1A,E00,087101,Goodall; Grant Todd,14,0,14,0
1653299718671,LIFR 1A,F00,087102,Goodall; Grant Todd,13,0,14,1
1653299719196,LIFR 1AX,A00,087103,Goodall; Grant Todd,27,0,28,1
1653299719196,LIFR 1AX,B00,087104,Goodall; Grant Todd,27,0,28,1
1653299719196,LIFR 1AX,C00,087105,Goodall; Grant Todd,25,0,28,3
1653299719732,LIFR 1B,A00,087106,Goodall; Grant Todd,14,0,14,0
1653299719732,LIFR 1B,B00,087107,Goodall; Grant Todd,13,0,14,1
1653299719732,LIFR 1B,C00,087108,Goodall; Grant Todd,13,0,14,1
1653299719732,LIFR 1B,D00,087109,Goodall; Grant Todd,13,0,14,1
1653299720259,LIFR 1BX,A00,087110,Goodall; Grant Todd,26,0,28,2
1653299720259,LIFR 1BX,B00,087111,Goodall; Grant Todd,26,0,28,2
1653299720787,LIFR 1D,A00,087112,Goodall; Grant Todd,14,0,14,0
1653299720787,LIFR 1D,B00,087113,Goodall; Grant Todd,12,0,14,2
1653299720787,LIFR 1D,C00,087114,Goodall; Grant Todd,11,0,14,3
1653299720787,LIFR 1D,D00,087115,Goodall; Grant Todd,10,0,14,4
1653299721310,LIFR 1DX,A00,087116,Goodall; Grant Todd,26,0,28,2
1653299721310,LIFR 1DX,B00,087117,Goodall; Grant Todd,23,0,28,5
1653299721836,LIFR 11,A00,087118,Goodall; Grant Todd,10,0,10,0
1653299722367,LIGM 1A,A00,087119,Riebeling; Elke,14,0,14,0
1653299722367,LIGM 1A,B00,087120,Riebeling; Elke,14,0,14,0
1653299722367,LIGM 1A,C00,087121,Riebeling; Elke,12,0,14,2
1653299722367,LIGM 1A,D00,087122,Riebeling; Elke,14,0,14,0
1653299722367,LIGM 1A,E00,087123,Riebeling; Elke,14,0,14,0
1653299722893,LIGM 1AX,A00,087124,Riebeling; Elke,28,0,28,0
1653299722893,LIGM 1AX,B00,087125,Riebeling; Elke,28,0,28,0
1653299722893,LIGM 1AX,C00,087126,Riebeling; Elke,27,0,28,1
1653299723416,LIGM 1D,A00,087127,Riebeling; Elke,14,0,14,0
1653299723416,LIGM 1D,B00,087128,Riebeling; Elke,12,0,14,2
1653299723951,LIGM 1DX,A00,087129,Riebeling; Elke,26,0,28,2
1653299724477,LIGM 11,A00,087130,Goodall; Grant Todd,10,0,10,0
1653299725000,LIGN 5,A00,087005,Goodall; Grant Todd,74,0,75,1
1653299725540,LIGN 7,A00,087006,Mayberry; Rachel,139,0,146,7
1653299726064,LIGN 8,A00,087007,McIntosh; Justin Daniel,244,0,250,6
1653299726590,LIGN 17,A00,087008,Kehler; Andrew Scott,218,0,220,2
1653299727119,LIGN 101,A01,087010,Styler; William Francis,29,0,30,1
1653299727119,LIGN 101,A02,087011,Styler; William Francis,29,0,30,1
1653299727119,LIGN 101,A03,087012,Styler; William Francis,29,0,30,1
1653299727119,LIGN 101,A04,087013,Styler; William Francis,29,0,30,1
1653299727646,LIGN 110,A01,087015,Garellek; Marc,29,0,30,1
1653299727646,LIGN 110,A02,087016,Garellek; Marc,26,0,30,4
1653299727646,LIGN 110,A03,087017,Garellek; Marc,26,0,30,4
1653299727646,LIGN 110,A04,087018,Garellek; Marc,28,0,30,2
1653299728182,LIGN 121,A01,087020,Drake; Emily C,23,0,25,2
1653299728182,LIGN 121,A02,087021,Drake; Emily C,24,0,25,1
1653299728710,LIGN 150,A00,093702,Staff,71,0,75,4
1653299729234,LIGN 152,A00,087023,Caballero; Gabriela Hernandez,16,0,20,4
1653299729762,LIGN 154,A00,087024,Kluender; Robert,70,0,70,0
1653299730286,LIGN 167,A00,087025,Bergen; Leon,70,0,100,30
1653299730812,LIGN 187,A00,087026,McIntosh; Justin Daniel,20,0,20,0
1653299731339,LIHL 112F,A00,086505,Alicio; Atilio,25,0,28,3
1653299731886,LIHL 114F,A00,086506,Staff,21,0,28,7
1653299732430,LIHL 117F,A00,086508,Sadegholvad; Elham,20,0,20,0
1653299732953,LIHL 118,A00,086509,Staff,25,0,28,3
1653299733488,LIHL 119F,A00,086510,Staff,26,0,28,2
1653299734024,LIHL 124F,A00,086511,Staff,27,0,28,1
1653299734556,LIHL 132F,A00,086512,Alicio; Atilio,28,0,28,0
1653299735081,LIIT 1A,A00,087131,Riebeling; Elke,14,0,14,0
1653299735081,LIIT 1A,B00,087132,Riebeling; Elke,14,0,14,0
1653299735081,LIIT 1A,C00,087133,Riebeling; Elke,12,0,14,2
1653299735081,LIIT 1A,D00,087134,Riebeling; Elke,14,0,14,0
1653299735608,LIIT 1AX,A00,087135,Riebeling; Elke,28,0,28,0
1653299735608,LIIT 1AX,B00,087136,Riebeling; Elke,26,0,28,2
1653299736139,LIPO 1A,A00,087137,Paladini; Denise,14,0,14,0
1653299736139,LIPO 1A,B00,087138,Paladini; Denise,10,0,14,4
1653299736672,LIPO 1AX,A00,087139,De Abreu; Cassia,18,0,22,4
1653299736672,LIPO 1AX,B00,087140,De Abreu; Cassia,22,0,22,0
1653299737195,LIPO 1D,A00,087141,Paladini; Denise,10,0,14,4
1653299737720,LIPO 1DX,A00,087143,De Abreu; Cassia,10,0,14,4
1653299738257,LISL 1A,A00,087145,Lott; Margaret S.,10,0,14,4
1653299738257,LISL 1A,B00,087146,Lott; Margaret S.,14,0,14,0
1653299738257,LISL 1A,C00,087147,Lott; Margaret S.,10,0,14,4
1653299738257,LISL 1A,D00,087148,Lott; Margaret S.,11,0,14,3
1653299738257,LISL 1A,E00,087149,Lott; Margaret S.,13,0,14,1
1653299738257,LISL 1A,F00,087150,Lott; Margaret S.,12,0,14,2
1653299738257,LISL 1A,G00,087151,Lott; Margaret S.,13,0,14,1
1653299738257,LISL 1A,H00,087152,Lott; Margaret S.,13,0,14,1
1653299738875,LISL 1AX,A00,087153,Lott; Margaret S.,28,0,28,0
1653299738875,LISL 1AX,B00,087154,Lott; Margaret S.,25,0,28,3
1653299738875,LISL 1AX,C00,087155,Lott; Margaret S.,25,0,28,3
1653299738875,LISL 1AX,D00,087156,Lott; Margaret S.,24,0,28,4
1653299739399,LISL 1B,A00,087157,Lott; Margaret S.,13,0,14,1
1653299739399,LISL 1B,B00,087158,Lott; Margaret S.,12,0,14,2
1653299739399,LISL 1B,C00,087159,Lott; Margaret S.,11,0,14,3
1653299739399,LISL 1B,D00,087160,Lott; Margaret S.,13,0,14,1
1653299739399,LISL 1B,E00,087161,Lott; Margaret S.,13,0,14,1
1653299739399,LISL 1B,F00,087162,Lott; Margaret S.,13,0,14,1
1653299739924,LISL 1BX,A00,087163,Lott; Margaret S.,23,0,28,5
1653299739924,LISL 1BX,B00,087164,Lott; Margaret S.,26,0,28,2
1653299739924,LISL 1BX,C00,087165,Lott; Margaret S.,28,0,28,0
1653299740454,LISL 1D,A00,087166,Lott; Margaret S.,14,0,14,0
1653299740454,LISL 1D,B00,087167,Lott; Margaret S.,14,0,14,0
1653299740454,LISL 1D,C00,087168,Lott; Margaret S.,8,0,14,6
1653299740454,LISL 1D,D00,087169,Lott; Margaret S.,13,0,14,1
1653299740977,LISL 1DX,A00,087170,Lott; Margaret S.,23,0,28,5
1653299740977,LISL 1DX,B00,087171,Lott; Margaret S.,26,0,28,2
1653299741504,LISP 1A,001,087172,Munoz Sanchez; Alicia,13,0,14,1
1653299741504,LISP 1A,002,087173,Munoz Sanchez; Alicia,12,0,14,2
1653299741504,LISP 1A,003,087174,Munoz Sanchez; Alicia,13,0,14,1
1653299741504,LISP 1A,004,087175,Munoz Sanchez; Alicia,12,0,14,2
1653299741504,LISP 1A,005,087176,Munoz Sanchez; Alicia,10,0,14,4
1653299741504,LISP 1A,006,087177,Munoz Sanchez; Alicia,12,0,14,2
1653299741504,LISP 1A,007,087178,Munoz Sanchez; Alicia,12,0,14,2
1653299741504,LISP 1A,008,087179,Munoz Sanchez; Alicia,14,0,14,0
1653299742027,LISP 1AX,A00,087180,Munoz Sanchez; Alicia,27,0,28,1
1653299742027,LISP 1AX,B00,087181,Munoz Sanchez; Alicia,24,0,28,4
1653299742027,LISP 1AX,C00,087182,Munoz Sanchez; Alicia,25,0,28,3
1653299742027,LISP 1AX,D00,087183,Munoz Sanchez; Alicia,25,0,28,3
1653299742561,LISP 1B,001,087184,Munoz Sanchez; Alicia,14,0,14,0
1653299742561,LISP 1B,002,087185,Munoz Sanchez; Alicia,14,0,14,0
1653299742561,LISP 1B,003,087186,Munoz Sanchez; Alicia,11,0,14,3
1653299742561,LISP 1B,004,087187,Munoz Sanchez; Alicia,12,0,14,2
1653299742561,LISP 1B,005,087188,Munoz Sanchez; Alicia,13,0,14,1
1653299742561,LISP 1B,006,087189,Munoz Sanchez; Alicia,13,0,14,1
1653299742561,LISP 1B,007,087190,Munoz Sanchez; Alicia,14,0,14,0
1653299742561,LISP 1B,008,087191,Munoz Sanchez; Alicia,13,0,14,1
1653299742561,LISP 1B,009,087192,Munoz Sanchez; Alicia,14,0,14,0
1653299742561,LISP 1B,010,087193,Munoz Sanchez; Alicia,13,0,14,1
1653299742561,LISP 1B,011,087194,Munoz Sanchez; Alicia,14,0,14,0
1653299743091,LISP 1BX,A00,087195,Munoz Sanchez; Alicia,28,0,28,0
1653299743091,LISP 1BX,B00,087196,Munoz Sanchez; Alicia,26,0,28,2
1653299743091,LISP 1BX,C00,087197,Munoz Sanchez; Alicia,26,0,28,2
1653299743091,LISP 1BX,D00,087198,Munoz Sanchez; Alicia,26,0,28,2
1653299743091,LISP 1BX,E00,087199,Munoz Sanchez; Alicia,28,0,28,0
1653299743622,LISP 1D,001,087200,Munoz Sanchez; Alicia,13,0,14,1
1653299743622,LISP 1D,002,087201,Munoz Sanchez; Alicia,14,0,14,0
1653299743622,LISP 1D,003,087202,Munoz Sanchez; Alicia,8,0,14,6
1653299743622,LISP 1D,004,087203,Munoz Sanchez; Alicia,5,0,14,9
1653299743622,LISP 1D,005,087204,Munoz Sanchez; Alicia,11,0,14,3
1653299743622,LISP 1D,006,087205,Munoz Sanchez; Alicia,13,0,14,1
1653299743622,LISP 1D,007,087206,Munoz Sanchez; Alicia,13,0,14,1
1653299743622,LISP 1D,008,087207,Munoz Sanchez; Alicia,13,0,14,1
1653299743622,LISP 1D,009,087208,Munoz Sanchez; Alicia,14,0,14,0
1653299743622,LISP 1D,010,087209,Munoz Sanchez; Alicia,12,0,14,2
1653299743622,LISP 1D,011,087210,Munoz Sanchez; Alicia,13,0,14,1
1653299743622,LISP 1D,012,087211,Munoz Sanchez; Alicia,14,0,14,0
1653299743622,LISP 1D,013,087212,Munoz Sanchez; Alicia,14,0,14,0
1653299743622,LISP 1D,014,087213,Munoz Sanchez; Alicia,14,0,14,0
1653299744147,LISP 1DX,A00,087214,Munoz Sanchez; Alicia,27,0,28,1
1653299744147,LISP 1DX,B00,087215,Munoz Sanchez; Alicia,23,0,28,5
1653299744147,LISP 1DX,C00,087216,Munoz Sanchez; Alicia,23,0,28,5
1653299744147,LISP 1DX,D00,087217,Munoz Sanchez; Alicia,25,0,28,3
1653299744147,LISP 1DX,E00,087218,Munoz Sanchez; Alicia,27,0,28,1
1653299744147,LISP 1DX,F00,087219,Munoz Sanchez; Alicia,25,0,28,3
1653299744147,LISP 1DX,G00,087220,Munoz Sanchez; Alicia,28,0,28,0
1653299744674,LISP 15,A00,087221,Munoz Sanchez; Alicia,19,0,20,1
1653299745197,LISP 18,A00,087222,Munoz Sanchez; Alicia,15,0,20,5
1653299745720,LTAM 110,A00,087352,Chacon; Gloria Elizabeth,35,0,40,5
1653299746247,LTCS 87,A00,094011,Nguyen; Hoang Tan,19,0,20,1
1653299746789,LTCS 111,A00,087353,Vitkus; Daniel J.,40,0,40,0
1653299747312,LTCS 119,A00,087354,Nguyen; Hoang Tan,29,0,30,1
1653299747843,LTCS 130,A00,087355,Kim; Joo Ok,37,0,40,3
1653299748369,LTCS 165,A00,087356,Kim; Joo Ok,38,0,40,2
1653299748894,LTEA 120A,A00,087357,Fiss; Geraldine Anna,291,0,300,9
1653299749422,LTEA 140,A00,094009,Lee; Jin-Kyung,28,0,32,4
1653299749947,LTEA 142,A00,087358,Lee; Jin-Kyung,103,0,120,17
1653299750471,LTEN 21,A01,087275,Lampert-Weissig; Lisa,25,0,25,0
1653299750471,LTEN 21,A02,087276,Lampert-Weissig; Lisa,25,0,25,0
1653299750471,LTEN 21,A03,087277,Lampert-Weissig; Lisa,25,0,25,0
1653299750471,LTEN 21,A04,087278,Lampert-Weissig; Lisa,25,0,25,0
1653299750995,LTEN 25,A01,087280,Johnson; Sara E.,25,0,25,0
1653299750995,LTEN 25,A02,087281,Johnson; Sara E.,25,0,25,0
1653299750995,LTEN 25,A03,087282,Johnson; Sara E.,23,0,25,2
1653299750995,LTEN 25,A04,087283,Johnson; Sara E.,25,0,25,0
1653299751519,LTEN 29,A01,087285,Ruiz; Ariana,24,0,25,1
1653299751519,LTEN 29,A02,087286,Ruiz; Ariana,25,0,25,0
1653299751519,LTEN 29,A03,087287,Ruiz; Ariana,24,0,25,1
1653299751519,LTEN 29,A04,087288,Ruiz; Ariana,24,0,25,1
1653299752048,LTEN 107,A00,087359,Lampert-Weissig; Lisa,39,0,40,1
1653299752573,LTEN 117,A00,087360,Vitkus; Daniel J.,40,0,40,0
1653299753099,LTEN 127,A00,087361,Loose; Margaret,38,0,40,2
1653299753622,LTEN 142,A00,094010,Loose; Margaret,38,0,40,2
1653299754144,LTEN 148,A00,087363,Walkiewicz; Kathryn A,40,0,40,0
1653299754671,LTEN 152,A00,087364,Walkiewicz; Kathryn A,37,0,40,3
1653299755194,LTEN 180,A00,087365,Ruiz; Ariana,18,0,20,2
1653299755718,LTFR 2A,A01,087290,Ploye; Catherine,23,0,25,2
1653299756241,LTFR 2B,A01,087292,Ploye; Catherine,25,0,25,0
1653299756765,LTFR 104,A00,087366,Ploye; Catherine,25,0,25,0
1653299757288,LTFR 116,A00,087367,Zhiri; Oumelbanine,13,0,15,2
1653299757811,LTGK 1,A00,087293,Myerston Santana; Jacobo,27,0,30,3
1653299758350,LTGK 103,A00,087368,duBois; Page Ann,14,0,15,1
1653299758873,LTGM 2A,A01,087295,Fischer-Grunski; Eva K,24,0,25,1
1653299759401,LTIT 2A,A01,087297,De Marchi Gherini; Adriana,24,0,25,1
1653299759937,LTKO 1A,A01,087299,Staff,24,0,25,1
1653299759937,LTKO 1A,B01,087301,Staff,25,0,25,0
1653299759937,LTKO 1A,C01,087303,Staff,25,0,25,0
1653299759937,LTKO 1A,D01,087305,Staff,25,0,25,0
1653299759937,LTKO 1A,E01,087307,Staff,24,0,25,1
1653299759937,LTKO 1A,F01,087309,Staff,25,0,25,0
1653299759937,LTKO 1A,G01,087311,Staff,25,0,25,0
1653299759937,LTKO 1A,H01,087313,Staff,24,0,25,1
1653299759937,LTKO 1A,I01,087315,Staff,25,0,25,0
1653299760461,LTKO 2A,A01,087317,Staff,24,0,25,1
1653299760461,LTKO 2A,B01,087319,Staff,22,0,25,3
1653299760461,LTKO 2A,C01,087321,Lee; Jeyseon,24,0,25,1
1653299760984,LTKO 130,A00,087369,Lee; Jeyseon,25,0,25,0
1653299761511,LTLA 1,A00,087322,Murray; Kourtney Kristine,38,0,40,2
1653299762051,LTLA 100,A00,087371,Kelting; Edward William,23,0,25,2
1653299762576,LTRU 1A,A01,087324,Wells; Patricia Rebecca,23,0,25,2
1653299763111,LTRU 2A,A01,087326,Wells; Patricia Rebecca,20,0,20,0
1653299763635,LTRU 104B,A01,087373,Wells; Patricia Rebecca,14,0,15,1
1653299764159,LTSP 2A,A01,087328,Staff,25,0,25,0
1653299764159,LTSP 2A,B01,087330,Staff,22,0,25,3
1653299764159,LTSP 2A,C01,087332,Staff,22,0,25,3
1653299764686,LTSP 2B,A01,087334,Staff,22,0,25,3
1653299764686,LTSP 2B,B01,087336,Staff,19,0,25,6
1653299765208,LTSP 2D,A00,087337,Staff,25,0,25,0
1653299765208,LTSP 2D,B00,087338,Staff,25,0,25,0
1653299765208,LTSP 2D,C00,087339,Staff,25,0,25,0
1653299765741,LTSP 100A,A00,087374,Arcos Herrera; Carol,23,0,25,2
1653299766269,LTSP 116,A00,087375,Blanco; John D,29,0,30,1
1653299766795,LTSP 140,A00,087376,Chacon; Gloria Elizabeth,30,0,30,0
1653299767323,LTSP 175,A00,087377,Arcos Herrera; Carol,30,0,30,0
1653299767846,LTTH 150,A00,087379,Cohen; Alain J. J.,40,0,40,0
1653299768369,LTWL 19A,A00,087340,Myerston Santana; Jacobo,39,0,40,1
1653299768898,LTWL 87,A00,094012,Lampert-Weissig; Lisa,20,0,20,0
1653299769423,LTWL 116,A00,087380,Nguyen; Hoang Tan,60,0,60,0
1653299769946,LTWL 120,A00,087381,Fiss; Geraldine Anna,37,0,40,3
1653299770470,LTWL 172,A00,087382,De Marchi Gherini; Adriana,40,0,40,0
1653299770993,LTWL 180,A00,087383,Kontje; Todd Curtis,39,0,40,1
1653299771521,LTWL 194,A00,087384,Suzuki; Erin M.,31,0,32,1
1653299772044,LTWR 8A,A01,087342,Jemc; Jaclyn,24,0,25,1
1653299772044,LTWR 8A,A02,087343,Jemc; Jaclyn,25,0,25,0
1653299772044,LTWR 8A,A03,087344,Jemc; Jaclyn,24,0,25,1
1653299772044,LTWR 8A,A04,087345,Jemc; Jaclyn,24,0,25,1
1653299772568,LTWR 8C,A01,087348,Forbes; Camille,25,0,25,0
1653299772568,LTWR 8C,A02,087349,Forbes; Camille,25,0,25,0
1653299772568,LTWR 8C,A03,087350,Forbes; Camille,25,0,25,0
1653299772568,LTWR 8C,A04,087351,Forbes; Camille,23,0,25,2
1653299773091,LTWR 100,A00,087385,Staff,12,0,15,3
1653299773619,LTWR 102,A00,087386,Staff,14,0,15,1
1653299774143,LTWR 115,A00,087387,Carroll; Amy Sara,24,0,30,6
1653299774669,LTWR 119,A00,087388,Staff,22,0,30,8
1653299775193,LTWR 140,A00,087389,Carroll; Amy Sara,37,0,40,3
1653299775720,LTWR 194,A00,087390,Som; Brandon D,35,0,40,5
1653299776245,MAE 2,A01,090334,Anderson; Mark Ronald,8,0,8,0
1653299776245,MAE 2,A02,090335,Anderson; Mark Ronald,8,0,8,0
1653299776245,MAE 2,A03,090336,Anderson; Mark Ronald,8,0,8,0
1653299776245,MAE 2,A04,090337,Anderson; Mark Ronald,8,0,8,0
1653299776245,MAE 2,A05,090338,Anderson; Mark Ronald,8,0,8,0
1653299776245,MAE 2,A06,090339,Anderson; Mark Ronald,8,0,8,0
1653299776245,MAE 2,A07,090340,Anderson; Mark Ronald,8,0,8,0
1653299776245,MAE 2,A08,090341,Anderson; Mark Ronald,7,0,8,1
1653299776245,MAE 2,A09,090342,Anderson; Mark Ronald,8,0,8,0
1653299776770,MAE 3,A01,090344,Delson; Nathan Joseph,21,0,22,1
1653299776770,MAE 3,A02,090345,Delson; Nathan Joseph,20,0,22,2
1653299776770,MAE 3,A03,090346,Delson; Nathan Joseph,21,0,22,1
1653299776770,MAE 3,A04,090347,Delson; Nathan Joseph,22,0,22,0
1653299776770,MAE 3,B01,090349,Qi; Huihui,18,0,22,4
1653299776770,MAE 3,B02,090350,Qi; Huihui,17,0,22,5
1653299776770,MAE 3,B03,090351,Qi; Huihui,20,0,22,2
1653299776770,MAE 3,B04,090352,Qi; Huihui,19,0,22,3
1653299777296,MAE 8,A01,090354,Pham; Hieu Tan,182,0,185,3
1653299777824,MAE 11,A00,090355,Nomura; Keiko K.,155,0,165,10
1653299778365,MAE 20,A00,090356,Bandaru; Prabhakar,160,0,160,0
1653299778365,MAE 20,B00,090357,Evdokimenko; Ekaterina,145,0,160,15
1653299778890,MAE 21,A01,090359,Cai; Shengqiang,8,0,9,1
1653299778890,MAE 21,A02,090360,Cai; Shengqiang,9,0,9,0
1653299778890,MAE 21,A03,090361,Cai; Shengqiang,6,0,9,3
1653299778890,MAE 21,A04,090362,Cai; Shengqiang,7,0,9,2
1653299778890,MAE 21,A05,090363,Cai; Shengqiang,0,0,0,0
1653299778890,MAE 21,A06,090364,Cai; Shengqiang,9,0,9,0
1653299778890,MAE 21,A07,090365,Cai; Shengqiang,9,0,9,0
1653299778890,MAE 21,A08,090366,Cai; Shengqiang,8,0,9,1
1653299778890,MAE 21,A09,090367,Cai; Shengqiang,8,0,9,1
1653299778890,MAE 21,A10,090368,Cai; Shengqiang,0,0,0,0
1653299778890,MAE 21,A11,090369,Cai; Shengqiang,9,0,9,0
1653299778890,MAE 21,A12,090370,Cai; Shengqiang,8,0,9,1
1653299779423,MAE 30A,A00,090371,Lal; Ratnesh,72,0,75,3
1653299779951,MAE 40,A00,090372,Bitmead; Robert R.,167,0,175,8
1653299780473,MAE 101A,A00,090373,Bahadori; Mohammad Yousef,105,0,115,10
1653299780997,MAE 101C,A00,090374,Poulikakos; Lisa Voula,41,0,110,69
1653299780997,MAE 101C,B00,090375,Chen; Renkun,96,0,110,14
1653299781525,MAE 104,A00,090376,Sanchez; Antonio Luis,78,0,120,42
1653299782050,MAE 105,A00,090377,Saintillan; David,154,0,170,16
1653299782602,MAE 107,A00,090378,Lindsey; Stephanie,104,0,110,6
1653299782602,MAE 107,B00,090379,Tolley; Michael Thomas,85,0,110,25
1653299783126,MAE 118,A00,090380,Krasheninnikov; Sergei,27,0,45,18
1653299783650,MAE 131A,A00,090381,Ghazinejad; Maziar,70,0,75,5
1653299784174,MAE 133,A00,090382,Frazier; Michael,26,0,33,7
1653299784703,MAE 143A,A00,090383,de Oliveira; Mauricio,74,0,100,26
1653299785229,MAE 144,A00,090384,Bewley; Thomas R,50,0,70,20
1653299785752,MAE 148,A01,091597,Staff,32,0,32,0
1653299786280,MAE 150,A00,090385,Friend; James Robert,69,0,90,21
1653299786280,MAE 150,B00,090386,Ghazinejad; Maziar,4,0,90,86
1653299786804,MAE 152,A00,090387,Tynan; George Robert,0,0,16,16
1653299786804,MAE 152,B00,090388,Tynan; George Robert,0,0,16,16
1653299786804,MAE 152,C00,090389,Tynan; George Robert,0,0,16,16
1653299786804,MAE 152,D00,090390,Tynan; George Robert,0,0,16,16
1653299787328,MAE 156A,A01,090392,Delson; Nathan Joseph,2,0,12,10
1653299787328,MAE 156A,A02,090393,Delson; Nathan Joseph,1,0,12,11
1653299787328,MAE 156A,A03,090394,Delson; Nathan Joseph,4,0,12,8
1653299787858,MAE 170,A01,090396,Lubarda; Marko,14,0,30,16
1653299787858,MAE 170,A02,090397,Lubarda; Marko,19,0,30,11
1653299787858,MAE 170,A03,090398,Lubarda; Marko,28,0,30,2
1653299787858,MAE 170,A04,090399,Lubarda; Marko,20,0,30,10
1653299787858,MAE 170,B01,090401,Diagne; Mamadou Lamine,30,0,30,0
1653299787858,MAE 170,B02,090402,Diagne; Mamadou Lamine,27,0,30,3
1653299787858,MAE 170,B03,090403,Diagne; Mamadou Lamine,28,0,30,2
1653299787858,MAE 170,B04,090404,Diagne; Mamadou Lamine,28,0,30,2
1653299788408,MAE 180A,A00,090405,McEneaney; William Michael,110,0,125,15
1653299788930,MAE 181,A00,090406,Bahadori; Mohammad Yousef,46,0,60,14
1653299789454,MAE 190,A00,090407,Anderson; Mark Ronald,27,0,45,18
1653299789988,MAE 191,A01,090409,Qi; Huihui,25,0,32,7
1653299790525,MATH 2,A01,089123,Hammock; Frances H,0,0,0,0
1653299790525,MATH 2,B01,089126,Hammock; Frances H,0,0,0,0
1653299790525,MATH 2,C01,089129,Hammock; Frances H,0,0,0,0
1653299790525,MATH 2,D01,094201,Harel; Guershon,0,0,0,0
1653299791061,MATH 3C,A01,089132,Bowers; Adam R.,0,0,0,0
1653299791061,MATH 3C,A02,089133,Bowers; Adam R.,0,0,0,0
1653299791061,MATH 3C,A03,089134,Bowers; Adam R.,0,0,0,0
1653299791061,MATH 3C,A04,089135,Bowers; Adam R.,0,0,0,0
1653299791061,MATH 3C,A05,089136,Bowers; Adam R.,0,0,0,0
1653299791061,MATH 3C,A06,089137,Bowers; Adam R.,0,0,0,0
1653299791061,MATH 3C,A07,089138,Bowers; Adam R.,0,0,0,0
1653299791061,MATH 3C,A08,089139,Bowers; Adam R.,0,0,0,0
1653299791061,MATH 3C,A09,089140,Bowers; Adam R.,0,0,0,0
1653299791061,MATH 3C,A10,089141,Bowers; Adam R.,0,0,0,0
1653299791061,MATH 3C,A11,089142,Bowers; Adam R.,0,0,0,0
1653299791061,MATH 3C,A12,089143,Bowers; Adam R.,0,0,0,0
1653299791061,MATH 3C,A13,089144,Bowers; Adam R.,0,0,0,0
1653299791061,MATH 3C,A14,089145,Bowers; Adam R.,0,0,0,0
1653299791061,MATH 3C,A15,089146,Bowers; Adam R.,0,0,0,0
1653299791061,MATH 3C,A16,089147,Bowers; Adam R.,0,0,0,0
1653299791061,MATH 3C,A17,089148,Bowers; Adam R.,0,0,0,0
1653299791061,MATH 3C,A18,089149,Bowers; Adam R.,0,0,0,0
1653299791061,MATH 3C,A19,089150,Bowers; Adam R.,0,0,0,0
1653299791061,MATH 3C,A20,089151,Bowers; Adam R.,0,0,0,0
1653299791061,MATH 3C,A21,089152,Bowers; Adam R.,0,0,0,0
1653299791061,MATH 3C,A22,089153,Bowers; Adam R.,0,0,0,0
1653299791061,MATH 3C,A23,089154,Bowers; Adam R.,0,0,0,0
1653299791061,MATH 3C,A24,089155,Bowers; Adam R.,0,0,0,0
1653299791061,MATH 3C,B01,089158,Staff,0,0,0,0
1653299791061,MATH 3C,B02,089159,Staff,0,0,0,0
1653299791061,MATH 3C,B03,089160,Staff,0,0,0,0
1653299791061,MATH 3C,B04,089161,Staff,0,0,0,0
1653299791061,MATH 3C,C01,094244,Staff,0,0,0,0
1653299791061,MATH 3C,C02,094245,Staff,0,0,0,0
1653299791061,MATH 3C,C03,094246,Staff,0,0,0,0
1653299791061,MATH 3C,C04,094247,Staff,0,0,0,0
1653299791595,MATH 4C,A01,089164,Staff,0,0,0,0
1653299791595,MATH 4C,A02,089165,Staff,0,0,0,0
1653299791595,MATH 4C,A03,089166,Staff,0,0,0,0
1653299791595,MATH 4C,B01,089169,Ganzberger; Geoffrey Michael,0,0,0,0
1653299791595,MATH 4C,B02,089170,Ganzberger; Geoffrey Michael,0,0,0,0
1653299791595,MATH 4C,B03,089171,Ganzberger; Geoffrey Michael,0,0,0,0
1653299791595,MATH 4C,C01,089174,Ganzberger; Geoffrey Michael,0,0,0,0
1653299791595,MATH 4C,C02,089175,Ganzberger; Geoffrey Michael,0,0,0,0
1653299791595,MATH 4C,C03,089176,Ganzberger; Geoffrey Michael,0,0,0,0
1653299791595,MATH 4C,D01,094249,Ganzberger; Geoffrey Michael,0,0,0,0
1653299791595,MATH 4C,D02,094250,Ganzberger; Geoffrey Michael,0,0,0,0
1653299791595,MATH 4C,D03,094251,Ganzberger; Geoffrey Michael,0,0,0,0
1653299792249,MATH 10A,A01,089179,Jin; Muzhi,5,0,5,0
1653299792249,MATH 10A,A02,089180,Jin; Muzhi,5,0,5,0
1653299792249,MATH 10A,A03,089181,Jin; Muzhi,4,0,5,1
1653299792249,MATH 10A,A04,089182,Jin; Muzhi,4,0,5,1
1653299792249,MATH 10A,A05,089183,Jin; Muzhi,5,0,5,0
1653299792249,MATH 10A,A06,089184,Jin; Muzhi,5,0,5,0
1653299792249,MATH 10A,A07,089185,Jin; Muzhi,5,0,5,0
1653299792249,MATH 10A,A08,089186,Jin; Muzhi,5,0,5,0
1653299792249,MATH 10A,B01,089188,Stevens; Laura Jeanne,1,0,5,4
1653299792249,MATH 10A,B02,089189,Stevens; Laura Jeanne,4,0,5,1
1653299792249,MATH 10A,B03,089190,Stevens; Laura Jeanne,4,0,5,1
1653299792249,MATH 10A,B04,089191,Stevens; Laura Jeanne,5,0,5,0
1653299792249,MATH 10A,B05,089192,Stevens; Laura Jeanne,4,0,5,1
1653299792249,MATH 10A,B06,089193,Stevens; Laura Jeanne,5,0,5,0
1653299792249,MATH 10A,B07,089194,Stevens; Laura Jeanne,5,0,5,0
1653299792249,MATH 10A,B08,089195,Stevens; Laura Jeanne,4,0,5,1
1653299792249,MATH 10A,C01,089197,Jin; Muzhi,1,0,5,4
1653299792249,MATH 10A,C02,089198,Jin; Muzhi,5,0,5,0
1653299792249,MATH 10A,C03,089199,Jin; Muzhi,5,0,5,0
1653299792249,MATH 10A,C04,089200,Jin; Muzhi,5,0,5,0
1653299792249,MATH 10A,C05,089201,Jin; Muzhi,5,0,5,0
1653299792249,MATH 10A,C06,089202,Jin; Muzhi,5,0,5,0
1653299792249,MATH 10A,D01,089204,Upton; James Thomas,4,0,5,1
1653299792249,MATH 10A,D02,089205,Upton; James Thomas,5,0,5,0
1653299792249,MATH 10A,D03,089206,Upton; James Thomas,5,0,5,0
1653299792249,MATH 10A,D04,089207,Upton; James Thomas,5,0,5,0
1653299792249,MATH 10A,E01,089211,Greenfeld; Be'Eri,5,0,5,0
1653299792249,MATH 10A,E02,089212,Greenfeld; Be'Eri,3,0,5,2
1653299792249,MATH 10A,E03,089213,Greenfeld; Be'Eri,4,0,5,1
1653299792249,MATH 10A,E04,089214,Greenfeld; Be'Eri,5,0,5,0
1653299792249,MATH 10A,E05,089215,Greenfeld; Be'Eri,5,0,5,0
1653299792249,MATH 10A,E06,089216,Greenfeld; Be'Eri,5,0,5,0
1653299792784,MATH 10B,A01,089218,Stevens; Laura Jeanne,7,0,8,1
1653299792784,MATH 10B,A02,089219,Stevens; Laura Jeanne,7,0,8,1
1653299792784,MATH 10B,A03,089220,Stevens; Laura Jeanne,8,0,8,0
1653299792784,MATH 10B,A04,089221,Stevens; Laura Jeanne,6,0,8,2
1653299792784,MATH 10B,A05,089222,Stevens; Laura Jeanne,2,0,8,6
1653299792784,MATH 10B,A06,089223,Stevens; Laura Jeanne,0,0,8,8
1653299792784,MATH 10B,A07,089224,Stevens; Laura Jeanne,6,0,8,2
1653299792784,MATH 10B,A08,089225,Stevens; Laura Jeanne,4,0,8,4
1653299792784,MATH 10B,B01,089227,Staff,8,0,8,0
1653299792784,MATH 10B,B02,089228,Staff,8,0,8,0
1653299792784,MATH 10B,B03,089229,Staff,7,0,8,1
1653299792784,MATH 10B,B04,089230,Staff,8,0,8,0
1653299792784,MATH 10B,B05,089231,Staff,8,0,8,0
1653299792784,MATH 10B,B06,089232,Staff,8,0,8,0
1653299792784,MATH 10B,B07,089233,Staff,8,0,8,0
1653299792784,MATH 10B,B08,089234,Staff,8,0,8,0
1653299792784,MATH 10B,C01,089236,McKinley; Gweneth Anne,4,0,8,4
1653299792784,MATH 10B,C02,089237,McKinley; Gweneth Anne,8,0,8,0
1653299792784,MATH 10B,C03,089238,McKinley; Gweneth Anne,8,0,8,0
1653299792784,MATH 10B,C04,089239,McKinley; Gweneth Anne,8,0,8,0
1653299792784,MATH 10B,C05,089240,McKinley; Gweneth Anne,8,0,8,0
1653299792784,MATH 10B,C06,089241,McKinley; Gweneth Anne,8,0,8,0
1653299793311,MATH 10C,A01,089243,Staff,13,0,20,7
1653299793311,MATH 10C,A02,089244,Staff,20,0,20,0
1653299793311,MATH 10C,A03,089245,Staff,18,0,20,2
1653299793311,MATH 10C,A04,089246,Staff,20,0,20,0
1653299793311,MATH 10C,A05,089247,Staff,19,0,20,1
1653299793311,MATH 10C,A06,089248,Staff,20,0,20,0
1653299793311,MATH 10C,A07,094505,Staff,20,0,20,0
1653299793311,MATH 10C,A08,094506,Staff,20,0,20,0
1653299793311,MATH 10C,B01,089250,Staff,19,0,20,1
1653299793311,MATH 10C,B02,089251,Staff,19,0,20,1
1653299793311,MATH 10C,B03,089252,Staff,14,0,20,6
1653299793311,MATH 10C,B04,089253,Staff,20,0,20,0
1653299793311,MATH 10C,B05,089254,Staff,20,0,20,0
1653299793311,MATH 10C,B06,089255,Staff,18,0,20,2
1653299793856,MATH 11,A01,089258,Rava; Denise,1,0,15,14
1653299793856,MATH 11,A02,089260,Rava; Denise,9,0,15,6
1653299793856,MATH 11,A03,089263,Rava; Denise,10,0,15,5
1653299793856,MATH 11,A04,089265,Rava; Denise,13,0,15,2
1653299793856,MATH 11,A05,089267,Rava; Denise,10,0,15,5
1653299793856,MATH 11,A06,089269,Rava; Denise,14,0,15,1
1653299793856,MATH 11,A07,089271,Rava; Denise,14,0,15,1
1653299793856,MATH 11,A08,089273,Rava; Denise,13,0,15,2
1653299793856,MATH 11,B01,089279,Staff,4,0,15,11
1653299793856,MATH 11,B02,089281,Staff,14,0,15,1
1653299793856,MATH 11,B03,089283,Staff,14,0,15,1
1653299793856,MATH 11,B04,089284,Staff,15,0,15,0
1653299793856,MATH 11,B05,089286,Staff,14,0,15,1
1653299793856,MATH 11,B06,089288,Staff,15,0,15,0
1653299793856,MATH 11,B07,089289,Staff,14,0,15,1
1653299793856,MATH 11,B08,089290,Staff,14,0,15,1
1653299794389,MATH 18,A01,089303,Anzaldo; Leesa B,5,0,10,5
1653299794389,MATH 18,A02,089304,Anzaldo; Leesa B,6,0,10,4
1653299794389,MATH 18,A03,089305,Anzaldo; Leesa B,10,0,10,0
1653299794389,MATH 18,A04,089306,Anzaldo; Leesa B,8,0,10,2
1653299794389,MATH 18,A05,089307,Anzaldo; Leesa B,10,0,10,0
1653299794389,MATH 18,A06,089308,Anzaldo; Leesa B,9,0,10,1
1653299794389,MATH 18,A07,089309,Anzaldo; Leesa B,10,0,10,0
1653299794389,MATH 18,A08,089310,Anzaldo; Leesa B,10,0,10,0
1653299794389,MATH 18,A09,089311,Anzaldo; Leesa B,10,0,10,0
1653299794389,MATH 18,A10,089312,Anzaldo; Leesa B,10,0,10,0
1653299794389,MATH 18,A11,089313,Anzaldo; Leesa B,9,0,10,1
1653299794389,MATH 18,A12,089314,Anzaldo; Leesa B,10,0,10,0
1653299794389,MATH 18,A13,089315,Anzaldo; Leesa B,9,0,10,1
1653299794389,MATH 18,A14,089316,Anzaldo; Leesa B,10,0,10,0
1653299794389,MATH 18,A15,089317,Anzaldo; Leesa B,9,0,10,1
1653299794389,MATH 18,A16,089318,Anzaldo; Leesa B,10,0,10,0
1653299794389,MATH 18,A17,089319,Anzaldo; Leesa B,9,0,10,1
1653299794389,MATH 18,A18,089320,Anzaldo; Leesa B,10,0,10,0
1653299794389,MATH 18,A19,089321,Anzaldo; Leesa B,0,0,0,0
1653299794389,MATH 18,A20,089322,Anzaldo; Leesa B,0,0,0,0
1653299794389,MATH 18,A21,089323,Anzaldo; Leesa B,9,0,10,1
1653299794389,MATH 18,A22,089324,Anzaldo; Leesa B,7,0,10,3
1653299794389,MATH 18,A23,089325,Anzaldo; Leesa B,10,0,10,0
1653299794389,MATH 18,A24,089326,Anzaldo; Leesa B,9,0,10,1
1653299794389,MATH 18,B01,089329,Staff,13,0,13,0
1653299794389,MATH 18,B02,089330,Staff,12,0,13,1
1653299794389,MATH 18,B03,089331,Staff,12,0,13,1
1653299794389,MATH 18,B04,089332,Staff,13,0,13,0
1653299794389,MATH 18,B05,089333,Staff,12,0,13,1
1653299794389,MATH 18,C01,089336,Staff,13,0,13,0
1653299794389,MATH 18,C02,089337,Staff,11,0,13,2
1653299794389,MATH 18,C03,089338,Staff,0,0,0,0
1653299794389,MATH 18,C04,089339,Staff,0,0,0,0
1653299794389,MATH 18,C05,089340,Staff,0,0,0,1
1653299794389,MATH 18,D01,094194,Staff,0,0,0,0
1653299794389,MATH 18,D02,094195,Staff,0,0,0,0
1653299794389,MATH 18,D03,094196,Staff,0,0,0,0
1653299794389,MATH 18,D04,094197,Staff,0,0,0,0
1653299794389,MATH 18,D05,094198,Staff,0,0,0,0
1653299794925,MATH 20A,A01,089343,Staff,5,0,5,0
1653299794925,MATH 20A,A02,089344,Staff,5,0,5,0
1653299794925,MATH 20A,A03,089345,Staff,5,0,5,0
1653299794925,MATH 20A,B01,089347,Suk; Andrew Hoon,2,0,3,1
1653299794925,MATH 20A,B02,089348,Suk; Andrew Hoon,3,0,3,0
1653299794925,MATH 20A,B03,089349,Suk; Andrew Hoon,3,0,3,0
1653299794925,MATH 20A,B04,089350,Suk; Andrew Hoon,3,0,3,0
1653299794925,MATH 20A,B05,089351,Suk; Andrew Hoon,3,0,3,0
1653299794925,MATH 20A,B06,089352,Suk; Andrew Hoon,2,0,3,1
1653299794925,MATH 20A,B07,089353,Suk; Andrew Hoon,3,0,3,0
1653299794925,MATH 20A,B08,089354,Suk; Andrew Hoon,3,0,3,0
1653299794925,MATH 20A,B09,089355,Suk; Andrew Hoon,3,0,3,0
1653299794925,MATH 20A,B10,089356,Suk; Andrew Hoon,3,0,3,0
1653299794925,MATH 20A,B11,089357,Suk; Andrew Hoon,3,0,3,0
1653299794925,MATH 20A,B12,089358,Suk; Andrew Hoon,3,0,3,0
1653299794925,MATH 20A,B13,089359,Suk; Andrew Hoon,2,0,3,1
1653299794925,MATH 20A,B14,089360,Suk; Andrew Hoon,3,0,3,0
1653299794925,MATH 20A,B15,089361,Suk; Andrew Hoon,3,0,3,0
1653299794925,MATH 20A,B16,089362,Suk; Andrew Hoon,3,0,3,0
1653299794925,MATH 20A,B17,089363,Suk; Andrew Hoon,3,0,3,0
1653299794925,MATH 20A,B18,089364,Suk; Andrew Hoon,0,0,0,0
1653299794925,MATH 20A,B19,089365,Suk; Andrew Hoon,3,0,3,0
1653299794925,MATH 20A,B20,089366,Suk; Andrew Hoon,3,0,3,0
1653299794925,MATH 20A,B21,089367,Suk; Andrew Hoon,3,0,3,0
1653299794925,MATH 20A,B22,089368,Suk; Andrew Hoon,3,0,3,0
1653299794925,MATH 20A,B23,089369,Suk; Andrew Hoon,3,0,3,0
1653299794925,MATH 20A,B24,089370,Suk; Andrew Hoon,3,0,3,0
1653299795454,MATH 20B,A01,089372,Quarfoot; David James,8,0,8,0
1653299795454,MATH 20B,A02,089373,Quarfoot; David James,8,0,8,0
1653299795454,MATH 20B,A03,089374,Quarfoot; David James,7,0,8,1
1653299795454,MATH 20B,A04,089375,Quarfoot; David James,7,0,8,1
1653299795454,MATH 20B,A05,089376,Quarfoot; David James,0,0,0,0
1653299795454,MATH 20B,A06,089377,Quarfoot; David James,0,0,0,0
1653299795454,MATH 20B,A07,089378,Quarfoot; David James,0,0,0,0
1653299795454,MATH 20B,A08,089379,Quarfoot; David James,0,0,0,0
1653299795454,MATH 20B,A09,089380,Quarfoot; David James,0,0,0,0
1653299795454,MATH 20B,A10,089381,Quarfoot; David James,0,0,0,0
1653299795454,MATH 20B,A11,089382,Quarfoot; David James,0,0,0,0
1653299795454,MATH 20B,A12,089383,Quarfoot; David James,0,0,0,0
1653299795454,MATH 20B,A13,089384,Quarfoot; David James,0,0,0,0
1653299795454,MATH 20B,A14,089385,Quarfoot; David James,0,0,0,0
1653299795454,MATH 20B,A15,089386,Quarfoot; David James,0,0,0,0
1653299795454,MATH 20B,A16,089387,Quarfoot; David James,0,0,0,0
1653299795454,MATH 20B,A17,089388,Quarfoot; David James,8,0,8,0
1653299795454,MATH 20B,A18,089389,Quarfoot; David James,8,0,8,0
1653299795454,MATH 20B,A19,089390,Quarfoot; David James,8,0,8,0
1653299795454,MATH 20B,A20,089391,Quarfoot; David James,8,0,8,0
1653299795454,MATH 20B,A21,089392,Quarfoot; David James,8,0,8,0
1653299795454,MATH 20B,A22,089393,Quarfoot; David James,7,0,8,1
1653299795454,MATH 20B,A23,089394,Quarfoot; David James,7,0,8,1
1653299795454,MATH 20B,A24,089395,Quarfoot; David James,8,0,8,0
1653299795454,MATH 20B,B01,089397,Lahiri; Aranya,7,0,10,3
1653299795454,MATH 20B,B02,089398,Lahiri; Aranya,10,0,10,0
1653299795454,MATH 20B,B03,089399,Lahiri; Aranya,10,0,10,0
1653299795454,MATH 20B,B04,089400,Lahiri; Aranya,10,0,10,0
1653299795454,MATH 20B,B05,089401,Lahiri; Aranya,10,0,10,0
1653299795454,MATH 20B,C01,089403,Lahiri; Aranya,0,0,0,0
1653299795454,MATH 20B,C02,089404,Lahiri; Aranya,8,0,10,2
1653299795454,MATH 20B,C03,089405,Lahiri; Aranya,10,0,10,0
1653299795454,MATH 20B,C04,089406,Lahiri; Aranya,9,0,10,1
1653299795454,MATH 20B,C05,089407,Lahiri; Aranya,9,0,10,1
1653299795987,MATH 20C,A01,089409,Um; Ko Woon,10,0,10,0
1653299795987,MATH 20C,A02,089410,Um; Ko Woon,10,0,10,0
1653299795987,MATH 20C,A03,089411,Um; Ko Woon,9,0,10,1
1653299795987,MATH 20C,A04,089412,Um; Ko Woon,9,0,10,1
1653299795987,MATH 20C,A05,089413,Um; Ko Woon,10,0,10,0
1653299795987,MATH 20C,A06,089414,Um; Ko Woon,9,0,10,1
1653299795987,MATH 20C,A07,094270,Um; Ko Woon,10,0,10,0
1653299795987,MATH 20C,A08,094271,Um; Ko Woon,10,0,10,0
1653299795987,MATH 20C,A09,094272,Um; Ko Woon,7,0,10,3
1653299795987,MATH 20C,A10,094273,Um; Ko Woon,10,0,10,0
1653299795987,MATH 20C,A11,094274,Um; Ko Woon,10,0,10,0
1653299795987,MATH 20C,A12,094275,Um; Ko Woon,8,0,10,2
1653299795987,MATH 20C,A13,094276,Um; Ko Woon,10,0,10,0
1653299795987,MATH 20C,A14,094277,Um; Ko Woon,10,0,10,0
1653299795987,MATH 20C,A15,094278,Um; Ko Woon,10,0,10,0
1653299795987,MATH 20C,A16,094279,Um; Ko Woon,10,0,10,0
1653299795987,MATH 20C,B03,089418,Zhang; Ming,7,0,15,8
1653299795987,MATH 20C,B04,089419,Zhang; Ming,13,0,15,2
1653299795987,MATH 20C,B05,089420,Zhang; Ming,13,0,15,2
1653299795987,MATH 20C,C01,089423,Staff,15,0,15,0
1653299795987,MATH 20C,C02,089424,Staff,15,0,15,0
1653299795987,MATH 20C,C03,089425,Staff,15,0,15,0
1653299795987,MATH 20C,C04,089426,Staff,15,0,15,0
1653299795987,MATH 20C,C05,089427,Staff,15,0,15,0
1653299795987,MATH 20C,D04,089433,Zhang; Ming,13,0,15,2
1653299795987,MATH 20C,D05,089434,Zhang; Ming,15,0,15,0
1653299795987,MATH 20C,E01,089439,Staff,15,0,15,0
1653299795987,MATH 20C,E02,089440,Staff,15,0,15,0
1653299795987,MATH 20C,E03,089441,Staff,15,0,15,0
1653299795987,MATH 20C,E04,089442,Staff,15,0,15,0
1653299795987,MATH 20C,E05,089443,Staff,15,0,15,0
1653299795987,MATH 20C,E06,089444,Staff,15,0,15,0
1653299795987,MATH 20C,A17,094280,Um; Ko Woon,0,0,0,0
1653299795987,MATH 20C,A18,094281,Um; Ko Woon,0,0,0,0
1653299795987,MATH 20C,A19,094282,Um; Ko Woon,0,0,0,0
1653299795987,MATH 20C,A20,094283,Um; Ko Woon,0,0,0,0
1653299795987,MATH 20C,A21,094284,Um; Ko Woon,0,0,0,0
1653299795987,MATH 20C,A22,094285,Um; Ko Woon,0,0,0,0
1653299795987,MATH 20C,A23,094286,Um; Ko Woon,0,0,0,0
1653299795987,MATH 20C,A24,094287,Um; Ko Woon,0,0,0,0
1653299795987,MATH 20C,B01,089416,Zhang; Ming,0,0,0,0
1653299795987,MATH 20C,B02,089417,Zhang; Ming,0,0,0,0
1653299795987,MATH 20C,D01,089430,Zhang; Ming,0,0,0,0
1653299795987,MATH 20C,D02,089431,Zhang; Ming,0,0,0,0
1653299795987,MATH 20C,D03,089432,Zhang; Ming,0,0,0,0
1653299796513,MATH 20D,A01,089455,Lee; Kisun,11,0,25,14
1653299796513,MATH 20D,A02,089456,Lee; Kisun,24,0,25,1
1653299796513,MATH 20D,A03,089457,Lee; Kisun,24,0,25,1
1653299796513,MATH 20D,A04,089458,Lee; Kisun,25,0,25,0
1653299796513,MATH 20D,A05,089459,Lee; Kisun,25,0,25,0
1653299796513,MATH 20D,A06,089460,Lee; Kisun,25,0,25,0
1653299796513,MATH 20D,B01,089463,Lee; Kisun,20,0,25,5
1653299796513,MATH 20D,B02,089464,Lee; Kisun,25,0,25,0
1653299796513,MATH 20D,B03,089465,Lee; Kisun,24,0,25,1
1653299796513,MATH 20D,B04,089466,Lee; Kisun,25,0,25,0
1653299796513,MATH 20D,B05,089467,Lee; Kisun,23,0,25,2
1653299796513,MATH 20D,B06,089468,Lee; Kisun,24,0,25,1
1653299796513,MATH 20D,C01,089471,Staff,23,0,25,2
1653299796513,MATH 20D,C02,089472,Staff,25,0,25,0
1653299796513,MATH 20D,C03,089473,Staff,25,0,25,0
1653299796513,MATH 20D,C04,089474,Staff,25,0,25,0
1653299796513,MATH 20D,C05,089475,Staff,25,0,25,0
1653299796513,MATH 20D,C06,089476,Staff,25,0,25,0
1653299797037,MATH 20E,A01,089479,Eggers; John Dietrich,17,0,24,7
1653299797037,MATH 20E,A02,089480,Eggers; John Dietrich,24,0,25,1
1653299797037,MATH 20E,A03,089481,Eggers; John Dietrich,25,0,25,0
1653299797037,MATH 20E,A04,089482,Eggers; John Dietrich,25,0,25,0
1653299797037,MATH 20E,A05,089483,Eggers; John Dietrich,19,0,25,6
1653299797037,MATH 20E,A06,089484,Eggers; John Dietrich,25,0,25,0
1653299797037,MATH 20E,A07,089485,Eggers; John Dietrich,24,0,25,1
1653299797037,MATH 20E,A08,089486,Eggers; John Dietrich,24,0,25,1
1653299797037,MATH 20E,B01,089488,Staff,15,0,25,10
1653299797037,MATH 20E,B02,089489,Staff,21,0,25,4
1653299797037,MATH 20E,B03,089490,Staff,25,0,25,0
1653299797037,MATH 20E,B04,089491,Staff,25,0,25,0
1653299797037,MATH 20E,B05,089492,Staff,24,0,25,1
1653299797037,MATH 20E,B06,089493,Staff,24,0,25,1
1653299797037,MATH 20E,B07,089494,Staff,25,0,25,0
1653299797037,MATH 20E,B08,089495,Staff,25,0,25,0
1653299797037,MATH 20E,C01,089497,Staff,23,0,25,2
1653299797037,MATH 20E,C02,089498,Staff,25,0,25,0
1653299797037,MATH 20E,C03,089499,Staff,25,0,25,0
1653299797037,MATH 20E,C04,089500,Staff,25,0,25,0
1653299797037,MATH 20E,C05,089501,Staff,25,0,25,0
1653299797037,MATH 20E,C06,089502,Staff,25,0,25,0
1653299797037,MATH 20E,C07,089503,Staff,25,0,25,0
1653299797037,MATH 20E,C08,089504,Staff,25,0,25,0
1653299797560,MATH 31AH,A01,089506,Rabin; Jeffrey Mark,35,0,35,0
1653299797560,MATH 31AH,A02,089507,Rabin; Jeffrey Mark,35,0,35,0
1653299798085,MATH 87,A00,094827,Meyer; David A.,20,0,20,0
1653299798611,MATH 96,A00,094836,Kane; Daniel Mertz,11,0,30,19
1653299799134,MATH 100A,A01,089509,Kedlaya; Kiran S.,23,0,30,7
1653299799134,MATH 100A,A02,089510,Kedlaya; Kiran S.,28,0,30,2
1653299799134,MATH 100A,B01,089512,Greenfeld; Be'Eri,24,0,30,6
1653299799134,MATH 100A,B02,089513,Greenfeld; Be'Eri,30,0,30,0
1653299799659,MATH 102,A01,089515,Hodges; Reuven Moses,25,0,30,5
1653299799659,MATH 102,A02,089516,Hodges; Reuven Moses,30,0,30,0
1653299799659,MATH 102,A03,089517,Hodges; Reuven Moses,30,0,30,0
1653299799659,MATH 102,A04,089518,Hodges; Reuven Moses,29,0,30,1
1653299799659,MATH 102,B01,089520,Hodges; Reuven Moses,29,0,30,1
1653299799659,MATH 102,B02,089521,Hodges; Reuven Moses,29,0,30,1
1653299799659,MATH 102,B03,089522,Hodges; Reuven Moses,29,0,30,1
1653299799659,MATH 102,B04,089523,Hodges; Reuven Moses,30,0,30,0
1653299800183,MATH 103A,A01,089525,Staff,27,0,30,3
1653299800183,MATH 103A,A02,089526,Staff,30,0,30,0
1653299800183,MATH 103A,B01,089528,Seward; Brandon M.,9,0,30,21
1653299800183,MATH 103A,B02,089529,Seward; Brandon M.,22,0,30,8
1653299800183,MATH 103A,C01,089531,Staff,27,0,30,3
1653299800183,MATH 103A,C02,089532,Staff,28,0,30,2
1653299800183,MATH 103A,D01,089534,Staff,28,0,30,2
1653299800183,MATH 103A,D02,089535,Staff,28,0,30,2
1653299800710,MATH 109,A01,089537,Chung; Kwun,9,0,10,1
1653299800710,MATH 109,A02,089538,Chung; Kwun,10,0,10,0
1653299800710,MATH 109,B01,089540,Belmont; Eva Kinoshita,9,0,10,1
1653299800710,MATH 109,B02,089541,Belmont; Eva Kinoshita,6,0,10,4
1653299800710,MATH 109,C01,089543,Chow; Bennett,8,0,10,2
1653299800710,MATH 109,C02,089544,Chow; Bennett,10,0,10,0
1653299800710,MATH 109,D01,089546,Chung; Kwun,9,0,10,1
1653299800710,MATH 109,D02,089547,Chung; Kwun,9,0,10,1
1653299800710,MATH 109,E01,089549,Schweinsberg; Jason,6,0,10,4
1653299800710,MATH 109,E02,089550,Schweinsberg; Jason,10,0,10,0
1653299801250,MATH 110,A01,089552,Wenzl; Hans G,27,0,35,8
1653299801250,MATH 110,A02,089553,Wenzl; Hans G,33,0,35,2
1653299801774,MATH 111A,A01,089555,Meyer; David A.,0,0,0,1
1653299802298,MATH 120A,A01,089557,Manners; Frederick,30,0,35,5
1653299802298,MATH 120A,A02,089558,Manners; Frederick,33,0,35,2
1653299802823,MATH 140A,A01,089560,Seward; Brandon M.,25,0,30,5
1653299802823,MATH 140A,A02,089561,Seward; Brandon M.,29,0,30,1
1653299802823,MATH 140A,B01,089563,Chan; Pak Yeung,30,0,30,0
1653299802823,MATH 140A,B02,089564,Chan; Pak Yeung,22,0,30,8
1653299803348,MATH 142A,A01,089566,Staff,29,0,30,1
1653299803348,MATH 142A,A02,089567,Staff,29,0,30,1
1653299803348,MATH 142A,B01,089569,Staff,30,0,30,0
1653299803348,MATH 142A,B02,089570,Staff,29,0,30,1
1653299803348,MATH 142A,C01,089572,Staff,26,0,30,4
1653299803348,MATH 142A,C02,089573,Staff,29,0,30,1
1653299803348,MATH 142A,D01,089575,Eggers; John Dietrich,15,0,30,15
1653299803348,MATH 142A,D02,089576,Eggers; John Dietrich,27,0,30,3
1653299803871,MATH 144,A01,089578,Bejenaru; Ioan,29,0,30,1
1653299804393,MATH 150A,A01,089580,Chow; Bennett,29,0,35,6
1653299804393,MATH 150A,A02,089581,Chow; Bennett,34,0,35,1
1653299805456,MATH 153,A01,094204,Harel; Guershon,33,0,35,2
1653299805992,MATH 154,A01,089590,Verstraete; Jacques Allan,3,0,30,27
1653299805992,MATH 154,A02,089591,Verstraete; Jacques Allan,23,0,30,7
1653299805992,MATH 154,A03,089592,Verstraete; Jacques Allan,28,0,30,2
1653299805992,MATH 154,A04,089593,Verstraete; Jacques Allan,26,0,30,4
1653299806519,MATH 155A,A01,089595,Buss; Samuel R,22,0,35,13
1653299806519,MATH 155A,A02,089596,Buss; Samuel R,32,0,35,3
1653299807061,MATH 160A,A01,089598,Manners; Frederick,28,0,35,7
1653299807061,MATH 160A,A02,094207,Manners; Frederick,34,0,35,1
1653299807603,MATH 170A,A01,089600,Liu; Shuang,24,0,25,1
1653299807603,MATH 170A,A02,089601,Liu; Shuang,24,0,25,1
1653299807603,MATH 170A,A03,089602,Liu; Shuang,24,0,25,1
1653299807603,MATH 170A,A04,089603,Liu; Shuang,23,0,25,2
1653299807603,MATH 170A,B01,089605,Dumitriu; Ioana,8,0,25,17
1653299807603,MATH 170A,B02,089606,Dumitriu; Ioana,20,0,25,5
1653299807603,MATH 170A,B03,089607,Dumitriu; Ioana,21,0,25,4
1653299807603,MATH 170A,B04,089608,Dumitriu; Ioana,25,0,25,0
1653299808127,MATH 173A,A01,089610,Cloninger; Alexander,0,0,35,35
1653299808127,MATH 173A,A02,089611,Cloninger; Alexander,2,0,35,33
1653299808127,MATH 173A,A03,089612,Cloninger; Alexander,20,0,35,15
1653299808655,MATH 174,A01,089614,Cheng; Li-Tien,23,0,25,2
1653299808655,MATH 174,A02,089615,Cheng; Li-Tien,25,0,25,0
1653299809186,MATH 180A,A01,089617,Jekel; David Andrew,0,0,25,25
1653299809186,MATH 180A,A02,089618,Jekel; David Andrew,23,0,25,2
1653299809186,MATH 180A,A03,089619,Jekel; David Andrew,22,0,25,3
1653299809186,MATH 180A,A04,089620,Jekel; David Andrew,22,0,25,3
1653299809186,MATH 180A,A05,089621,Jekel; David Andrew,24,0,25,1
1653299809186,MATH 180A,A06,089622,Jekel; David Andrew,23,0,25,2
1653299809186,MATH 180A,B01,089624,Agarwal; Pooja,23,0,25,2
1653299809186,MATH 180A,B02,089625,Agarwal; Pooja,24,0,25,1
1653299809186,MATH 180A,B03,089626,Agarwal; Pooja,22,0,25,3
1653299809186,MATH 180A,B04,089627,Agarwal; Pooja,25,0,25,0
1653299809186,MATH 180A,B05,089628,Agarwal; Pooja,24,0,25,1
1653299809186,MATH 180A,B06,089629,Agarwal; Pooja,25,0,25,0
1653299809186,MATH 180A,C01,089631,Staff,22,0,25,3
1653299809186,MATH 180A,C02,089632,Staff,25,0,25,0
1653299809186,MATH 180A,C03,089633,Staff,25,0,25,0
1653299809186,MATH 180A,C04,089634,Staff,25,0,25,0
1653299809718,MATH 180C,A01,089636,Fitzsimmons; Patrick J,4,0,25,21
1653299809718,MATH 180C,A02,089637,Fitzsimmons; Patrick J,21,0,25,4
1653299810242,MATH 181B,A01,089639,Rava; Denise,31,0,35,4
1653299810242,MATH 181B,A02,089640,Rava; Denise,34,0,35,1
1653299810242,MATH 181B,A03,089641,Rava; Denise,31,0,35,4
1653299810242,MATH 181B,A04,089642,Rava; Denise,35,0,35,0
1653299810767,MATH 183,A01,089644,Staff,10,0,25,15
1653299810767,MATH 183,A02,089645,Staff,23,0,25,2
1653299810767,MATH 183,A03,089646,Staff,23,0,25,2
1653299810767,MATH 183,A04,089647,Staff,25,0,25,0
1653299810767,MATH 183,A05,089648,Staff,19,0,25,6
1653299810767,MATH 183,A06,089649,Staff,22,0,25,3
1653299810767,MATH 183,A07,089650,Staff,25,0,25,0
1653299810767,MATH 183,A08,089651,Staff,25,0,25,0
1653299811290,MATH 184,A01,089653,Kane; Daniel Mertz,24,0,30,6
1653299811290,MATH 184,A02,089654,Kane; Daniel Mertz,30,0,30,0
1653299811290,MATH 184,A03,089655,Kane; Daniel Mertz,30,0,30,0
1653299811290,MATH 184,A04,089656,Kane; Daniel Mertz,30,0,30,0
1653299811818,MATH 187A,A01,089658,Bucur; Alina Ioana,0,0,25,25
1653299811818,MATH 187A,A02,089659,Bucur; Alina Ioana,12,0,25,13
1653299811818,MATH 187A,A03,089660,Bucur; Alina Ioana,0,0,25,25
1653299811818,MATH 187A,A04,089661,Bucur; Alina Ioana,17,0,25,8
1653299812342,MATH 187B,A01,089663,Bucur; Alina Ioana,28,0,35,7
1653299812342,MATH 187B,A02,089664,Bucur; Alina Ioana,34,0,35,1
1653299812870,MATH 188,A01,094817,Sam; Steven V,33,0,35,2
1653299813404,MATH 190A,A01,089666,Sam; Steven V,21,0,35,14
1653299813927,MATH 196,A00,089667,Spolaor; Luca,33,0,45,12
1653299814457,MCWP 40,004,093486,Wastal; Carrie King,0,0,3,3
1653299814457,MCWP 40,005,093487,Wastal; Carrie King,0,0,3,3
1653299814457,MCWP 40,006,093488,Wastal; Carrie King,3,0,3,0
1653299814457,MCWP 40,007,093489,Wastal; Carrie King,3,0,3,0
1653299814457,MCWP 40,008,093490,Wastal; Carrie King,2,0,3,1
1653299814457,MCWP 40,009,093491,Wastal; Carrie King,2,0,3,1
1653299814457,MCWP 40,013,093495,Wastal; Carrie King,3,0,3,0
1653299814457,MCWP 40,014,093496,Wastal; Carrie King,0,0,3,3
1653299814457,MCWP 40,015,093497,Wastal; Carrie King,3,0,3,0
1653299814457,MCWP 40,016,093498,Wastal; Carrie King,3,0,3,0
1653299814457,MCWP 40,017,093499,Wastal; Carrie King,3,0,3,0
1653299814457,MCWP 40,018,093500,Wastal; Carrie King,1,0,3,2
1653299814457,MCWP 40,020,093502,Wastal; Carrie King,0,0,0,0
1653299814457,MCWP 40,021,093503,Wastal; Carrie King,3,0,3,0
1653299814457,MCWP 40,022,093504,Wastal; Carrie King,2,0,3,1
1653299814457,MCWP 40,023,093505,Wastal; Carrie King,2,0,3,1
1653299814457,MCWP 40,024,093506,Wastal; Carrie King,2,0,3,1
1653299814457,MCWP 40,026,093508,Wastal; Carrie King,3,0,3,0
1653299814457,MCWP 40,027,093509,Wastal; Carrie King,3,0,3,0
1653299814457,MCWP 40,028,093510,Wastal; Carrie King,3,0,3,0
1653299814457,MCWP 40,029,093511,Wastal; Carrie King,3,0,3,0
1653299814457,MCWP 40,030,093512,Wastal; Carrie King,2,0,3,1
1653299814457,MCWP 40,032,093514,Wastal; Carrie King,2,0,3,1
1653299814457,MCWP 40,033,093515,Wastal; Carrie King,3,0,3,0
1653299814457,MCWP 40,034,093516,Wastal; Carrie King,3,0,3,0
1653299814457,MCWP 40,035,093517,Wastal; Carrie King,3,0,3,0
1653299814457,MCWP 40,038,093520,Wastal; Carrie King,2,0,3,1
1653299814457,MCWP 40,039,093521,Wastal; Carrie King,3,0,3,0
1653299814457,MCWP 40,041,093523,Wastal; Carrie King,2,0,3,1
1653299814457,MCWP 40,042,093524,Wastal; Carrie King,3,0,3,0
1653299814457,MCWP 40,043,093525,Wastal; Carrie King,0,0,0,0
1653299814457,MCWP 40,049,093531,Wastal; Carrie King,2,0,3,1
1653299814457,MCWP 40,050,093532,Wastal; Carrie King,3,0,3,0
1653299814457,MCWP 40,051,093533,Wastal; Carrie King,3,0,3,0
1653299814992,MCWP 50,001,093534,Wastal; Carrie King,0,0,0,0
1653299814992,MCWP 50,002,093535,Wastal; Carrie King,0,0,3,3
1653299814992,MCWP 50,003,093536,Wastal; Carrie King,0,0,3,3
1653299814992,MCWP 50,004,093537,Wastal; Carrie King,0,0,3,3
1653299814992,MCWP 50,005,093538,Wastal; Carrie King,0,0,3,3
1653299814992,MCWP 50,006,093539,Wastal; Carrie King,2,0,3,1
1653299814992,MCWP 50,007,093540,Wastal; Carrie King,0,0,3,3
1653299814992,MCWP 50,008,093541,Wastal; Carrie King,0,0,3,3
1653299814992,MCWP 50,009,093542,Wastal; Carrie King,0,0,3,3
1653299814992,MCWP 50,010,093543,Wastal; Carrie King,0,0,3,3
1653299814992,MCWP 50,013,093546,Wastal; Carrie King,1,0,3,2
1653299814992,MCWP 50,014,093547,Wastal; Carrie King,0,0,3,3
1653299814992,MCWP 50,015,093548,Wastal; Carrie King,0,0,3,3
1653299814992,MCWP 50,016,093549,Wastal; Carrie King,0,0,0,0
1653299815518,MCWP 125,A00,093550,Wilson; Marion E.,3,0,3,0
1653299815518,MCWP 125,B00,093551,Guillen; Melinda,3,0,3,0
1653299815518,MCWP 125,C00,093552,Guillen; Melinda,3,0,3,0
1653299815518,MCWP 125,D00,093553,Guillen; Melinda,3,0,3,0
1653299815518,MCWP 125,E00,093554,Miller; Elizabeth Deen,3,0,3,0
1653299815518,MCWP 125,F00,093555,Miller; Elizabeth Deen,3,0,3,0
1653299815518,MCWP 125,G00,093556,Miller; Elizabeth Deen,3,0,3,0
1653299816047,MGT 3,A00,087704,Wagner; Timothy Ryan,90,0,90,0
1653299816571,MGT 4,A01,087706,Levkoff; Steven B.,2,0,3,1
1653299816571,MGT 4,A02,087707,Levkoff; Steven B.,3,0,3,0
1653299816571,MGT 4,A03,092659,Levkoff; Steven B.,1,0,4,3
1653299817095,MGT 5,A00,087708,Houskeeper; Robert,194,0,196,2
1653299817619,MGT 12,A00,087709,Pecore; Joseph P.,91,0,100,9
1653299817619,MGT 12,B00,087710,Lindenberger; Wade Douglas,91,0,100,9
1653299818145,MGT 16,A00,087711,Campbell; Robert Harold,108,0,110,2
1653299818145,MGT 16,B00,087712,Campbell; Robert Harold,110,0,110,0
1653299818145,MGT 16,C00,087713,Lindenberger; Wade Douglas,100,0,110,10
1653299818145,MGT 16,D00,087714,Lindenberger; Wade Douglas,107,0,110,3
1653299818145,MGT 16,E00,094819,Buchanan; Harold G,99,0,100,1
1653299818670,MGT 18,A00,087715,McKay; Michael J,88,0,90,2
1653299818670,MGT 18,B00,087716,McKay; Michael J,90,0,90,0
1653299818670,MGT 18,C00,087717,McKay; Michael J,88,0,90,2
1653299818670,MGT 18,D00,087718,McKay; Mary A,90,0,90,0
1653299818670,MGT 18,E00,087719,McKay; Mary A,87,0,90,3
1653299819197,MGT 45,A00,087720,Pecore; Joseph P.,136,0,150,14
1653299819197,MGT 45,B00,087721,Pecore; Joseph P.,140,0,150,10
1653299819723,MGT 52,A00,087722,Deal; Jennifer Jean,83,0,90,7
1653299820249,MGT 71,A00,087723,August; Terrence,60,0,90,30
1653299821302,MGT 103,A00,087726,Ehrich; Kristine R,86,0,90,4
1653299821302,MGT 103,B00,087727,Ehrich; Kristine R,89,0,90,1
1653299821302,MGT 103,C00,087728,Eberhard; Craig A,89,0,90,1
1653299821302,MGT 103,D00,087729,Eberhard; Craig A,88,0,90,2
1653299821302,MGT 103,E00,087730,Demill; Burritt,75,0,90,15
1653299821302,MGT 103,F00,087731,Bates; Kenneth Walter,81,0,90,9
1653299821302,MGT 103,G00,087732,Bates; Kenneth Walter,88,0,90,2
1653299821825,MGT 105,A00,087733,Campbell; Robert Harold,102,0,120,18
1653299822351,MGT 106,A00,087734,Eberhard; Craig A,81,0,90,9
1653299822879,MGT 108R,A00,087735,Amir; On,84,0,90,6
1653299823404,MGT 109,A00,087736,Staff,77,0,90,13
1653299823938,MGT 112,A00,087737,Somasundaram; Tyagarajan,89,0,90,1
1653299823938,MGT 112,B00,087738,Somasundaram; Tyagarajan,86,0,90,4
1653299823938,MGT 112,C00,087739,Ehrich; Kristine R,86,0,90,4
1653299823938,MGT 112,D00,087740,Zimmermann; Carsten,65,0,90,25
1653299824473,MGT 121A,A00,087741,Wang; Helen Shan,65,0,70,5
1653299824473,MGT 121A,B00,087742,Wang; Helen Shan,64,0,70,6
1653299825010,MGT 131A,A00,087743,Houskeeper; Robert,146,0,150,4
1653299825533,MGT 132,A00,087744,Blakley; Bruce,88,0,90,2
1653299826058,MGT 134,A00,087745,Houskeeper; Robert,84,0,90,6
1653299826585,MGT 135,A00,087746,Anderson; John Charles,83,0,90,7
1653299827112,MGT 139,A00,087747,Perols; Johan Lars,88,0,90,2
1653299827641,MGT 153,A00,087748,Perols; Johan Lars,82,0,90,8
1653299827641,MGT 153,B00,087749,Phiroz; Zal Navroze,76,0,90,14
1653299827641,MGT 153,C00,087750,Phiroz; Zal Navroze,87,0,90,3
1653299828166,MGT 162R,A00,087751,Gneezy; Uri,64,0,90,26
1653299828690,MGT 164,A00,087752,McKay; Mary A,90,0,90,0
1653299828690,MGT 164,B00,087753,Meyer; Alison Bloomfield,0,0,0,0
1653299828690,MGT 164,C00,087754,Smith; Pamela Karen,82,0,90,8
1653299829213,MGT 166,A00,087755,Moran; Cathleen L.,89,0,90,1
1653299829213,MGT 166,B00,087756,Moran; Cathleen L.,90,0,90,0
1653299829213,MGT 166,C00,087757,Moran; Cathleen L.,90,0,90,0
1653299829213,MGT 166,D00,087758,Demill; Burritt,56,0,90,34
1653299829747,MGT 167,A00,087759,Klaas; Jeffrey David,88,0,90,2
1653299829747,MGT 167,B00,087760,Jacob; Jo Dee C,83,0,90,7
1653299830273,MGT 171,A00,087761,Phiroz; Zal Navroze,85,0,90,5
1653299830797,MGT 172,A00,087762,Hedges; Kathleen & Royal; Rebecca,96,0,100,4
1653299830797,MGT 172,B00,087763,Hedges; Kathleen,79,0,90,11
1653299830797,MGT 172,C00,087764,Zimmermann; Carsten,90,0,90,0
1653299831323,MGT 172R,A00,094888,Erat; Sanjiv,90,0,90,0
1653299831848,MGT 173,A00,087765,Hayes; Sherry Lorine,80,0,100,20
1653299832369,MGT 175,A00,087766,Gopal; Christopher S.,84,0,90,6
1653299832924,MGT 181,A00,087767,Buchanan; Harold G,114,0,120,6
1653299832924,MGT 181,B00,087768,Buchanan; Harold G,110,0,120,10
1653299832924,MGT 181,C00,087769,Bliss; Barbara Ann,109,0,120,11
1653299833974,MGT 185,A00,087771,Dunn; Louis Jean,84,0,90,6
1653299834500,MGT 187,A00,087772,Dunn; Louis Jean,138,0,146,8
1653299835032,MMW 11,A01,086931,duBois; Page Ann,4,0,4,0
1653299835032,MMW 11,A02,086932,duBois; Page Ann,4,0,4,0
1653299835032,MMW 11,A03,086933,duBois; Page Ann,3,0,4,1
1653299835032,MMW 11,A04,086934,duBois; Page Ann,3,0,4,1
1653299835032,MMW 11,A05,086935,duBois; Page Ann,4,0,4,0
1653299835032,MMW 11,A06,086936,duBois; Page Ann,3,0,4,1
1653299835032,MMW 11,A07,086937,duBois; Page Ann,4,0,4,0
1653299835032,MMW 11,A08,086938,duBois; Page Ann,4,0,4,0
1653299835032,MMW 11,A09,086939,duBois; Page Ann,4,0,4,0
1653299835032,MMW 11,A10,086940,duBois; Page Ann,4,0,4,0
1653299835032,MMW 11,A11,086941,duBois; Page Ann,4,0,4,0
1653299835032,MMW 11,A12,093877,duBois; Page Ann,3,0,4,1
1653299835557,MMW 11R,A01,093852,Herbst; Matthew,4,0,4,0
1653299835557,MMW 11R,A02,093853,Herbst; Matthew,4,0,4,0
1653299835557,MMW 11R,A03,093854,Herbst; Matthew,4,0,4,0
1653299835557,MMW 11R,A04,093855,Herbst; Matthew,4,0,4,0
1653299835557,MMW 11R,A05,093856,Herbst; Matthew,4,0,4,0
1653299835557,MMW 11R,A06,093857,Herbst; Matthew,4,0,4,0
1653299835557,MMW 11R,A07,093858,Herbst; Matthew,4,0,4,0
1653299835557,MMW 11R,A08,093859,Herbst; Matthew,4,0,4,0
1653299835557,MMW 11R,A09,093860,Herbst; Matthew,4,0,4,0
1653299835557,MMW 11R,A10,093861,Herbst; Matthew,4,0,4,0
1653299835557,MMW 11R,A11,093862,Herbst; Matthew,4,0,4,0
1653299835557,MMW 11R,A12,093863,Herbst; Matthew,4,0,4,0
1653299835557,MMW 11R,B01,093865,Herbst; Matthew,4,0,4,0
1653299835557,MMW 11R,B02,093866,Herbst; Matthew,4,0,4,0
1653299835557,MMW 11R,B03,093867,Herbst; Matthew,4,0,4,0
1653299835557,MMW 11R,B04,093868,Herbst; Matthew,4,0,4,0
1653299835557,MMW 11R,B05,093869,Herbst; Matthew,4,0,4,0
1653299835557,MMW 11R,B06,093870,Herbst; Matthew,4,0,4,0
1653299835557,MMW 11R,B07,093871,Herbst; Matthew,4,0,4,0
1653299835557,MMW 11R,B08,093872,Herbst; Matthew,4,0,4,0
1653299835557,MMW 11R,B09,093873,Herbst; Matthew,4,0,4,0
1653299835557,MMW 11R,B10,093874,Herbst; Matthew,4,0,4,0
1653299835557,MMW 11R,B11,093875,Herbst; Matthew,4,0,4,0
1653299835557,MMW 11R,B12,093876,Herbst; Matthew,4,0,4,0
1653299836087,MMW 14,A01,086968,Chang; Edmond Yi-Teh,28,0,28,0
1653299836087,MMW 14,A02,086969,Chang; Edmond Yi-Teh,27,0,28,1
1653299836087,MMW 14,A03,086970,Chang; Edmond Yi-Teh,21,0,28,7
1653299836087,MMW 14,A04,086971,Chang; Edmond Yi-Teh,27,0,28,1
1653299836087,MMW 14,A05,086972,Chang; Edmond Yi-Teh,26,0,28,2
1653299836087,MMW 14,A06,086973,Chang; Edmond Yi-Teh,28,0,28,0
1653299836087,MMW 14,A07,086974,Chang; Edmond Yi-Teh,27,0,28,1
1653299836087,MMW 14,A08,086975,Chang; Edmond Yi-Teh,25,0,28,3
1653299836087,MMW 14,A09,086976,Chang; Edmond Yi-Teh,0,0,0,0
1653299836087,MMW 14,A10,086977,Chang; Edmond Yi-Teh,27,0,28,1
1653299836087,MMW 14,A11,086978,Chang; Edmond Yi-Teh,26,0,28,2
1653299836087,MMW 14,A12,086979,Chang; Edmond Yi-Teh,27,0,28,1
1653299836087,MMW 14,A13,086980,Chang; Edmond Yi-Teh,28,0,28,0
1653299836617,MMW 121,A01,086982,Chang; Edmond Yi-Teh,0,0,0,0
1653299836617,MMW 121,A02,086983,Chang; Edmond Yi-Teh,0,0,0,0
1653299836617,MMW 121,A03,086984,Chang; Edmond Yi-Teh,2,0,4,2
1653299836617,MMW 121,A04,086985,Chang; Edmond Yi-Teh,4,0,4,0
1653299836617,MMW 121,A05,086986,Chang; Edmond Yi-Teh,4,0,4,0
1653299836617,MMW 121,A06,086987,Chang; Edmond Yi-Teh,4,0,4,0
1653299836617,MMW 121,A07,086988,Chang; Edmond Yi-Teh,4,0,4,0
1653299836617,MMW 121,A08,086989,Chang; Edmond Yi-Teh,4,0,4,0
1653299836617,MMW 121,B01,086991,Patterson; Patrick H.,4,0,4,0
1653299836617,MMW 121,B02,086992,Patterson; Patrick H.,4,0,4,0
1653299836617,MMW 121,B03,086993,Patterson; Patrick H.,4,0,4,0
1653299836617,MMW 121,B04,086994,Patterson; Patrick H.,3,0,4,1
1653299836617,MMW 121,B05,086995,Patterson; Patrick H.,4,0,4,0
1653299836617,MMW 121,B06,086996,Patterson; Patrick H.,4,0,4,0
1653299836617,MMW 121,B07,086997,Patterson; Patrick H.,4,0,4,0
1653299836617,MMW 121,B08,086998,Patterson; Patrick H.,4,0,4,0
1653299836617,MMW 121,B09,086999,Patterson; Patrick H.,4,0,4,0
1653299836617,MMW 121,B10,087000,Patterson; Patrick H.,4,0,4,0
1653299836617,MMW 121,B11,087001,Patterson; Patrick H.,0,0,0,0
1653299836617,MMW 121,B12,087002,Patterson; Patrick H.,0,0,0,0
1653299837152,MUS 1A,A01,090497,Staff,19,0,20,1
1653299837152,MUS 1A,A02,090498,Staff,13,0,20,7
1653299837152,MUS 1A,A03,090499,Staff,18,0,20,2
1653299837152,MUS 1A,A04,090500,Staff,19,0,20,1
1653299837152,MUS 1A,A05,090501,Staff,20,0,20,0
1653299837152,MUS 1A,A06,090502,Staff,20,0,20,0
1653299837152,MUS 1A,B01,090504,Staff,18,0,20,2
1653299837152,MUS 1A,B02,090505,Staff,20,0,20,0
1653299837152,MUS 1A,B03,090506,Staff,18,0,20,2
1653299837152,MUS 1A,B04,090507,Staff,18,0,20,2
1653299837152,MUS 1A,B05,090508,Staff,16,0,20,4
1653299837152,MUS 1A,B06,090509,Staff,20,0,20,0
1653299837679,MUS 2A,A01,090511,Carlson; Erik Norman,19,0,20,1
1653299838212,MUS 2AK,A00,090512,Ohnishi; Takae,24,0,25,1
1653299838212,MUS 2AK,B00,090513,Ohnishi; Takae,15,0,15,0
1653299838739,MUS 4,A01,090515,Staff,24,0,25,1
1653299838739,MUS 4,A02,090516,Staff,24,0,25,1
1653299838739,MUS 4,A03,090517,Staff,22,0,25,3
1653299838739,MUS 4,A04,090518,Staff,24,0,25,1
1653299838739,MUS 4,A05,090519,Staff,25,0,25,0
1653299838739,MUS 4,A06,090520,Staff,25,0,25,0
1653299838739,MUS 4,A07,090521,Staff,24,0,25,1
1653299838739,MUS 4,A08,090522,Staff,24,0,25,1
1653299839265,MUS 5,A01,090524,Staff,20,0,20,0
1653299839265,MUS 5,A02,090525,Staff,18,0,20,2
1653299839265,MUS 5,A03,090526,Staff,20,0,20,0
1653299839265,MUS 5,A04,090527,Staff,20,0,20,0
1653299839265,MUS 5,A05,090528,Staff,19,0,20,1
1653299839787,MUS 6,A01,090530,Staff,22,0,25,3
1653299839787,MUS 6,A02,090531,Staff,25,0,25,0
1653299839787,MUS 6,A03,090532,Staff,25,0,25,0
1653299839787,MUS 6,A04,090533,Staff,23,0,25,2
1653299840315,MUS 8,A01,090535,Kenyatta; Kamau,17,0,25,8
1653299840315,MUS 8,A02,090536,Kenyatta; Kamau,19,0,25,6
1653299840315,MUS 8,A03,090537,Kenyatta; Kamau,17,0,25,8
1653299840315,MUS 8,A04,090538,Kenyatta; Kamau,21,0,25,4
1653299840838,MUS 12,A01,090540,Narucki; Susan M,20,0,20,0
1653299840838,MUS 12,A02,090541,Narucki; Susan M,20,0,20,0
1653299840838,MUS 12,A03,090542,Narucki; Susan M,17,0,20,3
1653299841364,MUS 15,A01,090544,Staff,21,0,25,4
1653299841364,MUS 15,A02,090545,Staff,23,0,25,2
1653299841364,MUS 15,A03,090546,Staff,24,0,25,1
1653299841364,MUS 15,A04,090547,Staff,22,0,25,3
1653299841364,MUS 15,A05,090548,Staff,25,0,25,0
1653299841364,MUS 15,A06,090549,Staff,24,0,25,1
1653299841890,MUS 19R,A01,090551,Britt; King James,17,0,20,3
1653299841890,MUS 19R,A02,090552,Britt; King James,19,0,20,1
1653299841890,MUS 19R,A03,090553,Britt; King James,20,0,20,0
1653299841890,MUS 19R,A04,090554,Britt; King James,19,0,20,1
1653299841890,MUS 19R,A05,090555,Britt; King James,20,0,20,0
1653299841890,MUS 19R,A06,090556,Britt; King James,18,0,20,2
1653299841890,MUS 19R,A07,090557,Britt; King James,19,0,20,1
1653299841890,MUS 19R,A08,090558,Britt; King James,19,0,20,1
1653299841890,MUS 19R,A09,090559,Britt; King James,20,0,20,0
1653299841890,MUS 19R,A10,090560,Britt; King James,20,0,20,0
1653299841890,MUS 19R,B01,090562,Britt; King James,10,0,10,0
1653299841890,MUS 19R,B02,090563,Britt; King James,10,0,10,0
1653299841890,MUS 19R,B03,090564,Britt; King James,10,0,10,0
1653299841890,MUS 19R,B04,090565,Britt; King James,10,0,10,0
1653299841890,MUS 19R,B05,090566,Britt; King James,10,0,10,0
1653299841890,MUS 19R,B06,090567,Britt; King James,10,0,10,0
1653299841890,MUS 19R,B07,090568,Britt; King James,10,0,10,0
1653299841890,MUS 19R,B08,090569,Britt; King James,10,0,10,0
1653299841890,MUS 19R,B09,090570,Britt; King James,10,0,10,0
1653299841890,MUS 19R,B10,090571,Britt; King James,10,0,10,0
1653299842426,MUS 20,A01,090573,Borgo; David Garcia,12,0,15,3
1653299842426,MUS 20,A02,090574,Borgo; David Garcia,14,0,15,1
1653299842426,MUS 20,A03,090575,Borgo; David Garcia,13,0,15,2
1653299842961,MUS 32,001,094074,Staff,10,0,10,0
1653299842961,MUS 32,002,094075,Kenyatta; Kamau,10,0,10,0
1653299842961,MUS 32,003,094076,Curtis; Charles Rector,10,0,10,0
1653299842961,MUS 32,005,094078,Terrazas Perez; Wilfrido D,10,0,10,0
1653299842961,MUS 32,006,094079,Ohnishi; Takae,10,0,10,0
1653299842961,MUS 32,007,094080,Burr; Anthony I,10,0,10,0
1653299842961,MUS 32,008,094081,Carlson; Erik Norman,10,0,10,0
1653299842961,MUS 32,009,094082,Dresser; Mark Stuart,10,0,10,0
1653299842961,MUS 32,011,094084,Richards; Stephanie F,10,0,10,0
1653299842961,MUS 32,012,094085,Borgo; David Garcia,10,0,10,0
1653299842961,MUS 32,013,094086,Paganos Koukakis; Dimitrios,10,0,10,0
1653299842961,MUS 32,014,094087,Jones; Michael David,10,0,10,0
1653299843484,MUS 32V,A00,094355,Zazueta Cervera; Miguel Angel,10,0,10,0
1653299843484,MUS 32V,B00,094089,Flores; Mariana,10,0,10,0
1653299844006,MUS 32VM,A00,094090,Zazueta Cervera; Miguel Angel,15,0,15,0
1653299844534,MUS 33A,A00,090576,Liang; Lei,24,0,25,1
1653299845069,MUS 43,A00,090577,Burr; Anthony I,92,0,100,8
1653299845666,MUS 95C,B00,094829,Staff,28,0,30,2
1653299846189,MUS 95D,A00,090579,Staff,30,0,30,0
1653299846716,MUS 95E,A00,090580,Staff,30,0,30,0
1653299847251,MUS 95G,A00,090581,Anderson; Kenneth,384,0,395,11
1653299847251,MUS 95G,B00,090582,Anderson; Kenneth,393,0,395,2
1653299847778,MUS 95JC,A00,090583,Kenyatta; Kamau,35,0,35,0
1653299848304,MUS 95L,A00,090584,Staff,30,0,30,0
1653299848828,MUS 95W,A00,090585,Seshadri; Kartik,60,0,60,0
1653299848828,MUS 95W,B00,090586,Seshadri; Kartik,30,0,30,0
1653299849352,MUS 101A,A01,090588,Staff,29,0,30,1
1653299849876,MUS 103A,A00,090589,Ung; Chinary,15,0,15,0
1653299850400,MUS 107,A00,090590,Terrazas Perez; Wilfrido D,30,0,30,0
1653299850923,MUS 111,A00,090591,Yadegari; Shahrokh D,124,0,130,6
1653299851448,MUS 114,A00,090592,Curtis; Charles Rector,117,0,125,8
1653299851987,MUS 120A,A01,090594,Cimini; Amy Marie,29,0,30,1
1653299852510,MUS 126R,A00,090595,Borgo; David Garcia,106,0,115,9
1653299853035,MUS 130,A00,090596,Ohnishi; Takae,30,0,30,0
1653299853558,MUS 132,001,094091,Nourai; Keyarash,10,0,10,0
1653299853558,MUS 132,002,094093,Kenyatta; Kamau,10,0,10,0
1653299853558,MUS 132,003,094094,Curtis; Charles Rector,10,0,10,0
1653299853558,MUS 132,005,094096,Terrazas Perez; Wilfrido D,10,0,10,0
1653299853558,MUS 132,006,094097,Ohnishi; Takae,10,0,10,0
1653299853558,MUS 132,007,094098,Burr; Anthony I,10,0,10,0
1653299853558,MUS 132,008,094099,Carlson; Erik Norman,10,0,10,0
1653299853558,MUS 132,009,094100,Dresser; Mark Stuart,10,0,10,0
1653299853558,MUS 132,011,094102,Richards; Stephanie F,10,0,10,0
1653299853558,MUS 132,012,094103,Borgo; David Garcia,10,0,10,0
1653299853558,MUS 132,013,094104,Jones; Michael David,10,0,10,0
1653299853558,MUS 132,014,094105,Staff,10,0,10,0
1653299854096,MUS 132V,A00,094106,Narucki; Susan M,15,0,15,0
1653299854617,MUS 134,A00,090597,Staff,30,0,30,0
1653299855142,MUS 137A,A00,090598,Kenyatta; Kamau,30,0,30,0
1653299855664,MUS 143,A00,090599,Staff,26,0,30,4
1653299856731,MUS 173,A00,090600,Britt; King James,19,0,30,11
1653299857253,MUS 174A,A00,090601,Staff,8,0,15,7
1653299858304,NANO 4,A01,088199,Vazquez Mena; Oscar,20,0,20,0
1653299858304,NANO 4,B01,088201,Vazquez Mena; Oscar,20,0,20,0
1653299858304,NANO 4,C01,088203,Vazquez Mena; Oscar,20,0,20,0
1653299858829,NANO 15,A01,088205,Lubarda; Vlado,50,0,50,0
1653299858829,NANO 15,B01,088207,Lubarda; Vlado,50,0,50,0
1653299859355,NANO 20L,A00,088208,Sirbuly; Donald,27,0,30,3
1653299859355,NANO 20L,B00,088209,Sirbuly; Donald,29,0,30,1
1653299859879,NANO 100L,A00,088210,Vecchio; Kenneth S,24,0,30,6
1653299860403,NANO 102,A00,088211,Tao; Andrea Rae,94,0,100,6
1653299860926,NANO 110,A00,088212,Pascal; Tod A,99,0,100,1
1653299861450,NANO 111,A00,088213,Fenning; David,45,0,50,5
1653299861976,NANO 117,A00,088214,Cubukcu; Ertugrul,71,0,75,4
1653299862500,NANO 119,A00,088215,Vazquez Mena; Oscar,50,0,50,0
1653299863023,NANO 159,A00,088216,Wang; Joseph,33,0,40,7
1653299863547,NANO 181,A01,088218,Ong; Shyue Ping,22,0,25,3
1653299864070,PHIL 1,A00,090815,Sher; Gila,57,0,60,3
1653299864600,PHIL 10,A01,090817,Grush; Rick Scott,37,0,40,3
1653299864600,PHIL 10,A02,090818,Grush; Rick Scott,37,0,40,3
1653299864600,PHIL 10,A03,090819,Grush; Rick Scott,38,0,40,2
1653299864600,PHIL 10,A04,090820,Grush; Rick Scott,40,0,40,0
1653299864600,PHIL 10,A05,090821,Grush; Rick Scott,38,0,40,2
1653299864600,PHIL 10,A06,090822,Grush; Rick Scott,39,0,40,1
1653299865123,PHIL 12,A01,090824,Bechtel; William,20,0,25,5
1653299865123,PHIL 12,A02,090825,Bechtel; William,24,0,25,1
1653299865123,PHIL 12,A03,090826,Bechtel; William,25,0,25,0
1653299865123,PHIL 12,A04,090827,Bechtel; William,25,0,25,0
1653299865646,PHIL 13,A01,090829,Wonderly; Monique L.,25,0,25,0
1653299865646,PHIL 13,A02,090830,Wonderly; Monique L.,24,0,25,1
1653299865646,PHIL 13,A03,090831,Wonderly; Monique L.,24,0,25,1
1653299865646,PHIL 13,A04,090832,Wonderly; Monique L.,25,0,25,0
1653299866170,PHIL 27,A01,090834,Harrell; Maralee Mae,23,0,35,12
1653299866170,PHIL 27,A02,090835,Harrell; Maralee Mae,35,0,35,0
1653299866170,PHIL 27,A03,090836,Harrell; Maralee Mae,33,0,35,2
1653299866170,PHIL 27,A04,090837,Harrell; Maralee Mae,33,0,35,2
1653299866170,PHIL 27,A05,090838,Harrell; Maralee Mae,35,0,35,0
1653299866170,PHIL 27,A06,090839,Harrell; Maralee Mae,35,0,35,0
1653299866699,PHIL 28,A01,090841,Bazargan-Forward; Saba,31,0,35,4
1653299866699,PHIL 28,A02,090842,Bazargan-Forward; Saba,31,0,35,4
1653299866699,PHIL 28,A03,090843,Bazargan-Forward; Saba,35,0,35,0
1653299866699,PHIL 28,A04,090844,Bazargan-Forward; Saba,30,0,35,5
1653299866699,PHIL 28,A05,090845,Bazargan-Forward; Saba,33,0,35,2
1653299866699,PHIL 28,A06,090846,Bazargan-Forward; Saba,34,0,35,1
1653299866699,PHIL 28,A07,090847,Bazargan-Forward; Saba,32,0,35,3
1653299866699,PHIL 28,A08,090848,Bazargan-Forward; Saba,33,0,35,2
1653299867233,PHIL 31,A00,090849,Johnson; Monte,59,0,60,1
1653299867756,PHIL 100,A00,090852,Nelkin; Dana Kay,28,0,35,7
1653299868282,PHIL 110,A00,090853,Johnson; Monte,29,0,30,1
1653299868806,PHIL 120,A00,090854,Rickless; Samuel Charles,23,0,35,12
1653299869333,PHIL 123,A00,090855,Sher; Gila,38,0,40,2
1653299869855,PHIL 131,A00,090856,Cohen; Jonathan David,34,0,35,1
1653299870381,PHIL 132,A00,090857,Carr; Jennifer Rose,33,0,35,2
1653299870912,PHIL 138,A00,090858,Brink; David O.,34,0,40,6
1653299871434,PHIL 147,A00,090860,Fulkerson; Matthew Todd,33,0,35,2
1653299871957,PHIL 150,A00,090861,Bechtel; William,36,0,40,4
1653299872486,PHIL 155,A00,090862,Vargas; Manuel Rogelio,38,0,40,2
1653299873008,PHIL 165,A00,090863,Rickless; Samuel Charles,59,0,70,11
1653299873530,PHIL 172,A00,090864,Bazargan-Forward; Saba,37,0,40,3
1653299874052,PHIL 173,A00,090865,Wonderly; Monique L.,33,0,40,7
1653299874575,PHYS 1A,A00,088555,Koslover; Elena F,354,0,362,8
1653299874575,PHYS 1A,B00,088556,Koslover; Elena F,343,0,362,19
1653299874575,PHYS 1A,C00,088557,Shpyrko; Oleg,326,0,362,36
1653299875108,PHYS 1AL,001,088558,Tsai; Philbert S,30,0,30,0
1653299875108,PHYS 1AL,002,088559,Tsai; Philbert S,30,0,30,0
1653299875108,PHYS 1AL,003,088560,Tsai; Philbert S,23,0,30,7
1653299875108,PHYS 1AL,004,088561,Tsai; Philbert S,26,0,30,4
1653299875108,PHYS 1AL,005,088562,Tsai; Philbert S,24,0,30,6
1653299875108,PHYS 1AL,006,088563,Tsai; Philbert S,30,0,30,0
1653299875108,PHYS 1AL,007,088564,Tsai; Philbert S,26,0,30,4
1653299875108,PHYS 1AL,008,088565,Tsai; Philbert S,29,0,30,1
1653299875108,PHYS 1AL,009,088566,Tsai; Philbert S,28,0,30,2
1653299875108,PHYS 1AL,010,088567,Tsai; Philbert S,30,0,30,0
1653299875108,PHYS 1AL,011,088568,Tsai; Philbert S,29,0,30,1
1653299875108,PHYS 1AL,012,088569,Tsai; Philbert S,29,0,30,1
1653299875108,PHYS 1AL,013,088570,Tsai; Philbert S,30,0,30,0
1653299875108,PHYS 1AL,014,088571,Tsai; Philbert S,29,0,30,1
1653299875108,PHYS 1AL,015,088572,Tsai; Philbert S,23,0,30,7
1653299875108,PHYS 1AL,016,088573,Tsai; Philbert S,28,0,30,2
1653299875108,PHYS 1AL,017,088574,Tsai; Philbert S,29,0,30,1
1653299875108,PHYS 1AL,018,088575,Tsai; Philbert S,28,0,30,2
1653299875108,PHYS 1AL,019,088576,Tsai; Philbert S,26,0,30,4
1653299875108,PHYS 1AL,020,088577,Tsai; Philbert S,29,0,30,1
1653299875108,PHYS 1AL,021,088578,Tsai; Philbert S,30,0,30,0
1653299875108,PHYS 1AL,022,088579,Tsai; Philbert S,30,0,30,0
1653299875108,PHYS 1AL,023,088580,Tsai; Philbert S,30,0,30,0
1653299875108,PHYS 1AL,024,088581,Tsai; Philbert S,30,0,30,0
1653299875108,PHYS 1AL,025,088582,Tsai; Philbert S,26,0,30,4
1653299875108,PHYS 1AL,026,088583,Tsai; Philbert S,29,0,30,1
1653299875108,PHYS 1AL,027,088584,Tsai; Philbert S,28,0,30,2
1653299875108,PHYS 1AL,028,088585,Tsai; Philbert S,30,0,30,0
1653299875108,PHYS 1AL,029,088586,Tsai; Philbert S,27,0,30,3
1653299875108,PHYS 1AL,030,088587,Tsai; Philbert S,29,0,30,1
1653299875108,PHYS 1AL,031,088588,Tsai; Philbert S,30,0,30,0
1653299875108,PHYS 1AL,032,088589,Tsai; Philbert S,30,0,30,0
1653299875108,PHYS 1AL,033,088590,Tsai; Philbert S,30,0,30,0
1653299875108,PHYS 1AL,034,088591,Tsai; Philbert S,30,0,30,0
1653299875108,PHYS 1AL,035,088592,Tsai; Philbert S,29,0,30,1
1653299875108,PHYS 1AL,036,088593,Tsai; Philbert S,30,0,30,0
1653299875635,PHYS 1B,A00,088594,Groisman; Alexander,351,0,360,9
1653299876160,PHYS 1BL,001,088595,Tsai; Philbert S,30,0,30,0
1653299876160,PHYS 1BL,002,088596,Tsai; Philbert S,25,0,30,5
1653299876160,PHYS 1BL,003,088597,Tsai; Philbert S,27,0,30,3
1653299876160,PHYS 1BL,004,088598,Tsai; Philbert S,30,0,30,0
1653299876160,PHYS 1BL,005,088599,Tsai; Philbert S,29,0,30,1
1653299876160,PHYS 1BL,006,088600,Tsai; Philbert S,25,0,30,5
1653299876160,PHYS 1BL,007,088601,Tsai; Philbert S,30,0,30,0
1653299876160,PHYS 1BL,008,088602,Tsai; Philbert S,29,0,30,1
1653299876160,PHYS 1BL,009,088603,Tsai; Philbert S,30,0,30,0
1653299876160,PHYS 1BL,010,088604,Tsai; Philbert S,30,0,30,0
1653299876160,PHYS 1BL,011,088605,Tsai; Philbert S,28,0,30,2
1653299876160,PHYS 1BL,012,088606,Tsai; Philbert S,26,0,30,4
1653299876683,PHYS 1C,A00,088607,Tsai; Philbert S,334,0,360,26
1653299877213,PHYS 1CL,001,088608,Tsai; Philbert S,30,0,30,0
1653299877213,PHYS 1CL,002,088609,Tsai; Philbert S,24,0,30,6
1653299877213,PHYS 1CL,003,088610,Tsai; Philbert S,24,0,30,6
1653299877213,PHYS 1CL,004,088611,Tsai; Philbert S,29,0,30,1
1653299877213,PHYS 1CL,005,088612,Tsai; Philbert S,17,0,30,13
1653299877213,PHYS 1CL,006,088613,Tsai; Philbert S,19,0,30,11
1653299877213,PHYS 1CL,007,088614,Tsai; Philbert S,30,0,30,0
1653299877213,PHYS 1CL,008,088615,Tsai; Philbert S,26,0,30,4
1653299877213,PHYS 1CL,009,088616,Tsai; Philbert S,27,0,30,3
1653299877213,PHYS 1CL,010,088617,Tsai; Philbert S,29,0,30,1
1653299877213,PHYS 1CL,011,088618,Tsai; Philbert S,27,0,30,3
1653299877213,PHYS 1CL,012,088619,Tsai; Philbert S,24,0,30,6
1653299877740,PHYS 2A,A01,092602,Meyertholen; Andrew D.,26,0,30,4
1653299877740,PHYS 2A,A02,092603,Meyertholen; Andrew D.,28,0,30,2
1653299877740,PHYS 2A,A03,092604,Meyertholen; Andrew D.,29,0,30,1
1653299877740,PHYS 2A,A04,092605,Meyertholen; Andrew D.,30,0,30,0
1653299877740,PHYS 2A,A05,092606,Meyertholen; Andrew D.,29,0,30,1
1653299877740,PHYS 2A,A06,092607,Meyertholen; Andrew D.,29,0,30,1
1653299877740,PHYS 2A,A07,092608,Meyertholen; Andrew D.,30,0,30,0
1653299877740,PHYS 2A,A08,092609,Meyertholen; Andrew D.,30,0,30,0
1653299877740,PHYS 2A,A09,092610,Meyertholen; Andrew D.,27,0,30,3
1653299877740,PHYS 2A,A10,092611,Meyertholen; Andrew D.,30,0,30,0
1653299877740,PHYS 2A,A11,092612,Meyertholen; Andrew D.,30,0,30,0
1653299877740,PHYS 2A,A12,094499,Meyertholen; Andrew D.,27,0,30,3
1653299878266,PHYS 2B,A01,092613,Branson; James G,28,0,30,2
1653299878266,PHYS 2B,A02,092614,Branson; James G,29,0,30,1
1653299878266,PHYS 2B,A03,092615,Branson; James G,30,0,30,0
1653299878266,PHYS 2B,A04,092616,Branson; James G,30,0,30,0
1653299878266,PHYS 2B,A05,092617,Branson; James G,29,0,30,1
1653299878266,PHYS 2B,A06,092618,Branson; James G,29,0,30,1
1653299878266,PHYS 2B,A07,092619,Branson; James G,29,0,30,1
1653299878266,PHYS 2B,A08,092620,Branson; James G,0,0,0,0
1653299878266,PHYS 2B,A09,092621,Branson; James G,0,0,0,0
1653299878266,PHYS 2B,A10,092622,Branson; James G,0,0,0,0
1653299878266,PHYS 2B,A11,092623,Branson; James G,0,0,0,0
1653299878266,PHYS 2B,A12,092624,Branson; James G,30,0,30,0
1653299878794,PHYS 2C,A01,092625,Barreiro Guerrero; Julio,27,0,30,3
1653299878794,PHYS 2C,A02,092626,Barreiro Guerrero; Julio,28,0,30,2
1653299878794,PHYS 2C,A03,092627,Barreiro Guerrero; Julio,29,0,30,1
1653299878794,PHYS 2C,A04,092628,Barreiro Guerrero; Julio,29,0,30,1
1653299878794,PHYS 2C,A05,092629,Barreiro Guerrero; Julio,30,0,30,0
1653299878794,PHYS 2C,A06,092630,Barreiro Guerrero; Julio,30,0,30,0
1653299878794,PHYS 2C,A07,092631,Barreiro Guerrero; Julio,30,0,30,0
1653299878794,PHYS 2C,A08,092632,Barreiro Guerrero; Julio,30,0,30,0
1653299878794,PHYS 2C,A09,092633,Barreiro Guerrero; Julio,29,0,30,1
1653299878794,PHYS 2C,A10,092634,Barreiro Guerrero; Julio,29,0,30,1
1653299878794,PHYS 2C,A11,092635,Barreiro Guerrero; Julio,27,0,30,3
1653299878794,PHYS 2C,A12,092636,Barreiro Guerrero; Julio,29,0,30,1
1653299878794,PHYS 2C,B01,092637,Barreiro Guerrero; Julio,29,0,30,1
1653299878794,PHYS 2C,B02,092638,Barreiro Guerrero; Julio,30,0,30,0
1653299878794,PHYS 2C,B03,092639,Barreiro Guerrero; Julio,28,0,30,2
1653299878794,PHYS 2C,B04,092640,Barreiro Guerrero; Julio,29,0,30,1
1653299878794,PHYS 2C,B05,092641,Barreiro Guerrero; Julio,26,0,30,4
1653299878794,PHYS 2C,B06,092642,Barreiro Guerrero; Julio,28,0,30,2
1653299878794,PHYS 2C,B07,092643,Barreiro Guerrero; Julio,29,0,30,1
1653299878794,PHYS 2C,B08,092644,Barreiro Guerrero; Julio,30,0,30,0
1653299878794,PHYS 2C,B09,092645,Barreiro Guerrero; Julio,29,0,30,1
1653299878794,PHYS 2C,B10,092646,Barreiro Guerrero; Julio,29,0,30,1
1653299878794,PHYS 2C,B11,092647,Barreiro Guerrero; Julio,30,0,30,0
1653299878794,PHYS 2C,B12,092648,Barreiro Guerrero; Julio,30,0,30,0
1653299879318,PHYS 2CL,A01,088625,Du; Chunhui,26,0,30,4
1653299879318,PHYS 2CL,A02,088626,Du; Chunhui,29,0,30,1
1653299879318,PHYS 2CL,A03,088627,Du; Chunhui,21,0,30,9
1653299879318,PHYS 2CL,A04,088628,Du; Chunhui,30,0,30,0
1653299879318,PHYS 2CL,A05,088629,Du; Chunhui,29,0,30,1
1653299879318,PHYS 2CL,A06,088630,Du; Chunhui,24,0,30,6
1653299879318,PHYS 2CL,A07,088631,Du; Chunhui,28,0,30,2
1653299879318,PHYS 2CL,A08,088632,Du; Chunhui,28,0,30,2
1653299879318,PHYS 2CL,A09,088633,Du; Chunhui,24,0,30,6
1653299879318,PHYS 2CL,A10,088634,Du; Chunhui,29,0,30,1
1653299879318,PHYS 2CL,A11,088635,Du; Chunhui,27,0,30,3
1653299879318,PHYS 2CL,A12,088636,Du; Chunhui,30,0,30,0
1653299879847,PHYS 2D,A01,092649,Hirsch; Jorge Eduardo,30,0,30,0
1653299879847,PHYS 2D,A02,092650,Hirsch; Jorge Eduardo,28,0,30,2
1653299879847,PHYS 2D,A03,092651,Hirsch; Jorge Eduardo,30,0,30,0
1653299879847,PHYS 2D,A04,092652,Hirsch; Jorge Eduardo,30,0,30,0
1653299879847,PHYS 2D,A05,092653,Hirsch; Jorge Eduardo,30,0,30,0
1653299879847,PHYS 2D,A06,092654,Hirsch; Jorge Eduardo,30,0,30,0
1653299880370,PHYS 2DL,A01,088639,Butov; Leonid,7,0,16,9
1653299880370,PHYS 2DL,A02,088640,Butov; Leonid,13,0,16,3
1653299880370,PHYS 2DL,A03,094501,Butov; Leonid,13,0,16,3
1653299880370,PHYS 2DL,A04,094502,Butov; Leonid,16,0,16,0
1653299880897,PHYS 4C,A01,092655,Averitt; Richard Douglas,28,0,30,2
1653299880897,PHYS 4C,A02,092656,Averitt; Richard Douglas,30,0,30,0
1653299880897,PHYS 4C,A03,092657,Averitt; Richard Douglas,30,0,30,0
1653299880897,PHYS 4C,A04,092658,Staff,30,0,30,0
1653299881430,PHYS 5,A01,092662,Konopacky; Quinn Morgan,197,0,200,3
1653299881953,PHYS 10,A01,092663,Tytler; David Robert,191,0,192,1
1653299882476,PHYS 100A,A01,092660,Shpyrko; Oleg,114,0,120,6
1653299883005,PHYS 110A,A01,092664,Arovas; Daniel P,116,0,120,4
1653299883528,PHYS 122,A01,088647,Yang; Liang,30,0,40,10
1653299884052,PHYS 130B,A01,092661,Grover; Tarun,106,0,120,14
1653299884578,PHYS 139,A00,088649,Kuti; Julius,19,0,20,1
1653299885104,PHYS 140A,A01,092665,Shotwell; Brian,105,0,120,15
1653299885633,PHYS 161,A01,092666,Fuller; George Michael,46,0,65,19
1653299886158,PHYS 163,A01,092667,Keres; Dusan,48,0,50,2
1653299886681,PHYS 175,A00,088653,Dudko; Olga,18,0,20,2
1653299887212,PHYS 191,A00,088654,Shpyrko; Oleg,26,0,30,4
1653299887737,POLI 11D,A01,090896,Ferree; Karen E,29,0,30,1
1653299887737,POLI 11D,A02,090897,Ferree; Karen E,28,0,30,2
1653299887737,POLI 11D,A03,090899,Ferree; Karen E,28,0,30,2
1653299887737,POLI 11D,A04,090900,Ferree; Karen E,29,0,30,1
1653299888267,POLI 12D,A01,090902,Roeder; Philip G,26,0,30,4
1653299888267,POLI 12D,A02,090903,Roeder; Philip G,27,0,30,3
1653299888267,POLI 12D,A05,090906,Roeder; Philip G,28,0,30,2
1653299888267,POLI 12D,A06,090907,Roeder; Philip G,30,0,30,0
1653299888790,POLI 13DR,A01,090909,Forman; Fonna,26,0,30,4
1653299888790,POLI 13DR,A02,090910,Forman; Fonna,30,0,30,0
1653299888790,POLI 13DR,A03,090911,Forman; Fonna,28,0,30,2
1653299888790,POLI 13DR,A04,090912,Forman; Fonna,30,0,30,0
1653299888790,POLI 13DR,A05,090913,Forman; Fonna,28,0,30,2
1653299888790,POLI 13DR,A06,090914,Forman; Fonna,34,0,34,0
1653299889313,POLI 27,A01,090916,Elgin; Samuel Zincke,23,0,30,7
1653299889313,POLI 27,A02,090917,Elgin; Samuel Zincke,26,0,30,4
1653299889313,POLI 27,A03,090918,Elgin; Samuel Zincke,30,0,30,0
1653299889313,POLI 27,A04,090919,Elgin; Samuel Zincke,28,0,30,2
1653299889313,POLI 27,A05,090920,Elgin; Samuel Zincke,24,0,30,6
1653299889313,POLI 27,A06,090921,Elgin; Samuel Zincke,29,0,30,1
1653299889839,POLI 28,A01,090923,Elgin; Samuel Zincke,23,0,30,7
1653299889839,POLI 28,A02,090924,Elgin; Samuel Zincke,26,0,30,4
1653299889839,POLI 28,A05,090927,Elgin; Samuel Zincke,23,0,30,7
1653299889839,POLI 28,A06,090928,Elgin; Samuel Zincke,23,0,30,7
1653299890380,POLI 30D,A01,090930,Desposato; Scott,22,0,24,2
1653299890380,POLI 30D,A02,090931,Desposato; Scott,22,0,24,2
1653299890380,POLI 30D,A03,090932,Desposato; Scott,23,0,24,1
1653299890380,POLI 30D,A04,090933,Desposato; Scott,24,0,24,0
1653299890380,POLI 30D,A05,090934,Desposato; Scott,23,0,24,1
1653299890380,POLI 30D,A06,090935,Desposato; Scott,24,0,24,0
1653299890909,POLI 100G,A00,090936,Fletcher; Nathan,199,0,208,9
1653299891434,POLI 100V,A00,090937,Gause; LaGina,111,0,115,4
1653299891962,POLI 100W,A00,090938,Paglayan; Agustina,161,0,165,4
1653299892489,POLI 104A,A00,090940,Smith; Glenn Chatmas,186,0,195,9
1653299893015,POLI 104F,A00,090941,Smith; Glenn Chatmas,11,0,19,8
1653299893541,POLI 104M,A00,090942,Stephens; Mattheus E,156,0,165,9
1653299894064,POLI 110A,A00,090943,Wiens; David,39,0,44,5
1653299894601,POLI 110F,A00,090944,Elgin; Samuel Zincke,50,0,50,0
1653299895128,POLI 113A,A00,090945,Magagna; Victor Valentine,469,0,475,6
1653299895128,POLI 113A,B00,090946,Magagna; Victor Valentine,467,0,475,8
1653299895653,POLI 117R,A00,090947,Forman; Fonna,16,0,40,24
1653299896177,POLI 120E,A00,090948,Strom; Kaare,47,0,50,3
1653299896723,POLI 120G,A00,090949,Fisk; David Lee,110,0,115,5
1653299897254,POLI 120H,A00,090950,Fisk; David Lee,111,0,115,4
1653299897780,POLI 133A,A00,090951,Naoi; Megumi,156,0,165,9
1653299898304,POLI 135,A00,090952,Fisk; David Lee,111,0,115,4
1653299898935,POLI 142J,A00,090953,Slantchev; Branislav,45,0,50,5
1653299899486,POLI 143,A00,090954,Gartzke; Erik,111,0,115,4
1653299900023,POLI 149,A00,090955,Joseph; Michael F,152,0,165,13
1653299900546,POLI 151,A00,090956,Schneider; Christina,92,0,100,8
1653299901085,POLI 165,A00,090957,Warren; Scott,45,0,50,5
1653299901609,POLI 178,A00,090958,Joseph; Michael F,34,0,50,16
1653299902136,POLI 191A,A00,090959,Forman; Fonna & Hoston; Germaine,25,0,25,0
1653299902664,POLI 194,A00,090960,Hill; Seth J,9999,0,9999,0
1653299903188,POLI 194SD,A00,090961,Nichter; Maysa,9999,0,9999,0
1653299903721,POLI 197SD,001,090962,Nichter; Maysa,9999,0,9999,0
1653299904244,PSYC 1,A00,088391,Ferreira; Victor,194,0,200,6
1653299904766,PSYC 2,A00,093916,Moranton; Nirelia Melbina-,192,0,195,3
1653299905289,PSYC 3,A00,088392,Pilegard; Celeste Cristine,221,0,225,4
1653299905814,PSYC 6,A00,088393,McCullough; Michael E,198,0,200,2
1653299906339,PSYC 7,A00,088394,Powell; Lindsey Jane,196,0,200,4
1653299906872,PSYC 60,A01,088397,Lowe; Angela Beth,12,0,25,13
1653299906872,PSYC 60,A02,088398,Lowe; Angela Beth,25,0,25,0
1653299906872,PSYC 60,A03,088399,Lowe; Angela Beth,24,0,25,1
1653299906872,PSYC 60,A04,088400,Lowe; Angela Beth,23,0,25,2
1653299906872,PSYC 60,A05,088401,Lowe; Angela Beth,24,0,25,1
1653299906872,PSYC 60,A06,088402,Lowe; Angela Beth,25,0,25,0
1653299906872,PSYC 60,A07,088403,Lowe; Angela Beth,24,0,25,1
1653299906872,PSYC 60,B01,088405,Rickard; Timothy C.,25,0,25,0
1653299906872,PSYC 60,B02,088406,Rickard; Timothy C.,25,0,25,0
1653299906872,PSYC 60,B03,088407,Rickard; Timothy C.,25,0,25,0
1653299906872,PSYC 60,B04,088408,Rickard; Timothy C.,23,0,25,2
1653299906872,PSYC 60,B05,088410,Rickard; Timothy C.,24,0,25,1
1653299906872,PSYC 60,B06,088411,Rickard; Timothy C.,24,0,25,1
1653299906872,PSYC 60,B07,088412,Rickard; Timothy C.,24,0,25,1
1653299907394,PSYC 70,A01,088414,Pilegard; Celeste Cristine,17,0,25,8
1653299907394,PSYC 70,A02,088415,Pilegard; Celeste Cristine,24,0,25,1
1653299907394,PSYC 70,A03,088416,Pilegard; Celeste Cristine,25,0,25,0
1653299907394,PSYC 70,A04,088417,Pilegard; Celeste Cristine,25,0,25,0
1653299907394,PSYC 70,A05,088418,Pilegard; Celeste Cristine,22,0,25,3
1653299907394,PSYC 70,A06,088419,Pilegard; Celeste Cristine,19,0,25,6
1653299907923,PSYC 71,A01,088421,Lowe; Angela Beth,15,0,25,10
1653299907923,PSYC 71,A02,088422,Lowe; Angela Beth,21,0,25,4
1653299907923,PSYC 71,B01,088424,Steiner; Eric Tomas,20,0,25,5
1653299907923,PSYC 71,B02,088425,Steiner; Eric Tomas,23,0,25,2
1653299908449,PSYC 87,A00,093915,Gorman; Michael R.,20,0,20,0
1653299908975,PSYC 88,A00,088426,Dobkins; Karen R.,61,0,65,4
1653299909500,PSYC 100,A00,088428,Chapman; Eddie Nathaniel,125,0,170,45
1653299910035,PSYC 101,A00,088429,Heyman; Gail D.,148,0,170,22
1653299910560,PSYC 102,A00,093917,Moranton; Nirelia Melbina-,162,0,170,8
1653299911087,PSYC 104,A00,088430,Fine; Rachel,163,0,175,12
1653299911615,PSYC 116A,A01,088433,Lang; Ariel,25,0,25,0
1653299912138,PSYC 122,A00,088434,Miller; Cory T.,103,0,115,12
1653299912662,PSYC 125,A00,088436,Rose; Fred E.,90,0,120,30
1653299913187,PSYC 134,A00,088437,Kaye; Walter H.,235,0,250,15
1653299913711,PSYC 137,A00,088438,Fine; Rachel,210,0,216,6
1653299914235,PSYC 145,A00,093918,Staff,73,0,90,17
1653299914774,PSYC 147,A00,088441,Wong; Lauren Hitomi,120,0,146,26
1653299915301,PSYC 154,A00,093919,Lacefield; Katharine I,270,0,295,25
1653299915830,PSYC 158,A00,088443,Willis; Jarryd Thomas,250,0,295,45
1653299916353,PSYC 162,A00,088444,Wixted; John T,210,0,225,15
1653299916881,PSYC 167,A00,088445,Walker; Caren Michelle,0,0,30,30
1653299917406,PSYC 168,A00,088446,Chapman; Eddie Nathaniel,222,0,250,28
1653299917931,PSYC 171,A00,088447,Mukku; Dhananjaya,66,0,75,9
1653299918457,PSYC 178,A00,088448,Glaser; Dale,105,0,120,15
1653299918983,PSYC 179,A00,088449,Lacefield; Katharine I,193,0,250,57
1653299919515,PSYC 181,A00,088450,Anagnostaras; Stephan,284,0,300,16
1653299920042,PSYC 189,A00,088451,Gentner; Tim,19,0,31,12
1653299920570,PSYC 193,A00,088452,Gremel; Christina M,19,0,20,1
1653299920570,PSYC 193,B00,088453,Staff,19,0,20,1
1653299921098,PSYC 193L,A01,088455,Staff,33,0,35,2
1653299921628,PSYC 194A,A01,088461,Heyman; Gail D.,35,0,35,0
1653299922153,RELI 1,A01,086478,Kalleres; Dayna,20,0,20,0
1653299922153,RELI 1,A02,086479,Kalleres; Dayna,19,0,20,1
1653299922679,RELI 147,A00,088409,Caciola; Nancy A,0,0,0,0
1653299923206,REV 1,A01,092308,Leigh; Brian,24,0,24,0
1653299923206,REV 1,A02,092310,Leigh; Brian,24,0,24,0
1653299923206,REV 1,A03,092312,Leigh; Brian,24,0,24,0
1653299923206,REV 1,A04,092314,Leigh; Brian,24,0,24,0
1653299923206,REV 1,A05,092316,Leigh; Brian,24,0,24,0
1653299923731,REV 2,A01,092318,Staff,28,0,28,0
1653299923731,REV 2,A02,092319,Staff,28,0,28,0
1653299924254,REV 20,A00,092320,Staff,40,0,40,0
1653299924777,REV 87,A00,092321,Lyon; Antony J.,20,0,20,0
1653299925307,SE 1,A01,088674,Van Den Einde; Yael Dahlia,48,0,48,0
1653299925307,SE 1,A02,088675,Van Den Einde; Yael Dahlia,47,0,48,1
1653299925307,SE 1,A03,088676,Van Den Einde; Yael Dahlia,46,0,48,2
1653299925829,SE 101A,A00,088677,Morrison; Machel Leigh,191,0,200,9
1653299926355,SE 101C,A00,088678,Zhu; Qiang,137,0,145,8
1653299926878,SE 125,A00,088679,Conte; Joel P,143,0,145,2
1653299927403,SE 130A,A00,088680,Loh; Kenneth J. H.,110,0,115,5
1653299927926,SE 131B,A00,088681,Krysl; Petr,84,0,115,31
1653299928459,SE 142,A01,088683,Staff,11,0,18,7
1653299928459,SE 142,A02,088684,Staff,13,0,18,5
1653299928985,SE 164,A01,088686,Loh; Kenneth J. H.,14,0,16,2
1653299929512,SE 180,A00,088687,Elgamal; Ahmed,66,0,75,9
1653299930035,SE 181,A01,088689,McCartney; John Scott,25,0,30,5
1653299930035,SE 181,A02,088690,McCartney; John Scott,14,0,30,16
1653299930035,SE 181,A03,088691,McCartney; John Scott,25,0,25,0
1653299930035,SE 181,A04,088692,McCartney; John Scott,25,0,25,0
1653299930559,SIO 12,A00,088342,Staff,141,0,146,5
1653299931082,SIO 15,A00,088343,Laske; Gabi,333,0,340,7
1653299931621,SIO 30,A01,092382,Castillo; Paterno R.,28,0,35,7
1653299931621,SIO 30,A02,092383,Castillo; Paterno R.,32,0,35,3
1653299931621,SIO 30,A03,092384,Castillo; Paterno R.,35,0,35,0
1653299931621,SIO 30,A04,092385,Castillo; Paterno R.,35,0,35,0
1653299932158,SIO 40,A00,088345,Barbeau; Katherine,144,0,146,2
1653299932681,SIO 50,A01,088347,Cook; Geoffrey W,11,0,14,3
1653299932681,SIO 50,A02,088348,Cook; Geoffrey W,11,0,14,3
1653299933211,SIO 87,A00,088350,Cook; Geoffrey W,20,0,20,0
1653299933211,SIO 87,B00,088351,Cook; Geoffrey W,20,0,20,0
1653299933211,SIO 87,C00,094017,Gilbert; Jack Anthony,20,0,20,0
1653299933211,SIO 87,D00,094018,Gerwick; William Henry,20,0,20,0
1653299933735,SIO 90,A00,088352,Staff,56,0,60,4
1653299934271,SIO 100,A00,088354,Norris; Richard D. & Gee; Jeffrey S,10,0,20,10
1653299934811,SIO 101,A01,088356,Aluwihare; Lihini & Decima; Moira R.,1,0,30,29
1653299934811,SIO 101,A02,088357,Aluwihare; Lihini & Decima; Moira R.,15,0,30,15
1653299935338,SIO 103,A01,088359,Parnell-Turner; Ross Ernes,21,0,25,4
1653299935861,SIO 105,A00,088360,Driscoll; Neal W.,18,0,20,2
1653299936385,SIO 108,A01,088363,Teranes; Jane,15,0,20,5
1653299936909,SIO 109R,A00,088364,Forman; Fonna,27,0,40,13
1653299937435,SIO 110,A01,088366,Staff,8,0,29,21
1653299937968,SIO 117,A01,088368,Keeling; Ralph F.,31,0,36,5
1653299938493,SIO 123,A00,088369,Allen; Andrew Ellis,61,0,70,9
1653299939035,SIO 132,A01,092386,Hechinger; Ryan F. & Kacev; David,17,0,28,11
1653299939035,SIO 132,A02,092387,Hechinger; Ryan F. & Kacev; David,26,0,28,2
1653299939035,SIO 132,A03,092388,Hechinger; Ryan F. & Kacev; David,28,0,28,0
1653299939035,SIO 132,A04,092389,Hechinger; Ryan F. & Kacev; David,23,0,28,5
1653299939035,SIO 132,A05,092390,Hechinger; Ryan F. & Kacev; David,27,0,28,1
1653299939035,SIO 132,A06,092391,Hechinger; Ryan F. & Kacev; David,27,0,28,1
1653299939558,SIO 136,A01,088373,Kacev; David & Bowman; Jeff Shovlowsky,0,0,5,7
1653299939558,SIO 136,B01,088376,Kacev; David & Bowman; Jeff Shovlowsky,0,0,5,5
1653299940086,SIO 155,A01,088379,Day; James M.D.,1,0,5,4
1653299940610,SIO 170,A00,088380,Cook; Geoffrey W,29,0,30,1
1653299941139,SIO 171,A01,088382,Rudnick; Daniel Lars,37,0,40,3
1653299941663,SIO 175,A01,088384,Merrifield; Mark A,22,0,25,3
1653299942189,SIO 177,A00,088385,Becker; Janet Maria,15,0,20,5
1653299942731,SIO 179,A01,088387,Martz; Todd R.,7,0,15,8
1653299943780,SIO 189,A00,088390,Hamdoun; Amr,35,0,60,25
1653299944304,SIO 194,A00,091602,Hill; Seth J,9999,0,9999,0
1653299944830,SOCE 194,A00,091601,Hill; Seth J,9999,0,9999,0
1653299945359,SOCI 1,A01,093704,Skrentny; John David,19,0,20,1
1653299945359,SOCI 1,A02,093705,Skrentny; John David,20,0,20,0
1653299945359,SOCI 1,A03,093706,Skrentny; John David,18,0,20,2
1653299945359,SOCI 1,A04,093707,Skrentny; John David,19,0,20,1
1653299945359,SOCI 1,A05,093708,Skrentny; John David,17,0,20,3
1653299945359,SOCI 1,A06,093709,Skrentny; John David,20,0,20,0
1653299945359,SOCI 1,A07,093710,Skrentny; John David,20,0,20,0
1653299945359,SOCI 1,A08,093711,Skrentny; John David,20,0,20,0
1653299945359,SOCI 1,A09,093712,Skrentny; John David,20,0,20,0
1653299945359,SOCI 1,A10,093713,Skrentny; John David,20,0,20,0
1653299945359,SOCI 1,A11,093714,Skrentny; John David,20,0,20,0
1653299945882,SOCI 30,A01,093716,Staff,30,0,30,0
1653299945882,SOCI 30,A02,093717,Staff,30,0,30,0
1653299946410,SOCI 60,A01,093719,Staff,17,0,20,3
1653299946410,SOCI 60,A02,093720,Staff,18,0,20,2
1653299946410,SOCI 60,A03,093721,Staff,20,0,20,0
1653299946410,SOCI 60,A04,093722,Staff,20,0,20,0
1653299946934,SOCI 87,A00,093819,Blair-Loy; Mary,20,0,20,0
1653299947458,SOCI 100,A01,093724,Estefan; Michel,15,0,20,5
1653299947458,SOCI 100,A02,093725,Estefan; Michel,5,0,20,15
1653299947984,SOCI 104,A00,093728,Gong; Neil M,22,0,25,3
1653299948511,SOCI 104Q,A00,093729,Staff,23,0,25,2
1653299949035,SOCI 106,A00,093730,Staff,25,0,25,0
1653299949558,SOCI 109,A00,093731,Staff,21,0,25,4
1653299950084,SOCI 110,A00,093732,Binder; Amy,24,0,25,1
1653299951660,SOCI 117,A01,091568,Chung; Luz Marina,29,0,35,6
1653299951660,SOCI 117,A02,091569,Chung; Luz Marina,35,0,35,0
1653299952257,SOCI 118,A00,093735,Staff,0,0,0,0
1653299952781,SOCI 120T,A00,093736,Lampland; Martha,50,0,50,0
1653299952781,SOCI 120T,B00,094832,Staff,69,0,70,1
1653299953305,SOCI 122,A00,093737,Lewis; Kevin Michael,62,0,70,8
1653299953830,SOCI 123,A00,094831,Staff,57,0,65,8
1653299954369,SOCI 125,A00,093738,Staff,115,0,120,5
1653299954899,SOCI 127,A00,094894,Staff,54,0,56,2
1653299955428,SOCI 132,A00,093739,Blair-Loy; Mary,51,0,60,9
1653299956478,SOCI 136F,A00,094830,Staff,45,0,56,11
1653299957004,SOCI 138,A00,093741,Navon; Daniel,117,0,120,3
1653299957526,SOCI 140A,A00,093743,Gong; Neil M,53,0,60,7
1653299958050,SOCI 141,A00,093744,Summers; Valerie R.,111,0,120,9
1653299959100,SOCI 144,A00,093746,Staff,0,0,0,0
1653299961207,SOCI 159,A00,094902,Staff,49,0,50,1
1653299961731,SOCI 160,A00,093750,Staff,0,0,0,0
1653299962259,SOCI 165,A00,093751,Rona-Tas; Akos,43,0,48,5
1653299962782,SOCI 165A,A00,094206,Hallin; Daniel C,3,0,4,1
1653299963311,SOCI 166,A00,093752,Lampland; Martha,52,0,56,4
1653299963838,SOCI 176,A00,093753,Turner; Christena L.,44,0,48,4
1653299964361,SOCI 180,A00,094901,Staff,56,0,56,0
1653299964889,SOCI 185,A00,094903,Staff,55,0,56,1
1653299965415,SOCI 196A,A00,093754,Shafir; Gershon,20,0,20,0
1653299965938,SXTH 1,A01,092351,Bronstein; Phoebe Malan,18,0,18,0
1653299965938,SXTH 1,A02,092352,Bronstein; Phoebe Malan,18,0,18,0
1653299965938,SXTH 1,A03,092353,Bronstein; Phoebe Malan,18,0,18,0
1653299966461,SXTH 20A,A00,092355,Chilukuri; Lakshmi N,56,0,56,0
1653299966994,SYN 2,001,091487,Gladstein; Jill M,13,0,15,2
1653299966994,SYN 2,002,091488,Gladstein; Jill M,14,0,15,1
1653299966994,SYN 2,003,091490,Gladstein; Jill M,12,0,15,3
1653299966994,SYN 2,004,091491,Gladstein; Jill M,15,0,15,0
1653299966994,SYN 2,005,091493,Gladstein; Jill M,15,0,15,0
1653299966994,SYN 2,006,091495,Gladstein; Jill M,15,0,15,0
1653299966994,SYN 2,007,091496,Gladstein; Jill M,15,0,15,0
1653299966994,SYN 2,008,091497,Gladstein; Jill M,14,0,15,1
1653299966994,SYN 2,009,091499,Gladstein; Jill M,13,0,15,2
1653299966994,SYN 2,010,091501,Gladstein; Jill M,13,0,15,2
1653299966994,SYN 2,011,091502,Gladstein; Jill M,13,0,15,2
1653299966994,SYN 2,012,091503,Gladstein; Jill M,15,0,15,0
1653299966994,SYN 2,013,091505,Gladstein; Jill M,13,0,15,2
1653299966994,SYN 2,014,091506,Gladstein; Jill M,12,0,15,3
1653299966994,SYN 2,015,091508,Gladstein; Jill M,14,0,15,1
1653299966994,SYN 2,016,091509,Gladstein; Jill M,12,0,15,3
1653299966994,SYN 2,017,091510,Gladstein; Jill M,14,0,15,1
1653299966994,SYN 2,018,091512,Gladstein; Jill M,15,0,15,0
1653299966994,SYN 2,019,091513,Gladstein; Jill M,15,0,15,0
1653299966994,SYN 2,020,091514,Gladstein; Jill M,15,0,15,0
1653299966994,SYN 2,021,091516,Gladstein; Jill M,12,0,15,3
1653299966994,SYN 2,022,091517,Gladstein; Jill M,13,0,15,2
1653299966994,SYN 2,023,091518,Gladstein; Jill M,15,0,15,0
1653299966994,SYN 2,024,091519,Gladstein; Jill M,15,0,15,0
1653299966994,SYN 2,025,091520,Gladstein; Jill M,11,0,15,4
1653299966994,SYN 2,026,091521,Gladstein; Jill M,15,0,15,0
1653299966994,SYN 2,027,091522,Gladstein; Jill M,0,0,0,0
1653299966994,SYN 2,028,091523,Gladstein; Jill M,0,0,0,0
1653299966994,SYN 2,029,091524,Gladstein; Jill M,0,0,0,0
1653299966994,SYN 2,030,091525,Gladstein; Jill M,0,0,0,0
1653299966994,SYN 2,031,091526,Gladstein; Jill M,14,0,15,1
1653299966994,SYN 2,032,091527,Gladstein; Jill M,15,0,15,0
1653299966994,SYN 2,033,091528,Gladstein; Jill M,0,0,0,0
1653299966994,SYN 2,034,091529,Gladstein; Jill M,15,0,15,0
1653299966994,SYN 2,035,091530,Gladstein; Jill M,15,0,15,0
1653299966994,SYN 2,036,091531,Gladstein; Jill M,15,0,15,0
1653299966994,SYN 2,037,091532,Gladstein; Jill M,15,0,15,0
1653299966994,SYN 2,038,091533,Gladstein; Jill M,15,0,15,0
1653299966994,SYN 2,039,091534,Gladstein; Jill M,15,0,15,0
1653299966994,SYN 2,040,091535,Gladstein; Jill M,15,0,15,0
1653299967518,SYN 100,A01,091537,Gladstein; Jill M,26,0,30,4
1653299967518,SYN 100,B01,091539,Gladstein; Jill M,26,0,30,4
1653299967518,SYN 100,C01,091541,Gladstein; Jill M,26,0,30,4
1653299967518,SYN 100,D01,091543,Gladstein; Jill M,25,0,30,5
1653299967518,SYN 100,E01,091545,Gladstein; Jill M,28,0,30,2
1653299968047,TDAC 1,A00,088922,Walsh; Kim C.,10,0,10,0
1653299968047,TDAC 1,B00,088923,Walsh; Kim C.,8,0,10,2
1653299968047,TDAC 1,C00,088924,Walsh; Kim C.,0,0,10,10
1653299968047,TDAC 1,D00,088925,Walsh; Kim C.,7,0,10,3
1653299968047,TDAC 1,E00,088926,Walsh; Kim C.,2,0,10,8
1653299968047,TDAC 1,F00,088927,Walsh; Kim C.,9,0,10,1
1653299968582,TDAC 101,A00,088972,Harting; Carla Kelso,9,0,10,1
1653299968582,TDAC 101,B00,088973,Salovey; Todd,8,0,10,2
1653299968582,TDAC 101,C00,088974,Walsh; Kim C.,6,0,10,4
1653299969106,TDAC 102,A00,088975,Basso; Beatrice,9,0,10,1
1653299969106,TDAC 102,B00,088976,Basso; Beatrice,7,0,10,3
1653299969634,TDAC 103A,A00,094044,Castro; Robert Jess,32,0,35,3
1653299970156,TDAC 108,A00,088977,Staff,20,0,20,0
1653299970679,TDAC 109,A00,088978,Blair; Kyle Adam,20,0,20,0
1653299971214,TDAC 115,A00,088979,Newcomb; James,20,0,20,0
1653299971748,TDAC 122,A00,088981,Staff,30,0,30,0
1653299972274,TDAC 123,A00,088982,Staff,30,0,30,0
1653299972797,TDDE 1,A01,088929,Benzoni; Elisa,9,0,11,2
1653299972797,TDDE 1,A02,088930,Benzoni; Elisa,11,0,11,0
1653299972797,TDDE 1,A03,088931,Benzoni; Elisa,11,0,11,0
1653299972797,TDDE 1,A04,088932,Benzoni; Elisa,10,0,11,1
1653299972797,TDDE 1,A05,088933,Benzoni; Elisa,11,0,11,0
1653299973322,TDDE 130,A00,088983,Staff,20,0,20,0
1653299973845,TDDE 132,A00,094263,Staff,20,0,20,0
1653299974371,TDDE 169A,A00,094046,Petrovich; Victoria A.,18,0,20,2
1653299974894,TDDM 1,A00,088934,Snaith; Yolande,6,0,10,4
1653299975420,TDDM 5,A00,088935,Smith; Alison D,30,0,30,0
1653299975947,TDDR 101,A00,088986,Powell; Lora,34,0,35,1
1653299976474,TDDR 111,A00,088987,Stalling; Vanessa,24,0,30,6
1653299976474,TDDR 111,B00,094045,Castro; Robert Jess,14,0,16,2
1653299976999,TDDR 190,A00,088988,Stalling; Vanessa,10,0,10,0
1653299977529,TDGE 1,A01,088937,Salovey; Todd,12,0,12,0
1653299977529,TDGE 1,A02,088938,Salovey; Todd,10,0,12,2
1653299977529,TDGE 1,A03,088939,Salovey; Todd,8,0,12,4
1653299977529,TDGE 1,A04,088940,Salovey; Todd,12,0,12,0
1653299977529,TDGE 1,A05,088941,Salovey; Todd,11,0,12,1
1653299977529,TDGE 1,A06,088942,Salovey; Todd,12,0,12,0
1653299978052,TDGE 10,A00,088943,Havis; Allan,191,0,200,9
1653299978578,TDGE 11,A00,088944,Staff,200,0,200,0
1653299979102,TDGE 25,A00,088945,Harting; Carla Kelso,19,0,20,1
1653299979102,TDGE 25,B00,088946,Harting; Carla Kelso,19,0,20,1
1653299979102,TDGE 25,C00,088947,Harting; Carla Kelso,20,0,20,0
1653299979102,TDGE 25,D00,088948,Harting; Carla Kelso,19,0,20,1
1653299979102,TDGE 25,E00,088949,Harting; Carla Kelso,20,0,20,0
1653299979102,TDGE 25,F00,088950,Harting; Carla Kelso,19,0,20,1
1653299979102,TDGE 25,G00,088951,Harting; Carla Kelso,19,0,20,1
1653299979624,TDGE 127,A00,088990,Havis; Allan,188,0,200,12
1653299980147,TDHD 21,A00,088952,Jun; Grace Shin Hae,20,0,20,0
1653299980677,TDHT 10,A00,088953,Power; Jade Yukana,14,0,14,0
1653299980677,TDHT 10,B00,088954,Power; Jade Yukana,13,0,14,1
1653299981200,TDHT 21,A01,088956,Power; Jade Yukana,17,0,18,1
1653299981200,TDHT 21,A02,088957,Power; Jade Yukana,7,0,11,4
1653299981200,TDHT 21,A03,088958,Power; Jade Yukana,11,0,11,0
1653299981772,TDHT 101,A00,088994,Burelle; Julie Sara Veronique,21,0,25,4
1653299982300,TDHT 114,A00,094208,Williams; Madison Mae,47,0,50,3
1653299982827,TDHT 119,A00,094299,Burelle; Julie Sara Veronique,25,0,25,0
1653299983353,TDMV 1,A00,088959,Weinberg; Sadie,23,0,30,7
1653299983876,TDMV 2,A00,088960,Sammartano; Tonnie,27,0,30,3
1653299983876,TDMV 2,B00,094043,Duran; Marcos Antonio,29,0,30,1
1653299984399,TDMV 3,A00,088961,Arcidiacono; Kristin,27,0,30,3
1653299984924,TDMV 110,A00,088995,Wilson; Terry A.,0,0,0,0
1653299985447,TDMV 120,A00,088996,Smith; Alison D,17,0,20,3
1653299985974,TDMV 122,A00,088997,Chaleff; Rebecca,28,0,30,2
1653299986496,TDMV 130,A00,094042,Rincon; Alicia,30,0,30,0
1653299987023,TDMV 138,A00,088998,Jun; Grace Shin Hae,12,0,40,28
1653299987561,TDMV 142,A00,088999,Caligagan; Tony,28,0,40,12
1653299988085,TDMV 143,A00,094041,Foster-King; Sandra,37,0,40,3
1653299988616,TDMV 146,A00,089000,Caligagan; Tony,39,0,40,1
1653299989141,TDPF 160,A00,094264,Snaith; Yolande,30,0,30,0
1653299989141,TDPF 160,B00,094265,Smith; Alison D,30,0,30,0
1653299989141,TDPF 160,C00,094266,Weinberg; Sadie,30,0,30,0
1653299989665,TDPR 6,A01,088963,Benzoni; Elisa,25,0,25,0
1653299989665,TDPR 6,A02,088964,Benzoni; Elisa,25,0,25,0
1653299990188,TDPR 102,A00,089003,Staff,15,0,15,0
1653299990714,TDPR 104,A00,089004,Powell; Lora,15,0,15,0
1653299991236,TDPW 1,A00,088965,Staff,10,0,10,0
1653299991236,TDPW 1,B00,088966,Staff,10,0,10,0
1653299991236,TDPW 1,C00,088967,Staff,9,0,10,1
1653299991236,TDPW 1,D00,088968,Staff,9,0,10,1
1653299991236,TDPW 1,E00,088969,Staff,10,0,10,0
1653299991236,TDPW 1,F00,088970,Staff,9,0,10,1
1653299991780,TDTR 10,A00,088971,Wilson; Terry A.,22,0,25,3
1653299992303,TMC 2,A01,092358,Carver; Leslie J.,20,0,20,0
1653299992303,TMC 2,A02,092359,Carver; Leslie J.,20,0,20,0
1653299992303,TMC 2,A03,092360,Carver; Leslie J.,20,0,20,0
1653299992303,TMC 2,A04,092361,Carver; Leslie J.,20,0,20,0
1653299992303,TMC 2,A05,092362,Carver; Leslie J.,20,0,20,0
1653299992303,TMC 2,A06,092363,Carver; Leslie J.,20,0,20,0
1653299992827,TMC 15,A00,092364,Atkinson; Arthur Laird,20,0,20,0
1653299993350,TMC 20,A00,092365,Carver; Leslie J.,20,0,20,0
1653299993885,TMC 90,A00,092366,Mell; Loren K.,20,0,20,0
1653299994413,TMC 120,A01,092368,Staff,20,0,20,0
1653299994946,USP 1,A01,087520,Kwak; Nancy,19,0,20,1
1653299994946,USP 1,A02,087521,Kwak; Nancy,17,0,20,3
1653299994946,USP 1,A03,087522,Kwak; Nancy,16,0,20,4
1653299994946,USP 1,A04,087523,Kwak; Nancy,19,0,20,1
1653299995469,USP 2,A01,087525,Lerner; Amy M,29,0,30,1
1653299995469,USP 2,A02,087526,Lerner; Amy M,29,0,30,1
1653299995992,USP 4,A00,094267,Polat; Soydan Alihan,16,0,20,4
1653299995992,USP 4,B00,094268,Staff,20,0,20,0
1653299996515,USP 5,A01,087532,Staff,26,0,30,4
1653299996515,USP 5,A02,087533,Staff,27,0,30,3
1653299997050,USP 6,A01,094322,Shvartzberg Carrio; Manuel,20,0,20,0
1653299997050,USP 6,A02,094323,Shvartzberg Carrio; Manuel,20,0,20,0
1653299997580,USP 15,A01,087535,Anderson; William Raymond,20,0,25,5
1653299997580,USP 15,A02,087536,Anderson; William Raymond,23,0,25,2
1653299998107,USP 25,A00,087537,Staff,0,0,7,7
1653299998631,USP 50,A00,087538,Martin; Isaac,38,0,40,2
1653299999157,USP 124,A00,087539,Bussell; Mirle Rabinowitz,26,0,35,9
1653299999682,USP 125,A00,087540,Staff,17,0,23,6
1653300000208,USP 136,A00,087541,Staff,23,0,25,2
1653300000735,USP 144,A00,087542,Staff,136,0,146,10
1653300001273,USP 151,A00,087543,Boomhower; Matthew Charles,18,0,20,2
1653300001796,USP 152,A01,087545,Moeder; Nathan L,17,0,20,3
1653300001796,USP 152,A02,087546,Moeder; Nathan L,20,0,20,0
1653300002324,USP 153,A00,087547,Moden; Kelly Kjestine,27,0,30,3
1653300002848,USP 161,A00,094854,Wartell; Julie Dara,25,0,25,0
1653300003378,USP 169,A00,087548,Bajaj; Ravi Siddharth,30,0,35,5
1653300003919,USP 170,A00,087549,Hinds; Juli Beth,30,0,35,5
1653300004442,USP 171,A00,087550,Lerner; Amy M,38,0,50,12
1653300004965,USP 176,A00,094853,Staff,24,0,25,1
1653300005588,USP 177A,A00,087551,Peerson; Susan,20,0,22,2
1653300006109,USP 184,A00,094324,Shvartzberg Carrio; Manuel,24,0,25,1
1653300006637,USP 185A,A01,087553,Norr; Alex Vaughn,28,0,30,2
1653300006637,USP 185A,B01,087555,Boomhower; Matthew Charles,26,0,30,4
1653300007164,USP 186,A01,087557,Pezzoli; Keith,22,0,25,3
1653300007164,USP 186,A02,087558,Pezzoli; Keith,20,0,25,5
1653300008237,USP 191A,A00,087561,Rothberg; Scott Jacob,18,0,20,2
1653300008777,USP 194,A00,091599,Hill; Seth J,9999,0,9999,0
1653300009311,VIS 1,A01,088809,Tonies; Joshua Vanjaymes,10,0,10,0
1653300009311,VIS 1,A02,088810,Tonies; Joshua Vanjaymes,10,0,10,0
1653300009311,VIS 1,A03,088811,Tonies; Joshua Vanjaymes,3,0,10,7
1653300009311,VIS 1,A04,088812,Tonies; Joshua Vanjaymes,8,0,10,2
1653300009311,VIS 1,A05,088813,Tonies; Joshua Vanjaymes,4,0,10,6
1653300009311,VIS 1,A06,088814,Tonies; Joshua Vanjaymes,6,0,10,4
1653300009311,VIS 1,A07,088815,Tonies; Joshua Vanjaymes,6,0,10,4
1653300009311,VIS 1,A08,088816,Tonies; Joshua Vanjaymes,9,0,10,1
1653300009311,VIS 1,A09,088817,Tonies; Joshua Vanjaymes,8,0,10,2
1653300009311,VIS 1,A10,088818,Tonies; Joshua Vanjaymes,8,0,10,2
1653300009311,VIS 1,A11,088819,Tonies; Joshua Vanjaymes,3,0,10,7
1653300009311,VIS 1,A12,088820,Tonies; Joshua Vanjaymes,6,0,10,4
1653300009311,VIS 1,A13,088821,Tonies; Joshua Vanjaymes,6,0,10,4
1653300009311,VIS 1,A14,088822,Tonies; Joshua Vanjaymes,7,0,10,3
1653300009311,VIS 1,A15,088823,Tonies; Joshua Vanjaymes,7,0,10,3
1653300009311,VIS 1,A16,088824,Tonies; Joshua Vanjaymes,8,0,10,2
1653300009836,VIS 20,A01,088826,Woods; Ann,19,0,20,1
1653300009836,VIS 20,A02,088827,Woods; Ann,20,0,20,0
1653300009836,VIS 20,A03,088828,Woods; Ann,18,0,20,2
1653300009836,VIS 20,A04,088829,Woods; Ann,17,0,20,3
1653300009836,VIS 20,A05,088830,Woods; Ann,20,0,20,0
1653300009836,VIS 20,A06,088831,Woods; Ann,20,0,20,0
1653300009836,VIS 20,A07,088832,Woods; Ann,20,0,20,0
1653300009836,VIS 20,A08,088833,Woods; Ann,20,0,20,0
1653300009836,VIS 20,A09,088834,Woods; Ann,18,0,20,2
1653300009836,VIS 20,A10,088835,Woods; Ann,19,0,20,1
1653300009836,VIS 20,A11,088836,Woods; Ann,20,0,20,0
1653300009836,VIS 20,A12,088837,Woods; Ann,20,0,20,0
1653300010361,VIS 23,A00,088838,Rose; Jordan M,3,0,3,0
1653300010888,VIS 30,A01,088840,Stone; Patricia,11,0,11,0
1653300010888,VIS 30,A02,088841,Stone; Patricia,7,0,11,4
1653300010888,VIS 30,A03,094821,Stone; Patricia,8,0,11,3
1653300010888,VIS 30,A04,094822,Stone; Patricia,11,0,11,0
1653300011424,VIS 41,A01,088844,D'Elena-Tweed; Jessica Erin,9,0,10,1
1653300011424,VIS 41,A02,088845,D'Elena-Tweed; Jessica Erin,9,0,10,1
1653300011424,VIS 41,A03,088846,D'Elena-Tweed; Jessica Erin,9,0,10,1
1653300011424,VIS 41,A04,088847,D'Elena-Tweed; Jessica Erin,9,0,10,1
1653300011424,VIS 41,A05,088848,D'Elena-Tweed; Jessica Erin,10,0,10,0
1653300011424,VIS 41,A06,088849,D'Elena-Tweed; Jessica Erin,10,0,10,0
1653300011424,VIS 41,A07,088850,D'Elena-Tweed; Jessica Erin,10,0,10,0
1653300011424,VIS 41,A08,088851,D'Elena-Tweed; Jessica Erin,10,0,10,0
1653300011961,VIS 60,A01,088853,Sepuya; Paul Mpagi,9,0,10,1
1653300011961,VIS 60,A02,088854,Sepuya; Paul Mpagi,10,0,10,0
1653300011961,VIS 60,A03,088855,Sepuya; Paul Mpagi,10,0,10,0
1653300011961,VIS 60,A04,088856,Sepuya; Paul Mpagi,10,0,10,0
1653300011961,VIS 60,A05,088857,Sepuya; Paul Mpagi,10,0,10,0
1653300011961,VIS 60,A06,088858,Sepuya; Paul Mpagi,10,0,10,0
1653300011961,VIS 60,A07,088859,Sepuya; Paul Mpagi,9,0,10,1
1653300011961,VIS 60,A08,093932,Sepuya; Paul Mpagi,10,0,10,0
1653300012487,VIS 70N,A01,088861,Segade; Alexandro Abraham,8,0,8,0
1653300012487,VIS 70N,A02,088862,Segade; Alexandro Abraham,8,0,8,0
1653300012487,VIS 70N,A03,088863,Segade; Alexandro Abraham,8,0,8,0
1653300012487,VIS 70N,A04,088864,Segade; Alexandro Abraham,8,0,8,0
1653300012487,VIS 70N,A05,088865,Segade; Alexandro Abraham,7,0,8,1
1653300012487,VIS 70N,A06,088866,Segade; Alexandro Abraham,8,0,8,0
1653300013016,VIS 80,A01,088868,Adler; Amy,9,0,10,1
1653300013016,VIS 80,A02,088869,Adler; Amy,8,0,10,2
1653300013016,VIS 80,A03,088870,Adler; Amy,9,0,10,1
1653300013016,VIS 80,A04,088871,Adler; Amy,8,0,10,2
1653300013016,VIS 80,A05,088872,Adler; Amy,10,0,10,0
1653300013016,VIS 80,A06,088873,Adler; Amy,7,0,10,3
1653300013545,VIS 100,A00,088874,Cruz; Edwin Teddy,65,0,75,10
1653300014072,VIS 105A,A00,088875,Tonies; Joshua Vanjaymes,26,0,30,4
1653300014618,VIS 105B,A00,088876,Staff,25,0,30,5
1653300015144,VIS 106A,A00,088877,Tobe; Geoffroy,21,0,25,4
1653300015667,VIS 106B,A00,088878,Staff,21,0,25,4
1653300016193,VIS 106C,A00,088879,Staff,9,0,15,6
1653300016719,VIS 107B,A00,088880,Gallaccio; Anya,24,0,25,1
1653300017243,VIS 108,A00,093894,Gallaccio; Anya,5,0,15,10
1653300017768,VIS 110A,A00,093895,Dean; Danielle Adobi,15,0,15,0
1653300018293,VIS 110B,A00,088881,Adler; Amy,14,0,15,1
1653300018844,VIS 125E,A00,093896,Welchman; John C.,75,0,75,0
1653300019367,VIS 126HN,A00,088882,Newsome; Elizabeth Ann,74,0,75,1
1653300019896,VIS 126P,A00,088883,Wardwell; Mariana Razo,72,0,75,3
1653300020418,VIS 128E,A00,088884,Staff,68,0,75,7
1653300020947,VIS 132,A00,088885,Miller; Nicole L,15,0,15,0
1653300021475,VIS 133,A01,094348,D'Elena-Tweed; Jessica Erin,34,0,34,0
1653300021475,VIS 133,A02,094492,D'Elena-Tweed; Jessica Erin,33,0,34,1
1653300021999,VIS 142,A01,088887,Stalbaum; Brett,14,0,15,1
1653300021999,VIS 142,A02,088888,Stalbaum; Brett,10,0,15,5
1653300021999,VIS 142,A03,088889,Stalbaum; Brett,15,0,15,0
1653300021999,VIS 142,A04,088890,Stalbaum; Brett,8,0,15,7
1653300021999,VIS 142,A05,088891,Stalbaum; Brett,14,0,15,1
1653300021999,VIS 142,A06,094828,Stalbaum; Brett,15,0,15,0
1653300022527,VIS 143,A00,088892,Akten; Mehmet,11,0,22,11
1653300023053,VIS 147A,A01,088894,Stalbaum; Brett,20,0,22,2
1653300023053,VIS 147A,A02,088895,Stalbaum; Brett,17,0,22,5
1653300023585,VIS 149,A00,088896,Akten; Mehmet,11,0,15,4
1653300024106,VIS 150,A00,093893,Tufenkian; Armand Yervant,24,0,30,6
1653300024631,VIS 151A,A00,088897,Williams; Alena J,13,0,15,2
1653300025157,VIS 163,A00,088901,Bratton; Benjamin H.,75,0,75,0
1653300025687,VIS 164,A00,088902,Nakayama; Yue,22,0,22,0
1653300026214,VIS 165A,A00,093892,Cross; Brian R,19,0,22,3
1653300026750,VIS 167,A00,088903,Ortiz-Torres; Ruben,19,0,22,3
1653300027275,VIS 174,A00,088905,Staff,21,0,22,1
1653300027275,VIS 174,B00,088906,Kauffmann; Casey,22,0,22,0
1653300027802,VIS 175,A00,093891,Staff,18,0,22,4
1653300028326,VIS 177,A00,088907,Segade; Alexandro Abraham,20,0,22,2
1653300028849,VIS 178,A00,093890,Staff,17,0,22,5
1653300029373,VIS 179,A00,093889,Kauffmann; Casey,21,0,22,1
1653300029903,VIS 180A,A00,093888,Nakayama; Yue,16,0,22,6
1653300030428,VIS 180B,A00,088908,Miller; Nicole L,21,0,22,1
1653300030957,VIS 183A,A00,088909,Sepuya; Paul Mpagi,20,0,22,2
1653300031484,WCWP 10A,001,086588,Gagnon; Jeffrey C,15,0,15,0
1653300031484,WCWP 10A,002,086589,Gagnon; Jeffrey C,14,0,15,1
1653300031484,WCWP 10A,003,086590,Gagnon; Jeffrey C,15,0,15,0
1653300031484,WCWP 10A,004,086591,Gagnon; Jeffrey C,15,0,15,0
1653300031484,WCWP 10A,005,086592,Gagnon; Jeffrey C,15,0,15,0
1653300031484,WCWP 10A,006,086593,Gagnon; Jeffrey C,15,0,15,0
1653300031484,WCWP 10A,007,086594,Gagnon; Jeffrey C,15,0,15,0
1653300031484,WCWP 10A,008,086595,Gagnon; Jeffrey C,15,0,15,0
1653300031484,WCWP 10A,009,086596,Gagnon; Jeffrey C,15,0,15,0
1653300031484,WCWP 10A,010,086597,Gagnon; Jeffrey C,15,0,15,0
1653300031484,WCWP 10A,011,086598,Gagnon; Jeffrey C,20,0,20,0
1653300031484,WCWP 10A,012,086599,Gagnon; Jeffrey C,20,0,20,0
1653300031484,WCWP 10A,013,086600,Gagnon; Jeffrey C,20,0,20,0
1653300031484,WCWP 10A,014,086601,Gagnon; Jeffrey C,20,0,20,0
1653300031484,WCWP 10A,015,086602,Gagnon; Jeffrey C,20,0,20,0
1653300031484,WCWP 10A,016,086603,Gagnon; Jeffrey C,20,0,20,0
1653300031484,WCWP 10A,017,086604,Gagnon; Jeffrey C,20,0,20,0
1653300031484,WCWP 10A,018,086605,Gagnon; Jeffrey C,19,0,20,1
1653300031484,WCWP 10A,019,086606,Gagnon; Jeffrey C,19,0,20,1
1653300031484,WCWP 10A,020,086607,Gagnon; Jeffrey C,20,0,20,0
1653300031484,WCWP 10A,021,086608,Gagnon; Jeffrey C,20,0,20,0
1653300031484,WCWP 10A,022,086609,Gagnon; Jeffrey C,20,0,20,0
1653300031484,WCWP 10A,023,086610,Gagnon; Jeffrey C,19,0,20,1
1653300031484,WCWP 10A,024,086611,Gagnon; Jeffrey C,20,0,20,0
1653300031484,WCWP 10A,025,086612,Gagnon; Jeffrey C,0,0,0,0
1653300031484,WCWP 10A,026,086613,Gagnon; Jeffrey C,0,0,0,0
1653300031484,WCWP 10A,027,086614,Gagnon; Jeffrey C,0,0,0,0
1653300031484,WCWP 10A,028,086615,Gagnon; Jeffrey C,0,0,0,0
1653300031484,WCWP 10A,029,086616,Gagnon; Jeffrey C,0,0,0,0
1653300031484,WCWP 10A,030,086617,Gagnon; Jeffrey C,15,0,15,0
1653300031484,WCWP 10A,031,086618,Gagnon; Jeffrey C,15,0,15,0
1653300031484,WCWP 10A,032,093687,Gagnon; Jeffrey C,15,0,15,0
1653300031484,WCWP 10A,033,093688,Gagnon; Jeffrey C,15,0,15,0
1653300031484,WCWP 10A,034,093689,Gagnon; Jeffrey C,0,0,0,0
1653300031484,WCWP 10A,035,093690,Gagnon; Jeffrey C,0,0,0,0
1653300032010,WCWP 10B,003,086621,Gagnon; Jeffrey C,0,0,0,0
1653300032010,WCWP 10B,004,086622,Gagnon; Jeffrey C,16,0,20,4
1653300032010,WCWP 10B,005,086623,Gagnon; Jeffrey C,18,0,20,2
1653300032010,WCWP 10B,006,086624,Gagnon; Jeffrey C,20,0,20,0
1653300032010,WCWP 10B,007,086625,Gagnon; Jeffrey C,0,0,0,0
1653300032533,WCWP 100,A00,086626,McCleary; Keith Long,20,0,20,0
1653300032533,WCWP 100,B00,086627,McCleary; Keith Long,20,0,20,0
1653300032533,WCWP 100,C00,086628,McCleary; Keith Long,18,0,20,2
1653300032533,WCWP 100,D00,086629,Twohig; Niall Ivan,17,0,20,3
1653300032533,WCWP 100,E00,086630,Twohig; Niall Ivan,17,0,20,3
1653300032533,WCWP 100,F00,086631,Twohig; Niall Ivan,18,0,20,2
1653300032533,WCWP 100,G00,086632,Young; Mark T,20,0,20,0
1653300032533,WCWP 100,H00,086633,Young; Mark T,20,0,20,0
1653300090758,AAS 10,A01,085689,Butler; Elizabeth Annette,28,0,34,6
1653300090758,AAS 10,A02,085690,Butler; Elizabeth Annette,34,0,34,0
1653300091281,AAS 170,A00,085691,Butler; Elizabeth Annette,30,0,32,2
1653300091804,AIP 197,001,085683,Staff,100,0,100,0
1653300091804,AIP 197,002,085684,Rao; Ramesh R,50,0,50,0
1653300092327,AIP 197DC,001,085696,Anderson; Patrick W.,27,0,27,0
1653300092849,AIP 197T,A00,085685,Anderson; Patrick W.,15,0,15,0
1653300093376,ANAR 100,A00,094326,Fortier; Jana,22,0,25,3
1653300093904,ANAR 104,A01,085846,Staff,13,0,15,2
1653300094428,ANAR 120,A00,085847,Staff,15,0,15,0
1653300094951,ANAR 143,A00,094288,Staff,31,0,32,1
1653300095479,ANBI 100,A00,085849,Marchetto; Maria Carolina,31,0,34,3
1653300096005,ANBI 112,A00,085850,Marchetto; Maria Carolina,21,0,28,7
1653300096535,ANBI 118,A00,085851,Fox; Patrick Keolu Ozer,32,0,32,0
1653300097057,ANBI 136,A00,085852,Semendeferi; Ekaterini,20,0,22,2
1653300097586,ANBI 141,A00,085854,Gagneux; Pascal,186,0,192,6
1653300098110,ANBI 145,A00,085855,Staff,30,0,32,2
1653300098633,ANBI 175,A00,085857,Staff,30,0,32,2
1653300099156,ANSC 104,A00,094290,Yeh; Rihan Wen Xin,40,0,46,6
1653300099679,ANSC 105,A00,085859,Olivas Hernandez; Olga Lid,36,0,37,1
1653300100204,ANSC 120,A00,085860,Jassal; Aftab,51,0,56,5
1653300100731,ANSC 121,A00,085861,Staff,29,0,32,3
1653300101781,ANSC 148,A00,085866,Staff,71,0,73,2
1653300102308,ANSC 169,A00,085869,Fortier; Jana,23,0,25,2
1653300102832,ANSC 175,A00,085871,Pedersen; David,28,0,32,4
1653300103355,ANTH 1,A00,085803,Varma; Saiba,146,0,146,0
1653300103884,ANTH 2,A01,085805,Staff,43,0,44,1
1653300103884,ANTH 2,A02,085806,Staff,42,0,44,2
1653300103884,ANTH 2,A03,085807,Staff,44,0,44,0
1653300103884,ANTH 2,A04,085808,Staff,44,0,44,0
1653300103884,ANTH 2,A05,085809,Staff,40,0,40,0
1653300104413,ANTH 4,A01,085811,Yeh; Rihan Wen Xin,32,0,32,0
1653300104413,ANTH 4,A02,095113,Yeh; Rihan Wen Xin,32,0,32,0
1653300104413,ANTH 4,A03,095114,Yeh; Rihan Wen Xin,32,0,32,0
1653300104413,ANTH 4,A04,095115,Yeh; Rihan Wen Xin,34,0,34,0
1653300104949,ANTH 10,A00,085814,Stewart; Alexander B,215,0,216,1
1653300105483,ANTH 21,A01,085816,Kang; Byung Chu,35,0,35,0
1653300105483,ANTH 21,A02,085817,Kang; Byung Chu,35,0,35,0
1653300105483,ANTH 21,A03,085818,Kang; Byung Chu,35,0,35,0
1653300105483,ANTH 21,A04,085819,Kang; Byung Chu,35,0,35,0
1653300105483,ANTH 21,A05,085820,Kang; Byung Chu,33,0,35,2
1653300105483,ANTH 21,A06,085821,Kang; Byung Chu,33,0,35,2
1653300105483,ANTH 21,A07,085822,Kang; Byung Chu,35,0,35,0
1653300105483,ANTH 21,A08,085823,Kang; Byung Chu,35,0,35,0
1653300105483,ANTH 21,A09,085824,Kang; Byung Chu,0,0,0,0
1653300105483,ANTH 21,A10,085825,Kang; Byung Chu,0,0,0,0
1653300105483,ANTH 21,A11,095111,Kang; Byung Chu,30,0,30,0
1653300105483,ANTH 21,A12,095112,Kang; Byung Chu,30,0,30,0
1653300105483,ANTH 21,B01,085827,Staff,36,0,36,0
1653300105483,ANTH 21,B02,085828,Staff,36,0,36,0
1653300105483,ANTH 21,B03,085829,Staff,36,0,36,0
1653300105483,ANTH 21,B04,085830,Staff,38,0,38,0
1653300106007,ANTH 23,A01,085832,Stewart; Alexander B,31,0,31,0
1653300106007,ANTH 23,A02,085833,Stewart; Alexander B,31,0,31,0
1653300106007,ANTH 23,A03,085834,Stewart; Alexander B,31,0,31,0
1653300106007,ANTH 23,A04,085835,Stewart; Alexander B,31,0,31,0
1653300106007,ANTH 23,A05,085836,Stewart; Alexander B,31,0,31,0
1653300106007,ANTH 23,A06,085837,Stewart; Alexander B,0,0,0,0
1653300106007,ANTH 23,A07,085838,Stewart; Alexander B,0,0,0,0
1653300106531,ANTH 87,A00,085842,Staff,20,0,20,0
1653300106531,ANTH 87,B00,085843,Staff,20,0,20,0
1653300107057,ANTH 101,A01,085873,Goldstein; Paul S,33,0,36,3
1653300107057,ANTH 101,A02,085874,Goldstein; Paul S,33,0,36,3
1653300107057,ANTH 101,A03,085875,Goldstein; Paul S,36,0,36,0
1653300107057,ANTH 101,A04,085876,Goldstein; Paul S,36,0,38,2
1653300107580,ANTH 105,A00,085877,Staff,39,0,40,1
1653300108107,ANTH 108,A00,085878,Staff,31,0,32,1
1653300108632,ANTH 192,A00,094234,Kaiser; Bronwyn Nicole & Non; Amy L,20,0,20,0
1653300109156,ANTH 196A,A00,085879,Varma; Saiba,20,0,20,0
1653300109690,AWP 3,001,085697,Staff,13,0,13,0
1653300109690,AWP 3,002,085698,Staff,13,0,13,0
1653300109690,AWP 3,003,085699,Staff,13,0,13,0
1653300109690,AWP 3,004,085700,Staff,0,0,0,0
1653300109690,AWP 3,005,085701,Staff,0,0,0,0
1653300109690,AWP 3,006,085703,Staff,0,0,0,0
1653300109690,AWP 3,007,085704,Staff,13,0,13,0
1653300109690,AWP 3,008,085707,Staff,0,0,0,0
1653300109690,AWP 3,009,085709,Staff,13,0,13,0
1653300109690,AWP 3,010,085710,Staff,13,0,13,0
1653300109690,AWP 3,011,085711,Staff,0,0,0,0
1653300109690,AWP 3,012,085712,Staff,0,0,0,0
1653300109690,AWP 3,013,085713,Staff,13,0,13,0
1653300109690,AWP 3,014,085715,Staff,13,0,13,0
1653300109690,AWP 3,015,085717,Staff,13,0,13,0
1653300109690,AWP 3,016,085719,Staff,13,0,13,0
1653300109690,AWP 3,017,085720,Staff,13,0,13,0
1653300109690,AWP 3,018,085721,Staff,13,0,13,0
1653300109690,AWP 3,019,085722,Staff,13,0,13,0
1653300109690,AWP 3,020,085723,Staff,13,0,13,0
1653300109690,AWP 3,021,085724,Staff,13,0,13,0
1653300109690,AWP 3,022,085725,Staff,13,0,13,0
1653300109690,AWP 3,023,085726,Staff,13,0,13,0
1653300109690,AWP 3,024,085727,Staff,13,0,13,0
1653300109690,AWP 3,025,085728,Staff,13,0,13,0
1653300109690,AWP 3,026,085729,Staff,13,0,13,0
1653300109690,AWP 3,027,085730,Staff,13,0,13,0
1653300109690,AWP 3,028,085731,Staff,13,0,13,0
1653300109690,AWP 3,029,085732,Staff,13,0,13,0
1653300109690,AWP 3,030,085733,Staff,13,0,13,0
1653300109690,AWP 3,031,085734,Staff,13,0,13,0
1653300109690,AWP 3,032,085735,Staff,13,0,13,0
1653300109690,AWP 3,033,085736,Staff,13,0,13,0
1653300109690,AWP 3,034,085737,Staff,13,0,13,0
1653300109690,AWP 3,035,085738,Staff,13,0,13,0
1653300109690,AWP 3,036,085739,Staff,13,0,13,0
1653300109690,AWP 3,037,085740,Staff,13,0,13,0
1653300109690,AWP 3,038,085741,Staff,13,0,13,0
1653300109690,AWP 3,039,085742,Staff,13,0,13,0
1653300109690,AWP 3,040,085743,Staff,13,0,13,0
1653300109690,AWP 3,041,085744,Staff,13,0,13,0
1653300109690,AWP 3,042,085745,Staff,13,0,13,0
1653300109690,AWP 3,043,085746,Staff,13,0,13,0
1653300109690,AWP 3,044,085747,Staff,13,0,13,0
1653300109690,AWP 3,045,085748,Staff,13,0,13,0
1653300109690,AWP 3,046,085749,Staff,13,0,13,0
1653300109690,AWP 3,047,085750,Staff,13,0,13,0
1653300109690,AWP 3,048,085751,Staff,13,0,13,0
1653300109690,AWP 3,049,085752,Staff,13,0,13,0
1653300109690,AWP 3,050,085753,Staff,13,0,13,0
1653300109690,AWP 3,051,085754,Staff,13,0,13,0
1653300109690,AWP 3,052,085755,Staff,0,0,0,0
1653300109690,AWP 3,053,085756,Staff,13,0,13,0
1653300109690,AWP 3,054,085757,Staff,0,0,0,0
1653300109690,AWP 3,055,085758,Staff,13,0,13,0
1653300109690,AWP 3,056,085759,Staff,13,0,13,0
1653300109690,AWP 3,057,085760,Staff,13,0,13,0
1653300109690,AWP 3,058,085761,Staff,13,0,13,0
1653300109690,AWP 3,059,085762,Staff,13,0,13,0
1653300109690,AWP 3,060,085763,Staff,13,0,13,0
1653300109690,AWP 3,061,085764,Staff,13,0,13,0
1653300109690,AWP 3,062,085765,Staff,13,0,13,0
1653300109690,AWP 3,063,085766,Staff,13,0,13,0
1653300109690,AWP 3,064,085767,Staff,13,0,13,0
1653300109690,AWP 3,065,085768,Staff,13,0,13,0
1653300109690,AWP 3,066,085769,Staff,0,0,0,0
1653300110217,AWP 4A,001,085770,Staff,0,0,0,0
1653300110217,AWP 4A,002,085771,Staff,13,0,13,0
1653300110217,AWP 4A,003,085772,Staff,13,0,13,0
1653300110217,AWP 4A,004,085773,Staff,13,0,13,0
1653300110217,AWP 4A,005,085774,Staff,0,0,0,0
1653300110217,AWP 4A,006,085775,Staff,13,0,13,0
1653300110217,AWP 4A,007,085776,Staff,0,0,0,0
1653300110217,AWP 4A,008,085777,Staff,0,0,0,0
1653300110217,AWP 4A,009,085778,Staff,0,0,0,0
1653300110217,AWP 4A,010,085779,Staff,13,0,13,0
1653300110217,AWP 4A,011,085780,Staff,13,0,13,0
1653300110217,AWP 4A,012,085781,Staff,0,0,0,0
1653300110217,AWP 4A,013,085782,Staff,13,0,13,0
1653300110217,AWP 4A,014,085783,Staff,13,0,13,0
1653300110217,AWP 4A,015,085784,Staff,13,0,13,0
1653300110217,AWP 4A,016,085785,Staff,13,0,13,0
1653300110217,AWP 4A,017,085786,Staff,13,0,13,0
1653300110217,AWP 4A,018,085787,Staff,0,0,0,0
1653300110217,AWP 4A,019,085788,Staff,13,0,13,0
1653300110217,AWP 4A,020,085789,Staff,13,0,13,0
1653300110217,AWP 4A,021,085790,Staff,0,0,0,0
1653300110217,AWP 4A,022,085791,Staff,13,0,13,0
1653300110217,AWP 4A,023,085792,Staff,0,0,0,0
1653300110217,AWP 4A,024,085793,Staff,0,0,0,0
1653300110217,AWP 4A,025,085794,Staff,13,0,13,0
1653300110217,AWP 4A,026,085795,Staff,13,0,13,0
1653300110217,AWP 4A,027,085796,Staff,13,0,13,0
1653300110217,AWP 4A,028,085797,Staff,13,0,13,0
1653300110217,AWP 4A,029,085798,Staff,0,0,0,0
1653300110217,AWP 4A,030,085799,Staff,0,0,0,0
1653300110217,AWP 4A,031,093835,Staff,0,0,0,0
1653300110742,AWP 4B,001,085800,Staff,0,0,0,0
1653300110742,AWP 4B,002,085801,Staff,0,0,0,0
1653300111265,BENG 2,A00,085936,Wheeler; Bruce Christopher,28,0,30,2
1653300111793,BENG 110,A01,085939,Mc Culloch; Andrew Douglas,20,0,30,10
1653300111793,BENG 110,A02,085940,Mc Culloch; Andrew Douglas,18,0,30,12
1653300111793,BENG 110,A03,085941,Mc Culloch; Andrew Douglas,27,0,30,3
1653300112317,BENG 119A,A01,085943,Wheeler; Bruce Christopher,29,0,30,1
1653300112845,BENG 122A,A01,085945,Cauwenberghs; Gert,18,0,25,7
1653300112845,BENG 122A,A02,085946,Cauwenberghs; Gert,22,0,25,3
1653300112845,BENG 122A,A03,085947,Cauwenberghs; Gert,22,0,25,3
1653300113445,BENG 126A,A01,085949,Wheeler; Bruce Christopher,30,0,30,0
1653300113968,BENG 127A,A01,085951,Wheeler; Bruce Christopher,28,0,30,2
1653300114495,BENG 128A,A01,085953,Wheeler; Bruce Christopher,29,0,30,1
1653300115018,BENG 134,A01,085955,Smarr; Benjamin,0,0,0,0
1653300115546,BENG 135,A00,085956,Wheeler; Bruce Christopher,23,0,30,7
1653300116069,BENG 141,A00,085958,Lal; Ratnesh,20,0,30,10
1653300116591,BENG 147A,A01,085963,Wheeler; Bruce Christopher,30,0,30,0
1653300117114,BENG 148A,A01,085967,Wheeler; Bruce Christopher,30,0,30,0
1653300117639,BENG 149A,A01,085969,Wheeler; Bruce Christopher,30,0,30,0
1653300118164,BENG 161A,A01,085971,Fraley; Stephanie I.,20,0,25,5
1653300118164,BENG 161A,A02,085972,Fraley; Stephanie I.,13,0,25,12
1653300118164,BENG 161A,A03,085973,Fraley; Stephanie I.,9,0,25,16
1653300118691,BENG 162,A01,085975,Mali; Prashant Gulab Ram,0,0,35,35
1653300118691,BENG 162,A02,085976,Mali; Prashant Gulab Ram,26,0,35,9
1653300119224,BENG 166A,A00,085977,Sah; Robert Lie-Yuan,0,0,0,0
1653300119954,BENG 169A,A01,085982,Wheeler; Bruce Christopher,28,0,30,2
1653300120480,BENG 179A,A01,085984,Wheeler; Bruce Christopher,30,0,30,0
1653300121011,BENG 183,A01,085986,Zhong; Sheng,13,0,30,17
1653300121011,BENG 183,A02,085987,Zhong; Sheng,15,0,30,15
1653300121011,BENG 183,A03,085988,Zhong; Sheng,20,0,30,10
1653300121535,BENG 187B,A00,085989,Wheeler; Bruce Christopher,105,0,170,65
1653300122057,BENG 196,001,094047,Engler; Adam J.,9999,0,9999,0
1653300122590,BIBC 100,A01,092918,Huffaker; Alisa,0,0,19,19
1653300122590,BIBC 100,A02,092919,Huffaker; Alisa,19,0,19,0
1653300122590,BIBC 100,A03,092920,Huffaker; Alisa,18,0,19,1
1653300122590,BIBC 100,A04,092921,Huffaker; Alisa,18,0,19,1
1653300122590,BIBC 100,A05,092922,Huffaker; Alisa,19,0,19,0
1653300122590,BIBC 100,A06,092923,Huffaker; Alisa,18,0,19,1
1653300122590,BIBC 100,A07,092924,Huffaker; Alisa,10,0,19,9
1653300122590,BIBC 100,A08,092925,Huffaker; Alisa,17,0,19,2
1653300122590,BIBC 100,A09,092926,Huffaker; Alisa,19,0,19,0
1653300122590,BIBC 100,A10,092927,Huffaker; Alisa,11,0,19,8
1653300123118,BIBC 102,A01,092997,Schmelz; Eric Alexander,16,0,19,3
1653300123118,BIBC 102,A02,092998,Schmelz; Eric Alexander,5,0,19,14
1653300123118,BIBC 102,A03,092999,Schmelz; Eric Alexander,1,0,19,18
1653300123118,BIBC 102,A04,093000,Schmelz; Eric Alexander,17,0,19,2
1653300123118,BIBC 102,A05,093001,Schmelz; Eric Alexander,9,0,19,10
1653300123118,BIBC 102,A06,093002,Schmelz; Eric Alexander,16,0,19,3
1653300123118,BIBC 102,A07,093003,Schmelz; Eric Alexander,19,0,19,0
1653300123118,BIBC 102,A08,093004,Schmelz; Eric Alexander,19,0,19,0
1653300123118,BIBC 102,A09,093005,Schmelz; Eric Alexander,14,0,19,5
1653300123118,BIBC 102,B01,093064,Coleman; Aaron B.,19,0,19,0
1653300123118,BIBC 102,B02,093065,Coleman; Aaron B.,17,0,19,2
1653300123118,BIBC 102,B03,093066,Coleman; Aaron B.,16,0,19,3
1653300123118,BIBC 102,B04,093067,Coleman; Aaron B.,11,0,19,8
1653300123118,BIBC 102,B05,093068,Coleman; Aaron B.,18,0,19,1
1653300123118,BIBC 102,B06,093069,Coleman; Aaron B.,16,0,19,3
1653300123118,BIBC 102,B07,093070,Coleman; Aaron B.,19,0,19,0
1653300123118,BIBC 102,B08,093071,Coleman; Aaron B.,15,0,19,4
1653300123118,BIBC 102,B09,093072,Coleman; Aaron B.,17,0,19,2
1653300123654,BIBC 103,A01,089887,Bozinovic; Goran,19,0,24,5
1653300123654,BIBC 103,A02,089888,Bozinovic; Goran,23,0,24,1
1653300123654,BIBC 103,B01,089890,Burg; Michael,1,0,24,23
1653300123654,BIBC 103,B02,089891,Burg; Michael,20,0,24,4
1653300123654,BIBC 103,C01,089893,Beyhan; Sinem,14,0,24,10
1653300123654,BIBC 103,C02,089894,Beyhan; Sinem,22,0,24,2
1653300123654,BIBC 103,D01,089896,Coleman; Aaron B.,10,0,24,14
1653300123654,BIBC 103,D02,089897,Coleman; Aaron B.,22,0,24,2
1653300124177,BIBC 194,A00,089898,Hui; Enfu,16,0,27,11
1653300124725,BICD 100,A01,092396,Smith; Laurie,21,0,22,1
1653300124725,BICD 100,A02,092397,Smith; Laurie,22,0,22,0
1653300124725,BICD 100,A03,092398,Smith; Laurie,21,0,22,1
1653300124725,BICD 100,A04,092399,Smith; Laurie,22,0,22,0
1653300124725,BICD 100,A05,092400,Smith; Laurie,21,0,22,1
1653300124725,BICD 100,A06,092401,Smith; Laurie,22,0,22,0
1653300124725,BICD 100,A07,092402,Smith; Laurie,22,0,22,0
1653300124725,BICD 100,A08,092403,Smith; Laurie,22,0,22,0
1653300124725,BICD 100,B01,093073,Mueller; Liam O'Connor,21,0,22,1
1653300124725,BICD 100,B02,093074,Mueller; Liam O'Connor,22,0,22,0
1653300124725,BICD 100,B03,093075,Mueller; Liam O'Connor,22,0,22,0
1653300124725,BICD 100,B04,093076,Mueller; Liam O'Connor,22,0,22,0
1653300124725,BICD 100,B05,093077,Mueller; Liam O'Connor,22,0,22,0
1653300124725,BICD 100,B06,093078,Mueller; Liam O'Connor,22,0,22,0
1653300124725,BICD 100,B07,093079,Mueller; Liam O'Connor,21,0,22,1
1653300124725,BICD 100,B08,093080,Mueller; Liam O'Connor,22,0,22,0
1653300124725,BICD 100,C01,093021,McDonnell; Lisa Marie,21,0,22,1
1653300124725,BICD 100,C02,093022,McDonnell; Lisa Marie,20,0,22,2
1653300124725,BICD 100,C03,093023,McDonnell; Lisa Marie,22,0,22,0
1653300124725,BICD 100,C04,093024,McDonnell; Lisa Marie,22,0,22,0
1653300124725,BICD 100,C05,093025,McDonnell; Lisa Marie,22,0,22,0
1653300124725,BICD 100,C06,093026,McDonnell; Lisa Marie,22,0,22,0
1653300124725,BICD 100,C07,093027,McDonnell; Lisa Marie,20,0,22,2
1653300124725,BICD 100,C08,093028,McDonnell; Lisa Marie,22,0,22,0
1653300124725,BICD 100,D01,093081,Day; Christopher D,22,0,22,0
1653300124725,BICD 100,D02,093082,Day; Christopher D,17,0,22,5
1653300124725,BICD 100,D03,093083,Day; Christopher D,21,0,22,1
1653300124725,BICD 100,D04,093084,Day; Christopher D,19,0,22,3
1653300124725,BICD 100,D05,093085,Day; Christopher D,22,0,22,0
1653300124725,BICD 100,D06,093086,Day; Christopher D,20,0,22,2
1653300124725,BICD 100,D07,093087,Day; Christopher D,19,0,22,3
1653300124725,BICD 100,D08,093088,Day; Christopher D,20,0,22,2
1653300125263,BICD 110,A01,093089,Kiger; Amy,29,0,32,3
1653300125263,BICD 110,A02,093091,Kiger; Amy,32,0,32,0
1653300125263,BICD 110,A03,093092,Kiger; Amy,31,0,32,1
1653300125263,BICD 110,A04,093093,Kiger; Amy,31,0,32,1
1653300125263,BICD 110,A05,093094,Kiger; Amy,26,0,32,6
1653300125263,BICD 110,A06,093095,Kiger; Amy,31,0,32,1
1653300125263,BICD 110,A07,093096,Kiger; Amy,31,0,32,1
1653300125263,BICD 110,B01,093029,Grossman; Emily N,21,0,32,11
1653300125263,BICD 110,B02,093030,Grossman; Emily N,28,0,32,4
1653300125263,BICD 110,B03,093031,Grossman; Emily N,32,0,32,0
1653300125263,BICD 110,B04,093032,Grossman; Emily N,28,0,32,4
1653300125263,BICD 110,B05,093033,Grossman; Emily N,26,0,32,6
1653300125263,BICD 110,B06,093034,Grossman; Emily N,19,0,32,13
1653300125263,BICD 110,B07,093035,Grossman; Emily N,20,0,32,12
1653300125798,BICD 140,A01,093097,Zuniga; Elina I,19,0,32,13
1653300125798,BICD 140,A02,093098,Zuniga; Elina I,17,0,32,15
1653300125798,BICD 140,A03,093099,Zuniga; Elina I,30,0,32,2
1653300125798,BICD 140,A04,093100,Zuniga; Elina I,32,0,32,0
1653300125798,BICD 140,A05,093101,Zuniga; Elina I,29,0,32,3
1653300125798,BICD 140,A06,093102,Zuniga; Elina I,27,0,32,5
1653300126326,BIEB 102,A01,092528,Butler; Shannon Rhey,22,0,27,5
1653300126326,BIEB 102,A02,092529,Butler; Shannon Rhey,17,0,27,10
1653300126326,BIEB 102,A03,092530,Butler; Shannon Rhey,24,0,27,3
1653300126326,BIEB 102,A04,092531,Butler; Shannon Rhey,26,0,27,1
1653300126326,BIEB 102,A05,092532,Butler; Shannon Rhey,25,0,27,2
1653300126326,BIEB 102,A06,092533,Butler; Shannon Rhey,24,0,27,3
1653300126326,BIEB 102,A07,092534,Butler; Shannon Rhey,23,0,27,4
1653300126853,BIEB 121,A00,089907,Holway; David A.,0,0,32,32
1653300127378,BIEB 126,A01,092974,Kohn; Joshua R,24,0,27,3
1653300127378,BIEB 126,A02,092975,Kohn; Joshua R,26,0,27,1
1653300127378,BIEB 126,A03,092976,Kohn; Joshua R,23,0,27,4
1653300127378,BIEB 126,A04,092977,Kohn; Joshua R,25,0,27,2
1653300127378,BIEB 126,A05,092978,Kohn; Joshua R,27,0,27,0
1653300127913,BIEB 146,A01,093054,Petrie; Katherine Lynn,1,0,27,26
1653300127913,BIEB 146,A02,093055,Petrie; Katherine Lynn,4,0,27,23
1653300127913,BIEB 146,A03,093056,Petrie; Katherine Lynn,0,0,27,27
1653300127913,BIEB 146,A04,093057,Petrie; Katherine Lynn,0,0,27,27
1653300127913,BIEB 146,A05,093058,Petrie; Katherine Lynn,20,0,27,7
1653300127913,BIEB 146,A06,093059,Petrie; Katherine Lynn,26,0,27,1
1653300127913,BIEB 146,A07,093060,Petrie; Katherine Lynn,16,0,27,11
1653300127913,BIEB 146,A08,093061,Petrie; Katherine Lynn,25,0,27,2
1653300127913,BIEB 146,A09,093062,Petrie; Katherine Lynn,17,0,27,10
1653300128439,BIEB 150,A01,093103,Rennison; Diana,16,0,27,11
1653300128439,BIEB 150,A02,093104,Rennison; Diana,21,0,27,6
1653300128439,BIEB 150,A03,093105,Rennison; Diana,26,0,27,1
1653300128439,BIEB 150,A04,093106,Rennison; Diana,24,0,27,3
1653300128439,BIEB 150,A05,093107,Rennison; Diana,25,0,27,2
1653300128439,BIEB 150,A06,093108,Rennison; Diana,27,0,27,0
1653300128970,BIEB 158,A01,094057,Reese; Aspen Taylor & Jackrel; Sara,31,0,32,1
1653300128970,BIEB 158,A02,094058,Reese; Aspen Taylor & Jackrel; Sara,28,0,32,4
1653300128970,BIEB 158,A03,094059,Reese; Aspen Taylor & Jackrel; Sara,31,0,32,1
1653300128970,BIEB 158,A04,094060,Reese; Aspen Taylor & Jackrel; Sara,32,0,32,0
1653300129502,BIEB 174,A01,092465,Cleland; Elsa Eleanor & Barton; Andrew David,27,0,27,0
1653300129502,BIEB 174,A02,092466,Cleland; Elsa Eleanor & Barton; Andrew David,27,0,27,0
1653300129502,BIEB 174,A03,092467,Cleland; Elsa Eleanor & Barton; Andrew David,23,0,27,4
1653300129502,BIEB 174,A04,092468,Cleland; Elsa Eleanor & Barton; Andrew David,20,0,27,7
1653300129502,BIEB 174,A05,092469,Cleland; Elsa Eleanor & Barton; Andrew David,25,0,27,2
1653300129502,BIEB 174,A06,092470,Cleland; Elsa Eleanor & Barton; Andrew David,27,0,27,0
1653300129502,BIEB 174,A07,092471,Cleland; Elsa Eleanor & Barton; Andrew David,25,0,27,2
1653300130031,BILD 1,A01,092884,Pickett; Brooke Elizabeth,16,0,19,3
1653300130031,BILD 1,A02,092885,Pickett; Brooke Elizabeth,19,0,19,0
1653300130031,BILD 1,A03,092886,Pickett; Brooke Elizabeth,19,0,19,0
1653300130031,BILD 1,A04,092887,Pickett; Brooke Elizabeth,18,0,19,1
1653300130031,BILD 1,A05,092888,Pickett; Brooke Elizabeth,19,0,19,0
1653300130031,BILD 1,A06,092889,Pickett; Brooke Elizabeth,19,0,19,0
1653300130031,BILD 1,A07,092890,Pickett; Brooke Elizabeth,17,0,19,2
1653300130031,BILD 1,B01,092891,Pekkurnaz Banghart; Gulcin,19,0,19,0
1653300130031,BILD 1,B02,092892,Pekkurnaz Banghart; Gulcin,16,0,19,3
1653300130031,BILD 1,B03,092893,Pekkurnaz Banghart; Gulcin,19,0,19,0
1653300130031,BILD 1,B04,092894,Pekkurnaz Banghart; Gulcin,19,0,19,0
1653300130031,BILD 1,B05,092895,Pekkurnaz Banghart; Gulcin,17,0,19,2
1653300130031,BILD 1,B06,092896,Pekkurnaz Banghart; Gulcin,19,0,19,0
1653300130031,BILD 1,B07,092897,Pekkurnaz Banghart; Gulcin,19,0,19,0
1653300130031,BILD 1,C01,092421,Meaders; Clara Leigh,18,0,19,1
1653300130031,BILD 1,C02,092422,Meaders; Clara Leigh,18,0,19,1
1653300130031,BILD 1,C03,092423,Meaders; Clara Leigh,17,0,19,2
1653300130031,BILD 1,C04,092424,Meaders; Clara Leigh,16,0,19,3
1653300130031,BILD 1,C05,092425,Meaders; Clara Leigh,19,0,19,0
1653300130031,BILD 1,C06,092426,Meaders; Clara Leigh,19,0,19,0
1653300130031,BILD 1,C07,092427,Meaders; Clara Leigh,19,0,19,0
1653300130031,BILD 1,D01,092428,Meaders; Clara Leigh,14,0,19,5
1653300130031,BILD 1,D02,092429,Meaders; Clara Leigh,19,0,19,0
1653300130031,BILD 1,D03,092430,Meaders; Clara Leigh,19,0,19,0
1653300130031,BILD 1,D04,092431,Meaders; Clara Leigh,19,0,19,0
1653300130031,BILD 1,D05,092432,Meaders; Clara Leigh,19,0,19,0
1653300130031,BILD 1,D06,092433,Meaders; Clara Leigh,19,0,19,0
1653300130031,BILD 1,D07,092434,Meaders; Clara Leigh,19,0,19,0
1653300130031,BILD 1,E01,092445,Cooper; Andrew Michael,19,0,19,0
1653300130031,BILD 1,E02,092446,Cooper; Andrew Michael,19,0,19,0
1653300130031,BILD 1,E03,092447,Cooper; Andrew Michael,19,0,19,0
1653300130031,BILD 1,E04,092448,Cooper; Andrew Michael,19,0,19,0
1653300130031,BILD 1,E05,092449,Cooper; Andrew Michael,17,0,19,2
1653300130031,BILD 1,E06,092450,Cooper; Andrew Michael,19,0,19,0
1653300130031,BILD 1,E07,092451,Cooper; Andrew Michael,19,0,19,0
1653300130564,BILD 2,A01,092822,Glasgow; Stacey Marie,25,0,25,0
1653300130564,BILD 2,A02,092823,Glasgow; Stacey Marie,24,0,25,1
1653300130564,BILD 2,A03,092824,Glasgow; Stacey Marie,24,0,25,1
1653300130564,BILD 2,A04,092825,Glasgow; Stacey Marie,25,0,25,0
1653300130564,BILD 2,A05,092826,Glasgow; Stacey Marie,25,0,25,0
1653300130564,BILD 2,A06,092827,Glasgow; Stacey Marie,25,0,25,0
1653300130564,BILD 2,A07,092828,Glasgow; Stacey Marie,25,0,25,0
1653300130564,BILD 2,B01,092830,Owens; Melinda Tsao-Ying,25,0,25,0
1653300130564,BILD 2,B02,092831,Owens; Melinda Tsao-Ying,21,0,25,4
1653300130564,BILD 2,B03,092832,Owens; Melinda Tsao-Ying,23,0,25,2
1653300130564,BILD 2,B04,092833,Owens; Melinda Tsao-Ying,25,0,25,0
1653300130564,BILD 2,B05,092834,Owens; Melinda Tsao-Ying,24,0,25,1
1653300130564,BILD 2,B06,092835,Owens; Melinda Tsao-Ying,21,0,25,4
1653300130564,BILD 2,B07,092836,Owens; Melinda Tsao-Ying,25,0,25,0
1653300130564,BILD 2,C01,092668,Owens; Melinda Tsao-Ying,24,0,25,1
1653300130564,BILD 2,C02,092669,Owens; Melinda Tsao-Ying,23,0,25,2
1653300130564,BILD 2,C03,092670,Owens; Melinda Tsao-Ying,22,0,25,3
1653300130564,BILD 2,C04,092671,Owens; Melinda Tsao-Ying,25,0,25,0
1653300130564,BILD 2,C05,092672,Owens; Melinda Tsao-Ying,25,0,25,0
1653300130564,BILD 2,C06,092673,Owens; Melinda Tsao-Ying,24,0,25,1
1653300130564,BILD 2,C07,092674,Owens; Melinda Tsao-Ying,25,0,25,0
1653300131100,BILD 3,A01,092454,Stockwell; Sarah R,17,0,19,2
1653300131100,BILD 3,A02,092455,Stockwell; Sarah R,17,0,19,2
1653300131100,BILD 3,A03,092456,Stockwell; Sarah R,18,0,19,1
1653300131100,BILD 3,A04,092457,Stockwell; Sarah R,19,0,19,0
1653300131100,BILD 3,A05,092458,Stockwell; Sarah R,19,0,19,0
1653300131100,BILD 3,A06,092459,Stockwell; Sarah R,18,0,19,1
1653300131100,BILD 3,A07,092460,Stockwell; Sarah R,18,0,19,1
1653300131100,BILD 3,A08,092461,Stockwell; Sarah R,19,0,19,0
1653300131100,BILD 3,A09,092462,Stockwell; Sarah R,19,0,19,0
1653300131100,BILD 3,B01,092479,Stockwell; Sarah R,19,0,19,0
1653300131100,BILD 3,B02,092480,Stockwell; Sarah R,18,0,19,1
1653300131100,BILD 3,B03,092481,Stockwell; Sarah R,18,0,19,1
1653300131100,BILD 3,B04,092482,Stockwell; Sarah R,19,0,19,0
1653300131100,BILD 3,B05,092483,Stockwell; Sarah R,19,0,19,0
1653300131100,BILD 3,B06,092484,Stockwell; Sarah R,19,0,19,0
1653300131100,BILD 3,B07,092485,Stockwell; Sarah R,19,0,19,0
1653300131100,BILD 3,B08,092486,Stockwell; Sarah R,18,0,19,1
1653300131100,BILD 3,B09,092487,Stockwell; Sarah R,18,0,19,1
1653300131100,BILD 3,C01,092412,Butler; Shannon Rhey,18,0,19,1
1653300131100,BILD 3,C02,092413,Butler; Shannon Rhey,15,0,19,4
1653300131100,BILD 3,C03,092414,Butler; Shannon Rhey,19,0,19,0
1653300131100,BILD 3,C04,092415,Butler; Shannon Rhey,19,0,19,0
1653300131100,BILD 3,C05,092416,Butler; Shannon Rhey,19,0,19,0
1653300131100,BILD 3,C06,092417,Butler; Shannon Rhey,19,0,19,0
1653300131100,BILD 3,C07,092418,Butler; Shannon Rhey,19,0,19,0
1653300131100,BILD 3,C08,092419,Butler; Shannon Rhey,19,0,19,0
1653300131100,BILD 3,C09,092420,Butler; Shannon Rhey,19,0,19,0
1653300131100,BILD 3,D01,092898,Reuther; Keefe,18,0,19,1
1653300131100,BILD 3,D02,092899,Reuther; Keefe,19,0,19,0
1653300131100,BILD 3,D03,092900,Reuther; Keefe,19,0,19,0
1653300131100,BILD 3,D04,092901,Reuther; Keefe,19,0,19,0
1653300131100,BILD 3,D05,092902,Reuther; Keefe,19,0,19,0
1653300131100,BILD 3,D06,092903,Reuther; Keefe,19,0,19,0
1653300131100,BILD 3,D07,092904,Reuther; Keefe,18,0,19,1
1653300131100,BILD 3,D08,092905,Reuther; Keefe,19,0,19,0
1653300131100,BILD 3,D09,092906,Reuther; Keefe,19,0,19,0
1653300131625,BILD 4,A01,089840,Mel; Stephanie,0,0,0,0
1653300131625,BILD 4,A02,089841,Mel; Stephanie,0,0,0,0
1653300131625,BILD 4,A03,089842,Mel; Stephanie,0,0,0,0
1653300131625,BILD 4,A04,089843,Mel; Stephanie,0,0,0,0
1653300131625,BILD 4,A05,089844,Mel; Stephanie,0,0,0,0
1653300131625,BILD 4,A06,089845,Mel; Stephanie,0,0,0,0
1653300131625,BILD 4,A07,089846,Mel; Stephanie,0,0,0,0
1653300131625,BILD 4,A08,089847,Mel; Stephanie,0,0,0,0
1653300131625,BILD 4,A09,089848,Mel; Stephanie,0,0,0,0
1653300131625,BILD 4,A10,089849,Mel; Stephanie,0,0,0,0
1653300131625,BILD 4,A11,089850,Mel; Stephanie,0,0,0,0
1653300131625,BILD 4,A12,089851,Mel; Stephanie,0,0,0,0
1653300131625,BILD 4,A13,089852,Mel; Stephanie,0,0,0,0
1653300131625,BILD 4,A14,089853,Mel; Stephanie,0,0,0,0
1653300131625,BILD 4,A15,089854,Mel; Stephanie,0,0,0,0
1653300131625,BILD 4,A16,089855,Mel; Stephanie,0,0,0,0
1653300131625,BILD 4,B01,089857,Lo; Stanley M.,0,0,0,0
1653300131625,BILD 4,B02,089858,Lo; Stanley M.,0,0,0,0
1653300131625,BILD 4,B03,089859,Lo; Stanley M.,0,0,0,0
1653300131625,BILD 4,B04,089860,Lo; Stanley M.,0,0,0,0
1653300131625,BILD 4,B05,089861,Lo; Stanley M.,0,0,0,0
1653300131625,BILD 4,B06,089862,Lo; Stanley M.,0,0,0,0
1653300131625,BILD 4,B07,089863,Lo; Stanley M.,0,0,0,0
1653300131625,BILD 4,B08,089864,Lo; Stanley M.,0,0,0,0
1653300131625,BILD 4,B09,089865,Lo; Stanley M.,0,0,0,0
1653300131625,BILD 4,B10,089866,Lo; Stanley M.,0,0,0,0
1653300131625,BILD 4,B11,089867,Lo; Stanley M.,0,0,0,0
1653300131625,BILD 4,B12,089868,Lo; Stanley M.,0,0,0,0
1653300131625,BILD 4,B13,089869,Lo; Stanley M.,0,0,0,0
1653300131625,BILD 4,B14,089870,Lo; Stanley M.,0,0,0,0
1653300131625,BILD 4,B15,089871,Lo; Stanley M.,0,0,0,0
1653300131625,BILD 4,B16,089872,Lo; Stanley M.,0,0,0,0
1653300132148,BILD 5,A01,092907,Reuther; Keefe,31,0,32,1
1653300132148,BILD 5,A02,092908,Reuther; Keefe,30,0,32,2
1653300132672,BILD 10,A01,092909,Gustafson-Brown; Cindy,27,0,27,0
1653300132672,BILD 10,A02,092910,Gustafson-Brown; Cindy,27,0,27,0
1653300132672,BILD 10,A03,092911,Gustafson-Brown; Cindy,27,0,27,0
1653300132672,BILD 10,A04,092912,Gustafson-Brown; Cindy,27,0,27,0
1653300132672,BILD 10,A05,092913,Gustafson-Brown; Cindy,25,0,27,2
1653300132672,BILD 10,A06,092914,Gustafson-Brown; Cindy,26,0,27,1
1653300132672,BILD 10,A07,092915,Gustafson-Brown; Cindy,27,0,27,0
1653300132672,BILD 10,A08,092916,Gustafson-Brown; Cindy,27,0,27,0
1653300132672,BILD 10,A09,092917,Gustafson-Brown; Cindy,27,0,27,0
1653300133209,BILD 20,A01,092956,Rana; Brinda Kanti,24,0,27,3
1653300133209,BILD 20,A02,092957,Rana; Brinda Kanti,24,0,27,3
1653300133209,BILD 20,A03,092958,Rana; Brinda Kanti,27,0,27,0
1653300133209,BILD 20,A04,092959,Rana; Brinda Kanti,27,0,27,0
1653300133734,BILD 32,A01,092990,Burg; Michael,27,0,27,0
1653300133734,BILD 32,A02,092991,Burg; Michael,26,0,27,1
1653300133734,BILD 32,A03,092992,Burg; Michael,27,0,27,0
1653300133734,BILD 32,A04,092993,Burg; Michael,26,0,27,1
1653300133734,BILD 32,A05,092994,Burg; Michael,27,0,27,0
1653300133734,BILD 32,A06,092995,Burg; Michael,27,0,27,0
1653300133734,BILD 32,A07,092996,Burg; Michael,27,0,27,0
1653300134266,BILD 60,A01,092392,Hammond; LaTisha Marie,24,0,24,0
1653300134266,BILD 60,A02,092393,Hammond; LaTisha Marie,24,0,24,0
1653300134266,BILD 60,B01,092394,Macagno; Eduardo R.,23,0,24,1
1653300134266,BILD 60,B02,092395,Macagno; Eduardo R.,24,0,24,0
1653300134794,BILD 62,A01,092949,Aljadeff; Johnatan,31,0,32,1
1653300134794,BILD 62,A02,092950,Aljadeff; Johnatan,32,0,32,0
1653300134794,BILD 62,A03,092951,Aljadeff; Johnatan,32,0,32,0
1653300135319,BILD 80,A00,089880,Pogliano; Joseph,27,0,30,3
1653300135844,BIMM 100,A01,092435,Pasquinelli; Amy,32,0,32,0
1653300135844,BIMM 100,A02,092436,Pasquinelli; Amy,30,0,32,2
1653300135844,BIMM 100,A03,092437,Pasquinelli; Amy,32,0,32,0
1653300135844,BIMM 100,A04,092438,Pasquinelli; Amy,31,0,32,1
1653300135844,BIMM 100,A05,092439,Pasquinelli; Amy,32,0,32,0
1653300135844,BIMM 100,A06,092440,Pasquinelli; Amy,32,0,32,0
1653300135844,BIMM 100,A07,092441,Pasquinelli; Amy,32,0,32,0
1653300135844,BIMM 100,A08,092442,Pasquinelli; Amy,32,0,32,0
1653300135844,BIMM 100,A09,092443,Pasquinelli; Amy,32,0,32,0
1653300135844,BIMM 100,A10,092444,Pasquinelli; Amy,32,0,32,0
1653300135844,BIMM 100,B01,092518,Pruneda-Paz; Jose L.,26,0,32,6
1653300135844,BIMM 100,B02,092519,Pruneda-Paz; Jose L.,19,0,32,13
1653300135844,BIMM 100,B03,092520,Pruneda-Paz; Jose L.,20,0,32,12
1653300135844,BIMM 100,B04,092521,Pruneda-Paz; Jose L.,24,0,32,8
1653300135844,BIMM 100,B05,092522,Pruneda-Paz; Jose L.,23,0,32,9
1653300135844,BIMM 100,B06,092523,Pruneda-Paz; Jose L.,24,0,32,8
1653300135844,BIMM 100,B07,092524,Pruneda-Paz; Jose L.,28,0,32,4
1653300135844,BIMM 100,B08,092525,Pruneda-Paz; Jose L.,25,0,32,7
1653300135844,BIMM 100,B09,092526,Pruneda-Paz; Jose L.,26,0,32,6
1653300135844,BIMM 100,B10,092527,Pruneda-Paz; Jose L.,24,0,32,8
1653300136377,BIMM 101,A01,089915,Rusert; Jessica Marie,22,0,24,2
1653300136377,BIMM 101,A02,089916,Rusert; Jessica Marie,21,0,24,3
1653300136377,BIMM 101,A03,089917,Rusert; Jessica Marie,21,0,24,3
1653300136377,BIMM 101,A04,089918,Rusert; Jessica Marie,20,0,24,4
1653300136377,BIMM 101,B01,089920,Grossman; Emily N,0,0,24,24
1653300136377,BIMM 101,B02,089921,Grossman; Emily N,1,0,24,23
1653300136377,BIMM 101,C01,089923,Day; Christopher D,0,0,24,24
1653300136377,BIMM 101,C02,089924,Day; Christopher D,0,0,24,24
1653300136377,BIMM 101,D01,089926,Cooper; Andrew Michael,18,0,24,6
1653300136377,BIMM 101,D02,089927,Cooper; Andrew Michael,24,0,24,0
1653300136377,BIMM 101,E01,089929,McDonnell; Lisa Marie,1,0,24,23
1653300136377,BIMM 101,E02,089930,McDonnell; Lisa Marie,12,0,24,12
1653300136905,BIMM 110,A01,092472,Tour; Ella,26,0,32,6
1653300136905,BIMM 110,A02,092473,Tour; Ella,23,0,32,9
1653300136905,BIMM 110,A03,092474,Tour; Ella,29,0,32,3
1653300136905,BIMM 110,A04,092475,Tour; Ella,27,0,32,5
1653300136905,BIMM 110,A05,092476,Tour; Ella,32,0,32,0
1653300136905,BIMM 110,A06,092477,Tour; Ella,30,0,32,2
1653300136905,BIMM 110,A07,092478,Tour; Ella,29,0,32,3
1653300137429,BIMM 120,A01,092979,Allen; Eric,28,0,32,4
1653300137429,BIMM 120,A02,092980,Allen; Eric,1,0,32,31
1653300137429,BIMM 120,A03,092981,Allen; Eric,14,0,32,18
1653300137429,BIMM 120,A04,092982,Allen; Eric,27,0,32,5
1653300137429,BIMM 120,A05,092983,Allen; Eric,30,0,32,2
1653300137429,BIMM 120,A06,092984,Allen; Eric,29,0,32,3
1653300137429,BIMM 120,A07,092985,Allen; Eric,20,0,32,12
1653300137429,BIMM 120,A08,092986,Allen; Eric,30,0,32,2
1653300137429,BIMM 120,A09,092987,Allen; Eric,30,0,32,2
1653300137429,BIMM 120,A10,092988,Allen; Eric,30,0,32,2
1653300137429,BIMM 120,A11,092989,Allen; Eric,32,0,32,0
1653300137959,BIMM 121,A01,089934,Petrie; Katherine Lynn,0,0,24,24
1653300137959,BIMM 121,A02,089935,Petrie; Katherine Lynn,0,0,24,24
1653300137959,BIMM 121,B01,089937,Pickett; Brooke Elizabeth,0,0,24,24
1653300137959,BIMM 121,B02,089938,Pickett; Brooke Elizabeth,0,0,24,24
1653300137959,BIMM 121,C01,089940,Pirino; Giorgia,0,0,24,24
1653300137959,BIMM 121,C02,089941,Pirino; Giorgia,0,0,24,24
1653300137959,BIMM 121,C03,089942,Pirino; Giorgia,0,0,24,24
1653300137959,BIMM 121,C04,089943,Pirino; Giorgia,0,0,24,24
1653300138487,BIMM 122,A01,093006,Russell; Alistair B,18,0,32,14
1653300138487,BIMM 122,A02,093007,Russell; Alistair B,16,0,32,16
1653300138487,BIMM 122,A03,093008,Russell; Alistair B,26,0,32,6
1653300138487,BIMM 122,A04,093009,Russell; Alistair B,32,0,32,0
1653300138487,BIMM 122,A05,093010,Russell; Alistair B,30,0,32,2
1653300139009,BIMM 124,A01,092404,Gustafson-Brown; Cindy,26,0,32,6
1653300139009,BIMM 124,A02,092405,Gustafson-Brown; Cindy,29,0,32,3
1653300139009,BIMM 124,A03,092406,Gustafson-Brown; Cindy,30,0,32,2
1653300139009,BIMM 124,A04,092407,Gustafson-Brown; Cindy,32,0,32,0
1653300139009,BIMM 124,A05,092408,Gustafson-Brown; Cindy,28,0,32,4
1653300139009,BIMM 124,A06,092409,Gustafson-Brown; Cindy,31,0,32,1
1653300139009,BIMM 124,A07,092410,Gustafson-Brown; Cindy,32,0,32,0
1653300139539,BIMM 140,A01,089947,Suel; Gurol Mehmet & Hao; Nan,16,0,27,11
1653300139539,BIMM 140,A02,089948,Suel; Gurol Mehmet & Hao; Nan,24,0,27,3
1653300139539,BIMM 140,A03,089949,Suel; Gurol Mehmet & Hao; Nan,21,0,27,6
1653300139539,BIMM 140,A04,089950,Suel; Gurol Mehmet & Hao; Nan,25,0,27,2
1653300139539,BIMM 140,A05,089951,Suel; Gurol Mehmet & Hao; Nan,24,0,27,3
1653300140165,BIMM 143,A01,089953,Grant; Barry J,0,0,40,40
1653300140165,BIMM 143,B01,089955,Fan; Chun Chieh,39,0,40,1
1653300140165,BIMM 143,C01,089957,Bozinovic; Goran,29,0,40,11
1653300140692,BIMM 194,A00,089958,Hasty; Jeff M,15,0,27,12
1653300140692,BIMM 194,B00,089959,Golden; James W,19,0,27,8
1653300140692,BIMM 194,C00,089960,Lykke-Andersen; Jens,2,0,27,25
1653300140692,BIMM 194,D00,094317,Golden; Susan S.,25,0,27,2
1653300141237,BIPN 100,A01,093011,Cooke; James Edward,7,0,19,12
1653300141237,BIPN 100,A02,093012,Cooke; James Edward,10,0,19,9
1653300141237,BIPN 100,A03,093013,Cooke; James Edward,8,0,19,11
1653300141237,BIPN 100,A04,093014,Cooke; James Edward,12,0,19,7
1653300141237,BIPN 100,A05,093015,Cooke; James Edward,17,0,19,2
1653300141237,BIPN 100,A06,093016,Cooke; James Edward,12,0,19,7
1653300141237,BIPN 100,A07,093017,Cooke; James Edward,12,0,19,7
1653300141237,BIPN 100,A08,093018,Cooke; James Edward,18,0,19,1
1653300141237,BIPN 100,A09,093019,Cooke; James Edward,17,0,19,2
1653300141237,BIPN 100,A10,093020,Cooke; James Edward,18,0,19,1
1653300141237,BIPN 100,B01,093036,Reyes Gonzalez; Catalina,17,0,19,2
1653300141237,BIPN 100,B02,093037,Reyes Gonzalez; Catalina,14,0,19,5
1653300141237,BIPN 100,B03,093038,Reyes Gonzalez; Catalina,16,0,19,3
1653300141237,BIPN 100,B04,093039,Reyes Gonzalez; Catalina,19,0,19,0
1653300141237,BIPN 100,B05,093040,Reyes Gonzalez; Catalina,19,0,19,0
1653300141237,BIPN 100,B06,093041,Reyes Gonzalez; Catalina,19,0,19,0
1653300141237,BIPN 100,B07,093042,Reyes Gonzalez; Catalina,14,0,19,5
1653300141237,BIPN 100,B08,093043,Reyes Gonzalez; Catalina,16,0,19,3
1653300141237,BIPN 100,B09,093044,Reyes Gonzalez; Catalina,19,0,19,0
1653300141237,BIPN 100,B10,093045,Reyes Gonzalez; Catalina,19,0,19,0
1653300141762,BIPN 102,A01,093046,Reyes Gonzalez; Catalina,28,0,32,4
1653300141762,BIPN 102,A02,093047,Reyes Gonzalez; Catalina,17,0,32,15
1653300141762,BIPN 102,A05,093050,Reyes Gonzalez; Catalina,29,0,32,3
1653300141762,BIPN 102,A06,093051,Reyes Gonzalez; Catalina,15,0,32,17
1653300141762,BIPN 102,A07,093052,Reyes Gonzalez; Catalina,29,0,32,3
1653300141762,BIPN 102,A08,093053,Reyes Gonzalez; Catalina,31,0,32,1
1653300142285,BIPN 105,A01,089966,Armour; Jon Christopher,0,0,21,21
1653300142285,BIPN 105,A02,089967,Armour; Jon Christopher,0,0,21,21
1653300142285,BIPN 105,A03,089968,Armour; Jon Christopher,3,0,21,18
1653300142285,BIPN 105,A04,089969,Armour; Jon Christopher,10,0,21,11
1653300142814,BIPN 140,A01,092514,Spitzer; Nicholas & Su; Chih-Ying,9,0,19,10
1653300142814,BIPN 140,A02,092515,Spitzer; Nicholas & Su; Chih-Ying,12,0,19,7
1653300142814,BIPN 140,A03,092516,Spitzer; Nicholas & Su; Chih-Ying,11,0,19,8
1653300142814,BIPN 140,A04,092517,Spitzer; Nicholas & Su; Chih-Ying,15,0,19,4
1653300142814,BIPN 140,B01,092952,Banghart; Matthew Ryan,12,0,19,7
1653300142814,BIPN 140,B02,092953,Banghart; Matthew Ryan,19,0,19,0
1653300142814,BIPN 140,B03,092954,Banghart; Matthew Ryan,19,0,19,0
1653300142814,BIPN 140,B04,092955,Banghart; Matthew Ryan,19,0,19,0
1653300143338,BIPN 145,A01,089973,Marino; Marc J,35,0,42,7
1653300143338,BIPN 145,A02,089974,Marino; Marc J,36,0,42,6
1653300143338,BIPN 145,B01,089976,Juavinett; Ashley Lauren,0,0,42,42
1653300143862,BIPN 148,A01,092960,Leutgeb; Jill K.,31,0,32,1
1653300143862,BIPN 148,A02,092961,Leutgeb; Jill K.,25,0,32,7
1653300143862,BIPN 148,A03,092962,Leutgeb; Jill K.,29,0,31,2
1653300143862,BIPN 148,A04,092963,Leutgeb; Jill K.,31,0,31,0
1653300143862,BIPN 148,A05,092964,Leutgeb; Jill K.,31,0,31,0
1653300143862,BIPN 148,A06,094351,Leutgeb; Jill K.,26,0,31,5
1653300143862,BIPN 148,A07,092966,Leutgeb; Jill K.,26,0,31,5
1653300143862,BIPN 148,A08,092967,Leutgeb; Jill K.,26,0,31,5
1653300144388,BIPN 189,A00,090665,Gentner; Tim,0,0,25,25
1653300144911,BIPN 194,A00,089978,Pekkurnaz Banghart; Gulcin,17,0,27,10
1653300144911,BIPN 194,B00,089979,Leutgeb; Stefan,24,0,27,3
1653300145434,BISP 194,A00,089980,Wertheim; Joel Okrent,8,0,27,19
1653300145962,CAT 1,A01,086671,Bronstein; Phoebe Malan,17,0,17,0
1653300145962,CAT 1,A02,086672,Bronstein; Phoebe Malan,13,0,17,4
1653300145962,CAT 1,A03,086673,Bronstein; Phoebe Malan,17,0,17,0
1653300145962,CAT 1,A04,086674,Bronstein; Phoebe Malan,15,0,17,2
1653300145962,CAT 1,A05,086675,Bronstein; Phoebe Malan,17,0,17,0
1653300145962,CAT 1,A06,086676,Bronstein; Phoebe Malan,17,0,17,0
1653300145962,CAT 1,A07,086677,Bronstein; Phoebe Malan,16,0,17,1
1653300145962,CAT 1,A08,086678,Bronstein; Phoebe Malan,17,0,17,0
1653300145962,CAT 1,A09,086679,Bronstein; Phoebe Malan,16,0,17,1
1653300145962,CAT 1,A10,086680,Bronstein; Phoebe Malan,17,0,17,0
1653300145962,CAT 1,A11,086681,Bronstein; Phoebe Malan,16,0,17,1
1653300145962,CAT 1,A12,086682,Bronstein; Phoebe Malan,17,0,17,0
1653300145962,CAT 1,A13,086683,Bronstein; Phoebe Malan,17,0,17,0
1653300145962,CAT 1,A14,086684,Bronstein; Phoebe Malan,17,0,17,0
1653300145962,CAT 1,A15,086685,Bronstein; Phoebe Malan,17,0,17,0
1653300145962,CAT 1,A16,086686,Bronstein; Phoebe Malan,17,0,17,0
1653300145962,CAT 1,B01,086688,Bigham; David Joseph,17,0,17,0
1653300145962,CAT 1,B02,086689,Bigham; David Joseph,16,0,17,1
1653300145962,CAT 1,B03,086690,Bigham; David Joseph,17,0,17,0
1653300145962,CAT 1,B04,086691,Bigham; David Joseph,17,0,17,0
1653300145962,CAT 1,B05,086692,Bigham; David Joseph,16,0,17,1
1653300145962,CAT 1,B06,086693,Bigham; David Joseph,17,0,17,0
1653300145962,CAT 1,B07,086694,Bigham; David Joseph,17,0,17,0
1653300145962,CAT 1,B08,086695,Bigham; David Joseph,17,0,17,0
1653300145962,CAT 1,B09,086696,Bigham; David Joseph,17,0,17,0
1653300145962,CAT 1,B10,086697,Bigham; David Joseph,17,0,17,0
1653300145962,CAT 1,B11,086698,Bigham; David Joseph,17,0,17,0
1653300145962,CAT 1,B12,086699,Bigham; David Joseph,17,0,17,0
1653300145962,CAT 1,B13,086700,Bigham; David Joseph,15,0,17,2
1653300145962,CAT 1,B14,086701,Bigham; David Joseph,17,0,17,0
1653300145962,CAT 1,C01,086703,Algaze; Guillermo,17,0,17,0
1653300145962,CAT 1,C02,086704,Algaze; Guillermo,17,0,17,0
1653300145962,CAT 1,C03,086705,Algaze; Guillermo,17,0,17,0
1653300145962,CAT 1,C04,086706,Algaze; Guillermo,17,0,17,0
1653300145962,CAT 1,C05,086707,Algaze; Guillermo,17,0,17,0
1653300145962,CAT 1,C06,086708,Algaze; Guillermo,17,0,17,0
1653300145962,CAT 1,C07,086709,Algaze; Guillermo,17,0,17,0
1653300145962,CAT 1,C08,086710,Algaze; Guillermo,17,0,17,0
1653300145962,CAT 1,C09,086711,Algaze; Guillermo,17,0,17,0
1653300145962,CAT 1,C10,086712,Algaze; Guillermo,17,0,17,0
1653300145962,CAT 1,C11,086713,Algaze; Guillermo,17,0,17,0
1653300145962,CAT 1,C12,086714,Algaze; Guillermo,17,0,17,0
1653300145962,CAT 1,C13,086715,Algaze; Guillermo,17,0,17,0
1653300145962,CAT 1,C14,086716,Algaze; Guillermo,16,0,17,1
1653300145962,CAT 1,C15,086717,Algaze; Guillermo,17,0,17,0
1653300145962,CAT 1,C16,086718,Algaze; Guillermo,16,0,17,1
1653300145962,CAT 1,D01,086720,Staff,17,0,17,0
1653300145962,CAT 1,D02,086721,Staff,17,0,17,0
1653300145962,CAT 1,D03,086722,Staff,17,0,17,0
1653300145962,CAT 1,D04,086723,Staff,17,0,17,0
1653300145962,CAT 1,D05,086724,Staff,16,0,17,1
1653300145962,CAT 1,D06,086725,Staff,16,0,17,1
1653300145962,CAT 1,D07,086726,Staff,17,0,17,0
1653300145962,CAT 1,D08,086727,Staff,17,0,17,0
1653300145962,CAT 1,D09,086728,Staff,16,0,17,1
1653300145962,CAT 1,D10,086729,Staff,17,0,17,0
1653300145962,CAT 1,D11,086730,Staff,17,0,17,0
1653300145962,CAT 1,D12,086731,Staff,17,0,17,0
1653300145962,CAT 1,D13,086732,Staff,17,0,17,0
1653300145962,CAT 1,D14,086733,Staff,17,0,17,0
1653300146486,CAT 3,A01,086735,Gumm; Elizabeth Ashley,14,0,15,1
1653300146486,CAT 3,A02,086736,Gumm; Elizabeth Ashley,14,0,15,1
1653300146486,CAT 3,A03,086737,Gumm; Elizabeth Ashley,15,0,15,0
1653300146486,CAT 3,A04,086738,Gumm; Elizabeth Ashley,15,0,15,0
1653300146486,CAT 3,A05,086739,Gumm; Elizabeth Ashley,15,0,15,0
1653300146486,CAT 3,A06,086740,Gumm; Elizabeth Ashley,15,0,15,0
1653300147010,CAT 124,A01,086742,Staff,15,0,15,0
1653300147535,CAT 125R,A01,094882,Staff,14,0,16,2
1653300147535,CAT 125R,A02,086745,Staff,16,0,16,0
1653300147535,CAT 125R,A03,086746,Staff,14,0,16,2
1653300147535,CAT 125R,A04,086747,Staff,13,0,16,3
1653300147535,CAT 125R,A05,086748,Staff,15,0,16,1
1653300147535,CAT 125R,A06,086749,Staff,12,0,16,4
1653300147535,CAT 125R,A07,086750,Staff,14,0,16,2
1653300147535,CAT 125R,A08,094883,Staff,14,0,16,2
1653300147535,CAT 125R,A09,094884,Staff,16,0,16,0
1653300147535,CAT 125R,A10,094885,Staff,15,0,16,1
1653300147535,CAT 125R,A14,086761,Staff,15,0,16,1
1653300147535,CAT 125R,A15,086762,Staff,16,0,16,0
1653300147535,CAT 125R,A16,086763,Staff,13,0,16,3
1653300147535,CAT 125R,A17,086764,Staff,14,0,16,2
1653300147535,CAT 125R,A18,086765,Staff,14,0,16,2
1653300147535,CAT 125R,A19,086766,Staff,14,0,16,2
1653300148063,CCS 101,A00,088353,Staff,29,0,35,6
1653300148586,CENG 4,A01,086204,Bae; Jinhye,30,0,30,0
1653300148586,CENG 4,A02,086205,Bae; Jinhye,30,0,30,0
1653300148586,CENG 4,B01,086207,Drews; Aaron,30,0,30,0
1653300148586,CENG 4,B02,086208,Drews; Aaron,30,0,30,0
1653300149115,CENG 15,A01,086210,Lubarda; Vlado,63,0,65,2
1653300149115,CENG 15,B01,086212,Lubarda; Vlado,65,0,65,0
1653300149647,CENG 100,A00,086213,Chen; Zheng,147,0,150,3
1653300150169,CENG 101A,A00,086214,Bae; Jinhye,142,0,150,8
1653300150691,CENG 120,A00,086215,Opatkiewicz; Justin Paul,125,0,150,25
1653300151215,CENG 122,A00,086216,Opatkiewicz; Justin Paul,137,0,150,13
1653300151745,CGS 2A,A01,086271,Shelby; Karen Lee,12,0,15,3
1653300151745,CGS 2A,A02,086272,Shelby; Karen Lee,13,0,15,2
1653300151745,CGS 2A,A03,086273,Shelby; Karen Lee,14,0,15,1
1653300151745,CGS 2A,A04,086274,Shelby; Karen Lee,15,0,15,0
1653300152270,CGS 100A,A00,086275,Perez; Roy,26,0,32,6
1653300152794,CGS 101,A00,086276,Shelby; Karen Lee,30,0,30,0
1653300153318,CGS 106,A00,086277,Shelby; Karen Lee,24,0,30,6
1653300153843,CGS 119,A00,086279,Nguyen; Hoang Tan,27,0,30,3
1653300154372,CGS 121,A00,086280,Martin Sandino; Amanda Maria Yoland,19,0,20,1
1653300154898,CGS 122,A00,086281,Whitley; Leila Marie,20,0,20,0
1653300155430,CGS 123,A00,086282,Staff,0,0,0,0
1653300155955,CGS 127,A00,086283,Whitley; Leila Marie,15,0,15,0
1653300156479,CGS 130,A00,086284,Martin Sandino; Amanda Maria Yoland,15,0,15,0
1653300157007,CGS 187,A00,086285,Perez; Roy,15,0,16,1
1653300157531,CGS 190,A00,086286,Staff,5,0,5,0
1653300158057,CHEM 4,A01,089669,Bussey; Thomas J,40,0,40,0
1653300158057,CHEM 4,A02,089670,Bussey; Thomas J,42,0,42,0
1653300158057,CHEM 4,A03,089671,Bussey; Thomas J,40,0,42,2
1653300158057,CHEM 4,A04,089672,Bussey; Thomas J,42,0,42,0
1653300158057,CHEM 4,A05,089673,Bussey; Thomas J,40,0,42,2
1653300158057,CHEM 4,A06,089674,Bussey; Thomas J,40,0,42,2
1653300158057,CHEM 4,A07,089675,Bussey; Thomas J,42,0,42,0
1653300158057,CHEM 4,A08,089676,Bussey; Thomas J,42,0,42,0
1653300158057,CHEM 4,A09,089677,Bussey; Thomas J,41,0,41,0
1653300158057,CHEM 4,A10,089678,Bussey; Thomas J,40,0,40,0
1653300158589,CHEM 6A,A01,092734,Pomeroy; Robert S.,4,0,4,0
1653300158589,CHEM 6A,A02,092735,Pomeroy; Robert S.,4,0,4,0
1653300158589,CHEM 6A,A03,092736,Pomeroy; Robert S.,4,0,4,0
1653300158589,CHEM 6A,A04,092737,Pomeroy; Robert S.,4,0,4,0
1653300158589,CHEM 6A,A05,092738,Pomeroy; Robert S.,4,0,4,0
1653300158589,CHEM 6A,A06,092739,Pomeroy; Robert S.,4,0,4,0
1653300158589,CHEM 6A,A07,092740,Pomeroy; Robert S.,4,0,4,0
1653300158589,CHEM 6A,A08,092741,Pomeroy; Robert S.,4,0,4,0
1653300158589,CHEM 6A,A09,092742,Pomeroy; Robert S.,0,0,0,0
1653300158589,CHEM 6A,B01,092744,Schurmeier; Kimberly,4,0,4,0
1653300158589,CHEM 6A,B02,092746,Schurmeier; Kimberly,4,0,4,0
1653300158589,CHEM 6A,B03,092749,Schurmeier; Kimberly,4,0,4,0
1653300158589,CHEM 6A,B04,092751,Schurmeier; Kimberly,4,0,4,0
1653300158589,CHEM 6A,B05,092753,Schurmeier; Kimberly,4,0,4,0
1653300158589,CHEM 6A,B06,092755,Schurmeier; Kimberly,3,0,4,1
1653300158589,CHEM 6A,B07,092756,Schurmeier; Kimberly,4,0,4,0
1653300158589,CHEM 6A,B08,092757,Schurmeier; Kimberly,4,0,4,0
1653300158589,CHEM 6A,B09,092758,Schurmeier; Kimberly,0,0,0,0
1653300158589,CHEM 6A,C01,092805,Schurmeier; Kimberly,4,0,4,0
1653300158589,CHEM 6A,C02,092806,Schurmeier; Kimberly,4,0,4,0
1653300158589,CHEM 6A,C03,092807,Schurmeier; Kimberly,4,0,4,0
1653300158589,CHEM 6A,C04,092808,Schurmeier; Kimberly,4,0,4,0
1653300158589,CHEM 6A,C05,092809,Schurmeier; Kimberly,4,0,4,0
1653300158589,CHEM 6A,C06,092810,Schurmeier; Kimberly,4,0,4,0
1653300158589,CHEM 6A,C07,092811,Schurmeier; Kimberly,4,0,4,0
1653300158589,CHEM 6A,C08,092812,Schurmeier; Kimberly,4,0,4,0
1653300158589,CHEM 6A,C09,092813,Schurmeier; Kimberly,0,0,0,0
1653300158589,CHEM 6A,D01,092837,Stallings; Dontarie M,4,0,4,0
1653300158589,CHEM 6A,D02,092838,Stallings; Dontarie M,4,0,4,0
1653300158589,CHEM 6A,D03,092839,Stallings; Dontarie M,4,0,4,0
1653300158589,CHEM 6A,D04,092840,Stallings; Dontarie M,4,0,4,0
1653300158589,CHEM 6A,D05,092841,Stallings; Dontarie M,4,0,4,0
1653300158589,CHEM 6A,D06,092842,Stallings; Dontarie M,4,0,4,0
1653300158589,CHEM 6A,D07,092843,Stallings; Dontarie M,4,0,4,0
1653300158589,CHEM 6A,D08,092844,Stallings; Dontarie M,4,0,4,0
1653300158589,CHEM 6A,D09,092845,Stallings; Dontarie M,0,0,0,0
1653300158589,CHEM 6A,E01,092796,Brydges; Stacey,4,0,4,0
1653300158589,CHEM 6A,E02,092797,Brydges; Stacey,3,0,4,1
1653300158589,CHEM 6A,E03,092798,Brydges; Stacey,4,0,4,0
1653300158589,CHEM 6A,E04,092799,Brydges; Stacey,3,0,4,1
1653300158589,CHEM 6A,E05,092800,Brydges; Stacey,4,0,4,0
1653300158589,CHEM 6A,E06,092801,Brydges; Stacey,4,0,4,0
1653300158589,CHEM 6A,E07,092802,Brydges; Stacey,4,0,4,0
1653300158589,CHEM 6A,E08,092803,Brydges; Stacey,4,0,4,0
1653300158589,CHEM 6A,E09,092804,Brydges; Stacey,0,0,0,0
1653300158589,CHEM 6A,F01,092759,Brydges; Stacey,4,0,4,0
1653300158589,CHEM 6A,F02,092760,Brydges; Stacey,4,0,4,0
1653300158589,CHEM 6A,F03,092761,Brydges; Stacey,3,0,4,1
1653300158589,CHEM 6A,F04,092762,Brydges; Stacey,4,0,4,0
1653300158589,CHEM 6A,F05,092763,Brydges; Stacey,4,0,4,0
1653300158589,CHEM 6A,F06,092764,Brydges; Stacey,4,0,4,0
1653300158589,CHEM 6A,F07,092765,Brydges; Stacey,4,0,4,0
1653300158589,CHEM 6A,F08,092766,Brydges; Stacey,4,0,4,0
1653300158589,CHEM 6A,F09,092767,Brydges; Stacey,0,0,0,0
1653300158589,CHEM 6A,G01,092774,Zid; Brian M,0,0,4,4
1653300158589,CHEM 6A,G02,092775,Zid; Brian M,2,0,4,2
1653300158589,CHEM 6A,G03,092776,Zid; Brian M,2,0,4,2
1653300158589,CHEM 6A,G04,092777,Zid; Brian M,2,0,4,2
1653300158589,CHEM 6A,G05,092778,Zid; Brian M,4,0,4,0
1653300158589,CHEM 6A,G06,092779,Zid; Brian M,4,0,4,0
1653300158589,CHEM 6A,G07,092780,Zid; Brian M,3,0,4,1
1653300158589,CHEM 6A,G08,092781,Zid; Brian M,3,0,4,1
1653300158589,CHEM 6A,G09,092782,Zid; Brian M,0,0,0,0
1653300158589,CHEM 6A,H01,092846,Stallings; Dontarie M,4,0,4,0
1653300158589,CHEM 6A,H02,092847,Stallings; Dontarie M,3,0,4,1
1653300158589,CHEM 6A,H03,092848,Stallings; Dontarie M,4,0,4,0
1653300158589,CHEM 6A,H04,092849,Stallings; Dontarie M,4,0,4,0
1653300158589,CHEM 6A,H05,092850,Stallings; Dontarie M,4,0,4,0
1653300158589,CHEM 6A,H06,092851,Stallings; Dontarie M,3,0,4,1
1653300158589,CHEM 6A,H07,092852,Stallings; Dontarie M,4,0,4,0
1653300158589,CHEM 6A,H08,092853,Stallings; Dontarie M,3,0,4,1
1653300158589,CHEM 6A,H09,092854,Stallings; Dontarie M,0,0,0,0
1653300158589,CHEM 6A,I01,092814,Staff,0,0,0,0
1653300158589,CHEM 6A,I02,092815,Staff,0,0,0,0
1653300158589,CHEM 6A,I04,092816,Staff,0,0,0,0
1653300158589,CHEM 6A,I05,092817,Staff,0,0,0,0
1653300158589,CHEM 6A,I06,092818,Staff,0,0,0,0
1653300158589,CHEM 6A,I07,092819,Staff,0,0,0,0
1653300158589,CHEM 6A,I08,092820,Staff,0,0,0,0
1653300158589,CHEM 6A,I09,092821,Staff,0,0,0,0
1653300159113,CHEM 6AH,A01,092793,Paesani; Francesco,15,0,16,1
1653300159113,CHEM 6AH,A02,092794,Paesani; Francesco,16,0,16,0
1653300159113,CHEM 6AH,A03,092795,Paesani; Francesco,16,0,16,0
1653300159638,CHEM 6B,A01,092691,Hopkins; Patrycja Anna,21,0,25,4
1653300159638,CHEM 6B,A02,092692,Hopkins; Patrycja Anna,23,0,25,2
1653300159638,CHEM 6B,A03,092693,Hopkins; Patrycja Anna,25,0,25,0
1653300159638,CHEM 6B,A04,092694,Hopkins; Patrycja Anna,0,0,0,0
1653300159638,CHEM 6B,A05,092695,Hopkins; Patrycja Anna,24,0,25,1
1653300159638,CHEM 6B,A06,092696,Hopkins; Patrycja Anna,22,0,25,3
1653300159638,CHEM 6B,A07,092697,Hopkins; Patrycja Anna,24,0,25,1
1653300160162,CHEM 6C,A01,092708,Albizati; Kim F.,31,0,38,7
1653300160162,CHEM 6C,A02,092709,Albizati; Kim F.,32,0,38,6
1653300160162,CHEM 6C,A03,092710,Albizati; Kim F.,37,0,38,1
1653300160162,CHEM 6C,A04,092711,Albizati; Kim F.,36,0,38,2
1653300160162,CHEM 6C,A05,092712,Albizati; Kim F.,0,0,0,0
1653300160162,CHEM 6C,A06,092714,Albizati; Kim F.,33,0,38,5
1653300160162,CHEM 6C,A07,092715,Albizati; Kim F.,32,0,38,6
1653300160162,CHEM 6C,A08,092716,Albizati; Kim F.,37,0,38,1
1653300160162,CHEM 6C,A09,092717,Albizati; Kim F.,38,0,38,0
1653300160712,CHEM 7L,A01,089692,Leigh; Brian,11,0,19,8
1653300160712,CHEM 7L,A02,089693,Leigh; Brian,23,0,24,1
1653300160712,CHEM 7L,A03,089694,Leigh; Brian,24,0,24,0
1653300160712,CHEM 7L,A04,089695,Leigh; Brian,24,0,24,0
1653300160712,CHEM 7L,A05,089696,Leigh; Brian,23,0,24,1
1653300160712,CHEM 7L,A06,089697,Leigh; Brian,22,0,24,2
1653300160712,CHEM 7L,A07,089698,Leigh; Brian,21,0,21,0
1653300160712,CHEM 7L,A08,089699,Leigh; Brian,17,0,24,7
1653300160712,CHEM 7L,A09,089700,Leigh; Brian,23,0,24,1
1653300160712,CHEM 7L,A10,089701,Leigh; Brian,0,0,0,0
1653300160712,CHEM 7L,B01,089703,Leigh; Brian,18,0,24,6
1653300160712,CHEM 7L,B02,089704,Leigh; Brian,18,0,24,6
1653300160712,CHEM 7L,B03,089705,Leigh; Brian,23,0,24,1
1653300160712,CHEM 7L,B04,089706,Leigh; Brian,20,0,21,1
1653300160712,CHEM 7L,B05,089707,Leigh; Brian,17,0,24,7
1653300160712,CHEM 7L,B06,089708,Leigh; Brian,17,0,24,7
1653300160712,CHEM 7L,B07,089709,Leigh; Brian,17,0,24,7
1653300160712,CHEM 7L,B08,089710,Leigh; Brian,21,0,24,3
1653300160712,CHEM 7L,B09,089711,Leigh; Brian,21,0,24,3
1653300160712,CHEM 7L,B10,089712,Leigh; Brian,0,0,0,0
1653300160712,CHEM 7L,C01,089714,Staff,23,0,24,1
1653300160712,CHEM 7L,C02,089715,Staff,22,0,24,2
1653300160712,CHEM 7L,C03,089716,Staff,23,0,24,1
1653300160712,CHEM 7L,C04,089717,Staff,24,0,24,0
1653300160712,CHEM 7L,C05,089718,Staff,21,0,24,3
1653300160712,CHEM 7L,C06,089719,Staff,22,0,24,2
1653300160712,CHEM 7L,C07,089720,Staff,23,0,24,1
1653300160712,CHEM 7L,C08,089721,Staff,24,0,24,0
1653300160712,CHEM 7L,C09,089722,Staff,24,0,24,0
1653300160712,CHEM 7L,C10,089723,Staff,0,0,0,0
1653300161237,CHEM 40A,A01,092871,Schmidt; Valerie A,31,0,31,0
1653300161237,CHEM 40A,A02,092872,Schmidt; Valerie A,31,0,31,0
1653300161237,CHEM 40A,A03,092873,Schmidt; Valerie A,31,0,31,0
1653300161237,CHEM 40A,A04,092874,Schmidt; Valerie A,0,0,0,0
1653300161237,CHEM 40A,A05,092875,Schmidt; Valerie A,31,0,31,0
1653300161237,CHEM 40A,A06,092876,Schmidt; Valerie A,29,0,31,2
1653300161237,CHEM 40A,A07,092877,Schmidt; Valerie A,31,0,31,0
1653300161237,CHEM 40A,A08,092878,Schmidt; Valerie A,28,0,28,0
1653300161237,CHEM 40A,B01,089726,Lam; Tin Yiu,31,0,31,0
1653300161237,CHEM 40A,B02,089727,Lam; Tin Yiu,31,0,31,0
1653300161237,CHEM 40A,B03,089728,Lam; Tin Yiu,31,0,31,0
1653300161237,CHEM 40A,B04,089729,Lam; Tin Yiu,30,0,31,1
1653300161237,CHEM 40A,B05,089730,Lam; Tin Yiu,31,0,31,0
1653300161237,CHEM 40A,B06,089731,Lam; Tin Yiu,30,0,31,1
1653300161237,CHEM 40A,B07,089732,Lam; Tin Yiu,29,0,31,2
1653300161237,CHEM 40A,B08,089733,Lam; Tin Yiu,0,0,0,0
1653300161237,CHEM 40A,C01,092718,Albizati; Kim F.,17,0,31,14
1653300161237,CHEM 40A,C02,092719,Albizati; Kim F.,24,0,31,7
1653300161237,CHEM 40A,C03,092720,Albizati; Kim F.,12,0,31,19
1653300161237,CHEM 40A,C04,092721,Albizati; Kim F.,24,0,31,7
1653300161237,CHEM 40A,C05,092722,Albizati; Kim F.,21,0,31,10
1653300161237,CHEM 40A,C06,092723,Albizati; Kim F.,24,0,31,7
1653300161237,CHEM 40A,C07,092724,Albizati; Kim F.,30,0,31,1
1653300161237,CHEM 40A,C08,092725,Albizati; Kim F.,0,0,0,0
1653300161237,CHEM 40A,D01,092863,Yang; Jerry,28,0,31,3
1653300161237,CHEM 40A,D02,092864,Yang; Jerry,28,0,31,3
1653300161237,CHEM 40A,D03,092865,Yang; Jerry,31,0,31,0
1653300161237,CHEM 40A,D04,092866,Yang; Jerry,31,0,31,0
1653300161237,CHEM 40A,D05,092867,Yang; Jerry,0,0,0,0
1653300161237,CHEM 40A,D06,092868,Yang; Jerry,31,0,31,0
1653300161237,CHEM 40A,D07,092869,Yang; Jerry,31,0,31,0
1653300161237,CHEM 40A,D08,092870,Yang; Jerry,31,0,31,0
1653300161763,CHEM 40B,A01,092698,Oconnor; Joseph M.,24,0,34,10
1653300161763,CHEM 40B,A02,092699,Oconnor; Joseph M.,34,0,34,0
1653300161763,CHEM 40B,A03,092700,Oconnor; Joseph M.,0,0,0,0
1653300161763,CHEM 40B,A04,092701,Oconnor; Joseph M.,30,0,34,4
1653300161763,CHEM 40B,A05,092702,Oconnor; Joseph M.,33,0,34,1
1653300161763,CHEM 40B,A06,092703,Oconnor; Joseph M.,34,0,34,0
1653300161763,CHEM 40B,A07,092704,Oconnor; Joseph M.,32,0,34,2
1653300161763,CHEM 40B,A08,092705,Oconnor; Joseph M.,33,0,34,1
1653300161763,CHEM 40B,A09,092706,Oconnor; Joseph M.,34,0,34,0
1653300162292,CHEM 40C,A01,089739,Lam; Tin Yiu,0,0,0,0
1653300162292,CHEM 40C,A02,089740,Lam; Tin Yiu,0,0,0,0
1653300162292,CHEM 40C,A03,089741,Lam; Tin Yiu,0,0,0,0
1653300162292,CHEM 40C,A04,089742,Lam; Tin Yiu,13,0,34,21
1653300162292,CHEM 40C,A05,089743,Lam; Tin Yiu,32,0,34,2
1653300162292,CHEM 40C,A06,089744,Lam; Tin Yiu,31,0,34,3
1653300162818,CHEM 41A,A01,093840,Ternansky; Robert J.,29,0,33,4
1653300162818,CHEM 41A,A02,093841,Ternansky; Robert J.,32,0,33,1
1653300162818,CHEM 41A,A03,093842,Ternansky; Robert J.,33,0,33,0
1653300162818,CHEM 41A,A04,093843,Ternansky; Robert J.,30,0,33,3
1653300162818,CHEM 41A,A05,093844,Ternansky; Robert J.,31,0,33,2
1653300162818,CHEM 41A,A06,093845,Ternansky; Robert J.,27,0,27,0
1653300162818,CHEM 41A,A07,093846,Ternansky; Robert J.,32,0,33,1
1653300162818,CHEM 41A,A08,093847,Ternansky; Robert J.,33,0,33,0
1653300163353,CHEM 43A,A01,089746,Klosterman; Jeremy K,11,0,24,13
1653300163353,CHEM 43A,A02,089747,Klosterman; Jeremy K,16,0,24,8
1653300163353,CHEM 43A,A03,089748,Klosterman; Jeremy K,21,0,24,3
1653300163353,CHEM 43A,A04,089749,Klosterman; Jeremy K,22,0,24,2
1653300163353,CHEM 43A,A05,089750,Klosterman; Jeremy K,23,0,24,1
1653300163353,CHEM 43A,A06,089751,Klosterman; Jeremy K,9,0,24,15
1653300163353,CHEM 43A,A07,089752,Klosterman; Jeremy K,17,0,24,7
1653300163353,CHEM 43A,A08,089753,Klosterman; Jeremy K,16,0,24,8
1653300163353,CHEM 43A,A09,089754,Klosterman; Jeremy K,21,0,24,3
1653300163353,CHEM 43A,A10,089755,Klosterman; Jeremy K,21,0,24,3
1653300163353,CHEM 43A,A11,089756,Klosterman; Jeremy K,0,0,0,0
1653300163353,CHEM 43A,A12,089757,Klosterman; Jeremy K,0,0,0,0
1653300163353,CHEM 43A,A13,089758,Klosterman; Jeremy K,0,0,0,0
1653300163353,CHEM 43A,B01,089760,Klosterman; Jeremy K,0,0,0,0
1653300163353,CHEM 43A,B02,089761,Klosterman; Jeremy K,0,0,0,0
1653300163353,CHEM 43A,B03,089762,Klosterman; Jeremy K,16,0,24,8
1653300163353,CHEM 43A,B04,089763,Klosterman; Jeremy K,22,0,24,2
1653300163353,CHEM 43A,B05,089764,Klosterman; Jeremy K,23,0,24,1
1653300163353,CHEM 43A,B06,089765,Klosterman; Jeremy K,23,0,24,1
1653300163353,CHEM 43A,B07,089766,Klosterman; Jeremy K,17,0,24,7
1653300163353,CHEM 43A,B08,089767,Klosterman; Jeremy K,23,0,24,1
1653300163353,CHEM 43A,B09,089768,Klosterman; Jeremy K,24,0,24,0
1653300163353,CHEM 43A,B10,089769,Klosterman; Jeremy K,23,0,24,1
1653300163353,CHEM 43A,B11,089770,Klosterman; Jeremy K,22,0,24,2
1653300163353,CHEM 43A,B12,089771,Klosterman; Jeremy K,21,0,24,3
1653300163881,CHEM 87,A00,089772,Bussey; Thomas J,20,0,20,0
1653300164404,CHEM 96,A00,089773,Bussey; Thomas J,20,0,25,5
1653300164934,CHEM 100A,A01,089775,Pomeroy; Robert S.,22,0,24,2
1653300164934,CHEM 100A,A02,089776,Pomeroy; Robert S.,19,0,24,5
1653300164934,CHEM 100A,A03,089777,Pomeroy; Robert S.,13,0,24,11
1653300164934,CHEM 100A,A04,089778,Pomeroy; Robert S.,18,0,24,6
1653300164934,CHEM 100A,A05,089779,Pomeroy; Robert S.,19,0,24,5
1653300164934,CHEM 100A,A06,089780,Pomeroy; Robert S.,24,0,24,0
1653300164934,CHEM 100A,A07,089781,Pomeroy; Robert S.,0,0,0,0
1653300165457,CHEM 105A,A01,089783,Young; Mark,0,0,39,39
1653300165457,CHEM 105A,B01,089785,Young; Mark,26,0,39,13
1653300165983,CHEM 108,A01,089787,Ghosh; Gourisankar,1,0,22,21
1653300165983,CHEM 108,A02,089788,Ghosh; Gourisankar,6,0,22,16
1653300165983,CHEM 108,B01,089790,Ghosh; Gourisankar,13,0,22,9
1653300165983,CHEM 108,B02,089791,Ghosh; Gourisankar,20,0,22,2
1653300166507,CHEM 109,A01,089793,Hamaoka; Brent Y,4,0,22,18
1653300166507,CHEM 109,A02,089794,Hamaoka; Brent Y,10,0,22,12
1653300166507,CHEM 109,B01,089796,Hamaoka; Brent Y,6,0,22,16
1653300166507,CHEM 109,B02,089797,Hamaoka; Brent Y,18,0,22,4
1653300167123,CHEM 114A,A01,092855,Toor; Navtej,21,0,25,4
1653300167123,CHEM 114A,A02,092856,Toor; Navtej,25,0,25,0
1653300167123,CHEM 114A,A03,092857,Toor; Navtej,19,0,25,6
1653300167123,CHEM 114A,A04,092858,Toor; Navtej,24,0,25,1
1653300167123,CHEM 114A,A05,092859,Toor; Navtej,0,0,0,0
1653300167123,CHEM 114A,A06,092860,Toor; Navtej,14,0,25,11
1653300167123,CHEM 114A,A07,092861,Toor; Navtej,24,0,25,1
1653300167123,CHEM 114A,A08,092862,Toor; Navtej,24,0,25,1
1653300167646,CHEM 116,A01,092707,Ferguson; Fleur,7,0,35,28
1653300167646,CHEM 116,A02,094887,Ferguson; Fleur,31,0,35,4
1653300168175,CHEM 120A,A01,092785,Schimpf; Alina M,16,0,28,12
1653300168175,CHEM 120A,A02,092786,Schimpf; Alina M,26,0,28,2
1653300168175,CHEM 120A,A03,092787,Schimpf; Alina M,20,0,28,8
1653300168175,CHEM 120A,A04,092788,Schimpf; Alina M,27,0,28,1
1653300168175,CHEM 120A,A05,092789,Schimpf; Alina M,27,0,28,1
1653300168175,CHEM 120A,A06,092790,Schimpf; Alina M,0,0,0,0
1653300168175,CHEM 120A,A07,092791,Schimpf; Alina M,15,0,28,13
1653300168175,CHEM 120A,A08,092792,Schimpf; Alina M,0,0,0,0
1653300168701,CHEM 126A,A01,092768,Schoeneberg; Johannes,16,0,35,19
1653300168701,CHEM 126A,A02,092769,Schoeneberg; Johannes,35,0,35,0
1653300168701,CHEM 126A,A03,092770,Schoeneberg; Johannes,29,0,35,6
1653300168701,CHEM 126A,A04,092771,Schoeneberg; Johannes,0,0,0,0
1653300168701,CHEM 126A,A05,092772,Schoeneberg; Johannes,30,0,35,5
1653300168701,CHEM 126A,A06,092773,Schoeneberg; Johannes,33,0,35,2
1653300169231,CHEM 130,A01,092685,Sinha; Amitabha,28,0,38,10
1653300169231,CHEM 130,A02,092686,Sinha; Amitabha,31,0,38,7
1653300169231,CHEM 130,A03,092687,Sinha; Amitabha,34,0,38,4
1653300169760,CHEM 142,A00,089803,Esko; Jeffrey D. & Godula; Kamil,9,0,46,37
1653300170286,CHEM 143C,A01,089805,Ternansky; Robert J.,17,0,22,5
1653300170286,CHEM 143C,A02,089806,Ternansky; Robert J.,18,0,22,4
1653300170286,CHEM 143C,A03,089807,Ternansky; Robert J.,19,0,22,3
1653300170286,CHEM 143C,A04,089808,Ternansky; Robert J.,20,0,22,2
1653300170811,CHEM 152,A00,089809,Romero; Nathan A & Schmidt; Valerie A,35,0,40,5
1653300171337,CHEM 171,A01,092688,Slade; Jonathan,35,0,45,10
1653300171337,CHEM 171,A02,092689,Slade; Jonathan,44,0,45,1
1653300171337,CHEM 171,A03,092690,Slade; Jonathan,45,0,45,0
1653300171872,CHEM 186,A00,089811,Paesani; Francesco,9,0,15,6
1653300172668,CHIN 10AD,A01,086223,Staff,13,0,13,0
1653300172668,CHIN 10AD,A02,086224,Staff,12,0,13,1
1653300172668,CHIN 10AD,B01,086227,Staff,14,0,15,1
1653300173196,CHIN 10AM,A01,086230,Chen; Pei-Chia,16,0,16,0
1653300173196,CHIN 10AM,A02,086231,Chen; Pei-Chia,16,0,16,0
1653300173720,CHIN 10AN,A01,086234,Xu; Li,14,0,14,0
1653300173720,CHIN 10AN,A02,086235,Xu; Li,14,0,14,0
1653300173720,CHIN 10AN,B01,086240,Xu; Li,14,0,14,0
1653300173720,CHIN 10AN,B02,086242,Xu; Li,0,0,0,0
1653300173720,CHIN 10AN,C01,086245,Xu; Li,14,0,14,0
1653300173720,CHIN 10AN,C02,086246,Xu; Li,14,0,14,0
1653300174245,CHIN 20AD,A01,086248,Wang; Xiao,14,0,14,0
1653300174245,CHIN 20AD,A02,086249,Wang; Xiao,14,0,14,0
1653300174245,CHIN 20AD,B01,086251,Wang; Xiao,13,0,14,1
1653300174245,CHIN 20AD,B02,086252,Wang; Xiao,14,0,14,0
1653300174771,CHIN 20AM,A01,086254,Wang; Xiao,11,0,14,3
1653300174771,CHIN 20AM,A02,086255,Wang; Xiao,13,0,14,1
1653300174771,CHIN 20AM,B01,086257,Staff,15,0,15,0
1653300175295,CHIN 20AN,A01,086259,Anderson; Qin-Hong,11,0,12,1
1653300175295,CHIN 20AN,A02,086260,Anderson; Qin-Hong,12,0,12,0
1653300175295,CHIN 20AN,A03,086261,Anderson; Qin-Hong,0,0,0,0
1653300175295,CHIN 20AN,B01,086263,Anderson; Qin-Hong,12,0,13,1
1653300175295,CHIN 20AN,B02,086264,Anderson; Qin-Hong,13,0,13,0
1653300175832,CHIN 100AM,A00,086265,Anderson; Qin-Hong,20,0,20,0
1653300176356,CHIN 100AN,A00,086266,Chen; Pei-Chia,17,0,20,3
1653300176887,CHIN 185A,A00,086268,Staff,20,0,20,0
1653300177417,COGS 1,A01,087834,Barrera; Steven James,57,0,60,3
1653300177417,COGS 1,A02,087835,Barrera; Steven James,52,0,60,8
1653300177417,COGS 1,A03,087836,Barrera; Steven James,57,0,60,3
1653300177417,COGS 1,A04,087837,Barrera; Steven James,59,0,60,1
1653300177417,COGS 1,A05,087838,Barrera; Steven James,60,0,60,0
1653300177417,COGS 1,A06,087839,Barrera; Steven James,59,0,60,1
1653300177417,COGS 1,A07,087840,Barrera; Steven James,54,0,57,3
1653300177944,COGS 2,A01,087842,Boyle; Mary E. T.,64,0,64,0
1653300177944,COGS 2,A02,087843,Boyle; Mary E. T.,61,0,64,3
1653300177944,COGS 2,A03,087844,Boyle; Mary E. T.,64,0,64,0
1653300178476,COGS 3,A01,094312,Boyle; Mary E. T.,30,0,35,5
1653300178476,COGS 3,A02,094313,Boyle; Mary E. T.,33,0,35,2
1653300178476,COGS 3,A03,094314,Boyle; Mary E. T.,35,0,35,0
1653300178476,COGS 3,A04,094315,Boyle; Mary E. T.,35,0,35,0
1653300178476,COGS 3,A05,094316,Boyle; Mary E. T.,35,0,35,0
1653300179003,COGS 8,A01,087846,Staff,35,0,35,0
1653300179526,COGS 10,A01,094357,Hollan; James D.,53,0,60,7
1653300179526,COGS 10,A02,094358,Hollan; James D.,58,0,60,2
1653300179526,COGS 10,A03,094359,Hollan; James D.,59,0,60,1
1653300179526,COGS 10,A04,094360,Hollan; James D.,60,0,60,0
1653300179526,COGS 10,A05,094361,Hollan; James D.,60,0,60,0
1653300180055,COGS 11,A01,087848,Boyle; Mary E. T.,46,0,47,1
1653300180055,COGS 11,A02,087849,Boyle; Mary E. T.,44,0,47,3
1653300180055,COGS 11,A03,087850,Boyle; Mary E. T.,46,0,46,0
1653300180585,COGS 13,A01,087852,Davis; Joshua Daniel,56,0,60,4
1653300180585,COGS 13,A02,087853,Davis; Joshua Daniel,55,0,60,5
1653300180585,COGS 13,A03,087854,Davis; Joshua Daniel,57,0,60,3
1653300180585,COGS 13,A04,087855,Davis; Joshua Daniel,58,0,60,2
1653300181108,COGS 14A,A01,087857,Creel; Sarah,58,0,65,7
1653300181108,COGS 14A,A02,087858,Creel; Sarah,62,0,65,3
1653300181108,COGS 14A,A03,087859,Creel; Sarah,63,0,65,2
1653300181108,COGS 14A,A04,087860,Creel; Sarah,63,0,65,2
1653300181630,COGS 14B,A01,087862,Hoffman; Drew Ellen,56,0,60,4
1653300181630,COGS 14B,A02,087863,Hoffman; Drew Ellen,53,0,60,7
1653300181630,COGS 14B,A03,087864,Hoffman; Drew Ellen,60,0,60,0
1653300182156,COGS 15,A01,087866,Bergen; Benjamin,60,0,60,0
1653300182156,COGS 15,A02,087867,Bergen; Benjamin,59,0,60,1
1653300182682,COGS 17,A01,087869,Johnson; Christine M.,55,0,60,5
1653300182682,COGS 17,A02,087870,Johnson; Christine M.,58,0,60,2
1653300182682,COGS 17,A03,087871,Johnson; Christine M.,55,0,60,5
1653300182682,COGS 17,A04,087872,Johnson; Christine M.,60,0,60,0
1653300182682,COGS 17,A05,087873,Johnson; Christine M.,59,0,60,1
1653300182682,COGS 17,A06,087874,Johnson; Christine M.,60,0,60,0
1653300183208,COGS 18,A01,087876,Fleischer; Jason G,22,0,35,13
1653300183208,COGS 18,A02,087877,Fleischer; Jason G,31,0,35,4
1653300183208,COGS 18,A03,087878,Fleischer; Jason G,33,0,35,2
1653300183208,COGS 18,A04,087879,Fleischer; Jason G,33,0,35,2
1653300183208,COGS 18,A05,087880,Fleischer; Jason G,28,0,35,7
1653300183208,COGS 18,A06,087881,Fleischer; Jason G,34,0,35,1
1653300183208,COGS 18,A07,087882,Fleischer; Jason G,33,0,35,2
1653300183208,COGS 18,A08,087883,Fleischer; Jason G,31,0,35,4
1653300183208,COGS 18,A09,087884,Fleischer; Jason G,33,0,35,2
1653300183730,COGS 20,A01,090761,Borgo; David Garcia,5,0,5,0
1653300183730,COGS 20,A02,090762,Borgo; David Garcia,5,0,5,0
1653300183730,COGS 20,A03,090763,Borgo; David Garcia,5,0,5,0
1653300184265,COGS 87,A00,087885,Deak; Gedeon O.,20,0,20,0
1653300184265,COGS 87,B00,087886,Fleischer; Jason G,20,0,20,0
1653300184790,COGS 100,A01,087892,Kirsh; David Joel,56,0,60,4
1653300184790,COGS 100,A02,087893,Kirsh; David Joel,54,0,60,6
1653300184790,COGS 100,A03,087894,Kirsh; David Joel,54,0,60,6
1653300184790,COGS 100,A04,087895,Kirsh; David Joel,51,0,60,9
1653300184790,COGS 100,A05,087896,Kirsh; David Joel,48,0,60,12
1653300185315,COGS 101A,A01,087898,Hoffman; Drew Ellen,48,0,60,12
1653300185315,COGS 101A,A02,087899,Hoffman; Drew Ellen,58,0,60,2
1653300185315,COGS 101A,A03,087900,Hoffman; Drew Ellen,55,0,60,5
1653300185315,COGS 101A,A04,087901,Hoffman; Drew Ellen,58,0,60,2
1653300185315,COGS 101A,A05,087902,Hoffman; Drew Ellen,59,0,60,1
1653300185315,COGS 101A,A06,087903,Hoffman; Drew Ellen,56,0,60,4
1653300185839,COGS 101B,A01,087905,Barrera; Steven James,30,0,60,30
1653300185839,COGS 101B,A02,087906,Barrera; Steven James,52,0,60,8
1653300185839,COGS 101B,A03,087907,Barrera; Steven James,54,0,60,6
1653300186363,COGS 101C,A01,094240,Cooperrider; Kensy A,70,0,75,5
1653300186363,COGS 101C,A02,094241,Cooperrider; Kensy A,73,0,75,2
1653300186888,COGS 102A,A01,087909,Scott; Taylor Jackson,58,0,60,2
1653300186888,COGS 102A,A02,087910,Scott; Taylor Jackson,51,0,60,9
1653300187409,COGS 107A,A01,087912,Rangel; Lara M,51,0,60,9
1653300187409,COGS 107A,A02,087913,Rangel; Lara M,54,0,60,6
1653300187409,COGS 107A,A03,087914,Rangel; Lara M,47,0,60,13
1653300187409,COGS 107A,A04,087915,Rangel; Lara M,53,0,60,7
1653300187409,COGS 107A,A05,087916,Rangel; Lara M,55,0,60,5
1653300187409,COGS 107A,A06,087917,Rangel; Lara M,50,0,60,10
1653300187935,COGS 108,A01,087919,Fleischer; Jason G,14,0,60,46
1653300187935,COGS 108,A02,087920,Fleischer; Jason G,25,0,60,35
1653300187935,COGS 108,A03,087921,Fleischer; Jason G,40,0,60,20
1653300187935,COGS 108,A04,087922,Fleischer; Jason G,40,0,60,20
1653300187935,COGS 108,A05,087923,Fleischer; Jason G,48,0,60,12
1653300187935,COGS 108,A06,087924,Fleischer; Jason G,55,0,60,5
1653300187935,COGS 108,A07,087925,Fleischer; Jason G,42,0,57,15
1653300188470,COGS 110,A01,087927,Deak; Gedeon O.,30,0,35,5
1653300188470,COGS 110,A02,087928,Deak; Gedeon O.,33,0,35,2
1653300188995,COGS 116,A01,094228,Greene; Deanna Jacquelyn,51,0,52,1
1653300188995,COGS 116,A02,094229,Greene; Deanna Jacquelyn,52,0,52,0
1653300188995,COGS 116,A03,094230,Greene; Deanna Jacquelyn,50,0,52,2
1653300189521,COGS 118B,A01,087930,De Sa; Virginia,24,0,35,11
1653300189521,COGS 118B,A02,087931,De Sa; Virginia,28,0,35,7
1653300189521,COGS 118B,A03,087932,De Sa; Virginia,18,0,35,17
1653300189521,COGS 118B,A04,087933,De Sa; Virginia,29,0,35,6
1653300189521,COGS 118B,A05,087934,De Sa; Virginia,27,0,35,8
1653300189521,COGS 118B,A06,087935,De Sa; Virginia,27,0,35,8
1653300190047,COGS 120,A01,087937,Xia; Haijun,38,0,50,12
1653300190047,COGS 120,A02,087938,Xia; Haijun,32,0,50,18
1653300190047,COGS 120,A03,087939,Xia; Haijun,26,0,50,24
1653300190047,COGS 120,A04,087940,Xia; Haijun,1,0,50,49
1653300190574,COGS 128,A01,087944,Scott; Taylor Jackson,11,0,56,45
1653300191097,COGS 143,A01,087947,Johnson; Christine M.,23,0,40,17
1653300191620,COGS 153,A00,087949,Davis; Joshua Daniel,46,0,75,29
1653300192146,COGS 160,A00,087950,Deak; Gedeon O.,20,0,20,0
1653300192146,COGS 160,B00,094232,Saygin; Ayse P,40,0,40,0
1653300192672,COGS 175,A01,094238,Staff,27,0,40,13
1653300193196,COGS 187A,A01,087958,Kirsh; David Joel,22,0,50,28
1653300193196,COGS 187A,A02,087959,Kirsh; David Joel,30,0,50,20
1653300193196,COGS 187A,A03,087960,Kirsh; David Joel,34,0,45,11
1653300193720,COGS 190A,A00,087961,Staff,9999,0,9999,0
1653300194242,COGS 194,A00,087962,Hill; Seth J,9999,0,9999,0
1653300194765,COMM 10,A02,090628,Schmidt; Thomas Rainer,1,0,5,4
1653300194765,COMM 10,A03,090629,Schmidt; Thomas Rainer,3,0,5,2
1653300194765,COMM 10,A04,090630,Schmidt; Thomas Rainer,4,0,5,1
1653300194765,COMM 10,A05,090631,Schmidt; Thomas Rainer,4,0,5,1
1653300194765,COMM 10,A06,090632,Schmidt; Thomas Rainer,5,0,5,0
1653300194765,COMM 10,A07,090633,Schmidt; Thomas Rainer,5,0,5,0
1653300194765,COMM 10,A08,090634,Schmidt; Thomas Rainer,5,0,5,0
1653300194765,COMM 10,A09,090635,Schmidt; Thomas Rainer,5,0,5,0
1653300194765,COMM 10,A10,090636,Schmidt; Thomas Rainer,2,0,5,3
1653300194765,COMM 10,A11,090637,Schmidt; Thomas Rainer,4,0,5,1
1653300194765,COMM 10,A12,094013,Schmidt; Thomas Rainer,2,0,5,3
1653300194765,COMM 10,A13,094014,Schmidt; Thomas Rainer,5,0,5,0
1653300194765,COMM 10,A14,094015,Schmidt; Thomas Rainer,4,0,5,1
1653300194765,COMM 10,A15,094016,Schmidt; Thomas Rainer,5,0,5,0
1653300195287,COMM 100A,A01,090639,Irani; Lilly C,5,0,5,0
1653300195287,COMM 100A,A02,090640,Irani; Lilly C,4,0,5,1
1653300195287,COMM 100A,A03,090641,Irani; Lilly C,5,0,5,0
1653300195287,COMM 100A,A04,090642,Irani; Lilly C,3,0,5,2
1653300195287,COMM 100A,A05,090643,Irani; Lilly C,3,0,5,2
1653300195287,COMM 100A,A06,090644,Irani; Lilly C,4,0,5,1
1653300195287,COMM 100A,A07,090645,Irani; Lilly C,5,0,5,0
1653300195287,COMM 100A,A08,090646,Irani; Lilly C,5,0,5,0
1653300195287,COMM 100A,A09,090647,Irani; Lilly C,5,0,5,0
1653300195287,COMM 100A,A10,090648,Irani; Lilly C,5,0,5,0
1653300195287,COMM 100A,A11,090649,Irani; Lilly C,3,0,5,2
1653300195287,COMM 100A,A12,090650,Irani; Lilly C,5,0,5,0
1653300195810,COMM 101,A01,090652,Halm; Gavin Patrick,14,0,15,1
1653300195810,COMM 101,A02,090653,Halm; Gavin Patrick,14,0,15,1
1653300195810,COMM 101,A03,090654,Halm; Gavin Patrick,12,0,15,3
1653300195810,COMM 101,A04,090655,Halm; Gavin Patrick,13,0,15,2
1653300196331,COMM 101D,A00,090656,Halm; Gavin Patrick,14,0,15,1
1653300196857,COMM 101K,A00,090657,Ahn; Patricia Jeehyun,16,0,20,4
1653300197378,COMM 101T,A00,093701,Staff,20,0,20,0
1653300197903,COMM 102C,A01,090660,Staff,4,0,6,2
1653300197903,COMM 102C,A02,090661,Staff,6,0,6,0
1653300197903,COMM 102C,A03,090662,Staff,4,0,6,2
1653300198429,COMM 103D,A00,090663,Davis; Zeinabu I.,38,0,40,2
1653300198951,COMM 106E,A00,090667,Geiger; Richard Stuart,26,0,30,4
1653300199478,COMM 106G,A00,090668,Cordoba Azcarate; Matilde,25,0,30,5
1653300200005,COMM 108G,A00,090670,Walkover; Lillian B,30,0,30,0
1653300200530,COMM 109I,A00,090671,Tanaka; Stefan A.,30,0,30,0
1653300201052,COMM 109N,A00,094205,Hallin; Daniel C,25,0,30,5
1653300201579,COMM 110G,A00,090672,Whitworth-Smith; Andrew C,45,0,50,5
1653300202104,COMM 111P,A00,090673,Conner; Thomas Hartnell,27,0,30,3
1653300202627,COMM 111T,A00,090674,Iatarola; Briana Marie,27,0,30,3
1653300203149,COMM 124A,A00,090677,Sims; Christopher O,79,0,80,1
1653300203672,COMM 131,A00,090678,Fields; Gary,22,0,25,3
1653300204207,COMM 134,A00,090679,Kidman; Shawna F,16,0,25,9
1653300204737,COMM 146,A00,090680,Staff,22,0,25,3
1653300205266,COMM 166,A00,094493,Staff,24,0,25,1
1653300205788,COMM 172,A00,094066,Staff,23,0,25,2
1653300206311,COMM 182,A00,094063,Staff,25,0,25,0
1653300206837,COMM 190,A00,090686,Kidman; Shawna F,17,0,23,6
1653300206837,COMM 190,B00,090687,Irani; Lilly C,0,0,0,0
1653300206837,COMM 190,C00,090688,Keith; Kerry,21,0,23,2
1653300206837,COMM 190,D00,090689,Zilberg; Elana,23,0,23,0
1653300207358,COMM 194,A00,091600,Hill; Seth J,9999,0,9999,0
1653300207880,COMM 196A,A00,090690,Schmidt; Thomas Rainer,0,0,0,0
1653300208413,COMM 198,001,091397,Ahn; Patricia Jeehyun,9999,0,9999,0
1653300208413,COMM 198,002,091398,Alac; Morana,9999,0,9999,0
1653300208413,COMM 198,003,091399,Anderson; Patrick W.,9999,0,9999,0
1653300208413,COMM 198,004,091400,Boateng; Boatema,9999,0,9999,0
1653300208413,COMM 198,005,091401,Booker; Angela N,9999,0,9999,0
1653300208413,COMM 198,008,091402,Cordoba Azcarate; Matilde,9999,0,9999,0
1653300208413,COMM 198,009,091403,Davis; Zeinabu I.,9999,0,9999,0
1653300208413,COMM 198,010,091404,Dewaard; Andrew Michael,9999,0,9999,0
1653300208413,COMM 198,011,091405,Dominguez Rubio; Fernando,9999,0,9999,0
1653300208413,COMM 198,012,091406,Fattal; Alexander Leor,9999,0,9999,0
1653300208413,COMM 198,013,091407,Fields; Gary,9999,0,9999,0
1653300208413,COMM 198,014,091408,Gates; Kelly,9999,0,9999,0
1653300208413,COMM 198,015,091409,Goldfarb; Brian,9999,0,9999,0
1653300208413,COMM 198,018,091410,Hill; Erin Truesdell,9999,0,9999,0
1653300208413,COMM 198,019,091411,Horwitz; Robert B,9999,0,9999,0
1653300208413,COMM 198,021,091412,Irani; Lilly C,9999,0,9999,0
1653300208413,COMM 198,022,091413,Jack; Caroline Sarah,9999,0,9999,0
1653300208413,COMM 198,023,091414,Kidman; Shawna F,9999,0,9999,0
1653300208413,COMM 198,024,091415,Martinico; Daniel J,9999,0,9999,0
1653300208413,COMM 198,026,091416,Schmidt; Thomas Rainer,9999,0,9999,0
1653300208413,COMM 198,027,091417,Serlin; David,9999,0,9999,0
1653300208413,COMM 198,028,091418,Sims; Christopher O,9999,0,9999,0
1653300208413,COMM 198,029,091419,Tanaka; Stefan A.,9999,0,9999,0
1653300208413,COMM 198,030,091420,Zilberg; Elana,9999,0,9999,0
1653300208413,COMM 198,031,091421,Walkover; Lillian B,9999,0,9999,0
1653300208413,COMM 198,032,091422,Geiger; Richard Stuart,9999,0,9999,0
1653300208939,CSE 8A,A50,089985,Soosai Raj; Adalbert Geral,7,0,10,3
1653300208939,CSE 8A,A51,089986,Soosai Raj; Adalbert Geral,1,0,10,9
1653300208939,CSE 8A,A52,089987,Soosai Raj; Adalbert Geral,5,0,10,5
1653300208939,CSE 8A,A53,089988,Soosai Raj; Adalbert Geral,9,0,10,1
1653300208939,CSE 8A,B50,089990,Soosai Raj; Adalbert Geral,0,0,10,10
1653300208939,CSE 8A,B51,089991,Soosai Raj; Adalbert Geral,5,0,10,5
1653300208939,CSE 8A,B52,089992,Soosai Raj; Adalbert Geral,5,0,10,5
1653300208939,CSE 8A,B53,089993,Soosai Raj; Adalbert Geral,9,0,10,1
1653300208939,CSE 8A,C50,089995,Lerner; Sorin,0,0,10,10
1653300208939,CSE 8A,C51,089996,Lerner; Sorin,6,0,10,4
1653300208939,CSE 8A,C52,089997,Lerner; Sorin,9,0,10,1
1653300208939,CSE 8A,C53,089998,Lerner; Sorin,8,0,10,2
1653300209465,CSE 8B,A01,090000,Ochoa; Benjamin Lawrence,94,0,100,6
1653300209987,CSE 11,A01,090002,Cao; Yingjun,39,0,49,10
1653300209987,CSE 11,B01,090004,Cao; Yingjun,45,0,49,4
1653300209987,CSE 11,C01,090006,Cao; Yingjun,35,0,49,14
1653300210514,CSE 12,A01,090008,Staff,73,0,73,0
1653300210514,CSE 12,B01,090010,Staff,67,0,73,6
1653300210514,CSE 12,C01,090012,Staff,60,0,73,13
1653300211037,CSE 15L,A01,090014,Politz; Joseph Gibbs,4,0,10,6
1653300211037,CSE 15L,A02,090015,Politz; Joseph Gibbs,7,0,10,3
1653300211037,CSE 15L,A03,090016,Politz; Joseph Gibbs,9,0,10,1
1653300211037,CSE 15L,A04,090017,Politz; Joseph Gibbs,9,0,10,1
1653300211037,CSE 15L,A05,090018,Politz; Joseph Gibbs,9,0,10,1
1653300211037,CSE 15L,B01,090020,Politz; Joseph Gibbs,8,0,10,2
1653300211037,CSE 15L,B02,090021,Politz; Joseph Gibbs,6,0,10,4
1653300211037,CSE 15L,B03,090022,Politz; Joseph Gibbs,7,0,10,3
1653300211037,CSE 15L,B04,090023,Politz; Joseph Gibbs,7,0,10,3
1653300211037,CSE 15L,B05,090024,Politz; Joseph Gibbs,7,0,10,3
1653300211560,CSE 20,A01,090026,Staff,204,0,210,6
1653300212085,CSE 21,A01,090028,Impagliazzo; Russell,0,0,0,0
1653300212085,CSE 21,A02,094488,Impagliazzo; Russell,0,0,0,0
1653300212085,CSE 21,A03,094489,Impagliazzo; Russell,0,0,0,0
1653300212613,CSE 30,A01,092463,Muller; P Keith,73,0,100,27
1653300212613,CSE 30,A02,092464,Staff,97,0,100,3
1653300213135,CSE 87,A00,094193,Moshiri; Alexander Niema,20,0,20,0
1653300213661,CSE 95,A00,090030,Minnes Kemp; Mor Mia,35,0,35,0
1653300213661,CSE 95,B00,093883,Minnes Kemp; Mor Mia,35,0,35,0
1653300213661,CSE 95,C00,093885,Minnes Kemp; Mor Mia,35,0,35,0
1653300214183,CSE 100,A01,090033,Moshiri; Alexander Niema,68,0,114,46
1653300214710,CSE 100R,A01,093837,Moshiri; Alexander Niema,334,0,350,16
1653300215235,CSE 101,A01,090035,Saha; Barna,152,0,237,85
1653300215758,CSE 103,A01,090037,Freund; Yoav,60,0,75,15
1653300216284,CSE 105,A01,090039,Lovett; Shachar,201,0,225,24
1653300216808,CSE 106,A50,090042,Paturi; Ramamohan,11,0,30,19
1653300217330,CSE 107,A01,090044,Bellare; Mihir,94,0,120,26
1653300217853,CSE 110,A50,090047,Powell; Thomas Allan,39,0,50,11
1653300217853,CSE 110,A51,090048,Powell; Thomas Allan,39,0,50,11
1653300217853,CSE 110,A52,090049,Powell; Thomas Allan,48,0,50,2
1653300217853,CSE 110,A53,090050,Powell; Thomas Allan,49,0,50,1
1653300217853,CSE 110,A54,090051,Powell; Thomas Allan,45,0,50,5
1653300217853,CSE 110,A55,090052,Powell; Thomas Allan,50,0,50,0
1653300217853,CSE 110,A56,090053,Powell; Thomas Allan,49,0,50,1
1653300217853,CSE 110,A57,090054,Powell; Thomas Allan,41,0,45,4
1653300218380,CSE 118,A00,094897,Weibel; Nadir,0,0,0,0
1653300218906,CSE 120,A01,090056,Voelker; Geoffrey M.,226,0,300,74
1653300219427,CSE 124,A01,090058,Porter; George M,123,0,189,66
1653300219950,CSE 127,A01,090060,Savage; Stefan,46,0,189,143
1653300220549,CSE 130,A01,090062,Polikarpova; Nadezhda,171,0,189,18
1653300221082,CSE 132A,A01,090064,Deutsch; Alin Bernard,46,0,189,143
1653300221610,CSE 140,A01,090068,Eldon; John,169,0,196,27
1653300221610,CSE 140,B01,090070,Orailoglu; Alex,48,0,49,1
1653300222132,CSE 140L,A01,090072,Eldon; John,161,0,192,31
1653300222132,CSE 140L,B01,090075,Orailoglu; Alex,44,0,49,5
1653300222659,CSE 142,A01,090078,Porter; Leonard Emerson,86,0,146,60
1653300222659,CSE 142,B01,090080,Porter; Leonard Emerson,107,0,146,39
1653300223181,CSE 142L,A01,090082,Swanson; Steven James,48,0,146,98
1653300223181,CSE 142L,B01,090084,Swanson; Steven James,120,0,146,26
1653300223705,CSE 151B,A01,090088,Cottrell; Garrison W,258,0,328,70
1653300224228,CSE 152A,A01,090090,Chandraker; Manmohan Krishna,153,0,189,36
1653300224751,CSE 158,A01,090092,McAuley; Julian John,84,0,197,113
1653300225273,CSE 158R,A01,090094,McAuley; Julian John,306,0,353,47
1653300225797,CSE 167,A01,090096,Chern; Albert Ren-Haur,165,0,189,24
1653300226319,CSE 170,A01,090098,Vaccaro; Kristen Marie,20,0,20,0
1653300226319,CSE 170,A02,090099,Vaccaro; Kristen Marie,14,0,20,6
1653300226319,CSE 170,A03,090100,Vaccaro; Kristen Marie,14,0,20,6
1653300226319,CSE 170,A04,090101,Vaccaro; Kristen Marie,14,0,20,6
1653300226319,CSE 170,A05,090102,Vaccaro; Kristen Marie,18,0,20,2
1653300226842,CSE 190,A00,090103,Shalev; Aaron D,40,0,40,0
1653300226842,CSE 190,B00,090104,Vaccaro; Kristen Marie,100,0,100,0
1653300226842,CSE 190,C00,090105,Pannuto; Patrick William,25,0,25,0
1653300227363,CSE 191,A00,093848,Minnes Kemp; Mor Mia,9999,0,9999,0
1653300227887,CSE 193,A01,090107,Elsherif; May Elhussein,49,0,49,0
1653300228413,CSE 194,A01,090109,Munyaka; Imani N. S.,20,0,49,29
1653300228939,CSS 1,A01,086486,Staff,22,0,24,2
1653300228939,CSS 1,A02,086487,Staff,21,0,24,3
1653300228939,CSS 1,A03,086488,Staff,20,0,24,4
1653300228939,CSS 1,A04,086489,Staff,23,0,24,1
1653300229468,DOC 1,A01,086773,Solomon; Amanda Lee Albaniel,0,0,0,0
1653300229468,DOC 1,A02,086774,Solomon; Amanda Lee Albaniel,0,0,0,0
1653300229468,DOC 1,A03,086775,Solomon; Amanda Lee Albaniel,5,0,6,1
1653300229468,DOC 1,A04,086776,Solomon; Amanda Lee Albaniel,6,0,6,0
1653300229468,DOC 1,A05,086777,Solomon; Amanda Lee Albaniel,6,0,6,0
1653300229468,DOC 1,A06,086778,Solomon; Amanda Lee Albaniel,6,0,6,0
1653300229468,DOC 1,A07,086779,Solomon; Amanda Lee Albaniel,5,0,6,1
1653300229468,DOC 1,A08,086849,Solomon; Amanda Lee Albaniel,6,0,6,0
1653300229468,DOC 1,A09,086780,Solomon; Amanda Lee Albaniel,6,0,6,0
1653300229468,DOC 1,A10,086781,Solomon; Amanda Lee Albaniel,6,0,6,0
1653300229468,DOC 1,A11,086782,Solomon; Amanda Lee Albaniel,5,0,6,1
1653300229468,DOC 1,A12,086783,Solomon; Amanda Lee Albaniel,6,0,6,0
1653300229468,DOC 1,A13,086784,Solomon; Amanda Lee Albaniel,6,0,6,0
1653300229468,DOC 1,A14,086785,Solomon; Amanda Lee Albaniel,6,0,6,0
1653300229468,DOC 1,A15,086786,Solomon; Amanda Lee Albaniel,6,0,6,0
1653300229468,DOC 1,A16,086787,Solomon; Amanda Lee Albaniel,6,0,6,0
1653300229468,DOC 1,A17,086788,Solomon; Amanda Lee Albaniel,0,0,0,0
1653300229468,DOC 1,A18,086789,Solomon; Amanda Lee Albaniel,0,0,0,0
1653300229468,DOC 1,B01,086791,Solomon; Amanda Lee Albaniel,6,0,6,0
1653300229468,DOC 1,B02,086792,Solomon; Amanda Lee Albaniel,6,0,6,0
1653300229468,DOC 1,B03,086793,Solomon; Amanda Lee Albaniel,6,0,6,0
1653300229468,DOC 1,B04,086794,Solomon; Amanda Lee Albaniel,6,0,6,0
1653300229468,DOC 1,B05,086795,Solomon; Amanda Lee Albaniel,3,0,6,3
1653300229468,DOC 1,B06,086796,Solomon; Amanda Lee Albaniel,6,0,6,0
1653300229468,DOC 1,B07,086797,Solomon; Amanda Lee Albaniel,6,0,6,0
1653300229468,DOC 1,B08,086798,Solomon; Amanda Lee Albaniel,6,0,6,0
1653300229468,DOC 1,B09,086799,Solomon; Amanda Lee Albaniel,6,0,6,0
1653300229468,DOC 1,B10,086800,Solomon; Amanda Lee Albaniel,6,0,6,0
1653300229468,DOC 1,B11,086801,Solomon; Amanda Lee Albaniel,5,0,6,1
1653300229468,DOC 1,B12,086802,Solomon; Amanda Lee Albaniel,6,0,6,0
1653300229468,DOC 1,B13,086803,Solomon; Amanda Lee Albaniel,6,0,6,0
1653300229468,DOC 1,B14,086804,Solomon; Amanda Lee Albaniel,6,0,6,0
1653300229468,DOC 1,B15,086805,Solomon; Amanda Lee Albaniel,5,0,6,1
1653300229468,DOC 1,B16,086806,Solomon; Amanda Lee Albaniel,6,0,6,0
1653300229468,DOC 1,B17,086807,Solomon; Amanda Lee Albaniel,0,0,0,0
1653300229468,DOC 1,B18,086808,Solomon; Amanda Lee Albaniel,0,0,0,0
1653300229468,DOC 1,C01,086810,Strom; Megan C.,6,0,6,0
1653300229468,DOC 1,C02,086811,Strom; Megan C.,5,0,6,1
1653300229468,DOC 1,C03,086812,Strom; Megan C.,6,0,6,0
1653300229468,DOC 1,C04,086813,Strom; Megan C.,5,0,6,1
1653300229468,DOC 1,C05,086814,Strom; Megan C.,5,0,6,1
1653300229468,DOC 1,C06,086815,Strom; Megan C.,6,0,6,0
1653300229468,DOC 1,C07,086816,Strom; Megan C.,6,0,6,0
1653300229468,DOC 1,C08,086817,Strom; Megan C.,6,0,6,0
1653300229468,DOC 1,C09,086818,Strom; Megan C.,6,0,6,0
1653300229468,DOC 1,C10,086819,Strom; Megan C.,6,0,6,0
1653300229468,DOC 1,C11,086820,Strom; Megan C.,6,0,6,0
1653300229468,DOC 1,C12,086821,Strom; Megan C.,6,0,6,0
1653300229468,DOC 1,C13,086822,Strom; Megan C.,6,0,6,0
1653300229468,DOC 1,C14,086823,Strom; Megan C.,6,0,6,0
1653300229468,DOC 1,C15,086824,Strom; Megan C.,6,0,6,0
1653300229468,DOC 1,C16,086825,Strom; Megan C.,6,0,6,0
1653300229468,DOC 1,C17,086826,Strom; Megan C.,0,0,0,0
1653300229468,DOC 1,C18,086827,Strom; Megan C.,0,0,0,0
1653300229468,DOC 1,D01,086829,Strom; Megan C.,6,0,6,0
1653300229468,DOC 1,D02,086830,Strom; Megan C.,6,0,6,0
1653300229468,DOC 1,D03,086831,Strom; Megan C.,5,0,6,1
1653300229468,DOC 1,D04,086832,Strom; Megan C.,6,0,6,0
1653300229468,DOC 1,D05,086833,Strom; Megan C.,6,0,6,0
1653300229468,DOC 1,D06,086834,Strom; Megan C.,6,0,6,0
1653300229468,DOC 1,D07,086835,Strom; Megan C.,6,0,6,0
1653300229468,DOC 1,D08,086836,Strom; Megan C.,6,0,6,0
1653300229468,DOC 1,D09,086837,Strom; Megan C.,0,0,0,0
1653300229468,DOC 1,D10,086838,Strom; Megan C.,0,0,0,0
1653300229468,DOC 1,D11,086839,Strom; Megan C.,6,0,6,0
1653300229468,DOC 1,D12,086840,Strom; Megan C.,6,0,6,0
1653300229468,DOC 1,D13,086841,Strom; Megan C.,6,0,6,0
1653300229468,DOC 1,D14,086842,Strom; Megan C.,5,0,6,1
1653300229468,DOC 1,D15,086843,Strom; Megan C.,6,0,6,0
1653300229468,DOC 1,D16,086844,Strom; Megan C.,5,0,6,1
1653300229998,DOC 100D,A00,086845,Pass; Natalye Joann,0,0,0,0
1653300229998,DOC 100D,B00,086846,Pass; Natalye Joann,21,0,25,4
1653300229998,DOC 100D,C00,086847,Pass; Natalye Joann,23,0,25,2
1653300230533,DSC 10,A01,088092,Tiefenbruck; Janine LoBue,13,0,15,2
1653300230533,DSC 10,B01,088095,Tiefenbruck; Janine LoBue,9,0,15,6
1653300230533,DSC 10,C01,088098,Rampure; Suraj,0,0,15,15
1653300231069,DSC 20,A01,088101,Langlois; Marina,148,0,150,2
1653300231593,DSC 30,A01,088105,Langlois; Marina,74,0,75,1
1653300232116,DSC 40A,A01,088107,Rampure; Suraj,97,0,100,3
1653300232116,DSC 40A,B01,088109,Rampure; Suraj,99,0,100,1
1653300232641,DSC 40B,A01,088111,Eldridge; Justin Matthew,73,0,75,2
1653300232641,DSC 40B,B01,088113,Wang; Yusu,75,0,75,0
1653300233164,DSC 80,A01,088115,Eldridge; Justin Matthew,95,0,100,5
1653300233687,DSC 95,A01,088117,Langlois; Marina,20,0,20,0
1653300234211,DSC 96,A00,088118,Liao; Soohyun Nam,50,0,50,0
1653300234734,DSC 100,A01,088120,Salimi; Babak,164,0,175,11
1653300235261,DSC 102,A01,094320,Kumar; Arun Kumar,77,0,125,48
1653300235786,DSC 180A,A01,088124,Fraenkel; Aaron Mcmillan,0,0,0,0
1653300235786,DSC 180A,A02,088125,Fraenkel; Aaron Mcmillan,0,0,0,0
1653300235786,DSC 180A,A03,088126,Fraenkel; Aaron Mcmillan,0,0,0,0
1653300235786,DSC 180A,A04,088127,Fraenkel; Aaron Mcmillan,0,0,0,0
1653300235786,DSC 180A,A05,088128,Fraenkel; Aaron Mcmillan,0,0,0,0
1653300235786,DSC 180A,A06,088129,Fraenkel; Aaron Mcmillan,0,0,0,0
1653300235786,DSC 180A,A07,088130,Fraenkel; Aaron Mcmillan,0,0,0,0
1653300235786,DSC 180A,A08,088131,Fraenkel; Aaron Mcmillan,0,0,0,0
1653300235786,DSC 180A,A09,088132,Fraenkel; Aaron Mcmillan,0,0,0,0
1653300235786,DSC 180A,A10,088133,Fraenkel; Aaron Mcmillan,0,0,0,0
1653300235786,DSC 180A,A11,088134,Fraenkel; Aaron Mcmillan,0,0,0,0
1653300235786,DSC 180A,A12,088135,Fraenkel; Aaron Mcmillan,0,0,0,0
1653300235786,DSC 180A,A13,088136,Fraenkel; Aaron Mcmillan,0,0,0,0
1653300235786,DSC 180A,A14,088137,Fraenkel; Aaron Mcmillan,0,0,0,0
1653300235786,DSC 180A,A15,088138,Fraenkel; Aaron Mcmillan,0,0,0,0
1653300235786,DSC 180A,B01,088141,Fraenkel; Aaron Mcmillan,0,0,0,0
1653300235786,DSC 180A,B02,088142,Fraenkel; Aaron Mcmillan,0,0,0,0
1653300235786,DSC 180A,B03,088143,Fraenkel; Aaron Mcmillan,0,0,0,0
1653300235786,DSC 180A,B04,088144,Fraenkel; Aaron Mcmillan,0,0,0,0
1653300235786,DSC 180A,B05,088145,Fraenkel; Aaron Mcmillan,0,0,0,0
1653300235786,DSC 180A,B06,088146,Fraenkel; Aaron Mcmillan,0,0,0,0
1653300235786,DSC 180A,B07,088147,Fraenkel; Aaron Mcmillan,0,0,0,0
1653300235786,DSC 180A,B08,088148,Fraenkel; Aaron Mcmillan,0,0,0,0
1653300235786,DSC 180A,B09,088149,Fraenkel; Aaron Mcmillan,0,0,0,0
1653300235786,DSC 180A,B10,088150,Fraenkel; Aaron Mcmillan,0,0,0,0
1653300235786,DSC 180A,B11,088151,Fraenkel; Aaron Mcmillan,0,0,0,0
1653300235786,DSC 180A,B12,088152,Fraenkel; Aaron Mcmillan,0,0,0,0
1653300235786,DSC 180A,B13,088153,Fraenkel; Aaron Mcmillan,0,0,0,0
1653300235786,DSC 180A,B14,088154,Fraenkel; Aaron Mcmillan,0,0,0,0
1653300235786,DSC 180A,B15,088155,Fraenkel; Aaron Mcmillan,0,0,0,0
1653300236311,DSC 190,A01,088158,Mishne; Gal,48,0,50,2
1653300236311,DSC 190,B01,088160,Silberman; Jack,16,0,21,5
1653300236833,DSC 197,001,088161,Eldridge; Justin Matthew,9999,0,9999,0
1653300237358,DSGN 1,A01,087888,Meyer; Michael Wayne,49,0,53,4
1653300237358,DSGN 1,A02,087889,Meyer; Michael Wayne,47,0,53,6
1653300237358,DSGN 1,A03,087890,Meyer; Michael Wayne,43,0,53,10
1653300237885,DSGN 100,A01,087983,Dow; Steven P,39,0,40,1
1653300237885,DSGN 100,A02,087984,Dow; Steven P,40,0,40,0
1653300237885,DSGN 100,A03,087985,Dow; Steven P,34,0,40,6
1653300238409,DSGN 118,A01,087987,Xia; Haijun,55,0,60,5
1653300238409,DSGN 118,A02,087988,Xia; Haijun,56,0,60,4
1653300238930,DSGN 119,A00,087989,Staff,51,0,70,19
1653300239454,ECE 5,A01,090699,Morris; Karcher William,0,0,0,0
1653300239454,ECE 5,A02,090700,Morris; Karcher William,0,0,0,0
1653300239454,ECE 5,A03,090701,Morris; Karcher William,0,0,0,0
1653300239454,ECE 5,A04,090702,Morris; Karcher William,0,0,0,0
1653300239454,ECE 5,A05,090703,Morris; Karcher William,0,0,0,0
1653300239454,ECE 5,A06,090704,Morris; Karcher William,0,0,0,0
1653300239978,ECE 15,A01,090706,Schurgers; Curt,0,0,0,0
1653300239978,ECE 15,A02,090707,Schurgers; Curt,0,0,0,0
1653300240510,ECE 16,A01,090709,Khoshabeh; Ramsin,24,0,30,6
1653300241045,ECE 17,A01,090711,Gilja; Vikash,55,0,60,5
1653300241568,ECE 25,A50,090714,Liu; Zhaowei,0,0,0,0
1653300241568,ECE 25,A51,090715,Liu; Zhaowei,0,0,0,0
1653300241568,ECE 25,A52,090716,Liu; Zhaowei,0,0,0,0
1653300242098,ECE 30,A50,094300,Mir Arabbaygi; Siavash,25,0,30,5
1653300242098,ECE 30,A51,094301,Mir Arabbaygi; Siavash,29,0,30,1
1653300242098,ECE 30,A52,094302,Mir Arabbaygi; Siavash,27,0,30,3
1653300242098,ECE 30,A53,094303,Mir Arabbaygi; Siavash,29,0,30,1
1653300242098,ECE 30,A54,094304,Mir Arabbaygi; Siavash,25,0,25,0
1653300242621,ECE 35,A50,090720,Schurgers; Curt,0,0,0,0
1653300242621,ECE 35,A51,090721,Schurgers; Curt,0,0,0,0
1653300242621,ECE 35,A52,090722,Schurgers; Curt,0,0,0,0
1653300242621,ECE 35,A53,090723,Schurgers; Curt,0,0,0,0
1653300242621,ECE 35,A54,090724,Schurgers; Curt,0,0,0,0
1653300242621,ECE 35,A55,090725,Schurgers; Curt,0,0,0,0
1653300242621,ECE 35,B50,090729,Schurgers; Curt,0,0,0,0
1653300242621,ECE 35,B51,090730,Schurgers; Curt,0,0,0,0
1653300242621,ECE 35,B52,090731,Schurgers; Curt,0,0,0,0
1653300242621,ECE 35,B53,090732,Schurgers; Curt,0,0,0,0
1653300242621,ECE 35,B54,090733,Schurgers; Curt,0,0,0,0
1653300242621,ECE 35,B55,090734,Schurgers; Curt,0,0,0,0
1653300243142,ECE 45,A01,090736,Franceschetti; Massimo,56,0,57,1
1653300243142,ECE 45,A02,090737,Franceschetti; Massimo,50,0,58,8
1653300243675,ECE 65,A50,090741,Baghdadchi; Saharnaz,13,0,15,2
1653300243675,ECE 65,A51,090742,Baghdadchi; Saharnaz,5,0,10,5
1653300243675,ECE 65,A52,090743,Baghdadchi; Saharnaz,14,0,15,1
1653300243675,ECE 65,A53,090744,Baghdadchi; Saharnaz,8,0,10,2
1653300243675,ECE 65,A54,094865,Baghdadchi; Saharnaz,14,0,15,1
1653300243675,ECE 65,A55,094866,Baghdadchi; Saharnaz,9,0,10,1
1653300243675,ECE 65,A56,094867,Baghdadchi; Saharnaz,14,0,15,1
1653300243675,ECE 65,A57,094868,Baghdadchi; Saharnaz,15,0,15,0
1653300243675,ECE 65,A58,094869,Baghdadchi; Saharnaz,10,0,10,0
1653300244200,ECE 100,A01,090746,Baghdadchi; Saharnaz,16,0,20,4
1653300244200,ECE 100,A02,090747,Baghdadchi; Saharnaz,20,0,20,0
1653300244200,ECE 100,A03,090748,Baghdadchi; Saharnaz,18,0,20,2
1653300244200,ECE 100,A04,090749,Baghdadchi; Saharnaz,20,0,20,0
1653300244200,ECE 100,A05,090750,Baghdadchi; Saharnaz,18,0,20,2
1653300244200,ECE 100,A06,090751,Baghdadchi; Saharnaz,18,0,20,2
1653300244200,ECE 100,A07,090752,Baghdadchi; Saharnaz,20,0,20,0
1653300244722,ECE 101,A01,090754,Siegel; Paul H.,62,0,75,13
1653300244722,ECE 101,A02,090755,Siegel; Paul H.,71,0,75,4
1653300245248,ECE 102,A00,090756,Hsueh; Tzu-Chien,57,0,75,18
1653300245772,ECE 103,A01,090767,Lo; Yu-Hwa,45,0,50,5
1653300246298,ECE 107,A01,090769,Lomakin; Vitaliy,72,0,75,3
1653300246823,ECE 109,A01,090771,Zeger; Kenneth A.,176,0,180,4
1653300247363,ECE 111,A01,090774,Koushanfar; Farinaz,100,0,120,20
1653300247887,ECE 121A,A50,090777,Esmaili; Gholamreza,17,0,24,7
1653300247887,ECE 121A,A51,090778,Esmaili; Gholamreza,9,0,24,15
1653300247887,ECE 121A,A52,090779,Esmaili; Gholamreza,22,0,24,2
1653300248411,ECE 128A,A00,090780,Staff,40,0,70,30
1653300248934,ECE 135A,A00,090781,Kuzum; Duygu,30,0,30,0
1653300249457,ECE 143,A00,090782,Unpingco; Jose H.,0,0,0,2
1653300249985,ECE 148,A01,090784,Staff,32,0,32,0
1653300250509,ECE 155,A01,090786,Milstein; Laurence B.,16,0,20,4
1653300251031,ECE 158A,A01,090788,Franceschetti; Massimo,56,0,65,9
1653300251554,ECE 161A,A01,090790,Rao; Bhaskar D.,103,0,115,12
1653300252077,ECE 164,A00,090791,Hall; Drew A.,87,0,115,28
1653300252600,ECE 166,A50,090796,Rebeiz; Gabriel,6,0,12,6
1653300252600,ECE 166,A51,090797,Rebeiz; Gabriel,9,0,12,3
1653300252600,ECE 166,A52,090799,Rebeiz; Gabriel,1,0,12,11
1653300252600,ECE 166,A53,090800,Rebeiz; Gabriel,6,0,12,6
1653300252600,ECE 166,A54,094335,Rebeiz; Gabriel,11,0,12,1
1653300252600,ECE 166,A55,094336,Rebeiz; Gabriel,12,0,12,0
1653300252600,ECE 166,A56,094349,Rebeiz; Gabriel,13,0,15,2
1653300252600,ECE 166,A57,094350,Rebeiz; Gabriel,14,0,15,1
1653300253123,ECE 171A,A01,090802,Atanasov; Nikolay A.,45,0,60,15
1653300253647,ECE 171B,A01,090804,Shi; Yuanyuan,44,0,50,6
1653300254178,ECE 174,A01,090806,Pal; Piya,125,0,146,21
1653300254708,ECE 182,A01,090808,Lomakin; Vitaliy,23,0,23,0
1653300255232,ECE 187,A00,090809,Liu; Zhaowei,19,0,20,1
1653300255754,ECE 196,A00,090812,Morris; Karcher William,19,0,24,5
1653300255754,ECE 196,B00,094833,Morris; Karcher William,24,0,24,0
1653300256279,ECE 197,001,090813,Sievenpiper; Daniel F.,9999,0,9999,0
1653300256810,ECON 1,A01,092535,Staff,0,0,0,0
1653300256810,ECON 1,A02,092536,Staff,0,0,0,0
1653300256810,ECON 1,A03,092537,Staff,0,0,0,0
1653300256810,ECON 1,A04,092538,Staff,0,0,0,0
1653300256810,ECON 1,A05,092539,Staff,0,0,0,0
1653300256810,ECON 1,B01,092540,Ma; Alyson Chan,42,0,45,3
1653300256810,ECON 1,B02,092541,Ma; Alyson Chan,45,0,45,0
1653300256810,ECON 1,B03,092542,Ma; Alyson Chan,45,0,45,0
1653300256810,ECON 1,B04,092543,Ma; Alyson Chan,40,0,40,0
1653300256810,ECON 1,B05,092544,Ma; Alyson Chan,40,0,40,0
1653300256810,ECON 1,C01,092545,Tocoian; Oana,0,0,0,0
1653300256810,ECON 1,C02,092546,Tocoian; Oana,0,0,0,0
1653300256810,ECON 1,C03,092547,Tocoian; Oana,0,0,0,0
1653300256810,ECON 1,C04,092548,Tocoian; Oana,0,0,0,0
1653300256810,ECON 1,D01,094253,Levkoff; Steven B.,41,0,45,4
1653300256810,ECON 1,D02,094254,Levkoff; Steven B.,44,0,45,1
1653300256810,ECON 1,D03,094255,Levkoff; Steven B.,45,0,45,0
1653300256810,ECON 1,D04,094256,Levkoff; Steven B.,36,0,40,4
1653300256810,ECON 1,D05,094257,Levkoff; Steven B.,40,0,40,0
1653300257334,ECON 2,A01,092549,Staff,0,0,0,0
1653300257334,ECON 2,A02,092550,Staff,0,0,0,0
1653300257334,ECON 2,A03,092551,Staff,0,0,0,0
1653300257867,ECON 4,A01,092554,Levkoff; Steven B.,29,0,30,1
1653300257867,ECON 4,A02,092555,Levkoff; Steven B.,27,0,30,3
1653300257867,ECON 4,A03,092556,Levkoff; Steven B.,30,0,30,0
1653300258396,ECON 100A,A01,092557,Newhouse; Herbert S,23,0,30,7
1653300258396,ECON 100A,A02,092558,Newhouse; Herbert S,28,0,30,2
1653300258396,ECON 100A,A03,092559,Newhouse; Herbert S,29,0,30,1
1653300258396,ECON 100A,A04,092560,Newhouse; Herbert S,35,0,35,0
1653300258396,ECON 100A,B01,092561,Newhouse; Herbert S,20,0,30,10
1653300258396,ECON 100A,B02,092562,Newhouse; Herbert S,28,0,30,2
1653300258396,ECON 100A,B03,092563,Newhouse; Herbert S,15,0,30,15
1653300258396,ECON 100A,B04,092564,Newhouse; Herbert S,35,0,35,0
1653300258929,ECON 100B,A01,092565,Galperti; Simone,27,0,30,3
1653300258929,ECON 100B,A02,092566,Galperti; Simone,18,0,20,2
1653300258929,ECON 100B,A03,094496,Staff,27,0,30,3
1653300258929,ECON 100B,A04,094497,Staff,16,0,20,4
1653300258929,ECON 100B,B01,092567,Galperti; Simone,16,0,25,9
1653300259459,ECON 100C,A01,092569,Du; Songzi,62,0,75,13
1653300259459,ECON 100C,B01,092570,Du; Songzi,70,0,75,5
1653300259459,ECON 100C,B02,094258,Du; Songzi,75,0,75,0
1653300259982,ECON 100CH,A00,088284,Andreoni; James,20,0,20,0
1653300260511,ECON 109,A01,092572,Watson; Joel Christopher,68,0,75,7
1653300260511,ECON 109,B01,092573,Watson; Joel Christopher,68,0,75,7
1653300261036,ECON 110A,A01,092574,Alon; Titan Michael,12,0,25,13
1653300261036,ECON 110A,A02,092575,Alon; Titan Michael,24,0,25,1
1653300261036,ECON 110A,B01,092576,Alon; Titan Michael,24,0,25,1
1653300261036,ECON 110A,B02,092577,Alon; Titan Michael,25,0,25,0
1653300261563,ECON 110B,A01,092578,Trottner; Fabian Gunter We,16,0,25,9
1653300261563,ECON 110B,A02,094054,Trottner; Fabian Gunter We,23,0,25,2
1653300261563,ECON 110B,B01,092579,Trottner; Fabian Gunter We,7,0,25,18
1653300261563,ECON 110B,B02,094055,Trottner; Fabian Gunter We,24,0,25,1
1653300262086,ECON 116,A00,088291,Lowes; Sara Rachel,58,0,70,12
1653300262616,ECON 120A,A01,092580,Elliott; Graham,18,0,25,7
1653300262616,ECON 120A,A02,092581,Elliott; Graham,22,0,25,3
1653300262616,ECON 120A,B01,092582,Elliott; Graham,18,0,25,7
1653300262616,ECON 120A,B02,092583,Elliott; Graham,20,0,25,5
1653300262616,ECON 120A,C01,092584,Tocoian; Oana,27,0,30,3
1653300262616,ECON 120A,C02,092585,Tocoian; Oana,28,0,30,2
1653300262616,ECON 120A,C03,092586,Tocoian; Oana,40,0,40,0
1653300263139,ECON 120B,A01,092587,Candido; Maria Teresa,58,0,70,12
1653300263139,ECON 120B,A02,092588,Candido; Maria Teresa,51,0,60,9
1653300263139,ECON 120B,A03,092589,Candido; Maria Teresa,56,0,60,4
1653300263670,ECON 120C,A01,092590,Candido; Maria Teresa,48,0,60,12
1653300263670,ECON 120C,A02,092591,Candido; Maria Teresa,59,0,60,1
1653300263670,ECON 120C,A03,094310,Candido; Maria Teresa,73,0,75,2
1653300264191,ECON 121,A00,088298,Vogl; Tom Saul,36,0,50,14
1653300264715,ECON 130,A00,088299,Staff,59,0,75,16
1653300265248,ECON 131,A00,088300,Jacobsen; Mark,129,0,150,21
1653300265248,ECON 131,B00,088301,Jacobsen; Mark,15,0,30,15
1653300265772,ECON 152,A00,088302,Fadlon; Yizhak,34,0,50,16
1653300265772,ECON 152,B00,088303,Fadlon; Yizhak,49,0,50,1
1653300266297,ECON 168,A00,088304,Staff,54,0,60,6
1653300266819,ECON 191B,A00,088312,Galperti; Simone,20,0,20,0
1653300267347,EDS 25,A01,087581,Staff,9,0,10,1
1653300267347,EDS 25,A02,087582,Staff,10,0,10,0
1653300267347,EDS 25,A03,087583,Staff,7,0,10,3
1653300267347,EDS 25,A04,087584,Staff,10,0,10,0
1653300267871,EDS 31,A00,087585,Bussey; Thomas J,9,0,10,1
1653300268394,EDS 110R,A01,087597,Cohen; Shana R,43,0,50,7
1653300268394,EDS 110R,B01,093579,Cohen; Shana R,10,0,10,0
1653300268933,EDS 113,A00,087598,Staff,45,0,50,5
1653300269459,EDS 114,A01,088091,Eguchi; Emi,17,0,20,3
1653300269459,EDS 114,A02,087600,Eguchi; Emi,19,0,20,1
1653300269984,EDS 117,A01,087603,Chung; Luz Marina,25,0,35,10
1653300269984,EDS 117,A02,087604,Chung; Luz Marina,34,0,35,1
1653300270509,EDS 124AR,A01,087606,Simon; Elizabeth A,0,0,19,19
1653300270509,EDS 124AR,A02,087607,Simon; Elizabeth A,13,0,19,6
1653300270509,EDS 124AR,A03,087608,Simon; Elizabeth A,15,0,19,4
1653300270509,EDS 124AR,A04,087609,Simon; Elizabeth A,4,0,19,15
1653300270509,EDS 124AR,B01,087611,Simon; Elizabeth A,14,0,19,5
1653300270509,EDS 124AR,B02,087612,Simon; Elizabeth A,18,0,19,1
1653300270509,EDS 124AR,B03,087613,Simon; Elizabeth A,18,0,19,1
1653300270509,EDS 124AR,B04,087614,Simon; Elizabeth A,19,0,19,0
1653300270509,EDS 124AR,C01,094210,Simon; Elizabeth A,6,0,6,0
1653300270509,EDS 124AR,C02,094211,Simon; Elizabeth A,6,0,6,0
1653300270509,EDS 124AR,C03,094212,Simon; Elizabeth A,6,0,6,0
1653300270509,EDS 124AR,C04,094213,Simon; Elizabeth A,6,0,6,0
1653300270509,EDS 124AR,D01,094215,Simon; Elizabeth A,6,0,6,0
1653300270509,EDS 124AR,D02,094216,Simon; Elizabeth A,6,0,6,0
1653300270509,EDS 124AR,D03,094217,Simon; Elizabeth A,6,0,6,0
1653300270509,EDS 124AR,D04,094218,Simon; Elizabeth A,6,0,6,0
1653300271034,EDS 124BR,A00,087615,Eguchi; Emi,65,0,75,10
1653300271034,EDS 124BR,B00,093580,Eguchi; Emi,25,0,25,0
1653300271558,EDS 125,A00,087616,Jones; Gabrielle Anastasia,51,0,60,9
1653300272087,EDS 129A,A01,087618,Heinzman; Erica M.,43,0,50,7
1653300272611,EDS 130,A01,087620,Holtzman; Caren Lynn,17,0,20,3
1653300272611,EDS 130,A02,087621,Holtzman; Caren Lynn,20,0,20,0
1653300272611,EDS 130,A03,087622,Holtzman; Caren Lynn,20,0,20,0
1653300273139,EDS 131,A01,087624,Wishard Guerra; Alison G.,37,0,40,3
1653300273741,EDS 133,A01,087627,Bintliff; Amy S.V.,17,0,20,3
1653300273741,EDS 133,A02,087628,Bintliff; Amy S.V.,19,0,20,1
1653300274266,EDS 139,A00,087629,Holtzman; Caren Lynn,55,0,60,5
1653300274266,EDS 139,B00,087630,Heinzman; Erica M.,51,0,60,9
1653300274266,EDS 139,C00,087631,Bintliff; Amy S.V.,57,0,60,3
1653300274266,EDS 139,D00,087632,Wishard Guerra; Alison G.,58,0,60,2
1653300274266,EDS 139,E00,087633,Holtzman; Caren Lynn,30,0,30,0
1653300274266,EDS 139,F00,094886,Staff,25,0,25,0
1653300274797,EDS 146,A01,094220,Staff,25,0,25,0
1653300275322,EDS 164R,A01,087644,Wishard Guerra; Alison G.,37,0,40,3
1653300275322,EDS 164R,B01,093582,Wishard Guerra; Alison G.,20,0,20,0
1653300275850,EDS 190,A00,087645,Bresser; Bernard George,20,0,20,0
1653300275850,EDS 190,B00,087646,Pappas; Elizabeth,20,0,20,0
1653300275850,EDS 190,C00,087647,Scharton; Susan Michelle,20,0,20,0
1653300275850,EDS 190,E00,087648,Staff,20,0,20,0
1653300276373,ENG 10,A00,086288,Staff,30,0,30,0
1653300276373,ENG 10,B00,086289,Staff,30,0,30,0
1653300276896,ENG 15,A01,086291,Staff,35,0,35,0
1653300277420,ENG 20,A00,086292,Evdokimenko; Ekaterina,33,0,35,2
1653300277949,ENG 100D,A00,086293,Ngo; Anh-Thu T.,45,0,50,5
1653300277949,ENG 100D,B00,094309,Staff,46,0,50,4
1653300278473,ENG 100L,A00,086295,Kleissl; Jan,6,0,6,0
1653300278473,ENG 100L,B00,086296,Bratton; Maryann,8,0,8,0
1653300278473,ENG 100L,C00,086297,Nguyen; Truong Quang,10,0,10,0
1653300278473,ENG 100L,E00,086299,de Oliveira; Mauricio,8,0,8,0
1653300278473,ENG 100L,F00,086300,Goldberg; Charles G.,6,0,6,0
1653300278473,ENG 100L,G00,086301,Bratton; Maryann,6,0,6,0
1653300278473,ENG 100L,H00,086302,Staff,6,0,6,0
1653300279000,ENVR 30,A01,093565,Staff,29,0,30,1
1653300279000,ENVR 30,A02,093567,Staff,28,0,30,2
1653300279000,ENVR 30,A03,093568,Staff,25,0,30,5
1653300279000,ENVR 30,A04,093569,Staff,30,0,30,0
1653300279000,ENVR 30,A05,093570,Staff,29,0,30,1
1653300279000,ENVR 30,A06,093566,Staff,29,0,30,1
1653300279522,ENVR 102,A00,093571,Daly; Heather Marie,25,0,30,5
1653300280575,ERC 1,A01,092328,Herbst; Matthew,20,0,20,0
1653300280575,ERC 1,A02,092330,Herbst; Matthew,20,0,20,0
1653300280575,ERC 1,A03,092331,Herbst; Matthew,20,0,20,0
1653300280575,ERC 1,A04,092332,Herbst; Matthew,20,0,20,0
1653300280575,ERC 1,A05,092333,Herbst; Matthew,20,0,20,0
1653300280575,ERC 1,A06,092334,Herbst; Matthew,20,0,20,0
1653300281103,ERC 2,A01,092336,Rahimi; Babak,20,0,20,0
1653300281103,ERC 2,A02,092337,Rahimi; Babak,20,0,20,0
1653300281103,ERC 2,A03,092338,Rahimi; Babak,20,0,20,0
1653300281103,ERC 2,A04,092339,Rahimi; Babak,20,0,20,0
1653300281626,ERC 20,A00,092340,Evans; Ivan T,30,0,30,0
1653300281626,ERC 20,B00,092341,Evans; Ivan T,30,0,30,0
1653300282148,ERC 87,A00,093850,Herbst; Matthew,20,0,20,0
1653300282670,ERC 92,A00,092342,Staff,1,0,1,0
1653300282670,ERC 92,B00,092343,Staff,1,0,1,0
1653300282670,ERC 92,C00,092344,Staff,1,0,1,0
1653300282670,ERC 92,D00,092345,Staff,1,0,1,0
1653300282670,ERC 92,E00,092346,Staff,1,0,1,0
1653300282670,ERC 92,F00,092347,Staff,1,0,1,0
1653300283192,ESYS 90,A00,086303,Teranes; Jane,12,0,12,0
1653300283714,ESYS 101,A01,086305,Taylor; Jennifer Rebecca & Diaz; Julia Michelle,25,0,27,2
1653300283714,ESYS 101,A02,086306,Taylor; Jennifer Rebecca & Diaz; Julia Michelle,15,0,27,12
1653300283714,ESYS 101,A03,086307,Taylor; Jennifer Rebecca & Diaz; Julia Michelle,21,0,27,6
1653300283714,ESYS 101,A04,086308,Taylor; Jennifer Rebecca & Diaz; Julia Michelle,27,0,27,0
1653300284247,ESYS 187A,A01,086310,Teranes; Jane,38,0,40,2
1653300284247,ESYS 187A,B01,086312,Teranes; Jane,30,0,40,10
1653300284771,ETHN 1,A01,086314,Frank; Ross H.,15,0,15,0
1653300284771,ETHN 1,A02,086315,Frank; Ross H.,15,0,15,0
1653300284771,ETHN 1,A03,086316,Frank; Ross H.,14,0,15,1
1653300284771,ETHN 1,A04,086317,Frank; Ross H.,15,0,15,0
1653300284771,ETHN 1,A05,086318,Frank; Ross H.,15,0,15,0
1653300284771,ETHN 1,A06,086319,Frank; Ross H.,13,0,15,2
1653300284771,ETHN 1,A07,086320,Frank; Ross H.,15,0,15,0
1653300284771,ETHN 1,A08,086321,Frank; Ross H.,14,0,15,1
1653300284771,ETHN 1,A09,086322,Frank; Ross H.,15,0,15,0
1653300284771,ETHN 1,A10,086323,Frank; Ross H.,15,0,15,0
1653300284771,ETHN 1,A11,086324,Frank; Ross H.,15,0,15,0
1653300284771,ETHN 1,A12,086325,Frank; Ross H.,15,0,15,0
1653300284771,ETHN 1,A13,086326,Frank; Ross H.,15,0,15,0
1653300284771,ETHN 1,A14,086327,Frank; Ross H.,15,0,15,0
1653300284771,ETHN 1,A15,086328,Frank; Ross H.,15,0,15,0
1653300284771,ETHN 1,A16,086329,Frank; Ross H.,15,0,15,0
1653300285292,ETHN 100A,A00,086330,Patel; Shaista,41,0,48,7
1653300285819,ETHN 103,A00,086331,Perreira; Christopher Michael,63,0,70,7
1653300286343,ETHN 104,A00,086332,Staff,0,0,0,0
1653300286867,ETHN 106,A00,086333,Staff,0,0,0,0
1653300287389,ETHN 121,A00,086341,Sasaki; Christen T,20,0,28,8
1653300287913,ETHN 139,A00,086342,Ruiz; Ariana,16,0,20,4
1653300288435,ETHN 144M,A00,086343,Jolivette; Andrew J,66,0,70,4
1653300288968,ETHN 159,A00,088427,Graham; Jessica Lynn,0,0,0,0
1653300289490,ETHN 163E,A00,086344,Patel; Shaista,37,0,40,3
1653300290029,ETHN 178R,A00,090798,Borgo; David Garcia,15,0,20,5
1653300290551,ETHN 187,A00,086345,Perez; Roy,14,0,16,2
1653300291073,EXPR 100,A00,085686,Staff,9999,0,9999,0
1653300291596,FMPH 40,A00,086370,Emory; Kristen,70,0,75,5
1653300291596,FMPH 40,B00,086371,Romero; Sally Ann Dominick,71,0,75,4
1653300292118,FMPH 101,A00,086372,Brouwer; Kimberly,43,0,55,12
1653300292641,FMPH 102,A50,094498,Rana; Brinda Kanti,42,0,55,13
1653300293167,FMPH 110,A00,086374,Zoumas-Morse; Christine E.,61,0,65,4
1653300293692,FMPH 120,A00,086375,Nguyen-Grozavu; France T.,45,0,65,20
1653300293692,FMPH 120,B00,086376,Nguyen-Grozavu; France T.,60,0,65,5
1653300294217,FMPH 130,A00,086377,Staff,48,0,65,17
1653300295266,FMPH 161,A00,086379,Zoumas-Morse; Christine E.,58,0,65,7
1653300295794,FMPH 191,A00,086380,Harrell; Maralee Mae,58,0,60,2
1653300296317,FMPH 196A,A00,086381,Binkin; Nancy Jeanne,0,0,0,0
1653300296839,GLBH 20,A00,086407,Walkover; Lillian B,85,0,90,5
1653300297364,GLBH 100,A00,086408,Staff,55,0,56,1
1653300297364,GLBH 100,B00,086409,Wu; Hua,52,0,56,4
1653300297364,GLBH 100,D00,086411,Staff,38,0,40,2
1653300297902,GLBH 103,A00,086412,Hannah; Seth Donal,48,0,50,2
1653300298425,GLBH 105,A00,086413,Olivas Hernandez; Olga Lid,36,0,38,2
1653300298951,GLBH 106,A00,086414,Kayser; Georgia Lyn,40,0,40,0
1653300299476,GLBH 111,A01,094330,Burgos; Jose L.,0,0,0,0
1653300299476,GLBH 111,B01,094332,Burgos; Jose L.,0,0,0,0
1653300300003,GLBH 148,A00,086415,Staff,69,0,73,4
1653300300530,GLBH 181,A00,086417,Burgos; Jose L.,144,0,146,2
1653300301052,GSS 20,A00,094269,Staff,73,0,75,2
1653300301581,HDS 1,A01,086423,Staff,24,0,25,1
1653300301581,HDS 1,A02,086424,Staff,24,0,25,1
1653300301581,HDS 1,A03,086425,Staff,23,0,25,2
1653300301581,HDS 1,A04,086426,Staff,25,0,25,0
1653300301581,HDS 1,A05,086427,Staff,24,0,25,1
1653300301581,HDS 1,A06,086428,Staff,25,0,25,0
1653300301581,HDS 1,A07,086429,Staff,30,0,30,0
1653300302104,HDS 60,A01,086431,Staff,23,0,25,2
1653300302627,HDS 111,A00,086432,Staff,73,0,80,7
1653300303155,HDS 121,A01,086434,Deak; Gedeon O.,11,0,15,4
1653300303155,HDS 121,A02,086435,Deak; Gedeon O.,13,0,15,2
1653300303678,HDS 150,A00,086436,Staff,25,0,25,0
1653300303678,HDS 150,B00,086437,Staff,25,0,25,0
1653300304205,HDS 173,A00,086439,Staff,27,0,30,3
1653300304728,HDS 181,A01,086441,Staff,30,0,30,0
1653300305257,HDS 191,A01,086443,Staff,25,0,25,0
1653300305786,HIEA 129,A00,088057,Schneewind; Sarah,0,0,0,0
1653300306319,HIEA 137,A00,088058,Lu; Weijing,53,0,55,2
1653300306846,HIEA 144,A00,088059,Henry; Todd A.,44,0,45,1
1653300307371,HIEA 171,A00,088060,Lu; Weijing,15,0,15,0
1653300307894,HIEU 102,A00,088061,Watts; Edward J.,0,0,0,0
1653300308422,HIEU 107,A00,088062,Caciola; Nancy A,0,0,0,0
1653300308946,HIEU 108,A00,088063,Balberg; Mira,53,0,60,7
1653300309474,HIEU 128,A00,088064,Neuheiser; Joerg,0,0,0,0
1653300309999,HIEU 144,A00,094327,Staff,48,0,50,2
1653300310523,HIEU 149,A00,088065,Devereux; Andrew W,38,0,45,7
1653300311049,HIEU 154,A00,088066,Biess; Frank Peter,58,0,65,7
1653300311572,HIGL 114,A00,088067,Edington; Claire Ellen,53,0,55,2
1653300312099,HILA 119,A00,088068,Vitz; Matthew,49,0,51,2
1653300312623,HILA 122,A00,088069,Widener; Daniel,61,0,65,4
1653300313152,HILD 2A,A01,088024,Hanna; Mark G.,28,0,28,0
1653300313152,HILD 2A,A02,088025,Hanna; Mark G.,25,0,25,0
1653300313152,HILD 2A,A03,088026,Hanna; Mark G.,27,0,28,1
1653300313152,HILD 2A,A04,088027,Hanna; Mark G.,28,0,28,0
1653300313152,HILD 2A,A05,088028,Hanna; Mark G.,28,0,28,0
1653300313152,HILD 2A,A06,088029,Hanna; Mark G.,28,0,28,0
1653300313676,HILD 7A,A01,088031,Graham; Jessica Lynn,28,0,28,0
1653300313676,HILD 7A,A02,088032,Graham; Jessica Lynn,27,0,28,1
1653300313676,HILD 7A,A03,088033,Graham; Jessica Lynn,27,0,28,1
1653300313676,HILD 7A,A04,088034,Graham; Jessica Lynn,26,0,28,2
1653300313676,HILD 7A,A05,088035,Graham; Jessica Lynn,26,0,28,2
1653300313676,HILD 7A,A06,088037,Graham; Jessica Lynn,22,0,28,6
1653300313676,HILD 7A,A07,088038,Graham; Jessica Lynn,28,0,28,0
1653300313676,HILD 7A,A08,088039,Graham; Jessica Lynn,28,0,28,0
1653300313676,HILD 7A,A09,088040,Graham; Jessica Lynn,27,0,28,1
1653300313676,HILD 7A,A10,088041,Graham; Jessica Lynn,28,0,28,0
1653300313676,HILD 7A,A11,088042,Graham; Jessica Lynn,28,0,28,0
1653300313676,HILD 7A,A12,088043,Graham; Jessica Lynn,28,0,28,0
1653300314200,HILD 10,A01,088045,Muscolino; Micah S,27,0,28,1
1653300314200,HILD 10,A02,088046,Muscolino; Micah S,27,0,28,1
1653300314200,HILD 10,A03,088047,Muscolino; Micah S,28,0,28,0
1653300314200,HILD 10,A04,088048,Muscolino; Micah S,27,0,28,1
1653300314200,HILD 10,A05,088049,Muscolino; Micah S,28,0,28,0
1653300314200,HILD 10,A06,088050,Muscolino; Micah S,27,0,28,1
1653300314727,HILD 30,A01,088052,Edington; Claire Ellen,24,0,28,4
1653300314727,HILD 30,A02,088053,Edington; Claire Ellen,28,0,28,0
1653300315251,HILD 41,A01,088055,Devereux; Andrew W,28,0,28,0
1653300315251,HILD 41,A02,088056,Devereux; Andrew W,28,0,28,0
1653300315774,HINE 116,A00,088070,Kayali; Hasan,47,0,50,3
1653300316308,HINE 144,A00,088071,Provence; Michael,40,0,45,5
1653300316834,HISC 106,A00,088072,Pineda De Avila; Nydia,47,0,50,3
1653300317360,HISC 115,A00,088073,Gere; Catherina M.,103,0,110,7
1653300317883,HITO 87,A00,094352,Patterson; Patrick H.,20,0,20,0
1653300317883,HITO 87,C00,094354,Patterson; Patrick H.,20,0,20,0
1653300317883,HITO 87,B00,094353,Hanna; Mark G.,20,0,20,0
1653300318405,HITO 100,A00,088074,Hanna; Mark G.,8,0,12,4
1653300318934,HITO 193,A00,091603,Hill; Seth J,9999,0,9999,0
1653300319458,HITO 196,A00,088075,Hendrickson; Gerald M.,20,0,20,0
1653300319983,HIUS 108B,A00,088076,Klann; Mary Cameron,48,0,51,3
1653300320511,HIUS 112,A00,088077,Plant; Rebecca Jo,144,0,148,4
1653300321033,HIUS 152A,A00,088078,Vandevelde; Kenneth Joseph,40,0,45,5
1653300321566,HIUS 155,A00,088079,Alvarez; Luis A,37,0,45,8
1653300322089,HIUS 183,A00,088080,Graham; Jessica Lynn,19,0,20,1
1653300322616,HUM 3,A01,087224,West; Geoffrey Scott,27,0,28,1
1653300322616,HUM 3,A02,087225,West; Geoffrey Scott,28,0,28,0
1653300322616,HUM 3,A03,087226,West; Geoffrey Scott,26,0,28,2
1653300322616,HUM 3,A04,087227,West; Geoffrey Scott,27,0,28,1
1653300322616,HUM 3,A05,087228,West; Geoffrey Scott,27,0,28,1
1653300322616,HUM 3,A06,087229,West; Geoffrey Scott,24,0,28,4
1653300322616,HUM 3,A07,087230,West; Geoffrey Scott,27,0,28,1
1653300322616,HUM 3,A08,087231,West; Geoffrey Scott,28,0,28,0
1653300322616,HUM 3,B01,087233,Staff,28,0,28,0
1653300322616,HUM 3,B02,087234,Staff,28,0,28,0
1653300322616,HUM 3,B03,087235,Staff,28,0,28,0
1653300322616,HUM 3,B04,087236,Staff,28,0,28,0
1653300322616,HUM 3,B05,087237,Staff,28,0,28,0
1653300322616,HUM 3,B06,087238,Staff,28,0,28,0
1653300322616,HUM 3,B07,087239,Staff,0,0,0,0
1653300322616,HUM 3,B08,087240,Staff,0,0,0,0
1653300322616,HUM 3,B09,087241,Staff,30,0,30,0
1653300322616,HUM 3,B10,087242,Staff,28,0,30,2
1653300322616,HUM 3,C01,087244,Patterson; Patrick H.,0,0,0,0
1653300322616,HUM 3,C02,087245,Patterson; Patrick H.,0,0,0,0
1653300322616,HUM 3,C03,087246,Patterson; Patrick H.,23,0,28,5
1653300322616,HUM 3,C04,087247,Patterson; Patrick H.,28,0,28,0
1653300322616,HUM 3,C05,087248,Patterson; Patrick H.,27,0,28,1
1653300322616,HUM 3,C06,087249,Patterson; Patrick H.,25,0,28,3
1653300322616,HUM 3,C07,087250,Patterson; Patrick H.,27,0,28,1
1653300322616,HUM 3,C08,087251,Patterson; Patrick H.,28,0,28,0
1653300322616,HUM 3,C09,087252,Patterson; Patrick H.,28,0,28,0
1653300322616,HUM 3,C10,087253,Patterson; Patrick H.,27,0,28,1
1653300322616,HUM 3,D01,087255,Lyon; Antony J.,24,0,28,4
1653300322616,HUM 3,D02,087256,Lyon; Antony J.,28,0,28,0
1653300322616,HUM 3,D03,087257,Lyon; Antony J.,0,0,0,0
1653300322616,HUM 3,D04,087258,Lyon; Antony J.,0,0,0,0
1653300322616,HUM 3,D05,087259,Lyon; Antony J.,27,0,28,1
1653300322616,HUM 3,D06,087260,Lyon; Antony J.,28,0,28,0
1653300322616,HUM 3,D07,087261,Lyon; Antony J.,21,0,28,7
1653300322616,HUM 3,D08,087262,Lyon; Antony J.,20,0,28,8
1653300322616,HUM 3,D09,087263,Lyon; Antony J.,28,0,28,0
1653300322616,HUM 3,D10,087264,Lyon; Antony J.,27,0,28,1
1653300322616,HUM 3,D11,087265,Lyon; Antony J.,30,0,30,0
1653300322616,HUM 3,D12,087266,Lyon; Antony J.,30,0,30,0
1653300322616,HUM 3,D13,087267,Lyon; Antony J.,26,0,28,2
1653300322616,HUM 3,D14,087268,Lyon; Antony J.,25,0,28,3
1653300323142,INTL 101,A01,088176,Day; Joel Keith,19,0,20,1
1653300323142,INTL 101,A02,088177,Day; Joel Keith,20,0,20,0
1653300323142,INTL 101,A03,088178,Day; Joel Keith,17,0,20,3
1653300323142,INTL 101,A04,088179,Day; Joel Keith,19,0,20,1
1653300323142,INTL 101,A05,088180,Day; Joel Keith,19,0,20,1
1653300323142,INTL 101,A06,088181,Day; Joel Keith,18,0,20,2
1653300323666,INTL 102,A01,088183,Walter; Barbara Florence,19,0,20,1
1653300323666,INTL 102,A02,088184,Walter; Barbara Florence,19,0,20,1
1653300323666,INTL 102,A03,088185,Walter; Barbara Florence,18,0,20,2
1653300323666,INTL 102,A04,088186,Walter; Barbara Florence,16,0,20,4
1653300323666,INTL 102,A05,088187,Walter; Barbara Florence,19,0,20,1
1653300323666,INTL 102,A06,088188,Walter; Barbara Florence,19,0,20,1
1653300324199,INTL 190,A00,088189,Auerbach; Bradford C,0,0,0,0
1653300324199,INTL 190,B00,088190,Auerbach; Bradford C,0,0,0,0
1653300324199,INTL 190,C00,088191,Fortier; Jana,0,0,0,0
1653300324199,INTL 190,D00,088192,Kshatriya; Krista C,0,0,0,0
1653300324199,INTL 190,E00,088193,Nadkarni; Vidya,0,0,0,0
1653300324199,INTL 190,F00,088194,Scott; Jeffrey F,0,0,0,0
1653300324199,INTL 190,G00,088195,Segui; Alan S,0,0,0,0
1653300324199,INTL 190,H00,088196,Segui; Alan S,0,0,0,0
1653300324726,INTL 190H,A00,088197,Gibson; Clark C,0,0,0,0
1653300325272,JAPN 10A,A01,086851,Maruyama; Rie,15,0,15,0
1653300325272,JAPN 10A,A02,086852,Maruyama; Rie,15,0,15,0
1653300325272,JAPN 10A,B01,086854,Staff,13,0,13,0
1653300325272,JAPN 10A,B02,086855,Staff,13,0,13,0
1653300325272,JAPN 10A,C01,086857,McKee; Mayumi Mochizuki,13,0,13,0
1653300325272,JAPN 10A,C02,086858,McKee; Mayumi Mochizuki,11,0,13,2
1653300325272,JAPN 10A,D01,086860,Sato; Kyoko,13,0,13,0
1653300325272,JAPN 10A,D02,086861,Sato; Kyoko,13,0,13,0
1653300325272,JAPN 10A,E01,086863,Kamioka; Sachiko,12,0,13,1
1653300325272,JAPN 10A,E02,086864,Kamioka; Sachiko,12,0,13,1
1653300325272,JAPN 10A,F01,086866,Sato; Kyoko,13,0,13,0
1653300325272,JAPN 10A,F02,086867,Sato; Kyoko,13,0,13,0
1653300325272,JAPN 10A,G01,086869,Maruyama; Rie,8,0,13,5
1653300325272,JAPN 10A,G02,086870,Maruyama; Rie,13,0,13,0
1653300325272,JAPN 10A,H01,086872,Kamioka; Sachiko,12,0,13,1
1653300325272,JAPN 10A,H02,086873,Kamioka; Sachiko,11,0,13,2
1653300325272,JAPN 10A,I01,086875,Staff,12,0,13,1
1653300325272,JAPN 10A,I02,086876,Staff,13,0,13,0
1653300325272,JAPN 10A,J01,086878,McKee; Mayumi Mochizuki,12,0,13,1
1653300325272,JAPN 10A,J02,086879,McKee; Mayumi Mochizuki,13,0,13,0
1653300325272,JAPN 10A,K01,086881,Inada; Minori,13,0,13,0
1653300325272,JAPN 10A,K02,086882,Inada; Minori,12,0,13,1
1653300325272,JAPN 10A,L01,086884,Tipton; Yuko,13,0,13,0
1653300325272,JAPN 10A,L02,086885,Tipton; Yuko,13,0,13,0
1653300325272,JAPN 10A,M01,086887,Inada; Minori,12,0,13,1
1653300325272,JAPN 10A,M02,086888,Inada; Minori,13,0,13,0
1653300325272,JAPN 10A,N01,086890,McKee; Mayumi Mochizuki,13,0,13,0
1653300325272,JAPN 10A,N02,086891,McKee; Mayumi Mochizuki,11,0,13,2
1653300325272,JAPN 10A,O01,086893,Staff,13,0,13,0
1653300325272,JAPN 10A,O02,086894,Staff,12,0,13,1
1653300325272,JAPN 10A,P01,086896,Tipton; Yuko,15,0,15,0
1653300325272,JAPN 10A,P02,086897,Tipton; Yuko,15,0,15,0
1653300325800,JAPN 20A,A01,086899,Simpson; Junko Tokuda,11,0,13,2
1653300325800,JAPN 20A,A02,086900,Simpson; Junko Tokuda,12,0,13,1
1653300325800,JAPN 20A,B01,086902,Takeda; Izumi,11,0,13,2
1653300325800,JAPN 20A,B02,086903,Takeda; Izumi,12,0,13,1
1653300325800,JAPN 20A,C01,086905,Ross; Kayoko F,12,0,13,1
1653300325800,JAPN 20A,C02,086906,Ross; Kayoko F,12,0,13,1
1653300325800,JAPN 20A,D01,086908,Takeda; Izumi,10,0,13,3
1653300325800,JAPN 20A,D02,086909,Takeda; Izumi,13,0,13,0
1653300325800,JAPN 20A,E01,086911,Maruyama; Rie,11,0,13,2
1653300325800,JAPN 20A,E02,086912,Maruyama; Rie,11,0,13,2
1653300325800,JAPN 20A,F01,086914,Kamioka; Sachiko,7,0,13,6
1653300325800,JAPN 20A,F02,086915,Kamioka; Sachiko,9,0,13,4
1653300325800,JAPN 20A,G01,086917,Ross; Kayoko F,13,0,13,0
1653300325800,JAPN 20A,G02,086918,Ross; Kayoko F,12,0,13,1
1653300326329,JAPN 130A,A01,086920,Simpson; Junko Tokuda,6,0,10,4
1653300326329,JAPN 130A,A02,086921,Simpson; Junko Tokuda,5,0,10,5
1653300326329,JAPN 130A,B01,086923,Ross; Kayoko F,9,0,10,1
1653300326329,JAPN 130A,B02,086924,Ross; Kayoko F,9,0,10,1
1653300326940,JAPN 135A,A00,086925,Inada; Minori,14,0,15,1
1653300326940,JAPN 135A,B00,086926,Takeda; Izumi,15,0,15,0
1653300327467,JAPN 140A,A00,086927,Sato; Kyoko,19,0,20,1
1653300327999,JWSP 1,A01,086445,Shuster; Alana,15,0,15,0
1653300327999,JWSP 1,A02,086446,Shuster; Alana,15,0,15,0
1653300328523,JWSP 104,A01,086448,Shuster; Alana,15,0,15,0
1653300329046,LATI 10,A01,093588,Kennemore; Amy Michelle,31,0,32,1
1653300329046,LATI 10,A02,093589,Kennemore; Amy Michelle,32,0,32,0
1653300329046,LATI 10,A03,093590,Kennemore; Amy Michelle,32,0,32,0
1653300329569,LATI 50,A01,093592,Kokinis; Troy Andreas,32,0,32,0
1653300329569,LATI 50,A02,093593,Kokinis; Troy Andreas,31,0,32,1
1653300329569,LATI 50,A03,093595,Kokinis; Troy Andreas,32,0,32,0
1653300330093,LATI 122A,A00,093649,Andrews; Abigail Leslie,0,0,0,0
1653300330623,LATI 180,A00,093597,Staff,36,0,40,4
1653300331145,LIAB 1A,A00,087085,Saab; Dima,13,0,14,1
1653300331145,LIAB 1A,B00,087086,Saab; Dima,13,0,14,1
1653300331145,LIAB 1A,C00,087087,Saab; Dima,14,0,14,0
1653300331145,LIAB 1A,D00,087088,El Cheddadi; Youniss,14,0,14,0
1653300331669,LIAB 1AX,A00,087089,Akjeje; Abdelhak,28,0,28,0
1653300331669,LIAB 1AX,B00,087091,Akjeje; Abdelhak,28,0,28,0
1653300332195,LIAB 1D,A00,087093,El Cheddadi; Youniss,13,0,14,1
1653300332195,LIAB 1D,B00,087094,El Cheddadi; Youniss,12,0,14,2
1653300332718,LIAB 1DX,A00,087095,Akjeje; Abdelhak,27,0,28,1
1653300333245,LIDS 19,001,095098,Goodall; Grant Todd,9999,0,9999,0
1653300333245,LIDS 19,002,095099,Goodall; Grant Todd,9999,0,9999,0
1653300333245,LIDS 19,003,095100,Goodall; Grant Todd,9999,0,9999,0
1653300333245,LIDS 19,004,095101,Goodall; Grant Todd,9999,0,9999,0
1653300333245,LIDS 19,005,095102,Goodall; Grant Todd,9999,0,9999,0
1653300333245,LIDS 19,006,095103,Goodall; Grant Todd,9999,0,9999,0
1653300333245,LIDS 19,007,095104,Goodall; Grant Todd,9999,0,9999,0
1653300333245,LIDS 19,008,095105,Goodall; Grant Todd,9999,0,9999,0
1653300333245,LIDS 19,009,095106,Goodall; Grant Todd,9999,0,9999,0
1653300333245,LIDS 19,010,095107,Goodall; Grant Todd,9999,0,9999,0
1653300333245,LIDS 19,011,095108,Goodall; Grant Todd,9999,0,9999,0
1653300333245,LIDS 19,012,095109,Goodall; Grant Todd,9999,0,9999,0
1653300333770,LIFR 1A,A00,087097,Goodall; Grant Todd,13,0,14,1
1653300333770,LIFR 1A,B00,087098,Goodall; Grant Todd,13,0,14,1
1653300333770,LIFR 1A,C00,087099,Goodall; Grant Todd,12,0,14,2
1653300333770,LIFR 1A,D00,087100,Goodall; Grant Todd,12,0,14,2
1653300333770,LIFR 1A,E00,087101,Goodall; Grant Todd,14,0,14,0
1653300333770,LIFR 1A,F00,087102,Goodall; Grant Todd,13,0,14,1
1653300334294,LIFR 1AX,A00,087103,Goodall; Grant Todd,27,0,28,1
1653300334294,LIFR 1AX,B00,087104,Goodall; Grant Todd,27,0,28,1
1653300334294,LIFR 1AX,C00,087105,Goodall; Grant Todd,25,0,28,3
1653300334819,LIFR 1B,A00,087106,Goodall; Grant Todd,14,0,14,0
1653300334819,LIFR 1B,B00,087107,Goodall; Grant Todd,13,0,14,1
1653300334819,LIFR 1B,C00,087108,Goodall; Grant Todd,13,0,14,1
1653300334819,LIFR 1B,D00,087109,Goodall; Grant Todd,13,0,14,1
1653300335341,LIFR 1BX,A00,087110,Goodall; Grant Todd,26,0,28,2
1653300335341,LIFR 1BX,B00,087111,Goodall; Grant Todd,26,0,28,2
1653300335865,LIFR 1D,A00,087112,Goodall; Grant Todd,14,0,14,0
1653300335865,LIFR 1D,B00,087113,Goodall; Grant Todd,12,0,14,2
1653300335865,LIFR 1D,C00,087114,Goodall; Grant Todd,11,0,14,3
1653300335865,LIFR 1D,D00,087115,Goodall; Grant Todd,10,0,14,4
1653300336395,LIFR 1DX,A00,087116,Goodall; Grant Todd,26,0,28,2
1653300336395,LIFR 1DX,B00,087117,Goodall; Grant Todd,23,0,28,5
1653300336920,LIFR 11,A00,087118,Goodall; Grant Todd,10,0,10,0
1653300337449,LIGM 1A,A00,087119,Riebeling; Elke,14,0,14,0
1653300337449,LIGM 1A,B00,087120,Riebeling; Elke,14,0,14,0
1653300337449,LIGM 1A,C00,087121,Riebeling; Elke,12,0,14,2
1653300337449,LIGM 1A,D00,087122,Riebeling; Elke,14,0,14,0
1653300337449,LIGM 1A,E00,087123,Riebeling; Elke,14,0,14,0
1653300337977,LIGM 1AX,A00,087124,Riebeling; Elke,28,0,28,0
1653300337977,LIGM 1AX,B00,087125,Riebeling; Elke,28,0,28,0
1653300337977,LIGM 1AX,C00,087126,Riebeling; Elke,27,0,28,1
1653300338509,LIGM 1D,A00,087127,Riebeling; Elke,14,0,14,0
1653300338509,LIGM 1D,B00,087128,Riebeling; Elke,12,0,14,2
1653300339043,LIGM 1DX,A00,087129,Riebeling; Elke,26,0,28,2
1653300339570,LIGM 11,A00,087130,Goodall; Grant Todd,10,0,10,0
1653300340099,LIGN 5,A00,087005,Goodall; Grant Todd,74,0,75,1
1653300340623,LIGN 7,A00,087006,Mayberry; Rachel,139,0,146,7
1653300341147,LIGN 8,A00,087007,McIntosh; Justin Daniel,244,0,250,6
1653300341675,LIGN 17,A00,087008,Kehler; Andrew Scott,218,0,220,2
1653300342201,LIGN 101,A01,087010,Styler; William Francis,29,0,30,1
1653300342201,LIGN 101,A02,087011,Styler; William Francis,29,0,30,1
1653300342201,LIGN 101,A03,087012,Styler; William Francis,29,0,30,1
1653300342201,LIGN 101,A04,087013,Styler; William Francis,29,0,30,1
1653300342741,LIGN 110,A01,087015,Garellek; Marc,29,0,30,1
1653300342741,LIGN 110,A02,087016,Garellek; Marc,26,0,30,4
1653300342741,LIGN 110,A03,087017,Garellek; Marc,26,0,30,4
1653300342741,LIGN 110,A04,087018,Garellek; Marc,28,0,30,2
1653300343264,LIGN 121,A01,087020,Drake; Emily C,23,0,25,2
1653300343264,LIGN 121,A02,087021,Drake; Emily C,24,0,25,1
1653300343786,LIGN 150,A00,093702,Staff,71,0,75,4
1653300344313,LIGN 152,A00,087023,Caballero; Gabriela Hernandez,16,0,20,4
1653300344839,LIGN 154,A00,087024,Kluender; Robert,70,0,70,0
1653300345364,LIGN 167,A00,087025,Bergen; Leon,70,0,100,30
1653300345887,LIGN 187,A00,087026,McIntosh; Justin Daniel,20,0,20,0
1653300346413,LIHL 112F,A00,086505,Alicio; Atilio,25,0,28,3
1653300346937,LIHL 114F,A00,086506,Staff,21,0,28,7
1653300347460,LIHL 117F,A00,086508,Sadegholvad; Elham,20,0,20,0
1653300347986,LIHL 118,A00,086509,Staff,25,0,28,3
1653300348512,LIHL 119F,A00,086510,Staff,26,0,28,2
1653300349037,LIHL 124F,A00,086511,Staff,27,0,28,1
1653300349559,LIHL 132F,A00,086512,Alicio; Atilio,28,0,28,0
1653300350089,LIIT 1A,A00,087131,Riebeling; Elke,14,0,14,0
1653300350089,LIIT 1A,B00,087132,Riebeling; Elke,14,0,14,0
1653300350089,LIIT 1A,C00,087133,Riebeling; Elke,12,0,14,2
1653300350089,LIIT 1A,D00,087134,Riebeling; Elke,14,0,14,0
1653300350615,LIIT 1AX,A00,087135,Riebeling; Elke,28,0,28,0
1653300350615,LIIT 1AX,B00,087136,Riebeling; Elke,26,0,28,2
1653300351141,LIPO 1A,A00,087137,Paladini; Denise,14,0,14,0
1653300351141,LIPO 1A,B00,087138,Paladini; Denise,10,0,14,4
1653300351663,LIPO 1AX,A00,087139,De Abreu; Cassia,18,0,22,4
1653300351663,LIPO 1AX,B00,087140,De Abreu; Cassia,22,0,22,0
1653300352186,LIPO 1D,A00,087141,Paladini; Denise,10,0,14,4
1653300352714,LIPO 1DX,A00,087143,De Abreu; Cassia,10,0,14,4
1653300353244,LISL 1A,A00,087145,Lott; Margaret S.,10,0,14,4
1653300353244,LISL 1A,B00,087146,Lott; Margaret S.,14,0,14,0
1653300353244,LISL 1A,C00,087147,Lott; Margaret S.,10,0,14,4
1653300353244,LISL 1A,D00,087148,Lott; Margaret S.,11,0,14,3
1653300353244,LISL 1A,E00,087149,Lott; Margaret S.,13,0,14,1
1653300353244,LISL 1A,F00,087150,Lott; Margaret S.,12,0,14,2
1653300353244,LISL 1A,G00,087151,Lott; Margaret S.,13,0,14,1
1653300353244,LISL 1A,H00,087152,Lott; Margaret S.,13,0,14,1
1653300353769,LISL 1AX,A00,087153,Lott; Margaret S.,28,0,28,0
1653300353769,LISL 1AX,B00,087154,Lott; Margaret S.,25,0,28,3
1653300353769,LISL 1AX,C00,087155,Lott; Margaret S.,25,0,28,3
1653300353769,LISL 1AX,D00,087156,Lott; Margaret S.,24,0,28,4
1653300354293,LISL 1B,A00,087157,Lott; Margaret S.,13,0,14,1
1653300354293,LISL 1B,B00,087158,Lott; Margaret S.,12,0,14,2
1653300354293,LISL 1B,C00,087159,Lott; Margaret S.,11,0,14,3
1653300354293,LISL 1B,D00,087160,Lott; Margaret S.,13,0,14,1
1653300354293,LISL 1B,E00,087161,Lott; Margaret S.,13,0,14,1
1653300354293,LISL 1B,F00,087162,Lott; Margaret S.,13,0,14,1
1653300354824,LISL 1BX,A00,087163,Lott; Margaret S.,23,0,28,5
1653300354824,LISL 1BX,B00,087164,Lott; Margaret S.,26,0,28,2
1653300354824,LISL 1BX,C00,087165,Lott; Margaret S.,28,0,28,0
1653300355348,LISL 1D,A00,087166,Lott; Margaret S.,14,0,14,0
1653300355348,LISL 1D,B00,087167,Lott; Margaret S.,14,0,14,0
1653300355348,LISL 1D,C00,087168,Lott; Margaret S.,8,0,14,6
1653300355348,LISL 1D,D00,087169,Lott; Margaret S.,13,0,14,1
1653300355876,LISL 1DX,A00,087170,Lott; Margaret S.,23,0,28,5
1653300355876,LISL 1DX,B00,087171,Lott; Margaret S.,26,0,28,2
1653300356400,LISP 1A,001,087172,Munoz Sanchez; Alicia,13,0,14,1
1653300356400,LISP 1A,002,087173,Munoz Sanchez; Alicia,12,0,14,2
1653300356400,LISP 1A,003,087174,Munoz Sanchez; Alicia,13,0,14,1
1653300356400,LISP 1A,004,087175,Munoz Sanchez; Alicia,12,0,14,2
1653300356400,LISP 1A,005,087176,Munoz Sanchez; Alicia,10,0,14,4
1653300356400,LISP 1A,006,087177,Munoz Sanchez; Alicia,12,0,14,2
1653300356400,LISP 1A,007,087178,Munoz Sanchez; Alicia,12,0,14,2
1653300356400,LISP 1A,008,087179,Munoz Sanchez; Alicia,14,0,14,0
1653300356931,LISP 1AX,A00,087180,Munoz Sanchez; Alicia,27,0,28,1
1653300356931,LISP 1AX,B00,087181,Munoz Sanchez; Alicia,24,0,28,4
1653300356931,LISP 1AX,C00,087182,Munoz Sanchez; Alicia,25,0,28,3
1653300356931,LISP 1AX,D00,087183,Munoz Sanchez; Alicia,25,0,28,3
1653300357456,LISP 1B,001,087184,Munoz Sanchez; Alicia,14,0,14,0
1653300357456,LISP 1B,002,087185,Munoz Sanchez; Alicia,14,0,14,0
1653300357456,LISP 1B,003,087186,Munoz Sanchez; Alicia,11,0,14,3
1653300357456,LISP 1B,004,087187,Munoz Sanchez; Alicia,12,0,14,2
1653300357456,LISP 1B,005,087188,Munoz Sanchez; Alicia,13,0,14,1
1653300357456,LISP 1B,006,087189,Munoz Sanchez; Alicia,13,0,14,1
1653300357456,LISP 1B,007,087190,Munoz Sanchez; Alicia,14,0,14,0
1653300357456,LISP 1B,008,087191,Munoz Sanchez; Alicia,13,0,14,1
1653300357456,LISP 1B,009,087192,Munoz Sanchez; Alicia,14,0,14,0
1653300357456,LISP 1B,010,087193,Munoz Sanchez; Alicia,13,0,14,1
1653300357456,LISP 1B,011,087194,Munoz Sanchez; Alicia,14,0,14,0
1653300357980,LISP 1BX,A00,087195,Munoz Sanchez; Alicia,28,0,28,0
1653300357980,LISP 1BX,B00,087196,Munoz Sanchez; Alicia,26,0,28,2
1653300357980,LISP 1BX,C00,087197,Munoz Sanchez; Alicia,26,0,28,2
1653300357980,LISP 1BX,D00,087198,Munoz Sanchez; Alicia,26,0,28,2
1653300357980,LISP 1BX,E00,087199,Munoz Sanchez; Alicia,28,0,28,0
1653300358506,LISP 1D,001,087200,Munoz Sanchez; Alicia,13,0,14,1
1653300358506,LISP 1D,002,087201,Munoz Sanchez; Alicia,14,0,14,0
1653300358506,LISP 1D,003,087202,Munoz Sanchez; Alicia,8,0,14,6
1653300358506,LISP 1D,004,087203,Munoz Sanchez; Alicia,5,0,14,9
1653300358506,LISP 1D,005,087204,Munoz Sanchez; Alicia,11,0,14,3
1653300358506,LISP 1D,006,087205,Munoz Sanchez; Alicia,13,0,14,1
1653300358506,LISP 1D,007,087206,Munoz Sanchez; Alicia,13,0,14,1
1653300358506,LISP 1D,008,087207,Munoz Sanchez; Alicia,13,0,14,1
1653300358506,LISP 1D,009,087208,Munoz Sanchez; Alicia,14,0,14,0
1653300358506,LISP 1D,010,087209,Munoz Sanchez; Alicia,12,0,14,2
1653300358506,LISP 1D,011,087210,Munoz Sanchez; Alicia,13,0,14,1
1653300358506,LISP 1D,012,087211,Munoz Sanchez; Alicia,14,0,14,0
1653300358506,LISP 1D,013,087212,Munoz Sanchez; Alicia,14,0,14,0
1653300358506,LISP 1D,014,087213,Munoz Sanchez; Alicia,14,0,14,0
1653300359039,LISP 1DX,A00,087214,Munoz Sanchez; Alicia,27,0,28,1
1653300359039,LISP 1DX,B00,087215,Munoz Sanchez; Alicia,23,0,28,5
1653300359039,LISP 1DX,C00,087216,Munoz Sanchez; Alicia,23,0,28,5
1653300359039,LISP 1DX,D00,087217,Munoz Sanchez; Alicia,25,0,28,3
1653300359039,LISP 1DX,E00,087218,Munoz Sanchez; Alicia,27,0,28,1
1653300359039,LISP 1DX,F00,087219,Munoz Sanchez; Alicia,25,0,28,3
1653300359039,LISP 1DX,G00,087220,Munoz Sanchez; Alicia,28,0,28,0
1653300359562,LISP 15,A00,087221,Munoz Sanchez; Alicia,19,0,20,1
1653300360085,LISP 18,A00,087222,Munoz Sanchez; Alicia,15,0,20,5
1653300360607,LTAM 110,A00,087352,Chacon; Gloria Elizabeth,35,0,40,5
1653300361131,LTCS 87,A00,094011,Nguyen; Hoang Tan,19,0,20,1
1653300361656,LTCS 111,A00,087353,Vitkus; Daniel J.,40,0,40,0
1653300362190,LTCS 119,A00,087354,Nguyen; Hoang Tan,29,0,30,1
1653300362717,LTCS 130,A00,087355,Kim; Joo Ok,37,0,40,3
1653300363240,LTCS 165,A00,087356,Kim; Joo Ok,38,0,40,2
1653300363764,LTEA 120A,A00,087357,Fiss; Geraldine Anna,291,0,300,9
1653300364288,LTEA 140,A00,094009,Lee; Jin-Kyung,28,0,32,4
1653300364812,LTEA 142,A00,087358,Lee; Jin-Kyung,103,0,120,17
1653300365341,LTEN 21,A01,087275,Lampert-Weissig; Lisa,25,0,25,0
1653300365341,LTEN 21,A02,087276,Lampert-Weissig; Lisa,25,0,25,0
1653300365341,LTEN 21,A03,087277,Lampert-Weissig; Lisa,25,0,25,0
1653300365341,LTEN 21,A04,087278,Lampert-Weissig; Lisa,25,0,25,0
1653300365869,LTEN 25,A01,087280,Johnson; Sara E.,25,0,25,0
1653300365869,LTEN 25,A02,087281,Johnson; Sara E.,25,0,25,0
1653300365869,LTEN 25,A03,087282,Johnson; Sara E.,23,0,25,2
1653300365869,LTEN 25,A04,087283,Johnson; Sara E.,25,0,25,0
1653300366393,LTEN 29,A01,087285,Ruiz; Ariana,24,0,25,1
1653300366393,LTEN 29,A02,087286,Ruiz; Ariana,25,0,25,0
1653300366393,LTEN 29,A03,087287,Ruiz; Ariana,24,0,25,1
1653300366393,LTEN 29,A04,087288,Ruiz; Ariana,24,0,25,1
1653300366918,LTEN 107,A00,087359,Lampert-Weissig; Lisa,39,0,40,1
1653300367443,LTEN 117,A00,087360,Vitkus; Daniel J.,40,0,40,0
1653300367973,LTEN 127,A00,087361,Loose; Margaret,38,0,40,2
1653300368496,LTEN 142,A00,094010,Loose; Margaret,38,0,40,2
1653300369040,LTEN 148,A00,087363,Walkiewicz; Kathryn A,40,0,40,0
1653300369562,LTEN 152,A00,087364,Walkiewicz; Kathryn A,37,0,40,3
1653300370092,LTEN 180,A00,087365,Ruiz; Ariana,18,0,20,2
1653300370619,LTFR 2A,A01,087290,Ploye; Catherine,23,0,25,2
1653300371143,LTFR 2B,A01,087292,Ploye; Catherine,25,0,25,0
1653300371667,LTFR 104,A00,087366,Ploye; Catherine,25,0,25,0
1653300372190,LTFR 116,A00,087367,Zhiri; Oumelbanine,13,0,15,2
1653300372714,LTGK 1,A00,087293,Myerston Santana; Jacobo,27,0,30,3
1653300373238,LTGK 103,A00,087368,duBois; Page Ann,14,0,15,1
1653300373765,LTGM 2A,A01,087295,Fischer-Grunski; Eva K,24,0,25,1
1653300374294,LTIT 2A,A01,087297,De Marchi Gherini; Adriana,24,0,25,1
1653300374831,LTKO 1A,A01,087299,Staff,24,0,25,1
1653300374831,LTKO 1A,B01,087301,Staff,25,0,25,0
1653300374831,LTKO 1A,C01,087303,Staff,25,0,25,0
1653300374831,LTKO 1A,D01,087305,Staff,25,0,25,0
1653300374831,LTKO 1A,E01,087307,Staff,24,0,25,1
1653300374831,LTKO 1A,F01,087309,Staff,25,0,25,0
1653300374831,LTKO 1A,G01,087311,Staff,25,0,25,0
1653300374831,LTKO 1A,H01,087313,Staff,24,0,25,1
1653300374831,LTKO 1A,I01,087315,Staff,25,0,25,0
1653300375366,LTKO 2A,A01,087317,Staff,24,0,25,1
1653300375366,LTKO 2A,B01,087319,Staff,22,0,25,3
1653300375366,LTKO 2A,C01,087321,Lee; Jeyseon,24,0,25,1
1653300375891,LTKO 130,A00,087369,Lee; Jeyseon,25,0,25,0
1653300376420,LTLA 1,A00,087322,Murray; Kourtney Kristine,38,0,40,2
1653300376943,LTLA 100,A00,087371,Kelting; Edward William,23,0,25,2
1653300377466,LTRU 1A,A01,087324,Wells; Patricia Rebecca,23,0,25,2
1653300377993,LTRU 2A,A01,087326,Wells; Patricia Rebecca,20,0,20,0
1653300378516,LTRU 104B,A01,087373,Wells; Patricia Rebecca,14,0,15,1
1653300379042,LTSP 2A,A01,087328,Staff,25,0,25,0
1653300379042,LTSP 2A,B01,087330,Staff,22,0,25,3
1653300379042,LTSP 2A,C01,087332,Staff,22,0,25,3
1653300379593,LTSP 2B,A01,087334,Staff,22,0,25,3
1653300379593,LTSP 2B,B01,087336,Staff,19,0,25,6
1653300380191,LTSP 2D,A00,087337,Staff,25,0,25,0
1653300380191,LTSP 2D,B00,087338,Staff,25,0,25,0
1653300380191,LTSP 2D,C00,087339,Staff,25,0,25,0
1653300380720,LTSP 100A,A00,087374,Arcos Herrera; Carol,23,0,25,2
1653300381245,LTSP 116,A00,087375,Blanco; John D,29,0,30,1
1653300381767,LTSP 140,A00,087376,Chacon; Gloria Elizabeth,30,0,30,0
1653300382300,LTSP 175,A00,087377,Arcos Herrera; Carol,30,0,30,0
1653300382825,LTTH 150,A00,087379,Cohen; Alain J. J.,40,0,40,0
1653300383352,LTWL 19A,A00,087340,Myerston Santana; Jacobo,39,0,40,1
1653300383876,LTWL 87,A00,094012,Lampert-Weissig; Lisa,20,0,20,0
1653300384400,LTWL 116,A00,087380,Nguyen; Hoang Tan,60,0,60,0
1653300384924,LTWL 120,A00,087381,Fiss; Geraldine Anna,37,0,40,3
1653300385447,LTWL 172,A00,087382,De Marchi Gherini; Adriana,40,0,40,0
1653300385971,LTWL 180,A00,087383,Kontje; Todd Curtis,39,0,40,1
1653300386501,LTWL 194,A00,087384,Suzuki; Erin M.,31,0,32,1
1653300387025,LTWR 8A,A01,087342,Jemc; Jaclyn,24,0,25,1
1653300387025,LTWR 8A,A02,087343,Jemc; Jaclyn,25,0,25,0
1653300387025,LTWR 8A,A03,087344,Jemc; Jaclyn,24,0,25,1
1653300387025,LTWR 8A,A04,087345,Jemc; Jaclyn,24,0,25,1
1653300387555,LTWR 8C,A01,087348,Forbes; Camille,25,0,25,0
1653300387555,LTWR 8C,A02,087349,Forbes; Camille,25,0,25,0
1653300387555,LTWR 8C,A03,087350,Forbes; Camille,25,0,25,0
1653300387555,LTWR 8C,A04,087351,Forbes; Camille,23,0,25,2
1653300388082,LTWR 100,A00,087385,Staff,12,0,15,3
1653300388605,LTWR 102,A00,087386,Staff,14,0,15,1
1653300389130,LTWR 115,A00,087387,Carroll; Amy Sara,24,0,30,6
1653300389654,LTWR 119,A00,087388,Staff,22,0,30,8
1653300390181,LTWR 140,A00,087389,Carroll; Amy Sara,37,0,40,3
1653300390705,LTWR 194,A00,087390,Som; Brandon D,35,0,40,5
1653300391244,MAE 2,A01,090334,Anderson; Mark Ronald,8,0,8,0
1653300391244,MAE 2,A02,090335,Anderson; Mark Ronald,8,0,8,0
1653300391244,MAE 2,A03,090336,Anderson; Mark Ronald,8,0,8,0
1653300391244,MAE 2,A04,090337,Anderson; Mark Ronald,8,0,8,0
1653300391244,MAE 2,A05,090338,Anderson; Mark Ronald,8,0,8,0
1653300391244,MAE 2,A06,090339,Anderson; Mark Ronald,8,0,8,0
1653300391244,MAE 2,A07,090340,Anderson; Mark Ronald,8,0,8,0
1653300391244,MAE 2,A08,090341,Anderson; Mark Ronald,7,0,8,1
1653300391244,MAE 2,A09,090342,Anderson; Mark Ronald,8,0,8,0
1653300391775,MAE 3,A01,090344,Delson; Nathan Joseph,21,0,22,1
1653300391775,MAE 3,A02,090345,Delson; Nathan Joseph,20,0,22,2
1653300391775,MAE 3,A03,090346,Delson; Nathan Joseph,21,0,22,1
1653300391775,MAE 3,A04,090347,Delson; Nathan Joseph,22,0,22,0
1653300391775,MAE 3,B01,090349,Qi; Huihui,18,0,22,4
1653300391775,MAE 3,B02,090350,Qi; Huihui,17,0,22,5
1653300391775,MAE 3,B03,090351,Qi; Huihui,20,0,22,2
1653300391775,MAE 3,B04,090352,Qi; Huihui,19,0,22,3
1653300392298,MAE 8,A01,090354,Pham; Hieu Tan,182,0,185,3
1653300392822,MAE 11,A00,090355,Nomura; Keiko K.,155,0,165,10
1653300393345,MAE 20,A00,090356,Bandaru; Prabhakar,160,0,160,0
1653300393345,MAE 20,B00,090357,Evdokimenko; Ekaterina,145,0,160,15
1653300393881,MAE 21,A01,090359,Cai; Shengqiang,8,0,9,1
1653300393881,MAE 21,A02,090360,Cai; Shengqiang,9,0,9,0
1653300393881,MAE 21,A03,090361,Cai; Shengqiang,6,0,9,3
1653300393881,MAE 21,A04,090362,Cai; Shengqiang,7,0,9,2
1653300393881,MAE 21,A05,090363,Cai; Shengqiang,0,0,0,0
1653300393881,MAE 21,A06,090364,Cai; Shengqiang,9,0,9,0
1653300393881,MAE 21,A07,090365,Cai; Shengqiang,9,0,9,0
1653300393881,MAE 21,A08,090366,Cai; Shengqiang,8,0,9,1
1653300393881,MAE 21,A09,090367,Cai; Shengqiang,8,0,9,1
1653300393881,MAE 21,A10,090368,Cai; Shengqiang,0,0,0,0
1653300393881,MAE 21,A11,090369,Cai; Shengqiang,9,0,9,0
1653300393881,MAE 21,A12,090370,Cai; Shengqiang,8,0,9,1
1653300394411,MAE 30A,A00,090371,Lal; Ratnesh,72,0,75,3
1653300394938,MAE 40,A00,090372,Bitmead; Robert R.,167,0,175,8
1653300395466,MAE 101A,A00,090373,Bahadori; Mohammad Yousef,105,0,115,10
1653300395993,MAE 101C,A00,090374,Poulikakos; Lisa Voula,41,0,110,69
1653300395993,MAE 101C,B00,090375,Chen; Renkun,96,0,110,14
1653300396518,MAE 104,A00,090376,Sanchez; Antonio Luis,78,0,120,42
1653300397041,MAE 105,A00,090377,Saintillan; David,154,0,170,16
1653300397566,MAE 107,A00,090378,Lindsey; Stephanie,104,0,110,6
1653300397566,MAE 107,B00,090379,Tolley; Michael Thomas,85,0,110,25
1653300398090,MAE 118,A00,090380,Krasheninnikov; Sergei,27,0,45,18
1653300398618,MAE 131A,A00,090381,Ghazinejad; Maziar,70,0,75,5
1653300399141,MAE 133,A00,090382,Frazier; Michael,26,0,33,7
1653300399671,MAE 143A,A00,090383,de Oliveira; Mauricio,74,0,100,26
1653300400196,MAE 144,A00,090384,Bewley; Thomas R,50,0,70,20
1653300400719,MAE 148,A01,091597,Staff,32,0,32,0
1653300401243,MAE 150,A00,090385,Friend; James Robert,69,0,90,21
1653300401243,MAE 150,B00,090386,Ghazinejad; Maziar,4,0,90,86
1653300401769,MAE 152,A00,090387,Tynan; George Robert,0,0,16,16
1653300401769,MAE 152,B00,090388,Tynan; George Robert,0,0,16,16
1653300401769,MAE 152,C00,090389,Tynan; George Robert,0,0,16,16
1653300401769,MAE 152,D00,090390,Tynan; George Robert,0,0,16,16
1653300402294,MAE 156A,A01,090392,Delson; Nathan Joseph,2,0,12,10
1653300402294,MAE 156A,A02,090393,Delson; Nathan Joseph,1,0,12,11
1653300402294,MAE 156A,A03,090394,Delson; Nathan Joseph,4,0,12,8
1653300402823,MAE 170,A01,090396,Lubarda; Marko,14,0,30,16
1653300402823,MAE 170,A02,090397,Lubarda; Marko,19,0,30,11
1653300402823,MAE 170,A03,090398,Lubarda; Marko,28,0,30,2
1653300402823,MAE 170,A04,090399,Lubarda; Marko,20,0,30,10
1653300402823,MAE 170,B01,090401,Diagne; Mamadou Lamine,30,0,30,0
1653300402823,MAE 170,B02,090402,Diagne; Mamadou Lamine,27,0,30,3
1653300402823,MAE 170,B03,090403,Diagne; Mamadou Lamine,28,0,30,2
1653300402823,MAE 170,B04,090404,Diagne; Mamadou Lamine,28,0,30,2
1653300403354,MAE 180A,A00,090405,McEneaney; William Michael,110,0,125,15
1653300403878,MAE 181,A00,090406,Bahadori; Mohammad Yousef,46,0,60,14
1653300404405,MAE 190,A00,090407,Anderson; Mark Ronald,27,0,45,18
1653300404928,MAE 191,A01,090409,Qi; Huihui,25,0,32,7
1653300405461,MATH 2,A01,089123,Hammock; Frances H,0,0,0,0
1653300405461,MATH 2,B01,089126,Hammock; Frances H,0,0,0,0
1653300405461,MATH 2,C01,089129,Hammock; Frances H,0,0,0,0
1653300405461,MATH 2,D01,094201,Harel; Guershon,0,0,0,0
1653300405988,MATH 3C,A01,089132,Bowers; Adam R.,0,0,0,0
1653300405988,MATH 3C,A02,089133,Bowers; Adam R.,0,0,0,0
1653300405988,MATH 3C,A03,089134,Bowers; Adam R.,0,0,0,0
1653300405988,MATH 3C,A04,089135,Bowers; Adam R.,0,0,0,0
1653300405988,MATH 3C,A05,089136,Bowers; Adam R.,0,0,0,0
1653300405988,MATH 3C,A06,089137,Bowers; Adam R.,0,0,0,0
1653300405988,MATH 3C,A07,089138,Bowers; Adam R.,0,0,0,0
1653300405988,MATH 3C,A08,089139,Bowers; Adam R.,0,0,0,0
1653300405988,MATH 3C,A09,089140,Bowers; Adam R.,0,0,0,0
1653300405988,MATH 3C,A10,089141,Bowers; Adam R.,0,0,0,0
1653300405988,MATH 3C,A11,089142,Bowers; Adam R.,0,0,0,0
1653300405988,MATH 3C,A12,089143,Bowers; Adam R.,0,0,0,0
1653300405988,MATH 3C,A13,089144,Bowers; Adam R.,0,0,0,0
1653300405988,MATH 3C,A14,089145,Bowers; Adam R.,0,0,0,0
1653300405988,MATH 3C,A15,089146,Bowers; Adam R.,0,0,0,0
1653300405988,MATH 3C,A16,089147,Bowers; Adam R.,0,0,0,0
1653300405988,MATH 3C,A17,089148,Bowers; Adam R.,0,0,0,0
1653300405988,MATH 3C,A18,089149,Bowers; Adam R.,0,0,0,0
1653300405988,MATH 3C,A19,089150,Bowers; Adam R.,0,0,0,0
1653300405988,MATH 3C,A20,089151,Bowers; Adam R.,0,0,0,0
1653300405988,MATH 3C,A21,089152,Bowers; Adam R.,0,0,0,0
1653300405988,MATH 3C,A22,089153,Bowers; Adam R.,0,0,0,0
1653300405988,MATH 3C,A23,089154,Bowers; Adam R.,0,0,0,0
1653300405988,MATH 3C,A24,089155,Bowers; Adam R.,0,0,0,0
1653300405988,MATH 3C,B01,089158,Staff,0,0,0,0
1653300405988,MATH 3C,B02,089159,Staff,0,0,0,0
1653300405988,MATH 3C,B03,089160,Staff,0,0,0,0
1653300405988,MATH 3C,B04,089161,Staff,0,0,0,0
1653300405988,MATH 3C,C01,094244,Staff,0,0,0,0
1653300405988,MATH 3C,C02,094245,Staff,0,0,0,0
1653300405988,MATH 3C,C03,094246,Staff,0,0,0,0
1653300405988,MATH 3C,C04,094247,Staff,0,0,0,0
1653300406526,MATH 4C,A01,089164,Staff,0,0,0,0
1653300406526,MATH 4C,A02,089165,Staff,0,0,0,0
1653300406526,MATH 4C,A03,089166,Staff,0,0,0,0
1653300406526,MATH 4C,B01,089169,Ganzberger; Geoffrey Michael,0,0,0,0
1653300406526,MATH 4C,B02,089170,Ganzberger; Geoffrey Michael,0,0,0,0
1653300406526,MATH 4C,B03,089171,Ganzberger; Geoffrey Michael,0,0,0,0
1653300406526,MATH 4C,C01,089174,Ganzberger; Geoffrey Michael,0,0,0,0
1653300406526,MATH 4C,C02,089175,Ganzberger; Geoffrey Michael,0,0,0,0
1653300406526,MATH 4C,C03,089176,Ganzberger; Geoffrey Michael,0,0,0,0
1653300406526,MATH 4C,D01,094249,Ganzberger; Geoffrey Michael,0,0,0,0
1653300406526,MATH 4C,D02,094250,Ganzberger; Geoffrey Michael,0,0,0,0
1653300406526,MATH 4C,D03,094251,Ganzberger; Geoffrey Michael,0,0,0,0
1653300407074,MATH 10A,A01,089179,Jin; Muzhi,5,0,5,0
1653300407074,MATH 10A,A02,089180,Jin; Muzhi,5,0,5,0
1653300407074,MATH 10A,A03,089181,Jin; Muzhi,4,0,5,1
1653300407074,MATH 10A,A04,089182,Jin; Muzhi,4,0,5,1
1653300407074,MATH 10A,A05,089183,Jin; Muzhi,5,0,5,0
1653300407074,MATH 10A,A06,089184,Jin; Muzhi,5,0,5,0
1653300407074,MATH 10A,A07,089185,Jin; Muzhi,5,0,5,0
1653300407074,MATH 10A,A08,089186,Jin; Muzhi,5,0,5,0
1653300407074,MATH 10A,B01,089188,Stevens; Laura Jeanne,1,0,5,4
1653300407074,MATH 10A,B02,089189,Stevens; Laura Jeanne,4,0,5,1
1653300407074,MATH 10A,B03,089190,Stevens; Laura Jeanne,4,0,5,1
1653300407074,MATH 10A,B04,089191,Stevens; Laura Jeanne,5,0,5,0
1653300407074,MATH 10A,B05,089192,Stevens; Laura Jeanne,4,0,5,1
1653300407074,MATH 10A,B06,089193,Stevens; Laura Jeanne,5,0,5,0
1653300407074,MATH 10A,B07,089194,Stevens; Laura Jeanne,5,0,5,0
1653300407074,MATH 10A,B08,089195,Stevens; Laura Jeanne,4,0,5,1
1653300407074,MATH 10A,C01,089197,Jin; Muzhi,1,0,5,4
1653300407074,MATH 10A,C02,089198,Jin; Muzhi,5,0,5,0
1653300407074,MATH 10A,C03,089199,Jin; Muzhi,5,0,5,0
1653300407074,MATH 10A,C04,089200,Jin; Muzhi,5,0,5,0
1653300407074,MATH 10A,C05,089201,Jin; Muzhi,5,0,5,0
1653300407074,MATH 10A,C06,089202,Jin; Muzhi,5,0,5,0
1653300407074,MATH 10A,D01,089204,Upton; James Thomas,4,0,5,1
1653300407074,MATH 10A,D02,089205,Upton; James Thomas,5,0,5,0
1653300407074,MATH 10A,D03,089206,Upton; James Thomas,5,0,5,0
1653300407074,MATH 10A,D04,089207,Upton; James Thomas,5,0,5,0
1653300407074,MATH 10A,E01,089211,Greenfeld; Be'Eri,5,0,5,0
1653300407074,MATH 10A,E02,089212,Greenfeld; Be'Eri,3,0,5,2
1653300407074,MATH 10A,E03,089213,Greenfeld; Be'Eri,4,0,5,1
1653300407074,MATH 10A,E04,089214,Greenfeld; Be'Eri,5,0,5,0
1653300407074,MATH 10A,E05,089215,Greenfeld; Be'Eri,5,0,5,0
1653300407074,MATH 10A,E06,089216,Greenfeld; Be'Eri,5,0,5,0
1653300407609,MATH 10B,A01,089218,Stevens; Laura Jeanne,7,0,8,1
1653300407609,MATH 10B,A02,089219,Stevens; Laura Jeanne,7,0,8,1
1653300407609,MATH 10B,A03,089220,Stevens; Laura Jeanne,8,0,8,0
1653300407609,MATH 10B,A04,089221,Stevens; Laura Jeanne,6,0,8,2
1653300407609,MATH 10B,A05,089222,Stevens; Laura Jeanne,2,0,8,6
1653300407609,MATH 10B,A06,089223,Stevens; Laura Jeanne,0,0,8,8
1653300407609,MATH 10B,A07,089224,Stevens; Laura Jeanne,6,0,8,2
1653300407609,MATH 10B,A08,089225,Stevens; Laura Jeanne,4,0,8,4
1653300407609,MATH 10B,B01,089227,Staff,8,0,8,0
1653300407609,MATH 10B,B02,089228,Staff,8,0,8,0
1653300407609,MATH 10B,B03,089229,Staff,7,0,8,1
1653300407609,MATH 10B,B04,089230,Staff,8,0,8,0
1653300407609,MATH 10B,B05,089231,Staff,8,0,8,0
1653300407609,MATH 10B,B06,089232,Staff,8,0,8,0
1653300407609,MATH 10B,B07,089233,Staff,8,0,8,0
1653300407609,MATH 10B,B08,089234,Staff,8,0,8,0
1653300407609,MATH 10B,C01,089236,McKinley; Gweneth Anne,4,0,8,4
1653300407609,MATH 10B,C02,089237,McKinley; Gweneth Anne,8,0,8,0
1653300407609,MATH 10B,C03,089238,McKinley; Gweneth Anne,8,0,8,0
1653300407609,MATH 10B,C04,089239,McKinley; Gweneth Anne,8,0,8,0
1653300407609,MATH 10B,C05,089240,McKinley; Gweneth Anne,8,0,8,0
1653300407609,MATH 10B,C06,089241,McKinley; Gweneth Anne,8,0,8,0
1653300408138,MATH 10C,A01,089243,Staff,13,0,20,7
1653300408138,MATH 10C,A02,089244,Staff,20,0,20,0
1653300408138,MATH 10C,A03,089245,Staff,18,0,20,2
1653300408138,MATH 10C,A04,089246,Staff,20,0,20,0
1653300408138,MATH 10C,A05,089247,Staff,19,0,20,1
1653300408138,MATH 10C,A06,089248,Staff,20,0,20,0
1653300408138,MATH 10C,A07,094505,Staff,20,0,20,0
1653300408138,MATH 10C,A08,094506,Staff,20,0,20,0
1653300408138,MATH 10C,B01,089250,Staff,19,0,20,1
1653300408138,MATH 10C,B02,089251,Staff,19,0,20,1
1653300408138,MATH 10C,B03,089252,Staff,14,0,20,6
1653300408138,MATH 10C,B04,089253,Staff,20,0,20,0
1653300408138,MATH 10C,B05,089254,Staff,20,0,20,0
1653300408138,MATH 10C,B06,089255,Staff,18,0,20,2
1653300408663,MATH 11,A01,089258,Rava; Denise,1,0,15,14
1653300408663,MATH 11,A02,089260,Rava; Denise,9,0,15,6
1653300408663,MATH 11,A03,089263,Rava; Denise,10,0,15,5
1653300408663,MATH 11,A04,089265,Rava; Denise,13,0,15,2
1653300408663,MATH 11,A05,089267,Rava; Denise,10,0,15,5
1653300408663,MATH 11,A06,089269,Rava; Denise,14,0,15,1
1653300408663,MATH 11,A07,089271,Rava; Denise,14,0,15,1
1653300408663,MATH 11,A08,089273,Rava; Denise,13,0,15,2
1653300408663,MATH 11,B01,089279,Staff,4,0,15,11
1653300408663,MATH 11,B02,089281,Staff,14,0,15,1
1653300408663,MATH 11,B03,089283,Staff,14,0,15,1
1653300408663,MATH 11,B04,089284,Staff,15,0,15,0
1653300408663,MATH 11,B05,089286,Staff,14,0,15,1
1653300408663,MATH 11,B06,089288,Staff,15,0,15,0
1653300408663,MATH 11,B07,089289,Staff,14,0,15,1
1653300408663,MATH 11,B08,089290,Staff,14,0,15,1
1653300409224,MATH 18,A01,089303,Anzaldo; Leesa B,5,0,10,5
1653300409224,MATH 18,A02,089304,Anzaldo; Leesa B,6,0,10,4
1653300409224,MATH 18,A03,089305,Anzaldo; Leesa B,10,0,10,0
1653300409224,MATH 18,A04,089306,Anzaldo; Leesa B,8,0,10,2
1653300409224,MATH 18,A05,089307,Anzaldo; Leesa B,10,0,10,0
1653300409224,MATH 18,A06,089308,Anzaldo; Leesa B,9,0,10,1
1653300409224,MATH 18,A07,089309,Anzaldo; Leesa B,10,0,10,0
1653300409224,MATH 18,A08,089310,Anzaldo; Leesa B,10,0,10,0
1653300409224,MATH 18,A09,089311,Anzaldo; Leesa B,10,0,10,0
1653300409224,MATH 18,A10,089312,Anzaldo; Leesa B,10,0,10,0
1653300409224,MATH 18,A11,089313,Anzaldo; Leesa B,9,0,10,1
1653300409224,MATH 18,A12,089314,Anzaldo; Leesa B,10,0,10,0
1653300409224,MATH 18,A13,089315,Anzaldo; Leesa B,9,0,10,1
1653300409224,MATH 18,A14,089316,Anzaldo; Leesa B,10,0,10,0
1653300409224,MATH 18,A15,089317,Anzaldo; Leesa B,9,0,10,1
1653300409224,MATH 18,A16,089318,Anzaldo; Leesa B,10,0,10,0
1653300409224,MATH 18,A17,089319,Anzaldo; Leesa B,9,0,10,1
1653300409224,MATH 18,A18,089320,Anzaldo; Leesa B,10,0,10,0
1653300409224,MATH 18,A19,089321,Anzaldo; Leesa B,0,0,0,0
1653300409224,MATH 18,A20,089322,Anzaldo; Leesa B,0,0,0,0
1653300409224,MATH 18,A21,089323,Anzaldo; Leesa B,9,0,10,1
1653300409224,MATH 18,A22,089324,Anzaldo; Leesa B,7,0,10,3
1653300409224,MATH 18,A23,089325,Anzaldo; Leesa B,10,0,10,0
1653300409224,MATH 18,A24,089326,Anzaldo; Leesa B,9,0,10,1
1653300409224,MATH 18,B01,089329,Staff,13,0,13,0
1653300409224,MATH 18,B02,089330,Staff,12,0,13,1
1653300409224,MATH 18,B03,089331,Staff,12,0,13,1
1653300409224,MATH 18,B04,089332,Staff,13,0,13,0
1653300409224,MATH 18,B05,089333,Staff,12,0,13,1
1653300409224,MATH 18,C01,089336,Staff,13,0,13,0
1653300409224,MATH 18,C02,089337,Staff,11,0,13,2
1653300409224,MATH 18,C03,089338,Staff,0,0,0,0
1653300409224,MATH 18,C04,089339,Staff,0,0,0,0
1653300409224,MATH 18,C05,089340,Staff,0,0,0,1
1653300409224,MATH 18,D01,094194,Staff,0,0,0,0
1653300409224,MATH 18,D02,094195,Staff,0,0,0,0
1653300409224,MATH 18,D03,094196,Staff,0,0,0,0
1653300409224,MATH 18,D04,094197,Staff,0,0,0,0
1653300409224,MATH 18,D05,094198,Staff,0,0,0,0
1653300409751,MATH 20A,A01,089343,Staff,5,0,5,0
1653300409751,MATH 20A,A02,089344,Staff,5,0,5,0
1653300409751,MATH 20A,A03,089345,Staff,5,0,5,0
1653300409751,MATH 20A,B01,089347,Suk; Andrew Hoon,2,0,3,1
1653300409751,MATH 20A,B02,089348,Suk; Andrew Hoon,3,0,3,0
1653300409751,MATH 20A,B03,089349,Suk; Andrew Hoon,3,0,3,0
1653300409751,MATH 20A,B04,089350,Suk; Andrew Hoon,3,0,3,0
1653300409751,MATH 20A,B05,089351,Suk; Andrew Hoon,3,0,3,0
1653300409751,MATH 20A,B06,089352,Suk; Andrew Hoon,2,0,3,1
1653300409751,MATH 20A,B07,089353,Suk; Andrew Hoon,3,0,3,0
1653300409751,MATH 20A,B08,089354,Suk; Andrew Hoon,3,0,3,0
1653300409751,MATH 20A,B09,089355,Suk; Andrew Hoon,3,0,3,0
1653300409751,MATH 20A,B10,089356,Suk; Andrew Hoon,3,0,3,0
1653300409751,MATH 20A,B11,089357,Suk; Andrew Hoon,3,0,3,0
1653300409751,MATH 20A,B12,089358,Suk; Andrew Hoon,3,0,3,0
1653300409751,MATH 20A,B13,089359,Suk; Andrew Hoon,2,0,3,1
1653300409751,MATH 20A,B14,089360,Suk; Andrew Hoon,3,0,3,0
1653300409751,MATH 20A,B15,089361,Suk; Andrew Hoon,3,0,3,0
1653300409751,MATH 20A,B16,089362,Suk; Andrew Hoon,3,0,3,0
1653300409751,MATH 20A,B17,089363,Suk; Andrew Hoon,3,0,3,0
1653300409751,MATH 20A,B18,089364,Suk; Andrew Hoon,0,0,0,0
1653300409751,MATH 20A,B19,089365,Suk; Andrew Hoon,3,0,3,0
1653300409751,MATH 20A,B20,089366,Suk; Andrew Hoon,3,0,3,0
1653300409751,MATH 20A,B21,089367,Suk; Andrew Hoon,3,0,3,0
1653300409751,MATH 20A,B22,089368,Suk; Andrew Hoon,3,0,3,0
1653300409751,MATH 20A,B23,089369,Suk; Andrew Hoon,3,0,3,0
1653300409751,MATH 20A,B24,089370,Suk; Andrew Hoon,3,0,3,0
1653300410278,MATH 20B,A01,089372,Quarfoot; David James,8,0,8,0
1653300410278,MATH 20B,A02,089373,Quarfoot; David James,8,0,8,0
1653300410278,MATH 20B,A03,089374,Quarfoot; David James,7,0,8,1
1653300410278,MATH 20B,A04,089375,Quarfoot; David James,7,0,8,1
1653300410278,MATH 20B,A05,089376,Quarfoot; David James,0,0,0,0
1653300410278,MATH 20B,A06,089377,Quarfoot; David James,0,0,0,0
1653300410278,MATH 20B,A07,089378,Quarfoot; David James,0,0,0,0
1653300410278,MATH 20B,A08,089379,Quarfoot; David James,0,0,0,0
1653300410278,MATH 20B,A09,089380,Quarfoot; David James,0,0,0,0
1653300410278,MATH 20B,A10,089381,Quarfoot; David James,0,0,0,0
1653300410278,MATH 20B,A11,089382,Quarfoot; David James,0,0,0,0
1653300410278,MATH 20B,A12,089383,Quarfoot; David James,0,0,0,0
1653300410278,MATH 20B,A13,089384,Quarfoot; David James,0,0,0,0
1653300410278,MATH 20B,A14,089385,Quarfoot; David James,0,0,0,0
1653300410278,MATH 20B,A15,089386,Quarfoot; David James,0,0,0,0
1653300410278,MATH 20B,A16,089387,Quarfoot; David James,0,0,0,0
1653300410278,MATH 20B,A17,089388,Quarfoot; David James,8,0,8,0
1653300410278,MATH 20B,A18,089389,Quarfoot; David James,8,0,8,0
1653300410278,MATH 20B,A19,089390,Quarfoot; David James,8,0,8,0
1653300410278,MATH 20B,A20,089391,Quarfoot; David James,8,0,8,0
1653300410278,MATH 20B,A21,089392,Quarfoot; David James,8,0,8,0
1653300410278,MATH 20B,A22,089393,Quarfoot; David James,7,0,8,1
1653300410278,MATH 20B,A23,089394,Quarfoot; David James,7,0,8,1
1653300410278,MATH 20B,A24,089395,Quarfoot; David James,8,0,8,0
1653300410278,MATH 20B,B01,089397,Lahiri; Aranya,7,0,10,3
1653300410278,MATH 20B,B02,089398,Lahiri; Aranya,10,0,10,0
1653300410278,MATH 20B,B03,089399,Lahiri; Aranya,10,0,10,0
1653300410278,MATH 20B,B04,089400,Lahiri; Aranya,10,0,10,0
1653300410278,MATH 20B,B05,089401,Lahiri; Aranya,10,0,10,0
1653300410278,MATH 20B,C01,089403,Lahiri; Aranya,0,0,0,0
1653300410278,MATH 20B,C02,089404,Lahiri; Aranya,8,0,10,2
1653300410278,MATH 20B,C03,089405,Lahiri; Aranya,10,0,10,0
1653300410278,MATH 20B,C04,089406,Lahiri; Aranya,9,0,10,1
1653300410278,MATH 20B,C05,089407,Lahiri; Aranya,9,0,10,1
1653300410816,MATH 20C,A01,089409,Um; Ko Woon,10,0,10,0
1653300410816,MATH 20C,A02,089410,Um; Ko Woon,10,0,10,0
1653300410816,MATH 20C,A03,089411,Um; Ko Woon,9,0,10,1
1653300410816,MATH 20C,A04,089412,Um; Ko Woon,9,0,10,1
1653300410816,MATH 20C,A05,089413,Um; Ko Woon,10,0,10,0
1653300410816,MATH 20C,A06,089414,Um; Ko Woon,9,0,10,1
1653300410816,MATH 20C,A07,094270,Um; Ko Woon,10,0,10,0
1653300410816,MATH 20C,A08,094271,Um; Ko Woon,10,0,10,0
1653300410816,MATH 20C,A09,094272,Um; Ko Woon,7,0,10,3
1653300410816,MATH 20C,A10,094273,Um; Ko Woon,10,0,10,0
1653300410816,MATH 20C,A11,094274,Um; Ko Woon,10,0,10,0
1653300410816,MATH 20C,A12,094275,Um; Ko Woon,8,0,10,2
1653300410816,MATH 20C,A13,094276,Um; Ko Woon,10,0,10,0
1653300410816,MATH 20C,A14,094277,Um; Ko Woon,10,0,10,0
1653300410816,MATH 20C,A15,094278,Um; Ko Woon,10,0,10,0
1653300410816,MATH 20C,A16,094279,Um; Ko Woon,10,0,10,0
1653300410816,MATH 20C,B03,089418,Zhang; Ming,7,0,15,8
1653300410816,MATH 20C,B04,089419,Zhang; Ming,13,0,15,2
1653300410816,MATH 20C,B05,089420,Zhang; Ming,13,0,15,2
1653300410816,MATH 20C,C01,089423,Staff,15,0,15,0
1653300410816,MATH 20C,C02,089424,Staff,15,0,15,0
1653300410816,MATH 20C,C03,089425,Staff,15,0,15,0
1653300410816,MATH 20C,C04,089426,Staff,15,0,15,0
1653300410816,MATH 20C,C05,089427,Staff,15,0,15,0
1653300410816,MATH 20C,D04,089433,Zhang; Ming,13,0,15,2
1653300410816,MATH 20C,D05,089434,Zhang; Ming,15,0,15,0
1653300410816,MATH 20C,E01,089439,Staff,15,0,15,0
1653300410816,MATH 20C,E02,089440,Staff,15,0,15,0
1653300410816,MATH 20C,E03,089441,Staff,15,0,15,0
1653300410816,MATH 20C,E04,089442,Staff,15,0,15,0
1653300410816,MATH 20C,E05,089443,Staff,15,0,15,0
1653300410816,MATH 20C,E06,089444,Staff,15,0,15,0
1653300410816,MATH 20C,A17,094280,Um; Ko Woon,0,0,0,0
1653300410816,MATH 20C,A18,094281,Um; Ko Woon,0,0,0,0
1653300410816,MATH 20C,A19,094282,Um; Ko Woon,0,0,0,0
1653300410816,MATH 20C,A20,094283,Um; Ko Woon,0,0,0,0
1653300410816,MATH 20C,A21,094284,Um; Ko Woon,0,0,0,0
1653300410816,MATH 20C,A22,094285,Um; Ko Woon,0,0,0,0
1653300410816,MATH 20C,A23,094286,Um; Ko Woon,0,0,0,0
1653300410816,MATH 20C,A24,094287,Um; Ko Woon,0,0,0,0
1653300410816,MATH 20C,B01,089416,Zhang; Ming,0,0,0,0
1653300410816,MATH 20C,B02,089417,Zhang; Ming,0,0,0,0
1653300410816,MATH 20C,D01,089430,Zhang; Ming,0,0,0,0
1653300410816,MATH 20C,D02,089431,Zhang; Ming,0,0,0,0
1653300410816,MATH 20C,D03,089432,Zhang; Ming,0,0,0,0
1653300411341,MATH 20D,A01,089455,Lee; Kisun,11,0,25,14
1653300411341,MATH 20D,A02,089456,Lee; Kisun,24,0,25,1
1653300411341,MATH 20D,A03,089457,Lee; Kisun,24,0,25,1
1653300411341,MATH 20D,A04,089458,Lee; Kisun,25,0,25,0
1653300411341,MATH 20D,A05,089459,Lee; Kisun,25,0,25,0
1653300411341,MATH 20D,A06,089460,Lee; Kisun,25,0,25,0
1653300411341,MATH 20D,B01,089463,Lee; Kisun,20,0,25,5
1653300411341,MATH 20D,B02,089464,Lee; Kisun,25,0,25,0
1653300411341,MATH 20D,B03,089465,Lee; Kisun,24,0,25,1
1653300411341,MATH 20D,B04,089466,Lee; Kisun,25,0,25,0
1653300411341,MATH 20D,B05,089467,Lee; Kisun,23,0,25,2
1653300411341,MATH 20D,B06,089468,Lee; Kisun,24,0,25,1
1653300411341,MATH 20D,C01,089471,Staff,23,0,25,2
1653300411341,MATH 20D,C02,089472,Staff,25,0,25,0
1653300411341,MATH 20D,C03,089473,Staff,25,0,25,0
1653300411341,MATH 20D,C04,089474,Staff,25,0,25,0
1653300411341,MATH 20D,C05,089475,Staff,25,0,25,0
1653300411341,MATH 20D,C06,089476,Staff,25,0,25,0
1653300411874,MATH 20E,A01,089479,Eggers; John Dietrich,17,0,24,7
1653300411874,MATH 20E,A02,089480,Eggers; John Dietrich,24,0,25,1
1653300411874,MATH 20E,A03,089481,Eggers; John Dietrich,25,0,25,0
1653300411874,MATH 20E,A04,089482,Eggers; John Dietrich,25,0,25,0
1653300411874,MATH 20E,A05,089483,Eggers; John Dietrich,19,0,25,6
1653300411874,MATH 20E,A06,089484,Eggers; John Dietrich,25,0,25,0
1653300411874,MATH 20E,A07,089485,Eggers; John Dietrich,24,0,25,1
1653300411874,MATH 20E,A08,089486,Eggers; John Dietrich,24,0,25,1
1653300411874,MATH 20E,B01,089488,Staff,15,0,25,10
1653300411874,MATH 20E,B02,089489,Staff,21,0,25,4
1653300411874,MATH 20E,B03,089490,Staff,25,0,25,0
1653300411874,MATH 20E,B04,089491,Staff,25,0,25,0
1653300411874,MATH 20E,B05,089492,Staff,24,0,25,1
1653300411874,MATH 20E,B06,089493,Staff,24,0,25,1
1653300411874,MATH 20E,B07,089494,Staff,25,0,25,0
1653300411874,MATH 20E,B08,089495,Staff,25,0,25,0
1653300411874,MATH 20E,C01,089497,Staff,23,0,25,2
1653300411874,MATH 20E,C02,089498,Staff,25,0,25,0
1653300411874,MATH 20E,C03,089499,Staff,25,0,25,0
1653300411874,MATH 20E,C04,089500,Staff,25,0,25,0
1653300411874,MATH 20E,C05,089501,Staff,25,0,25,0
1653300411874,MATH 20E,C06,089502,Staff,25,0,25,0
1653300411874,MATH 20E,C07,089503,Staff,25,0,25,0
1653300411874,MATH 20E,C08,089504,Staff,25,0,25,0
1653300412402,MATH 31AH,A01,089506,Rabin; Jeffrey Mark,35,0,35,0
1653300412402,MATH 31AH,A02,089507,Rabin; Jeffrey Mark,35,0,35,0
1653300412939,MATH 87,A00,094827,Meyer; David A.,20,0,20,0
1653300413463,MATH 96,A00,094836,Kane; Daniel Mertz,11,0,30,19
1653300413989,MATH 100A,A01,089509,Kedlaya; Kiran S.,23,0,30,7
1653300413989,MATH 100A,A02,089510,Kedlaya; Kiran S.,28,0,30,2
1653300413989,MATH 100A,B01,089512,Greenfeld; Be'Eri,24,0,30,6
1653300413989,MATH 100A,B02,089513,Greenfeld; Be'Eri,30,0,30,0
1653300414524,MATH 102,A01,089515,Hodges; Reuven Moses,25,0,30,5
1653300414524,MATH 102,A02,089516,Hodges; Reuven Moses,30,0,30,0
1653300414524,MATH 102,A03,089517,Hodges; Reuven Moses,30,0,30,0
1653300414524,MATH 102,A04,089518,Hodges; Reuven Moses,29,0,30,1
1653300414524,MATH 102,B01,089520,Hodges; Reuven Moses,29,0,30,1
1653300414524,MATH 102,B02,089521,Hodges; Reuven Moses,29,0,30,1
1653300414524,MATH 102,B03,089522,Hodges; Reuven Moses,29,0,30,1
1653300414524,MATH 102,B04,089523,Hodges; Reuven Moses,30,0,30,0
1653300415047,MATH 103A,A01,089525,Staff,27,0,30,3
1653300415047,MATH 103A,A02,089526,Staff,30,0,30,0
1653300415047,MATH 103A,B01,089528,Seward; Brandon M.,9,0,30,21
1653300415047,MATH 103A,B02,089529,Seward; Brandon M.,22,0,30,8
1653300415047,MATH 103A,C01,089531,Staff,27,0,30,3
1653300415047,MATH 103A,C02,089532,Staff,28,0,30,2
1653300415047,MATH 103A,D01,089534,Staff,28,0,30,2
1653300415047,MATH 103A,D02,089535,Staff,28,0,30,2
1653300415582,MATH 109,A01,089537,Chung; Kwun,9,0,10,1
1653300415582,MATH 109,A02,089538,Chung; Kwun,10,0,10,0
1653300415582,MATH 109,B01,089540,Belmont; Eva Kinoshita,9,0,10,1
1653300415582,MATH 109,B02,089541,Belmont; Eva Kinoshita,6,0,10,4
1653300415582,MATH 109,C01,089543,Chow; Bennett,8,0,10,2
1653300415582,MATH 109,C02,089544,Chow; Bennett,10,0,10,0
1653300415582,MATH 109,D01,089546,Chung; Kwun,9,0,10,1
1653300415582,MATH 109,D02,089547,Chung; Kwun,9,0,10,1
1653300415582,MATH 109,E01,089549,Schweinsberg; Jason,6,0,10,4
1653300415582,MATH 109,E02,089550,Schweinsberg; Jason,10,0,10,0
1653300416106,MATH 110,A01,089552,Wenzl; Hans G,27,0,35,8
1653300416106,MATH 110,A02,089553,Wenzl; Hans G,33,0,35,2
1653300416633,MATH 111A,A01,089555,Meyer; David A.,0,0,0,1
1653300417159,MATH 120A,A01,089557,Manners; Frederick,30,0,35,5
1653300417159,MATH 120A,A02,089558,Manners; Frederick,33,0,35,2
1653300417686,MATH 140A,A01,089560,Seward; Brandon M.,25,0,30,5
1653300417686,MATH 140A,A02,089561,Seward; Brandon M.,29,0,30,1
1653300417686,MATH 140A,B01,089563,Chan; Pak Yeung,30,0,30,0
1653300417686,MATH 140A,B02,089564,Chan; Pak Yeung,22,0,30,8
1653300418217,MATH 142A,A01,089566,Staff,29,0,30,1
1653300418217,MATH 142A,A02,089567,Staff,29,0,30,1
1653300418217,MATH 142A,B01,089569,Staff,30,0,30,0
1653300418217,MATH 142A,B02,089570,Staff,29,0,30,1
1653300418217,MATH 142A,C01,089572,Staff,26,0,30,4
1653300418217,MATH 142A,C02,089573,Staff,29,0,30,1
1653300418217,MATH 142A,D01,089575,Eggers; John Dietrich,15,0,30,15
1653300418217,MATH 142A,D02,089576,Eggers; John Dietrich,27,0,30,3
1653300418745,MATH 144,A01,089578,Bejenaru; Ioan,29,0,30,1
1653300419270,MATH 150A,A01,089580,Chow; Bennett,29,0,35,6
1653300419270,MATH 150A,A02,089581,Chow; Bennett,34,0,35,1
1653300420321,MATH 153,A01,094204,Harel; Guershon,33,0,35,2
1653300420845,MATH 154,A01,089590,Verstraete; Jacques Allan,3,0,30,27
1653300420845,MATH 154,A02,089591,Verstraete; Jacques Allan,23,0,30,7
1653300420845,MATH 154,A03,089592,Verstraete; Jacques Allan,28,0,30,2
1653300420845,MATH 154,A04,089593,Verstraete; Jacques Allan,26,0,30,4
1653300421371,MATH 155A,A01,089595,Buss; Samuel R,22,0,35,13
1653300421371,MATH 155A,A02,089596,Buss; Samuel R,32,0,35,3
1653300421894,MATH 160A,A01,089598,Manners; Frederick,28,0,35,7
1653300421894,MATH 160A,A02,094207,Manners; Frederick,34,0,35,1
1653300422419,MATH 170A,A01,089600,Liu; Shuang,24,0,25,1
1653300422419,MATH 170A,A02,089601,Liu; Shuang,24,0,25,1
1653300422419,MATH 170A,A03,089602,Liu; Shuang,24,0,25,1
1653300422419,MATH 170A,A04,089603,Liu; Shuang,23,0,25,2
1653300422419,MATH 170A,B01,089605,Dumitriu; Ioana,8,0,25,17
1653300422419,MATH 170A,B02,089606,Dumitriu; Ioana,20,0,25,5
1653300422419,MATH 170A,B03,089607,Dumitriu; Ioana,21,0,25,4
1653300422419,MATH 170A,B04,089608,Dumitriu; Ioana,25,0,25,0
1653300422943,MATH 173A,A01,089610,Cloninger; Alexander,0,0,35,35
1653300422943,MATH 173A,A02,089611,Cloninger; Alexander,2,0,35,33
1653300422943,MATH 173A,A03,089612,Cloninger; Alexander,20,0,35,15
1653300423473,MATH 174,A01,089614,Cheng; Li-Tien,23,0,25,2
1653300423473,MATH 174,A02,089615,Cheng; Li-Tien,25,0,25,0
1653300423998,MATH 180A,A01,089617,Jekel; David Andrew,0,0,25,25
1653300423998,MATH 180A,A02,089618,Jekel; David Andrew,23,0,25,2
1653300423998,MATH 180A,A03,089619,Jekel; David Andrew,22,0,25,3
1653300423998,MATH 180A,A04,089620,Jekel; David Andrew,22,0,25,3
1653300423998,MATH 180A,A05,089621,Jekel; David Andrew,24,0,25,1
1653300423998,MATH 180A,A06,089622,Jekel; David Andrew,23,0,25,2
1653300423998,MATH 180A,B01,089624,Agarwal; Pooja,23,0,25,2
1653300423998,MATH 180A,B02,089625,Agarwal; Pooja,24,0,25,1
1653300423998,MATH 180A,B03,089626,Agarwal; Pooja,22,0,25,3
1653300423998,MATH 180A,B04,089627,Agarwal; Pooja,25,0,25,0
1653300423998,MATH 180A,B05,089628,Agarwal; Pooja,24,0,25,1
1653300423998,MATH 180A,B06,089629,Agarwal; Pooja,25,0,25,0
1653300423998,MATH 180A,C01,089631,Staff,22,0,25,3
1653300423998,MATH 180A,C02,089632,Staff,25,0,25,0
1653300423998,MATH 180A,C03,089633,Staff,25,0,25,0
1653300423998,MATH 180A,C04,089634,Staff,25,0,25,0
1653300424532,MATH 180C,A01,089636,Fitzsimmons; Patrick J,4,0,25,21
1653300424532,MATH 180C,A02,089637,Fitzsimmons; Patrick J,21,0,25,4
1653300425061,MATH 181B,A01,089639,Rava; Denise,31,0,35,4
1653300425061,MATH 181B,A02,089640,Rava; Denise,34,0,35,1
1653300425061,MATH 181B,A03,089641,Rava; Denise,31,0,35,4
1653300425061,MATH 181B,A04,089642,Rava; Denise,35,0,35,0
1653300425592,MATH 183,A01,089644,Staff,10,0,25,15
1653300425592,MATH 183,A02,089645,Staff,23,0,25,2
1653300425592,MATH 183,A03,089646,Staff,23,0,25,2
1653300425592,MATH 183,A04,089647,Staff,25,0,25,0
1653300425592,MATH 183,A05,089648,Staff,19,0,25,6
1653300425592,MATH 183,A06,089649,Staff,22,0,25,3
1653300425592,MATH 183,A07,089650,Staff,25,0,25,0
1653300425592,MATH 183,A08,089651,Staff,25,0,25,0
1653300426120,MATH 184,A01,089653,Kane; Daniel Mertz,24,0,30,6
1653300426120,MATH 184,A02,089654,Kane; Daniel Mertz,30,0,30,0
1653300426120,MATH 184,A03,089655,Kane; Daniel Mertz,30,0,30,0
1653300426120,MATH 184,A04,089656,Kane; Daniel Mertz,30,0,30,0
1653300426645,MATH 187A,A01,089658,Bucur; Alina Ioana,0,0,25,25
1653300426645,MATH 187A,A02,089659,Bucur; Alina Ioana,12,0,25,13
1653300426645,MATH 187A,A03,089660,Bucur; Alina Ioana,0,0,25,25
1653300426645,MATH 187A,A04,089661,Bucur; Alina Ioana,17,0,25,8
1653300427168,MATH 187B,A01,089663,Bucur; Alina Ioana,28,0,35,7
1653300427168,MATH 187B,A02,089664,Bucur; Alina Ioana,34,0,35,1
1653300427694,MATH 188,A01,094817,Sam; Steven V,33,0,35,2
1653300428217,MATH 190A,A01,089666,Sam; Steven V,21,0,35,14
1653300428745,MATH 196,A00,089667,Spolaor; Luca,33,0,45,12
1653300429269,MCWP 40,004,093486,Wastal; Carrie King,0,0,3,3
1653300429269,MCWP 40,005,093487,Wastal; Carrie King,0,0,3,3
1653300429269,MCWP 40,006,093488,Wastal; Carrie King,3,0,3,0
1653300429269,MCWP 40,007,093489,Wastal; Carrie King,3,0,3,0
1653300429269,MCWP 40,008,093490,Wastal; Carrie King,2,0,3,1
1653300429269,MCWP 40,009,093491,Wastal; Carrie King,2,0,3,1
1653300429269,MCWP 40,013,093495,Wastal; Carrie King,3,0,3,0
1653300429269,MCWP 40,014,093496,Wastal; Carrie King,0,0,3,3
1653300429269,MCWP 40,015,093497,Wastal; Carrie King,3,0,3,0
1653300429269,MCWP 40,016,093498,Wastal; Carrie King,3,0,3,0
1653300429269,MCWP 40,017,093499,Wastal; Carrie King,3,0,3,0
1653300429269,MCWP 40,018,093500,Wastal; Carrie King,1,0,3,2
1653300429269,MCWP 40,020,093502,Wastal; Carrie King,0,0,0,0
1653300429269,MCWP 40,021,093503,Wastal; Carrie King,3,0,3,0
1653300429269,MCWP 40,022,093504,Wastal; Carrie King,2,0,3,1
1653300429269,MCWP 40,023,093505,Wastal; Carrie King,2,0,3,1
1653300429269,MCWP 40,024,093506,Wastal; Carrie King,2,0,3,1
1653300429269,MCWP 40,026,093508,Wastal; Carrie King,3,0,3,0
1653300429269,MCWP 40,027,093509,Wastal; Carrie King,3,0,3,0
1653300429269,MCWP 40,028,093510,Wastal; Carrie King,3,0,3,0
1653300429269,MCWP 40,029,093511,Wastal; Carrie King,3,0,3,0
1653300429269,MCWP 40,030,093512,Wastal; Carrie King,2,0,3,1
1653300429269,MCWP 40,032,093514,Wastal; Carrie King,2,0,3,1
1653300429269,MCWP 40,033,093515,Wastal; Carrie King,3,0,3,0
1653300429269,MCWP 40,034,093516,Wastal; Carrie King,3,0,3,0
1653300429269,MCWP 40,035,093517,Wastal; Carrie King,3,0,3,0
1653300429269,MCWP 40,038,093520,Wastal; Carrie King,2,0,3,1
1653300429269,MCWP 40,039,093521,Wastal; Carrie King,3,0,3,0
1653300429269,MCWP 40,041,093523,Wastal; Carrie King,2,0,3,1
1653300429269,MCWP 40,042,093524,Wastal; Carrie King,3,0,3,0
1653300429269,MCWP 40,043,093525,Wastal; Carrie King,0,0,0,0
1653300429269,MCWP 40,049,093531,Wastal; Carrie King,2,0,3,1
1653300429269,MCWP 40,050,093532,Wastal; Carrie King,3,0,3,0
1653300429269,MCWP 40,051,093533,Wastal; Carrie King,3,0,3,0
1653300429811,MCWP 50,001,093534,Wastal; Carrie King,0,0,0,0
1653300429811,MCWP 50,002,093535,Wastal; Carrie King,0,0,3,3
1653300429811,MCWP 50,003,093536,Wastal; Carrie King,0,0,3,3
1653300429811,MCWP 50,004,093537,Wastal; Carrie King,0,0,3,3
1653300429811,MCWP 50,005,093538,Wastal; Carrie King,0,0,3,3
1653300429811,MCWP 50,006,093539,Wastal; Carrie King,2,0,3,1
1653300429811,MCWP 50,007,093540,Wastal; Carrie King,0,0,3,3
1653300429811,MCWP 50,008,093541,Wastal; Carrie King,0,0,3,3
1653300429811,MCWP 50,009,093542,Wastal; Carrie King,0,0,3,3
1653300429811,MCWP 50,010,093543,Wastal; Carrie King,0,0,3,3
1653300429811,MCWP 50,013,093546,Wastal; Carrie King,1,0,3,2
1653300429811,MCWP 50,014,093547,Wastal; Carrie King,0,0,3,3
1653300429811,MCWP 50,015,093548,Wastal; Carrie King,0,0,3,3
1653300429811,MCWP 50,016,093549,Wastal; Carrie King,0,0,0,0
1653300430338,MCWP 125,A00,093550,Wilson; Marion E.,3,0,3,0
1653300430338,MCWP 125,B00,093551,Guillen; Melinda,3,0,3,0
1653300430338,MCWP 125,C00,093552,Guillen; Melinda,3,0,3,0
1653300430338,MCWP 125,D00,093553,Guillen; Melinda,3,0,3,0
1653300430338,MCWP 125,E00,093554,Miller; Elizabeth Deen,3,0,3,0
1653300430338,MCWP 125,F00,093555,Miller; Elizabeth Deen,3,0,3,0
1653300430338,MCWP 125,G00,093556,Miller; Elizabeth Deen,3,0,3,0
1653300430862,MGT 3,A00,087704,Wagner; Timothy Ryan,90,0,90,0
1653300431386,MGT 4,A01,087706,Levkoff; Steven B.,2,0,3,1
1653300431386,MGT 4,A02,087707,Levkoff; Steven B.,3,0,3,0
1653300431386,MGT 4,A03,092659,Levkoff; Steven B.,1,0,4,3
1653300431908,MGT 5,A00,087708,Houskeeper; Robert,194,0,196,2
1653300432436,MGT 12,A00,087709,Pecore; Joseph P.,91,0,100,9
1653300432436,MGT 12,B00,087710,Lindenberger; Wade Douglas,91,0,100,9
1653300432963,MGT 16,A00,087711,Campbell; Robert Harold,108,0,110,2
1653300432963,MGT 16,B00,087712,Campbell; Robert Harold,110,0,110,0
1653300432963,MGT 16,C00,087713,Lindenberger; Wade Douglas,100,0,110,10
1653300432963,MGT 16,D00,087714,Lindenberger; Wade Douglas,107,0,110,3
1653300432963,MGT 16,E00,094819,Buchanan; Harold G,99,0,100,1
1653300433579,MGT 18,A00,087715,McKay; Michael J,88,0,90,2
1653300433579,MGT 18,B00,087716,McKay; Michael J,90,0,90,0
1653300433579,MGT 18,C00,087717,McKay; Michael J,88,0,90,2
1653300433579,MGT 18,D00,087718,McKay; Mary A,90,0,90,0
1653300433579,MGT 18,E00,087719,McKay; Mary A,87,0,90,3
1653300434120,MGT 45,A00,087720,Pecore; Joseph P.,136,0,150,14
1653300434120,MGT 45,B00,087721,Pecore; Joseph P.,140,0,150,10
1653300434653,MGT 52,A00,087722,Deal; Jennifer Jean,83,0,90,7
1653300435177,MGT 71,A00,087723,August; Terrence,60,0,90,30
1653300436233,MGT 103,A00,087726,Ehrich; Kristine R,86,0,90,4
1653300436233,MGT 103,B00,087727,Ehrich; Kristine R,89,0,90,1
1653300436233,MGT 103,C00,087728,Eberhard; Craig A,89,0,90,1
1653300436233,MGT 103,D00,087729,Eberhard; Craig A,88,0,90,2
1653300436233,MGT 103,E00,087730,Demill; Burritt,75,0,90,15
1653300436233,MGT 103,F00,087731,Bates; Kenneth Walter,81,0,90,9
1653300436233,MGT 103,G00,087732,Bates; Kenneth Walter,88,0,90,2
1653300436762,MGT 105,A00,087733,Campbell; Robert Harold,102,0,120,18
1653300437289,MGT 106,A00,087734,Eberhard; Craig A,81,0,90,9
1653300437812,MGT 108R,A00,087735,Amir; On,84,0,90,6
1653300438336,MGT 109,A00,087736,Staff,77,0,90,13
1653300438862,MGT 112,A00,087737,Somasundaram; Tyagarajan,89,0,90,1
1653300438862,MGT 112,B00,087738,Somasundaram; Tyagarajan,86,0,90,4
1653300438862,MGT 112,C00,087739,Ehrich; Kristine R,86,0,90,4
1653300438862,MGT 112,D00,087740,Zimmermann; Carsten,65,0,90,25
1653300439386,MGT 121A,A00,087741,Wang; Helen Shan,65,0,70,5
1653300439386,MGT 121A,B00,087742,Wang; Helen Shan,64,0,70,6
1653300439917,MGT 131A,A00,087743,Houskeeper; Robert,146,0,150,4
1653300440439,MGT 132,A00,087744,Blakley; Bruce,88,0,90,2
1653300440961,MGT 134,A00,087745,Houskeeper; Robert,84,0,90,6
1653300441488,MGT 135,A00,087746,Anderson; John Charles,83,0,90,7
1653300442011,MGT 139,A00,087747,Perols; Johan Lars,88,0,90,2
1653300442538,MGT 153,A00,087748,Perols; Johan Lars,82,0,90,8
1653300442538,MGT 153,B00,087749,Phiroz; Zal Navroze,76,0,90,14
1653300442538,MGT 153,C00,087750,Phiroz; Zal Navroze,87,0,90,3
1653300443065,MGT 162R,A00,087751,Gneezy; Uri,64,0,90,26
1653300443591,MGT 164,A00,087752,McKay; Mary A,90,0,90,0
1653300443591,MGT 164,B00,087753,Meyer; Alison Bloomfield,0,0,0,0
1653300443591,MGT 164,C00,087754,Smith; Pamela Karen,82,0,90,8
1653300444117,MGT 166,A00,087755,Moran; Cathleen L.,89,0,90,1
1653300444117,MGT 166,B00,087756,Moran; Cathleen L.,90,0,90,0
1653300444117,MGT 166,C00,087757,Moran; Cathleen L.,90,0,90,0
1653300444117,MGT 166,D00,087758,Demill; Burritt,56,0,90,34
1653300444640,MGT 167,A00,087759,Klaas; Jeffrey David,88,0,90,2
1653300444640,MGT 167,B00,087760,Jacob; Jo Dee C,83,0,90,7
1653300445166,MGT 171,A00,087761,Phiroz; Zal Navroze,85,0,90,5
1653300445697,MGT 172,A00,087762,Hedges; Kathleen & Royal; Rebecca,96,0,100,4
1653300445697,MGT 172,B00,087763,Hedges; Kathleen,79,0,90,11
1653300445697,MGT 172,C00,087764,Zimmermann; Carsten,90,0,90,0
1653300446230,MGT 172R,A00,094888,Erat; Sanjiv,90,0,90,0
1653300446754,MGT 173,A00,087765,Hayes; Sherry Lorine,80,0,100,20
1653300447287,MGT 175,A00,087766,Gopal; Christopher S.,84,0,90,6
1653300447812,MGT 181,A00,087767,Buchanan; Harold G,114,0,120,6
1653300447812,MGT 181,B00,087768,Buchanan; Harold G,110,0,120,10
1653300447812,MGT 181,C00,087769,Bliss; Barbara Ann,109,0,120,11
1653300448863,MGT 185,A00,087771,Dunn; Louis Jean,84,0,90,6
1653300449387,MGT 187,A00,087772,Dunn; Louis Jean,138,0,146,8
1653300449923,MMW 11,A01,086931,duBois; Page Ann,4,0,4,0
1653300449923,MMW 11,A02,086932,duBois; Page Ann,4,0,4,0
1653300449923,MMW 11,A03,086933,duBois; Page Ann,3,0,4,1
1653300449923,MMW 11,A04,086934,duBois; Page Ann,3,0,4,1
1653300449923,MMW 11,A05,086935,duBois; Page Ann,4,0,4,0
1653300449923,MMW 11,A06,086936,duBois; Page Ann,3,0,4,1
1653300449923,MMW 11,A07,086937,duBois; Page Ann,4,0,4,0
1653300449923,MMW 11,A08,086938,duBois; Page Ann,4,0,4,0
1653300449923,MMW 11,A09,086939,duBois; Page Ann,4,0,4,0
1653300449923,MMW 11,A10,086940,duBois; Page Ann,4,0,4,0
1653300449923,MMW 11,A11,086941,duBois; Page Ann,4,0,4,0
1653300449923,MMW 11,A12,093877,duBois; Page Ann,3,0,4,1
1653300450452,MMW 11R,A01,093852,Herbst; Matthew,4,0,4,0
1653300450452,MMW 11R,A02,093853,Herbst; Matthew,4,0,4,0
1653300450452,MMW 11R,A03,093854,Herbst; Matthew,4,0,4,0
1653300450452,MMW 11R,A04,093855,Herbst; Matthew,4,0,4,0
1653300450452,MMW 11R,A05,093856,Herbst; Matthew,4,0,4,0
1653300450452,MMW 11R,A06,093857,Herbst; Matthew,4,0,4,0
1653300450452,MMW 11R,A07,093858,Herbst; Matthew,4,0,4,0
1653300450452,MMW 11R,A08,093859,Herbst; Matthew,4,0,4,0
1653300450452,MMW 11R,A09,093860,Herbst; Matthew,4,0,4,0
1653300450452,MMW 11R,A10,093861,Herbst; Matthew,4,0,4,0
1653300450452,MMW 11R,A11,093862,Herbst; Matthew,4,0,4,0
1653300450452,MMW 11R,A12,093863,Herbst; Matthew,4,0,4,0
1653300450452,MMW 11R,B01,093865,Herbst; Matthew,4,0,4,0
1653300450452,MMW 11R,B02,093866,Herbst; Matthew,4,0,4,0
1653300450452,MMW 11R,B03,093867,Herbst; Matthew,4,0,4,0
1653300450452,MMW 11R,B04,093868,Herbst; Matthew,4,0,4,0
1653300450452,MMW 11R,B05,093869,Herbst; Matthew,4,0,4,0
1653300450452,MMW 11R,B06,093870,Herbst; Matthew,4,0,4,0
1653300450452,MMW 11R,B07,093871,Herbst; Matthew,4,0,4,0
1653300450452,MMW 11R,B08,093872,Herbst; Matthew,4,0,4,0
1653300450452,MMW 11R,B09,093873,Herbst; Matthew,4,0,4,0
1653300450452,MMW 11R,B10,093874,Herbst; Matthew,4,0,4,0
1653300450452,MMW 11R,B11,093875,Herbst; Matthew,4,0,4,0
1653300450452,MMW 11R,B12,093876,Herbst; Matthew,4,0,4,0
1653300450983,MMW 14,A01,086968,Chang; Edmond Yi-Teh,28,0,28,0
1653300450983,MMW 14,A02,086969,Chang; Edmond Yi-Teh,27,0,28,1
1653300450983,MMW 14,A03,086970,Chang; Edmond Yi-Teh,21,0,28,7
1653300450983,MMW 14,A04,086971,Chang; Edmond Yi-Teh,27,0,28,1
1653300450983,MMW 14,A05,086972,Chang; Edmond Yi-Teh,26,0,28,2
1653300450983,MMW 14,A06,086973,Chang; Edmond Yi-Teh,28,0,28,0
1653300450983,MMW 14,A07,086974,Chang; Edmond Yi-Teh,27,0,28,1
1653300450983,MMW 14,A08,086975,Chang; Edmond Yi-Teh,25,0,28,3
1653300450983,MMW 14,A09,086976,Chang; Edmond Yi-Teh,0,0,0,0
1653300450983,MMW 14,A10,086977,Chang; Edmond Yi-Teh,27,0,28,1
1653300450983,MMW 14,A11,086978,Chang; Edmond Yi-Teh,26,0,28,2
1653300450983,MMW 14,A12,086979,Chang; Edmond Yi-Teh,27,0,28,1
1653300450983,MMW 14,A13,086980,Chang; Edmond Yi-Teh,28,0,28,0
1653300451507,MMW 121,A01,086982,Chang; Edmond Yi-Teh,0,0,0,0
1653300451507,MMW 121,A02,086983,Chang; Edmond Yi-Teh,0,0,0,0
1653300451507,MMW 121,A03,086984,Chang; Edmond Yi-Teh,2,0,4,2
1653300451507,MMW 121,A04,086985,Chang; Edmond Yi-Teh,4,0,4,0
1653300451507,MMW 121,A05,086986,Chang; Edmond Yi-Teh,4,0,4,0
1653300451507,MMW 121,A06,086987,Chang; Edmond Yi-Teh,4,0,4,0
1653300451507,MMW 121,A07,086988,Chang; Edmond Yi-Teh,4,0,4,0
1653300451507,MMW 121,A08,086989,Chang; Edmond Yi-Teh,4,0,4,0
1653300451507,MMW 121,B01,086991,Patterson; Patrick H.,4,0,4,0
1653300451507,MMW 121,B02,086992,Patterson; Patrick H.,4,0,4,0
1653300451507,MMW 121,B03,086993,Patterson; Patrick H.,4,0,4,0
1653300451507,MMW 121,B04,086994,Patterson; Patrick H.,3,0,4,1
1653300451507,MMW 121,B05,086995,Patterson; Patrick H.,4,0,4,0
1653300451507,MMW 121,B06,086996,Patterson; Patrick H.,4,0,4,0
1653300451507,MMW 121,B07,086997,Patterson; Patrick H.,4,0,4,0
1653300451507,MMW 121,B08,086998,Patterson; Patrick H.,4,0,4,0
1653300451507,MMW 121,B09,086999,Patterson; Patrick H.,4,0,4,0
1653300451507,MMW 121,B10,087000,Patterson; Patrick H.,4,0,4,0
1653300451507,MMW 121,B11,087001,Patterson; Patrick H.,0,0,0,0
1653300451507,MMW 121,B12,087002,Patterson; Patrick H.,0,0,0,0
1653300452034,MUS 1A,A01,090497,Staff,19,0,20,1
1653300452034,MUS 1A,A02,090498,Staff,13,0,20,7
1653300452034,MUS 1A,A03,090499,Staff,18,0,20,2
1653300452034,MUS 1A,A04,090500,Staff,19,0,20,1
1653300452034,MUS 1A,A05,090501,Staff,20,0,20,0
1653300452034,MUS 1A,A06,090502,Staff,20,0,20,0
1653300452034,MUS 1A,B01,090504,Staff,18,0,20,2
1653300452034,MUS 1A,B02,090505,Staff,20,0,20,0
1653300452034,MUS 1A,B03,090506,Staff,18,0,20,2
1653300452034,MUS 1A,B04,090507,Staff,18,0,20,2
1653300452034,MUS 1A,B05,090508,Staff,16,0,20,4
1653300452034,MUS 1A,B06,090509,Staff,20,0,20,0
1653300452565,MUS 2A,A01,090511,Carlson; Erik Norman,19,0,20,1
1653300453095,MUS 2AK,A00,090512,Ohnishi; Takae,24,0,25,1
1653300453095,MUS 2AK,B00,090513,Ohnishi; Takae,15,0,15,0
1653300453618,MUS 4,A01,090515,Staff,24,0,25,1
1653300453618,MUS 4,A02,090516,Staff,24,0,25,1
1653300453618,MUS 4,A03,090517,Staff,22,0,25,3
1653300453618,MUS 4,A04,090518,Staff,24,0,25,1
1653300453618,MUS 4,A05,090519,Staff,25,0,25,0
1653300453618,MUS 4,A06,090520,Staff,25,0,25,0
1653300453618,MUS 4,A07,090521,Staff,24,0,25,1
1653300453618,MUS 4,A08,090522,Staff,24,0,25,1
1653300454145,MUS 5,A01,090524,Staff,20,0,20,0
1653300454145,MUS 5,A02,090525,Staff,18,0,20,2
1653300454145,MUS 5,A03,090526,Staff,20,0,20,0
1653300454145,MUS 5,A04,090527,Staff,20,0,20,0
1653300454145,MUS 5,A05,090528,Staff,19,0,20,1
1653300454673,MUS 6,A01,090530,Staff,22,0,25,3
1653300454673,MUS 6,A02,090531,Staff,25,0,25,0
1653300454673,MUS 6,A03,090532,Staff,25,0,25,0
1653300454673,MUS 6,A04,090533,Staff,23,0,25,2
1653300455196,MUS 8,A01,090535,Kenyatta; Kamau,17,0,25,8
1653300455196,MUS 8,A02,090536,Kenyatta; Kamau,19,0,25,6
1653300455196,MUS 8,A03,090537,Kenyatta; Kamau,17,0,25,8
1653300455196,MUS 8,A04,090538,Kenyatta; Kamau,21,0,25,4
1653300455721,MUS 12,A01,090540,Narucki; Susan M,20,0,20,0
1653300455721,MUS 12,A02,090541,Narucki; Susan M,20,0,20,0
1653300455721,MUS 12,A03,090542,Narucki; Susan M,17,0,20,3
1653300456243,MUS 15,A01,090544,Staff,21,0,25,4
1653300456243,MUS 15,A02,090545,Staff,23,0,25,2
1653300456243,MUS 15,A03,090546,Staff,24,0,25,1
1653300456243,MUS 15,A04,090547,Staff,22,0,25,3
1653300456243,MUS 15,A05,090548,Staff,25,0,25,0
1653300456243,MUS 15,A06,090549,Staff,24,0,25,1
1653300456770,MUS 19R,A01,090551,Britt; King James,17,0,20,3
1653300456770,MUS 19R,A02,090552,Britt; King James,19,0,20,1
1653300456770,MUS 19R,A03,090553,Britt; King James,20,0,20,0
1653300456770,MUS 19R,A04,090554,Britt; King James,19,0,20,1
1653300456770,MUS 19R,A05,090555,Britt; King James,20,0,20,0
1653300456770,MUS 19R,A06,090556,Britt; King James,18,0,20,2
1653300456770,MUS 19R,A07,090557,Britt; King James,19,0,20,1
1653300456770,MUS 19R,A08,090558,Britt; King James,19,0,20,1
1653300456770,MUS 19R,A09,090559,Britt; King James,20,0,20,0
1653300456770,MUS 19R,A10,090560,Britt; King James,20,0,20,0
1653300456770,MUS 19R,B01,090562,Britt; King James,10,0,10,0
1653300456770,MUS 19R,B02,090563,Britt; King James,10,0,10,0
1653300456770,MUS 19R,B03,090564,Britt; King James,10,0,10,0
1653300456770,MUS 19R,B04,090565,Britt; King James,10,0,10,0
1653300456770,MUS 19R,B05,090566,Britt; King James,10,0,10,0
1653300456770,MUS 19R,B06,090567,Britt; King James,10,0,10,0
1653300456770,MUS 19R,B07,090568,Britt; King James,10,0,10,0
1653300456770,MUS 19R,B08,090569,Britt; King James,10,0,10,0
1653300456770,MUS 19R,B09,090570,Britt; King James,10,0,10,0
1653300456770,MUS 19R,B10,090571,Britt; King James,10,0,10,0
1653300457293,MUS 20,A01,090573,Borgo; David Garcia,12,0,15,3
1653300457293,MUS 20,A02,090574,Borgo; David Garcia,14,0,15,1
1653300457293,MUS 20,A03,090575,Borgo; David Garcia,13,0,15,2
1653300457819,MUS 32,001,094074,Staff,10,0,10,0
1653300457819,MUS 32,002,094075,Kenyatta; Kamau,10,0,10,0
1653300457819,MUS 32,003,094076,Curtis; Charles Rector,10,0,10,0
1653300457819,MUS 32,005,094078,Terrazas Perez; Wilfrido D,10,0,10,0
1653300457819,MUS 32,006,094079,Ohnishi; Takae,10,0,10,0
1653300457819,MUS 32,007,094080,Burr; Anthony I,10,0,10,0
1653300457819,MUS 32,008,094081,Carlson; Erik Norman,10,0,10,0
1653300457819,MUS 32,009,094082,Dresser; Mark Stuart,10,0,10,0
1653300457819,MUS 32,011,094084,Richards; Stephanie F,10,0,10,0
1653300457819,MUS 32,012,094085,Borgo; David Garcia,10,0,10,0
1653300457819,MUS 32,013,094086,Paganos Koukakis; Dimitrios,10,0,10,0
1653300457819,MUS 32,014,094087,Jones; Michael David,10,0,10,0
1653300458342,MUS 32V,A00,094355,Zazueta Cervera; Miguel Angel,10,0,10,0
1653300458342,MUS 32V,B00,094089,Flores; Mariana,10,0,10,0
1653300458866,MUS 32VM,A00,094090,Zazueta Cervera; Miguel Angel,15,0,15,0
1653300459388,MUS 33A,A00,090576,Liang; Lei,24,0,25,1
1653300459913,MUS 43,A00,090577,Burr; Anthony I,92,0,100,8
1653300460436,MUS 95C,B00,094829,Staff,28,0,30,2
1653300460962,MUS 95D,A00,090579,Staff,30,0,30,0
1653300461490,MUS 95E,A00,090580,Staff,30,0,30,0
1653300462017,MUS 95G,A00,090581,Anderson; Kenneth,384,0,395,11
1653300462017,MUS 95G,B00,090582,Anderson; Kenneth,393,0,395,2
1653300462541,MUS 95JC,A00,090583,Kenyatta; Kamau,35,0,35,0
1653300463065,MUS 95L,A00,090584,Staff,30,0,30,0
1653300463588,MUS 95W,A00,090585,Seshadri; Kartik,60,0,60,0
1653300463588,MUS 95W,B00,090586,Seshadri; Kartik,30,0,30,0
1653300464115,MUS 101A,A01,090588,Staff,29,0,30,1
1653300464639,MUS 103A,A00,090589,Ung; Chinary,15,0,15,0
1653300465168,MUS 107,A00,090590,Terrazas Perez; Wilfrido D,30,0,30,0
1653300465690,MUS 111,A00,090591,Yadegari; Shahrokh D,124,0,130,6
1653300466212,MUS 114,A00,090592,Curtis; Charles Rector,117,0,125,8
1653300466739,MUS 120A,A01,090594,Cimini; Amy Marie,29,0,30,1
1653300467270,MUS 126R,A00,090595,Borgo; David Garcia,106,0,115,9
1653300467804,MUS 130,A00,090596,Ohnishi; Takae,30,0,30,0
1653300468329,MUS 132,001,094091,Nourai; Keyarash,10,0,10,0
1653300468329,MUS 132,002,094093,Kenyatta; Kamau,10,0,10,0
1653300468329,MUS 132,003,094094,Curtis; Charles Rector,10,0,10,0
1653300468329,MUS 132,005,094096,Terrazas Perez; Wilfrido D,10,0,10,0
1653300468329,MUS 132,006,094097,Ohnishi; Takae,10,0,10,0
1653300468329,MUS 132,007,094098,Burr; Anthony I,10,0,10,0
1653300468329,MUS 132,008,094099,Carlson; Erik Norman,10,0,10,0
1653300468329,MUS 132,009,094100,Dresser; Mark Stuart,10,0,10,0
1653300468329,MUS 132,011,094102,Richards; Stephanie F,10,0,10,0
1653300468329,MUS 132,012,094103,Borgo; David Garcia,10,0,10,0
1653300468329,MUS 132,013,094104,Jones; Michael David,10,0,10,0
1653300468329,MUS 132,014,094105,Staff,10,0,10,0
1653300468857,MUS 132V,A00,094106,Narucki; Susan M,15,0,15,0
1653300469383,MUS 134,A00,090597,Staff,30,0,30,0
1653300469911,MUS 137A,A00,090598,Kenyatta; Kamau,30,0,30,0
1653300470446,MUS 143,A00,090599,Staff,26,0,30,4
1653300471493,MUS 173,A00,090600,Britt; King James,19,0,30,11
1653300472024,MUS 174A,A00,090601,Staff,8,0,15,7
1653300473077,NANO 4,A01,088199,Vazquez Mena; Oscar,20,0,20,0
1653300473077,NANO 4,B01,088201,Vazquez Mena; Oscar,20,0,20,0
1653300473077,NANO 4,C01,088203,Vazquez Mena; Oscar,20,0,20,0
1653300473607,NANO 15,A01,088205,Lubarda; Vlado,50,0,50,0
1653300473607,NANO 15,B01,088207,Lubarda; Vlado,50,0,50,0
1653300474130,NANO 20L,A00,088208,Sirbuly; Donald,27,0,30,3
1653300474130,NANO 20L,B00,088209,Sirbuly; Donald,29,0,30,1
1653300474657,NANO 100L,A00,088210,Vecchio; Kenneth S,24,0,30,6
1653300475182,NANO 102,A00,088211,Tao; Andrea Rae,94,0,100,6
1653300475707,NANO 110,A00,088212,Pascal; Tod A,99,0,100,1
1653300476232,NANO 111,A00,088213,Fenning; David,45,0,50,5
1653300476770,NANO 117,A00,088214,Cubukcu; Ertugrul,71,0,75,4
1653300477296,NANO 119,A00,088215,Vazquez Mena; Oscar,50,0,50,0
1653300477827,NANO 159,A00,088216,Wang; Joseph,33,0,40,7
1653300478352,NANO 181,A01,088218,Ong; Shyue Ping,22,0,25,3
1653300478875,PHIL 1,A00,090815,Sher; Gila,57,0,60,3
1653300479398,PHIL 10,A01,090817,Grush; Rick Scott,37,0,40,3
1653300479398,PHIL 10,A02,090818,Grush; Rick Scott,37,0,40,3
1653300479398,PHIL 10,A03,090819,Grush; Rick Scott,38,0,40,2
1653300479398,PHIL 10,A04,090820,Grush; Rick Scott,40,0,40,0
1653300479398,PHIL 10,A05,090821,Grush; Rick Scott,38,0,40,2
1653300479398,PHIL 10,A06,090822,Grush; Rick Scott,39,0,40,1
1653300479923,PHIL 12,A01,090824,Bechtel; William,20,0,25,5
1653300479923,PHIL 12,A02,090825,Bechtel; William,24,0,25,1
1653300479923,PHIL 12,A03,090826,Bechtel; William,25,0,25,0
1653300479923,PHIL 12,A04,090827,Bechtel; William,25,0,25,0
1653300480446,PHIL 13,A01,090829,Wonderly; Monique L.,25,0,25,0
1653300480446,PHIL 13,A02,090830,Wonderly; Monique L.,24,0,25,1
1653300480446,PHIL 13,A03,090831,Wonderly; Monique L.,24,0,25,1
1653300480446,PHIL 13,A04,090832,Wonderly; Monique L.,25,0,25,0
1653300480972,PHIL 27,A01,090834,Harrell; Maralee Mae,23,0,35,12
1653300480972,PHIL 27,A02,090835,Harrell; Maralee Mae,35,0,35,0
1653300480972,PHIL 27,A03,090836,Harrell; Maralee Mae,33,0,35,2
1653300480972,PHIL 27,A04,090837,Harrell; Maralee Mae,33,0,35,2
1653300480972,PHIL 27,A05,090838,Harrell; Maralee Mae,35,0,35,0
1653300480972,PHIL 27,A06,090839,Harrell; Maralee Mae,35,0,35,0
1653300481496,PHIL 28,A01,090841,Bazargan-Forward; Saba,31,0,35,4
1653300481496,PHIL 28,A02,090842,Bazargan-Forward; Saba,31,0,35,4
1653300481496,PHIL 28,A03,090843,Bazargan-Forward; Saba,35,0,35,0
1653300481496,PHIL 28,A04,090844,Bazargan-Forward; Saba,30,0,35,5
1653300481496,PHIL 28,A05,090845,Bazargan-Forward; Saba,33,0,35,2
1653300481496,PHIL 28,A06,090846,Bazargan-Forward; Saba,34,0,35,1
1653300481496,PHIL 28,A07,090847,Bazargan-Forward; Saba,32,0,35,3
1653300481496,PHIL 28,A08,090848,Bazargan-Forward; Saba,33,0,35,2
1653300482023,PHIL 31,A00,090849,Johnson; Monte,59,0,60,1
1653300482549,PHIL 100,A00,090852,Nelkin; Dana Kay,28,0,35,7
1653300483075,PHIL 110,A00,090853,Johnson; Monte,29,0,30,1
1653300483602,PHIL 120,A00,090854,Rickless; Samuel Charles,23,0,35,12
1653300484127,PHIL 123,A00,090855,Sher; Gila,38,0,40,2
1653300484649,PHIL 131,A00,090856,Cohen; Jonathan David,34,0,35,1
1653300485173,PHIL 132,A00,090857,Carr; Jennifer Rose,33,0,35,2
1653300485695,PHIL 138,A00,090858,Brink; David O.,34,0,40,6
1653300486221,PHIL 147,A00,090860,Fulkerson; Matthew Todd,33,0,35,2
1653300486821,PHIL 150,A00,090861,Bechtel; William,36,0,40,4
1653300487348,PHIL 155,A00,090862,Vargas; Manuel Rogelio,38,0,40,2
1653300487872,PHIL 165,A00,090863,Rickless; Samuel Charles,59,0,70,11
1653300488395,PHIL 172,A00,090864,Bazargan-Forward; Saba,37,0,40,3
1653300488918,PHIL 173,A00,090865,Wonderly; Monique L.,33,0,40,7
1653300489440,PHYS 1A,A00,088555,Koslover; Elena F,354,0,362,8
1653300489440,PHYS 1A,B00,088556,Koslover; Elena F,343,0,362,19
1653300489440,PHYS 1A,C00,088557,Shpyrko; Oleg,326,0,362,36
1653300489965,PHYS 1AL,001,088558,Tsai; Philbert S,30,0,30,0
1653300489965,PHYS 1AL,002,088559,Tsai; Philbert S,30,0,30,0
1653300489965,PHYS 1AL,003,088560,Tsai; Philbert S,23,0,30,7
1653300489965,PHYS 1AL,004,088561,Tsai; Philbert S,26,0,30,4
1653300489965,PHYS 1AL,005,088562,Tsai; Philbert S,24,0,30,6
1653300489965,PHYS 1AL,006,088563,Tsai; Philbert S,30,0,30,0
1653300489965,PHYS 1AL,007,088564,Tsai; Philbert S,26,0,30,4
1653300489965,PHYS 1AL,008,088565,Tsai; Philbert S,29,0,30,1
1653300489965,PHYS 1AL,009,088566,Tsai; Philbert S,28,0,30,2
1653300489965,PHYS 1AL,010,088567,Tsai; Philbert S,30,0,30,0
1653300489965,PHYS 1AL,011,088568,Tsai; Philbert S,29,0,30,1
1653300489965,PHYS 1AL,012,088569,Tsai; Philbert S,29,0,30,1
1653300489965,PHYS 1AL,013,088570,Tsai; Philbert S,30,0,30,0
1653300489965,PHYS 1AL,014,088571,Tsai; Philbert S,29,0,30,1
1653300489965,PHYS 1AL,015,088572,Tsai; Philbert S,23,0,30,7
1653300489965,PHYS 1AL,016,088573,Tsai; Philbert S,28,0,30,2
1653300489965,PHYS 1AL,017,088574,Tsai; Philbert S,29,0,30,1
1653300489965,PHYS 1AL,018,088575,Tsai; Philbert S,28,0,30,2
1653300489965,PHYS 1AL,019,088576,Tsai; Philbert S,26,0,30,4
1653300489965,PHYS 1AL,020,088577,Tsai; Philbert S,29,0,30,1
1653300489965,PHYS 1AL,021,088578,Tsai; Philbert S,30,0,30,0
1653300489965,PHYS 1AL,022,088579,Tsai; Philbert S,30,0,30,0
1653300489965,PHYS 1AL,023,088580,Tsai; Philbert S,30,0,30,0
1653300489965,PHYS 1AL,024,088581,Tsai; Philbert S,30,0,30,0
1653300489965,PHYS 1AL,025,088582,Tsai; Philbert S,26,0,30,4
1653300489965,PHYS 1AL,026,088583,Tsai; Philbert S,29,0,30,1
1653300489965,PHYS 1AL,027,088584,Tsai; Philbert S,28,0,30,2
1653300489965,PHYS 1AL,028,088585,Tsai; Philbert S,30,0,30,0
1653300489965,PHYS 1AL,029,088586,Tsai; Philbert S,27,0,30,3
1653300489965,PHYS 1AL,030,088587,Tsai; Philbert S,29,0,30,1
1653300489965,PHYS 1AL,031,088588,Tsai; Philbert S,30,0,30,0
1653300489965,PHYS 1AL,032,088589,Tsai; Philbert S,30,0,30,0
1653300489965,PHYS 1AL,033,088590,Tsai; Philbert S,30,0,30,0
1653300489965,PHYS 1AL,034,088591,Tsai; Philbert S,30,0,30,0
1653300489965,PHYS 1AL,035,088592,Tsai; Philbert S,29,0,30,1
1653300489965,PHYS 1AL,036,088593,Tsai; Philbert S,30,0,30,0
1653300490488,PHYS 1B,A00,088594,Groisman; Alexander,351,0,360,9
1653300491015,PHYS 1BL,001,088595,Tsai; Philbert S,30,0,30,0
1653300491015,PHYS 1BL,002,088596,Tsai; Philbert S,25,0,30,5
1653300491015,PHYS 1BL,003,088597,Tsai; Philbert S,27,0,30,3
1653300491015,PHYS 1BL,004,088598,Tsai; Philbert S,30,0,30,0
1653300491015,PHYS 1BL,005,088599,Tsai; Philbert S,29,0,30,1
1653300491015,PHYS 1BL,006,088600,Tsai; Philbert S,25,0,30,5
1653300491015,PHYS 1BL,007,088601,Tsai; Philbert S,30,0,30,0
1653300491015,PHYS 1BL,008,088602,Tsai; Philbert S,29,0,30,1
1653300491015,PHYS 1BL,009,088603,Tsai; Philbert S,30,0,30,0
1653300491015,PHYS 1BL,010,088604,Tsai; Philbert S,30,0,30,0
1653300491015,PHYS 1BL,011,088605,Tsai; Philbert S,28,0,30,2
1653300491015,PHYS 1BL,012,088606,Tsai; Philbert S,26,0,30,4
1653300491541,PHYS 1C,A00,088607,Tsai; Philbert S,334,0,360,26
1653300492068,PHYS 1CL,001,088608,Tsai; Philbert S,30,0,30,0
1653300492068,PHYS 1CL,002,088609,Tsai; Philbert S,24,0,30,6
1653300492068,PHYS 1CL,003,088610,Tsai; Philbert S,24,0,30,6
1653300492068,PHYS 1CL,004,088611,Tsai; Philbert S,29,0,30,1
1653300492068,PHYS 1CL,005,088612,Tsai; Philbert S,17,0,30,13
1653300492068,PHYS 1CL,006,088613,Tsai; Philbert S,19,0,30,11
1653300492068,PHYS 1CL,007,088614,Tsai; Philbert S,30,0,30,0
1653300492068,PHYS 1CL,008,088615,Tsai; Philbert S,26,0,30,4
1653300492068,PHYS 1CL,009,088616,Tsai; Philbert S,27,0,30,3
1653300492068,PHYS 1CL,010,088617,Tsai; Philbert S,29,0,30,1
1653300492068,PHYS 1CL,011,088618,Tsai; Philbert S,27,0,30,3
1653300492068,PHYS 1CL,012,088619,Tsai; Philbert S,24,0,30,6
1653300492598,PHYS 2A,A01,092602,Meyertholen; Andrew D.,26,0,30,4
1653300492598,PHYS 2A,A02,092603,Meyertholen; Andrew D.,28,0,30,2
1653300492598,PHYS 2A,A03,092604,Meyertholen; Andrew D.,29,0,30,1
1653300492598,PHYS 2A,A04,092605,Meyertholen; Andrew D.,30,0,30,0
1653300492598,PHYS 2A,A05,092606,Meyertholen; Andrew D.,29,0,30,1
1653300492598,PHYS 2A,A06,092607,Meyertholen; Andrew D.,29,0,30,1
1653300492598,PHYS 2A,A07,092608,Meyertholen; Andrew D.,30,0,30,0
1653300492598,PHYS 2A,A08,092609,Meyertholen; Andrew D.,30,0,30,0
1653300492598,PHYS 2A,A09,092610,Meyertholen; Andrew D.,27,0,30,3
1653300492598,PHYS 2A,A10,092611,Meyertholen; Andrew D.,30,0,30,0
1653300492598,PHYS 2A,A11,092612,Meyertholen; Andrew D.,30,0,30,0
1653300492598,PHYS 2A,A12,094499,Meyertholen; Andrew D.,27,0,30,3
1653300493123,PHYS 2B,A01,092613,Branson; James G,28,0,30,2
1653300493123,PHYS 2B,A02,092614,Branson; James G,29,0,30,1
1653300493123,PHYS 2B,A03,092615,Branson; James G,30,0,30,0
1653300493123,PHYS 2B,A04,092616,Branson; James G,30,0,30,0
1653300493123,PHYS 2B,A05,092617,Branson; James G,29,0,30,1
1653300493123,PHYS 2B,A06,092618,Branson; James G,29,0,30,1
1653300493123,PHYS 2B,A07,092619,Branson; James G,29,0,30,1
1653300493123,PHYS 2B,A08,092620,Branson; James G,0,0,0,0
1653300493123,PHYS 2B,A09,092621,Branson; James G,0,0,0,0
1653300493123,PHYS 2B,A10,092622,Branson; James G,0,0,0,0
1653300493123,PHYS 2B,A11,092623,Branson; James G,0,0,0,0
1653300493123,PHYS 2B,A12,092624,Branson; James G,30,0,30,0
1653300493647,PHYS 2C,A01,092625,Barreiro Guerrero; Julio,27,0,30,3
1653300493647,PHYS 2C,A02,092626,Barreiro Guerrero; Julio,28,0,30,2
1653300493647,PHYS 2C,A03,092627,Barreiro Guerrero; Julio,29,0,30,1
1653300493647,PHYS 2C,A04,092628,Barreiro Guerrero; Julio,29,0,30,1
1653300493647,PHYS 2C,A05,092629,Barreiro Guerrero; Julio,30,0,30,0
1653300493647,PHYS 2C,A06,092630,Barreiro Guerrero; Julio,30,0,30,0
1653300493647,PHYS 2C,A07,092631,Barreiro Guerrero; Julio,30,0,30,0
1653300493647,PHYS 2C,A08,092632,Barreiro Guerrero; Julio,30,0,30,0
1653300493647,PHYS 2C,A09,092633,Barreiro Guerrero; Julio,29,0,30,1
1653300493647,PHYS 2C,A10,092634,Barreiro Guerrero; Julio,29,0,30,1
1653300493647,PHYS 2C,A11,092635,Barreiro Guerrero; Julio,27,0,30,3
1653300493647,PHYS 2C,A12,092636,Barreiro Guerrero; Julio,29,0,30,1
1653300493647,PHYS 2C,B01,092637,Barreiro Guerrero; Julio,29,0,30,1
1653300493647,PHYS 2C,B02,092638,Barreiro Guerrero; Julio,30,0,30,0
1653300493647,PHYS 2C,B03,092639,Barreiro Guerrero; Julio,28,0,30,2
1653300493647,PHYS 2C,B04,092640,Barreiro Guerrero; Julio,29,0,30,1
1653300493647,PHYS 2C,B05,092641,Barreiro Guerrero; Julio,26,0,30,4
1653300493647,PHYS 2C,B06,092642,Barreiro Guerrero; Julio,28,0,30,2
1653300493647,PHYS 2C,B07,092643,Barreiro Guerrero; Julio,29,0,30,1
1653300493647,PHYS 2C,B08,092644,Barreiro Guerrero; Julio,30,0,30,0
1653300493647,PHYS 2C,B09,092645,Barreiro Guerrero; Julio,29,0,30,1
1653300493647,PHYS 2C,B10,092646,Barreiro Guerrero; Julio,29,0,30,1
1653300493647,PHYS 2C,B11,092647,Barreiro Guerrero; Julio,30,0,30,0
1653300493647,PHYS 2C,B12,092648,Barreiro Guerrero; Julio,30,0,30,0
1653300494171,PHYS 2CL,A01,088625,Du; Chunhui,26,0,30,4
1653300494171,PHYS 2CL,A02,088626,Du; Chunhui,29,0,30,1
1653300494171,PHYS 2CL,A03,088627,Du; Chunhui,21,0,30,9
1653300494171,PHYS 2CL,A04,088628,Du; Chunhui,30,0,30,0
1653300494171,PHYS 2CL,A05,088629,Du; Chunhui,29,0,30,1
1653300494171,PHYS 2CL,A06,088630,Du; Chunhui,24,0,30,6
1653300494171,PHYS 2CL,A07,088631,Du; Chunhui,28,0,30,2
1653300494171,PHYS 2CL,A08,088632,Du; Chunhui,28,0,30,2
1653300494171,PHYS 2CL,A09,088633,Du; Chunhui,24,0,30,6
1653300494171,PHYS 2CL,A10,088634,Du; Chunhui,29,0,30,1
1653300494171,PHYS 2CL,A11,088635,Du; Chunhui,27,0,30,3
1653300494171,PHYS 2CL,A12,088636,Du; Chunhui,30,0,30,0
1653300494700,PHYS 2D,A01,092649,Hirsch; Jorge Eduardo,30,0,30,0
1653300494700,PHYS 2D,A02,092650,Hirsch; Jorge Eduardo,28,0,30,2
1653300494700,PHYS 2D,A03,092651,Hirsch; Jorge Eduardo,30,0,30,0
1653300494700,PHYS 2D,A04,092652,Hirsch; Jorge Eduardo,30,0,30,0
1653300494700,PHYS 2D,A05,092653,Hirsch; Jorge Eduardo,30,0,30,0
1653300494700,PHYS 2D,A06,092654,Hirsch; Jorge Eduardo,30,0,30,0
1653300495221,PHYS 2DL,A01,088639,Butov; Leonid,7,0,16,9
1653300495221,PHYS 2DL,A02,088640,Butov; Leonid,13,0,16,3
1653300495221,PHYS 2DL,A03,094501,Butov; Leonid,13,0,16,3
1653300495221,PHYS 2DL,A04,094502,Butov; Leonid,16,0,16,0
1653300495744,PHYS 4C,A01,092655,Averitt; Richard Douglas,28,0,30,2
1653300495744,PHYS 4C,A02,092656,Averitt; Richard Douglas,30,0,30,0
1653300495744,PHYS 4C,A03,092657,Averitt; Richard Douglas,30,0,30,0
1653300495744,PHYS 4C,A04,092658,Staff,30,0,30,0
1653300496267,PHYS 5,A01,092662,Konopacky; Quinn Morgan,197,0,200,3
1653300496793,PHYS 10,A01,092663,Tytler; David Robert,191,0,192,1
1653300497316,PHYS 100A,A01,092660,Shpyrko; Oleg,114,0,120,6
1653300497849,PHYS 110A,A01,092664,Arovas; Daniel P,116,0,120,4
1653300498375,PHYS 122,A01,088647,Yang; Liang,30,0,40,10
1653300498897,PHYS 130B,A01,092661,Grover; Tarun,106,0,120,14
1653300499423,PHYS 139,A00,088649,Kuti; Julius,19,0,20,1
1653300499945,PHYS 140A,A01,092665,Shotwell; Brian,105,0,120,15
1653300500469,PHYS 161,A01,092666,Fuller; George Michael,46,0,65,19
1653300500994,PHYS 163,A01,092667,Keres; Dusan,48,0,50,2
1653300501522,PHYS 175,A00,088653,Dudko; Olga,18,0,20,2
1653300502047,PHYS 191,A00,088654,Shpyrko; Oleg,26,0,30,4
1653300502570,POLI 11D,A01,090896,Ferree; Karen E,29,0,30,1
1653300502570,POLI 11D,A02,090897,Ferree; Karen E,28,0,30,2
1653300502570,POLI 11D,A03,090899,Ferree; Karen E,28,0,30,2
1653300502570,POLI 11D,A04,090900,Ferree; Karen E,29,0,30,1
1653300503107,POLI 12D,A01,090902,Roeder; Philip G,26,0,30,4
1653300503107,POLI 12D,A02,090903,Roeder; Philip G,27,0,30,3
1653300503107,POLI 12D,A05,090906,Roeder; Philip G,28,0,30,2
1653300503107,POLI 12D,A06,090907,Roeder; Philip G,30,0,30,0
1653300503645,POLI 13DR,A01,090909,Forman; Fonna,26,0,30,4
1653300503645,POLI 13DR,A02,090910,Forman; Fonna,30,0,30,0
1653300503645,POLI 13DR,A03,090911,Forman; Fonna,28,0,30,2
1653300503645,POLI 13DR,A04,090912,Forman; Fonna,30,0,30,0
1653300503645,POLI 13DR,A05,090913,Forman; Fonna,28,0,30,2
1653300503645,POLI 13DR,A06,090914,Forman; Fonna,34,0,34,0
1653300504169,POLI 27,A01,090916,Elgin; Samuel Zincke,23,0,30,7
1653300504169,POLI 27,A02,090917,Elgin; Samuel Zincke,26,0,30,4
1653300504169,POLI 27,A03,090918,Elgin; Samuel Zincke,30,0,30,0
1653300504169,POLI 27,A04,090919,Elgin; Samuel Zincke,28,0,30,2
1653300504169,POLI 27,A05,090920,Elgin; Samuel Zincke,24,0,30,6
1653300504169,POLI 27,A06,090921,Elgin; Samuel Zincke,29,0,30,1
1653300504697,POLI 28,A01,090923,Elgin; Samuel Zincke,23,0,30,7
1653300504697,POLI 28,A02,090924,Elgin; Samuel Zincke,26,0,30,4
1653300504697,POLI 28,A05,090927,Elgin; Samuel Zincke,23,0,30,7
1653300504697,POLI 28,A06,090928,Elgin; Samuel Zincke,23,0,30,7
1653300505229,POLI 30D,A01,090930,Desposato; Scott,22,0,24,2
1653300505229,POLI 30D,A02,090931,Desposato; Scott,22,0,24,2
1653300505229,POLI 30D,A03,090932,Desposato; Scott,23,0,24,1
1653300505229,POLI 30D,A04,090933,Desposato; Scott,24,0,24,0
1653300505229,POLI 30D,A05,090934,Desposato; Scott,23,0,24,1
1653300505229,POLI 30D,A06,090935,Desposato; Scott,24,0,24,0
1653300505757,POLI 100G,A00,090936,Fletcher; Nathan,199,0,208,9
1653300506295,POLI 100V,A00,090937,Gause; LaGina,111,0,115,4
1653300506820,POLI 100W,A00,090938,Paglayan; Agustina,161,0,165,4
1653300507343,POLI 104A,A00,090940,Smith; Glenn Chatmas,186,0,195,9
1653300507876,POLI 104F,A00,090941,Smith; Glenn Chatmas,11,0,19,8
1653300508404,POLI 104M,A00,090942,Stephens; Mattheus E,156,0,165,9
1653300508929,POLI 110A,A00,090943,Wiens; David,39,0,44,5
1653300509461,POLI 110F,A00,090944,Elgin; Samuel Zincke,50,0,50,0
1653300509994,POLI 113A,A00,090945,Magagna; Victor Valentine,469,0,475,6
1653300509994,POLI 113A,B00,090946,Magagna; Victor Valentine,467,0,475,8
1653300510524,POLI 117R,A00,090947,Forman; Fonna,16,0,40,24
1653300511059,POLI 120E,A00,090948,Strom; Kaare,47,0,50,3
1653300511595,POLI 120G,A00,090949,Fisk; David Lee,110,0,115,5
1653300512148,POLI 120H,A00,090950,Fisk; David Lee,111,0,115,4
1653300512694,POLI 133A,A00,090951,Naoi; Megumi,156,0,165,9
1653300513215,POLI 135,A00,090952,Fisk; David Lee,111,0,115,4
1653300513738,POLI 142J,A00,090953,Slantchev; Branislav,45,0,50,5
1653300514264,POLI 143,A00,090954,Gartzke; Erik,111,0,115,4
1653300514798,POLI 149,A00,090955,Joseph; Michael F,152,0,165,13
1653300515322,POLI 151,A00,090956,Schneider; Christina,92,0,100,8
1653300515845,POLI 165,A00,090957,Warren; Scott,45,0,50,5
1653300516368,POLI 178,A00,090958,Joseph; Michael F,34,0,50,16
1653300516891,POLI 191A,A00,090959,Forman; Fonna & Hoston; Germaine,25,0,25,0
1653300517414,POLI 194,A00,090960,Hill; Seth J,9999,0,9999,0
1653300517938,POLI 194SD,A00,090961,Nichter; Maysa,9999,0,9999,0
1653300518488,POLI 197SD,001,090962,Nichter; Maysa,9999,0,9999,0
1653300519015,PSYC 1,A00,088391,Ferreira; Victor,194,0,200,6
1653300519538,PSYC 2,A00,093916,Moranton; Nirelia Melbina-,192,0,195,3
1653300520061,PSYC 3,A00,088392,Pilegard; Celeste Cristine,221,0,225,4
1653300520584,PSYC 6,A00,088393,McCullough; Michael E,198,0,200,2
1653300521110,PSYC 7,A00,088394,Powell; Lindsey Jane,196,0,200,4
1653300521639,PSYC 60,A01,088397,Lowe; Angela Beth,12,0,25,13
1653300521639,PSYC 60,A02,088398,Lowe; Angela Beth,25,0,25,0
1653300521639,PSYC 60,A03,088399,Lowe; Angela Beth,24,0,25,1
1653300521639,PSYC 60,A04,088400,Lowe; Angela Beth,23,0,25,2
1653300521639,PSYC 60,A05,088401,Lowe; Angela Beth,24,0,25,1
1653300521639,PSYC 60,A06,088402,Lowe; Angela Beth,25,0,25,0
1653300521639,PSYC 60,A07,088403,Lowe; Angela Beth,24,0,25,1
1653300521639,PSYC 60,B01,088405,Rickard; Timothy C.,25,0,25,0
1653300521639,PSYC 60,B02,088406,Rickard; Timothy C.,25,0,25,0
1653300521639,PSYC 60,B03,088407,Rickard; Timothy C.,25,0,25,0
1653300521639,PSYC 60,B04,088408,Rickard; Timothy C.,23,0,25,2
1653300521639,PSYC 60,B05,088410,Rickard; Timothy C.,24,0,25,1
1653300521639,PSYC 60,B06,088411,Rickard; Timothy C.,24,0,25,1
1653300521639,PSYC 60,B07,088412,Rickard; Timothy C.,24,0,25,1
1653300522177,PSYC 70,A01,088414,Pilegard; Celeste Cristine,17,0,25,8
1653300522177,PSYC 70,A02,088415,Pilegard; Celeste Cristine,24,0,25,1
1653300522177,PSYC 70,A03,088416,Pilegard; Celeste Cristine,25,0,25,0
1653300522177,PSYC 70,A04,088417,Pilegard; Celeste Cristine,25,0,25,0
1653300522177,PSYC 70,A05,088418,Pilegard; Celeste Cristine,22,0,25,3
1653300522177,PSYC 70,A06,088419,Pilegard; Celeste Cristine,19,0,25,6
1653300522700,PSYC 71,A01,088421,Lowe; Angela Beth,15,0,25,10
1653300522700,PSYC 71,A02,088422,Lowe; Angela Beth,21,0,25,4
1653300522700,PSYC 71,B01,088424,Steiner; Eric Tomas,20,0,25,5
1653300522700,PSYC 71,B02,088425,Steiner; Eric Tomas,23,0,25,2
1653300523224,PSYC 87,A00,093915,Gorman; Michael R.,20,0,20,0
1653300523751,PSYC 88,A00,088426,Dobkins; Karen R.,61,0,65,4
1653300524274,PSYC 100,A00,088428,Chapman; Eddie Nathaniel,125,0,170,45
1653300524801,PSYC 101,A00,088429,Heyman; Gail D.,148,0,170,22
1653300525329,PSYC 102,A00,093917,Moranton; Nirelia Melbina-,162,0,170,8
1653300525854,PSYC 104,A00,088430,Fine; Rachel,163,0,175,12
1653300526381,PSYC 116A,A01,088433,Lang; Ariel,25,0,25,0
1653300526913,PSYC 122,A00,088434,Miller; Cory T.,103,0,115,12
1653300527437,PSYC 125,A00,088436,Rose; Fred E.,90,0,120,30
1653300527966,PSYC 134,A00,088437,Kaye; Walter H.,235,0,250,15
1653300528493,PSYC 137,A00,088438,Fine; Rachel,210,0,216,6
1653300529016,PSYC 145,A00,093918,Staff,73,0,90,17
1653300529543,PSYC 147,A00,088441,Wong; Lauren Hitomi,120,0,146,26
1653300530068,PSYC 154,A00,093919,Lacefield; Katharine I,270,0,295,25
1653300530591,PSYC 158,A00,088443,Willis; Jarryd Thomas,250,0,295,45
1653300531114,PSYC 162,A00,088444,Wixted; John T,210,0,225,15
1653300531641,PSYC 167,A00,088445,Walker; Caren Michelle,0,0,30,30
1653300532167,PSYC 168,A00,088446,Chapman; Eddie Nathaniel,222,0,250,28
1653300532690,PSYC 171,A00,088447,Mukku; Dhananjaya,66,0,75,9
1653300533212,PSYC 178,A00,088448,Glaser; Dale,105,0,120,15
1653300533739,PSYC 179,A00,088449,Lacefield; Katharine I,193,0,250,57
1653300534261,PSYC 181,A00,088450,Anagnostaras; Stephan,284,0,300,16
1653300534788,PSYC 189,A00,088451,Gentner; Tim,19,0,31,12
1653300535311,PSYC 193,A00,088452,Gremel; Christina M,19,0,20,1
1653300535311,PSYC 193,B00,088453,Staff,19,0,20,1
1653300535834,PSYC 193L,A01,088455,Staff,33,0,35,2
1653300536358,PSYC 194A,A01,088461,Heyman; Gail D.,35,0,35,0
1653300536882,RELI 1,A01,086478,Kalleres; Dayna,20,0,20,0
1653300536882,RELI 1,A02,086479,Kalleres; Dayna,19,0,20,1
1653300537409,RELI 147,A00,088409,Caciola; Nancy A,0,0,0,0
1653300537932,REV 1,A01,092308,Leigh; Brian,24,0,24,0
1653300537932,REV 1,A02,092310,Leigh; Brian,24,0,24,0
1653300537932,REV 1,A03,092312,Leigh; Brian,24,0,24,0
1653300537932,REV 1,A04,092314,Leigh; Brian,24,0,24,0
1653300537932,REV 1,A05,092316,Leigh; Brian,24,0,24,0
1653300538472,REV 2,A01,092318,Staff,28,0,28,0
1653300538472,REV 2,A02,092319,Staff,28,0,28,0
1653300538998,REV 20,A00,092320,Staff,40,0,40,0
1653300539524,REV 87,A00,092321,Lyon; Antony J.,20,0,20,0
1653300540154,SE 1,A01,088674,Van Den Einde; Yael Dahlia,48,0,48,0
1653300540154,SE 1,A02,088675,Van Den Einde; Yael Dahlia,47,0,48,1
1653300540154,SE 1,A03,088676,Van Den Einde; Yael Dahlia,46,0,48,2
1653300540697,SE 101A,A00,088677,Morrison; Machel Leigh,191,0,200,9
1653300541230,SE 101C,A00,088678,Zhu; Qiang,137,0,145,8
1653300541767,SE 125,A00,088679,Conte; Joel P,143,0,145,2
1653300542290,SE 130A,A00,088680,Loh; Kenneth J. H.,110,0,115,5
1653300542815,SE 131B,A00,088681,Krysl; Petr,84,0,115,31
1653300543339,SE 142,A01,088683,Staff,11,0,18,7
1653300543339,SE 142,A02,088684,Staff,13,0,18,5
1653300543886,SE 164,A01,088686,Loh; Kenneth J. H.,14,0,16,2
1653300544409,SE 180,A00,088687,Elgamal; Ahmed,66,0,75,9
1653300544943,SE 181,A01,088689,McCartney; John Scott,25,0,30,5
1653300544943,SE 181,A02,088690,McCartney; John Scott,14,0,30,16
1653300544943,SE 181,A03,088691,McCartney; John Scott,25,0,25,0
1653300544943,SE 181,A04,088692,McCartney; John Scott,25,0,25,0
1653300545466,SIO 12,A00,088342,Staff,141,0,146,5
1653300545990,SIO 15,A00,088343,Laske; Gabi,333,0,340,7
1653300546514,SIO 30,A01,092382,Castillo; Paterno R.,28,0,35,7
1653300546514,SIO 30,A02,092383,Castillo; Paterno R.,32,0,35,3
1653300546514,SIO 30,A03,092384,Castillo; Paterno R.,35,0,35,0
1653300546514,SIO 30,A04,092385,Castillo; Paterno R.,35,0,35,0
1653300547049,SIO 40,A00,088345,Barbeau; Katherine,144,0,146,2
1653300547576,SIO 50,A01,088347,Cook; Geoffrey W,11,0,14,3
1653300547576,SIO 50,A02,088348,Cook; Geoffrey W,11,0,14,3
1653300548099,SIO 87,A00,088350,Cook; Geoffrey W,20,0,20,0
1653300548099,SIO 87,B00,088351,Cook; Geoffrey W,20,0,20,0
1653300548099,SIO 87,C00,094017,Gilbert; Jack Anthony,20,0,20,0
1653300548099,SIO 87,D00,094018,Gerwick; William Henry,20,0,20,0
1653300548626,SIO 90,A00,088352,Staff,56,0,60,4
1653300549151,SIO 100,A00,088354,Norris; Richard D. & Gee; Jeffrey S,10,0,20,10
1653300549680,SIO 101,A01,088356,Aluwihare; Lihini & Decima; Moira R.,1,0,30,29
1653300549680,SIO 101,A02,088357,Aluwihare; Lihini & Decima; Moira R.,15,0,30,15
1653300550208,SIO 103,A01,088359,Parnell-Turner; Ross Ernes,21,0,25,4
1653300550731,SIO 105,A00,088360,Driscoll; Neal W.,18,0,20,2
1653300551259,SIO 108,A01,088363,Teranes; Jane,15,0,20,5
1653300551792,SIO 109R,A00,088364,Forman; Fonna,27,0,40,13
1653300552319,SIO 110,A01,088366,Staff,8,0,29,21
1653300552848,SIO 117,A01,088368,Keeling; Ralph F.,31,0,36,5
1653300553386,SIO 123,A00,088369,Allen; Andrew Ellis,61,0,70,9
1653300553910,SIO 132,A01,092386,Hechinger; Ryan F. & Kacev; David,17,0,28,11
1653300553910,SIO 132,A02,092387,Hechinger; Ryan F. & Kacev; David,26,0,28,2
1653300553910,SIO 132,A03,092388,Hechinger; Ryan F. & Kacev; David,28,0,28,0
1653300553910,SIO 132,A04,092389,Hechinger; Ryan F. & Kacev; David,23,0,28,5
1653300553910,SIO 132,A05,092390,Hechinger; Ryan F. & Kacev; David,27,0,28,1
1653300553910,SIO 132,A06,092391,Hechinger; Ryan F. & Kacev; David,27,0,28,1
1653300554453,SIO 136,A01,088373,Kacev; David & Bowman; Jeff Shovlowsky,0,0,5,7
1653300554453,SIO 136,B01,088376,Kacev; David & Bowman; Jeff Shovlowsky,0,0,5,5
1653300554977,SIO 155,A01,088379,Day; James M.D.,1,0,5,4
1653300555502,SIO 170,A00,088380,Cook; Geoffrey W,29,0,30,1
1653300556027,SIO 171,A01,088382,Rudnick; Daniel Lars,37,0,40,3
1653300556549,SIO 175,A01,088384,Merrifield; Mark A,22,0,25,3
1653300557089,SIO 177,A00,088385,Becker; Janet Maria,15,0,20,5
1653300557614,SIO 179,A01,088387,Martz; Todd R.,7,0,15,8
1653300558683,SIO 189,A00,088390,Hamdoun; Amr,35,0,60,25
1653300559208,SIO 194,A00,091602,Hill; Seth J,9999,0,9999,0
1653300559738,SOCE 194,A00,091601,Hill; Seth J,9999,0,9999,0
1653300560268,SOCI 1,A01,093704,Skrentny; John David,19,0,20,1
1653300560268,SOCI 1,A02,093705,Skrentny; John David,20,0,20,0
1653300560268,SOCI 1,A03,093706,Skrentny; John David,18,0,20,2
1653300560268,SOCI 1,A04,093707,Skrentny; John David,19,0,20,1
1653300560268,SOCI 1,A05,093708,Skrentny; John David,17,0,20,3
1653300560268,SOCI 1,A06,093709,Skrentny; John David,20,0,20,0
1653300560268,SOCI 1,A07,093710,Skrentny; John David,20,0,20,0
1653300560268,SOCI 1,A08,093711,Skrentny; John David,20,0,20,0
1653300560268,SOCI 1,A09,093712,Skrentny; John David,20,0,20,0
1653300560268,SOCI 1,A10,093713,Skrentny; John David,20,0,20,0
1653300560268,SOCI 1,A11,093714,Skrentny; John David,20,0,20,0
1653300560794,SOCI 30,A01,093716,Staff,30,0,30,0
1653300560794,SOCI 30,A02,093717,Staff,30,0,30,0
1653300561317,SOCI 60,A01,093719,Staff,17,0,20,3
1653300561317,SOCI 60,A02,093720,Staff,18,0,20,2
1653300561317,SOCI 60,A03,093721,Staff,20,0,20,0
1653300561317,SOCI 60,A04,093722,Staff,20,0,20,0
1653300561844,SOCI 87,A00,093819,Blair-Loy; Mary,20,0,20,0
1653300562368,SOCI 100,A01,093724,Estefan; Michel,15,0,20,5
1653300562368,SOCI 100,A02,093725,Estefan; Michel,5,0,20,15
1653300562893,SOCI 104,A00,093728,Gong; Neil M,22,0,25,3
1653300563418,SOCI 104Q,A00,093729,Staff,23,0,25,2
1653300563946,SOCI 106,A00,093730,Staff,25,0,25,0
1653300564469,SOCI 109,A00,093731,Staff,21,0,25,4
1653300564990,SOCI 110,A00,093732,Binder; Amy,24,0,25,1
1653300566560,SOCI 117,A01,091568,Chung; Luz Marina,29,0,35,6
1653300566560,SOCI 117,A02,091569,Chung; Luz Marina,35,0,35,0
1653300567082,SOCI 118,A00,093735,Staff,0,0,0,0
1653300567607,SOCI 120T,A00,093736,Lampland; Martha,50,0,50,0
1653300567607,SOCI 120T,B00,094832,Staff,69,0,70,1
1653300568131,SOCI 122,A00,093737,Lewis; Kevin Michael,62,0,70,8
1653300568657,SOCI 123,A00,094831,Staff,57,0,65,8
1653300569178,SOCI 125,A00,093738,Staff,115,0,120,5
1653300569707,SOCI 127,A00,094894,Staff,54,0,56,2
1653300570230,SOCI 132,A00,093739,Blair-Loy; Mary,51,0,60,9
1653300571279,SOCI 136F,A00,094830,Staff,45,0,56,11
1653300571818,SOCI 138,A00,093741,Navon; Daniel,117,0,120,3
1653300572356,SOCI 140A,A00,093743,Gong; Neil M,53,0,60,7
1653300572881,SOCI 141,A00,093744,Summers; Valerie R.,111,0,120,9
1653300573925,SOCI 144,A00,093746,Staff,0,0,0,0
1653300576028,SOCI 159,A00,094902,Staff,49,0,50,1
1653300576554,SOCI 160,A00,093750,Staff,0,0,0,0
1653300577076,SOCI 165,A00,093751,Rona-Tas; Akos,43,0,48,5
1653300577599,SOCI 165A,A00,094206,Hallin; Daniel C,3,0,4,1
1653300578125,SOCI 166,A00,093752,Lampland; Martha,52,0,56,4
1653300578649,SOCI 176,A00,093753,Turner; Christena L.,44,0,48,4
1653300579174,SOCI 180,A00,094901,Staff,56,0,56,0
1653300579697,SOCI 185,A00,094903,Staff,55,0,56,1
1653300580220,SOCI 196A,A00,093754,Shafir; Gershon,20,0,20,0
1653300580747,SXTH 1,A01,092351,Bronstein; Phoebe Malan,18,0,18,0
1653300580747,SXTH 1,A02,092352,Bronstein; Phoebe Malan,18,0,18,0
1653300580747,SXTH 1,A03,092353,Bronstein; Phoebe Malan,18,0,18,0
1653300581282,SXTH 20A,A00,092355,Chilukuri; Lakshmi N,56,0,56,0
1653300581826,SYN 2,001,091487,Gladstein; Jill M,13,0,15,2
1653300581826,SYN 2,002,091488,Gladstein; Jill M,14,0,15,1
1653300581826,SYN 2,003,091490,Gladstein; Jill M,12,0,15,3
1653300581826,SYN 2,004,091491,Gladstein; Jill M,15,0,15,0
1653300581826,SYN 2,005,091493,Gladstein; Jill M,15,0,15,0
1653300581826,SYN 2,006,091495,Gladstein; Jill M,15,0,15,0
1653300581826,SYN 2,007,091496,Gladstein; Jill M,15,0,15,0
1653300581826,SYN 2,008,091497,Gladstein; Jill M,14,0,15,1
1653300581826,SYN 2,009,091499,Gladstein; Jill M,13,0,15,2
1653300581826,SYN 2,010,091501,Gladstein; Jill M,13,0,15,2
1653300581826,SYN 2,011,091502,Gladstein; Jill M,13,0,15,2
1653300581826,SYN 2,012,091503,Gladstein; Jill M,15,0,15,0
1653300581826,SYN 2,013,091505,Gladstein; Jill M,13,0,15,2
1653300581826,SYN 2,014,091506,Gladstein; Jill M,12,0,15,3
1653300581826,SYN 2,015,091508,Gladstein; Jill M,14,0,15,1
1653300581826,SYN 2,016,091509,Gladstein; Jill M,12,0,15,3
1653300581826,SYN 2,017,091510,Gladstein; Jill M,14,0,15,1
1653300581826,SYN 2,018,091512,Gladstein; Jill M,15,0,15,0
1653300581826,SYN 2,019,091513,Gladstein; Jill M,15,0,15,0
1653300581826,SYN 2,020,091514,Gladstein; Jill M,15,0,15,0
1653300581826,SYN 2,021,091516,Gladstein; Jill M,12,0,15,3
1653300581826,SYN 2,022,091517,Gladstein; Jill M,13,0,15,2
1653300581826,SYN 2,023,091518,Gladstein; Jill M,15,0,15,0
1653300581826,SYN 2,024,091519,Gladstein; Jill M,15,0,15,0
1653300581826,SYN 2,025,091520,Gladstein; Jill M,11,0,15,4
1653300581826,SYN 2,026,091521,Gladstein; Jill M,15,0,15,0
1653300581826,SYN 2,027,091522,Gladstein; Jill M,0,0,0,0
1653300581826,SYN 2,028,091523,Gladstein; Jill M,0,0,0,0
1653300581826,SYN 2,029,091524,Gladstein; Jill M,0,0,0,0
1653300581826,SYN 2,030,091525,Gladstein; Jill M,0,0,0,0
1653300581826,SYN 2,031,091526,Gladstein; Jill M,14,0,15,1
1653300581826,SYN 2,032,091527,Gladstein; Jill M,15,0,15,0
1653300581826,SYN 2,033,091528,Gladstein; Jill M,0,0,0,0
1653300581826,SYN 2,034,091529,Gladstein; Jill M,15,0,15,0
1653300581826,SYN 2,035,091530,Gladstein; Jill M,15,0,15,0
1653300581826,SYN 2,036,091531,Gladstein; Jill M,15,0,15,0
1653300581826,SYN 2,037,091532,Gladstein; Jill M,15,0,15,0
1653300581826,SYN 2,038,091533,Gladstein; Jill M,15,0,15,0
1653300581826,SYN 2,039,091534,Gladstein; Jill M,15,0,15,0
1653300581826,SYN 2,040,091535,Gladstein; Jill M,15,0,15,0
1653300582354,SYN 100,A01,091537,Gladstein; Jill M,26,0,30,4
1653300582354,SYN 100,B01,091539,Gladstein; Jill M,26,0,30,4
1653300582354,SYN 100,C01,091541,Gladstein; Jill M,26,0,30,4
1653300582354,SYN 100,D01,091543,Gladstein; Jill M,25,0,30,5
1653300582354,SYN 100,E01,091545,Gladstein; Jill M,28,0,30,2
1653300582879,TDAC 1,A00,088922,Walsh; Kim C.,10,0,10,0
1653300582879,TDAC 1,B00,088923,Walsh; Kim C.,8,0,10,2
1653300582879,TDAC 1,C00,088924,Walsh; Kim C.,0,0,10,10
1653300582879,TDAC 1,D00,088925,Walsh; Kim C.,7,0,10,3
1653300582879,TDAC 1,E00,088926,Walsh; Kim C.,2,0,10,8
1653300582879,TDAC 1,F00,088927,Walsh; Kim C.,9,0,10,1
1653300583401,TDAC 101,A00,088972,Harting; Carla Kelso,9,0,10,1
1653300583401,TDAC 101,B00,088973,Salovey; Todd,8,0,10,2
1653300583401,TDAC 101,C00,088974,Walsh; Kim C.,6,0,10,4
1653300583930,TDAC 102,A00,088975,Basso; Beatrice,9,0,10,1
1653300583930,TDAC 102,B00,088976,Basso; Beatrice,7,0,10,3
1653300584454,TDAC 103A,A00,094044,Castro; Robert Jess,32,0,35,3
1653300584990,TDAC 108,A00,088977,Staff,20,0,20,0
1653300585523,TDAC 109,A00,088978,Blair; Kyle Adam,20,0,20,0
1653300586049,TDAC 115,A00,088979,Newcomb; James,20,0,20,0
1653300586582,TDAC 122,A00,088981,Staff,30,0,30,0
1653300587105,TDAC 123,A00,088982,Staff,30,0,30,0
1653300587629,TDDE 1,A01,088929,Benzoni; Elisa,9,0,11,2
1653300587629,TDDE 1,A02,088930,Benzoni; Elisa,11,0,11,0
1653300587629,TDDE 1,A03,088931,Benzoni; Elisa,11,0,11,0
1653300587629,TDDE 1,A04,088932,Benzoni; Elisa,10,0,11,1
1653300587629,TDDE 1,A05,088933,Benzoni; Elisa,11,0,11,0
1653300588155,TDDE 130,A00,088983,Staff,20,0,20,0
1653300588678,TDDE 132,A00,094263,Staff,20,0,20,0
1653300589205,TDDE 169A,A00,094046,Petrovich; Victoria A.,18,0,20,2
1653300589761,TDDM 1,A00,088934,Snaith; Yolande,6,0,10,4
1653300590288,TDDM 5,A00,088935,Smith; Alison D,30,0,30,0
1653300590810,TDDR 101,A00,088986,Powell; Lora,34,0,35,1
1653300591333,TDDR 111,A00,088987,Stalling; Vanessa,24,0,30,6
1653300591333,TDDR 111,B00,094045,Castro; Robert Jess,14,0,16,2
1653300591856,TDDR 190,A00,088988,Stalling; Vanessa,10,0,10,0
1653300592382,TDGE 1,A01,088937,Salovey; Todd,12,0,12,0
1653300592382,TDGE 1,A02,088938,Salovey; Todd,10,0,12,2
1653300592382,TDGE 1,A03,088939,Salovey; Todd,8,0,12,4
1653300592382,TDGE 1,A04,088940,Salovey; Todd,12,0,12,0
1653300592382,TDGE 1,A05,088941,Salovey; Todd,11,0,12,1
1653300592382,TDGE 1,A06,088942,Salovey; Todd,12,0,12,0
1653300592908,TDGE 10,A00,088943,Havis; Allan,191,0,200,9
1653300593516,TDGE 11,A00,088944,Staff,200,0,200,0
1653300594040,TDGE 25,A00,088945,Harting; Carla Kelso,19,0,20,1
1653300594040,TDGE 25,B00,088946,Harting; Carla Kelso,19,0,20,1
1653300594040,TDGE 25,C00,088947,Harting; Carla Kelso,20,0,20,0
1653300594040,TDGE 25,D00,088948,Harting; Carla Kelso,19,0,20,1
1653300594040,TDGE 25,E00,088949,Harting; Carla Kelso,20,0,20,0
1653300594040,TDGE 25,F00,088950,Harting; Carla Kelso,19,0,20,1
1653300594040,TDGE 25,G00,088951,Harting; Carla Kelso,19,0,20,1
1653300594564,TDGE 127,A00,088990,Havis; Allan,188,0,200,12
1653300595097,TDHD 21,A00,088952,Jun; Grace Shin Hae,20,0,20,0
1653300595624,TDHT 10,A00,088953,Power; Jade Yukana,14,0,14,0
1653300595624,TDHT 10,B00,088954,Power; Jade Yukana,13,0,14,1
1653300596151,TDHT 21,A01,088956,Power; Jade Yukana,17,0,18,1
1653300596151,TDHT 21,A02,088957,Power; Jade Yukana,7,0,11,4
1653300596151,TDHT 21,A03,088958,Power; Jade Yukana,11,0,11,0
1653300596683,TDHT 101,A00,088994,Burelle; Julie Sara Veronique,21,0,25,4
1653300597209,TDHT 114,A00,094208,Williams; Madison Mae,47,0,50,3
1653300597734,TDHT 119,A00,094299,Burelle; Julie Sara Veronique,25,0,25,0
1653300598259,TDMV 1,A00,088959,Weinberg; Sadie,23,0,30,7
1653300598802,TDMV 2,A00,088960,Sammartano; Tonnie,27,0,30,3
1653300598802,TDMV 2,B00,094043,Duran; Marcos Antonio,29,0,30,1
1653300599328,TDMV 3,A00,088961,Arcidiacono; Kristin,27,0,30,3
1653300599856,TDMV 110,A00,088995,Wilson; Terry A.,0,0,0,0
1653300600387,TDMV 120,A00,088996,Smith; Alison D,17,0,20,3
1653300600916,TDMV 122,A00,088997,Chaleff; Rebecca,28,0,30,2
1653300601447,TDMV 130,A00,094042,Rincon; Alicia,30,0,30,0
1653300601972,TDMV 138,A00,088998,Jun; Grace Shin Hae,12,0,40,28
1653300602500,TDMV 142,A00,088999,Caligagan; Tony,28,0,40,12
1653300603029,TDMV 143,A00,094041,Foster-King; Sandra,37,0,40,3
1653300603554,TDMV 146,A00,089000,Caligagan; Tony,39,0,40,1
1653300604078,TDPF 160,A00,094264,Snaith; Yolande,30,0,30,0
1653300604078,TDPF 160,B00,094265,Smith; Alison D,30,0,30,0
1653300604078,TDPF 160,C00,094266,Weinberg; Sadie,30,0,30,0
1653300604601,TDPR 6,A01,088963,Benzoni; Elisa,25,0,25,0
1653300604601,TDPR 6,A02,088964,Benzoni; Elisa,25,0,25,0
1653300605129,TDPR 102,A00,089003,Staff,15,0,15,0
1653300605654,TDPR 104,A00,089004,Powell; Lora,15,0,15,0
1653300606182,TDPW 1,A00,088965,Staff,10,0,10,0
1653300606182,TDPW 1,B00,088966,Staff,10,0,10,0
1653300606182,TDPW 1,C00,088967,Staff,9,0,10,1
1653300606182,TDPW 1,D00,088968,Staff,9,0,10,1
1653300606182,TDPW 1,E00,088969,Staff,10,0,10,0
1653300606182,TDPW 1,F00,088970,Staff,9,0,10,1
1653300606709,TDTR 10,A00,088971,Wilson; Terry A.,22,0,25,3
1653300607232,TMC 2,A01,092358,Carver; Leslie J.,20,0,20,0
1653300607232,TMC 2,A02,092359,Carver; Leslie J.,20,0,20,0
1653300607232,TMC 2,A03,092360,Carver; Leslie J.,20,0,20,0
1653300607232,TMC 2,A04,092361,Carver; Leslie J.,20,0,20,0
1653300607232,TMC 2,A05,092362,Carver; Leslie J.,20,0,20,0
1653300607232,TMC 2,A06,092363,Carver; Leslie J.,20,0,20,0
1653300607757,TMC 15,A00,092364,Atkinson; Arthur Laird,20,0,20,0
1653300608284,TMC 20,A00,092365,Carver; Leslie J.,20,0,20,0
1653300608813,TMC 90,A00,092366,Mell; Loren K.,20,0,20,0
1653300609335,TMC 120,A01,092368,Staff,20,0,20,0
1653300609868,USP 1,A01,087520,Kwak; Nancy,19,0,20,1
1653300609868,USP 1,A02,087521,Kwak; Nancy,17,0,20,3
1653300609868,USP 1,A03,087522,Kwak; Nancy,16,0,20,4
1653300609868,USP 1,A04,087523,Kwak; Nancy,19,0,20,1
1653300610395,USP 2,A01,087525,Lerner; Amy M,29,0,30,1
1653300610395,USP 2,A02,087526,Lerner; Amy M,29,0,30,1
1653300610919,USP 4,A00,094267,Polat; Soydan Alihan,16,0,20,4
1653300610919,USP 4,B00,094268,Staff,20,0,20,0
1653300611454,USP 5,A01,087532,Staff,26,0,30,4
1653300611454,USP 5,A02,087533,Staff,27,0,30,3
1653300611978,USP 6,A01,094322,Shvartzberg Carrio; Manuel,20,0,20,0
1653300611978,USP 6,A02,094323,Shvartzberg Carrio; Manuel,20,0,20,0
1653300612504,USP 15,A01,087535,Anderson; William Raymond,20,0,25,5
1653300612504,USP 15,A02,087536,Anderson; William Raymond,23,0,25,2
1653300613030,USP 25,A00,087537,Staff,0,0,7,7
1653300613554,USP 50,A00,087538,Martin; Isaac,38,0,40,2
1653300614089,USP 124,A00,087539,Bussell; Mirle Rabinowitz,26,0,35,9
1653300614612,USP 125,A00,087540,Staff,17,0,23,6
1653300615148,USP 136,A00,087541,Staff,23,0,25,2
1653300615674,USP 144,A00,087542,Staff,136,0,146,10
1653300616198,USP 151,A00,087543,Boomhower; Matthew Charles,18,0,20,2
1653300616726,USP 152,A01,087545,Moeder; Nathan L,17,0,20,3
1653300616726,USP 152,A02,087546,Moeder; Nathan L,20,0,20,0
1653300617254,USP 153,A00,087547,Moden; Kelly Kjestine,27,0,30,3
1653300617777,USP 161,A00,094854,Wartell; Julie Dara,25,0,25,0
1653300618302,USP 169,A00,087548,Bajaj; Ravi Siddharth,30,0,35,5
1653300618825,USP 170,A00,087549,Hinds; Juli Beth,30,0,35,5
1653300619353,USP 171,A00,087550,Lerner; Amy M,38,0,50,12
1653300619875,USP 176,A00,094853,Staff,24,0,25,1
1653300620398,USP 177A,A00,087551,Peerson; Susan,20,0,22,2
1653300620923,USP 184,A00,094324,Shvartzberg Carrio; Manuel,24,0,25,1
1653300621451,USP 185A,A01,087553,Norr; Alex Vaughn,28,0,30,2
1653300621451,USP 185A,B01,087555,Boomhower; Matthew Charles,26,0,30,4
1653300621975,USP 186,A01,087557,Pezzoli; Keith,22,0,25,3
1653300621975,USP 186,A02,087558,Pezzoli; Keith,20,0,25,5
1653300623036,USP 191A,A00,087561,Rothberg; Scott Jacob,18,0,20,2
1653300623559,USP 194,A00,091599,Hill; Seth J,9999,0,9999,0
1653300624091,VIS 1,A01,088809,Tonies; Joshua Vanjaymes,10,0,10,0
1653300624091,VIS 1,A02,088810,Tonies; Joshua Vanjaymes,10,0,10,0
1653300624091,VIS 1,A03,088811,Tonies; Joshua Vanjaymes,3,0,10,7
1653300624091,VIS 1,A04,088812,Tonies; Joshua Vanjaymes,8,0,10,2
1653300624091,VIS 1,A05,088813,Tonies; Joshua Vanjaymes,4,0,10,6
1653300624091,VIS 1,A06,088814,Tonies; Joshua Vanjaymes,6,0,10,4
1653300624091,VIS 1,A07,088815,Tonies; Joshua Vanjaymes,6,0,10,4
1653300624091,VIS 1,A08,088816,Tonies; Joshua Vanjaymes,9,0,10,1
1653300624091,VIS 1,A09,088817,Tonies; Joshua Vanjaymes,8,0,10,2
1653300624091,VIS 1,A10,088818,Tonies; Joshua Vanjaymes,8,0,10,2
1653300624091,VIS 1,A11,088819,Tonies; Joshua Vanjaymes,3,0,10,7
1653300624091,VIS 1,A12,088820,Tonies; Joshua Vanjaymes,6,0,10,4
1653300624091,VIS 1,A13,088821,Tonies; Joshua Vanjaymes,6,0,10,4
1653300624091,VIS 1,A14,088822,Tonies; Joshua Vanjaymes,7,0,10,3
1653300624091,VIS 1,A15,088823,Tonies; Joshua Vanjaymes,7,0,10,3
1653300624091,VIS 1,A16,088824,Tonies; Joshua Vanjaymes,8,0,10,2
1653300624615,VIS 20,A01,088826,Woods; Ann,19,0,20,1
1653300624615,VIS 20,A02,088827,Woods; Ann,20,0,20,0
1653300624615,VIS 20,A03,088828,Woods; Ann,18,0,20,2
1653300624615,VIS 20,A04,088829,Woods; Ann,17,0,20,3
1653300624615,VIS 20,A05,088830,Woods; Ann,20,0,20,0
1653300624615,VIS 20,A06,088831,Woods; Ann,20,0,20,0
1653300624615,VIS 20,A07,088832,Woods; Ann,20,0,20,0
1653300624615,VIS 20,A08,088833,Woods; Ann,20,0,20,0
1653300624615,VIS 20,A09,088834,Woods; Ann,18,0,20,2
1653300624615,VIS 20,A10,088835,Woods; Ann,19,0,20,1
1653300624615,VIS 20,A11,088836,Woods; Ann,20,0,20,0
1653300624615,VIS 20,A12,088837,Woods; Ann,20,0,20,0
1653300625138,VIS 23,A00,088838,Rose; Jordan M,3,0,3,0
1653300625676,VIS 30,A01,088840,Stone; Patricia,11,0,11,0
1653300625676,VIS 30,A02,088841,Stone; Patricia,7,0,11,4
1653300625676,VIS 30,A03,094821,Stone; Patricia,8,0,11,3
1653300625676,VIS 30,A04,094822,Stone; Patricia,11,0,11,0
1653300626205,VIS 41,A01,088844,D'Elena-Tweed; Jessica Erin,9,0,10,1
1653300626205,VIS 41,A02,088845,D'Elena-Tweed; Jessica Erin,9,0,10,1
1653300626205,VIS 41,A03,088846,D'Elena-Tweed; Jessica Erin,9,0,10,1
1653300626205,VIS 41,A04,088847,D'Elena-Tweed; Jessica Erin,9,0,10,1
1653300626205,VIS 41,A05,088848,D'Elena-Tweed; Jessica Erin,10,0,10,0
1653300626205,VIS 41,A06,088849,D'Elena-Tweed; Jessica Erin,10,0,10,0
1653300626205,VIS 41,A07,088850,D'Elena-Tweed; Jessica Erin,10,0,10,0
1653300626205,VIS 41,A08,088851,D'Elena-Tweed; Jessica Erin,10,0,10,0
1653300626730,VIS 60,A01,088853,Sepuya; Paul Mpagi,9,0,10,1
1653300626730,VIS 60,A02,088854,Sepuya; Paul Mpagi,10,0,10,0
1653300626730,VIS 60,A03,088855,Sepuya; Paul Mpagi,10,0,10,0
1653300626730,VIS 60,A04,088856,Sepuya; Paul Mpagi,10,0,10,0
1653300626730,VIS 60,A05,088857,Sepuya; Paul Mpagi,10,0,10,0
1653300626730,VIS 60,A06,088858,Sepuya; Paul Mpagi,10,0,10,0
1653300626730,VIS 60,A07,088859,Sepuya; Paul Mpagi,9,0,10,1
1653300626730,VIS 60,A08,093932,Sepuya; Paul Mpagi,10,0,10,0
1653300627256,VIS 70N,A01,088861,Segade; Alexandro Abraham,8,0,8,0
1653300627256,VIS 70N,A02,088862,Segade; Alexandro Abraham,8,0,8,0
1653300627256,VIS 70N,A03,088863,Segade; Alexandro Abraham,8,0,8,0
1653300627256,VIS 70N,A04,088864,Segade; Alexandro Abraham,8,0,8,0
1653300627256,VIS 70N,A05,088865,Segade; Alexandro Abraham,7,0,8,1
1653300627256,VIS 70N,A06,088866,Segade; Alexandro Abraham,8,0,8,0
1653300627782,VIS 80,A01,088868,Adler; Amy,9,0,10,1
1653300627782,VIS 80,A02,088869,Adler; Amy,8,0,10,2
1653300627782,VIS 80,A03,088870,Adler; Amy,9,0,10,1
1653300627782,VIS 80,A04,088871,Adler; Amy,8,0,10,2
1653300627782,VIS 80,A05,088872,Adler; Amy,10,0,10,0
1653300627782,VIS 80,A06,088873,Adler; Amy,7,0,10,3
1653300628309,VIS 100,A00,088874,Cruz; Edwin Teddy,65,0,75,10
1653300628834,VIS 105A,A00,088875,Tonies; Joshua Vanjaymes,26,0,30,4
1653300629359,VIS 105B,A00,088876,Staff,25,0,30,5
1653300629884,VIS 106A,A00,088877,Tobe; Geoffroy,21,0,25,4
1653300630410,VIS 106B,A00,088878,Staff,21,0,25,4
1653300630931,VIS 106C,A00,088879,Staff,9,0,15,6
1653300631455,VIS 107B,A00,088880,Gallaccio; Anya,24,0,25,1
1653300631989,VIS 108,A00,093894,Gallaccio; Anya,5,0,15,10
1653300632520,VIS 110A,A00,093895,Dean; Danielle Adobi,15,0,15,0
1653300633054,VIS 110B,A00,088881,Adler; Amy,14,0,15,1
1653300633580,VIS 125E,A00,093896,Welchman; John C.,75,0,75,0
1653300634106,VIS 126HN,A00,088882,Newsome; Elizabeth Ann,74,0,75,1
1653300634632,VIS 126P,A00,088883,Wardwell; Mariana Razo,72,0,75,3
1653300635161,VIS 128E,A00,088884,Staff,68,0,75,7
1653300635690,VIS 132,A00,088885,Miller; Nicole L,15,0,15,0
1653300636211,VIS 133,A01,094348,D'Elena-Tweed; Jessica Erin,34,0,34,0
1653300636211,VIS 133,A02,094492,D'Elena-Tweed; Jessica Erin,33,0,34,1
1653300636756,VIS 142,A01,088887,Stalbaum; Brett,14,0,15,1
1653300636756,VIS 142,A02,088888,Stalbaum; Brett,10,0,15,5
1653300636756,VIS 142,A03,088889,Stalbaum; Brett,15,0,15,0
1653300636756,VIS 142,A04,088890,Stalbaum; Brett,8,0,15,7
1653300636756,VIS 142,A05,088891,Stalbaum; Brett,14,0,15,1
1653300636756,VIS 142,A06,094828,Stalbaum; Brett,15,0,15,0
1653300637286,VIS 143,A00,088892,Akten; Mehmet,11,0,22,11
1653300637809,VIS 147A,A01,088894,Stalbaum; Brett,20,0,22,2
1653300637809,VIS 147A,A02,088895,Stalbaum; Brett,17,0,22,5
1653300638342,VIS 149,A00,088896,Akten; Mehmet,11,0,15,4
1653300638864,VIS 150,A00,093893,Tufenkian; Armand Yervant,24,0,30,6
1653300639389,VIS 151A,A00,088897,Williams; Alena J,13,0,15,2
1653300639914,VIS 163,A00,088901,Bratton; Benjamin H.,75,0,75,0
1653300640450,VIS 164,A00,088902,Nakayama; Yue,22,0,22,0
1653300640974,VIS 165A,A00,093892,Cross; Brian R,19,0,22,3
1653300641497,VIS 167,A00,088903,Ortiz-Torres; Ruben,19,0,22,3
1653300642022,VIS 174,A00,088905,Staff,21,0,22,1
1653300642022,VIS 174,B00,088906,Kauffmann; Casey,22,0,22,0
1653300642545,VIS 175,A00,093891,Staff,18,0,22,4
1653300643069,VIS 177,A00,088907,Segade; Alexandro Abraham,20,0,22,2
1653300643601,VIS 178,A00,093890,Staff,17,0,22,5
1653300644125,VIS 179,A00,093889,Kauffmann; Casey,21,0,22,1
1653300644651,VIS 180A,A00,093888,Nakayama; Yue,16,0,22,6
1653300645185,VIS 180B,A00,088908,Miller; Nicole L,21,0,22,1
1653300645712,VIS 183A,A00,088909,Sepuya; Paul Mpagi,20,0,22,2
1653300646239,WCWP 10A,001,086588,Gagnon; Jeffrey C,15,0,15,0
1653300646239,WCWP 10A,002,086589,Gagnon; Jeffrey C,14,0,15,1
1653300646239,WCWP 10A,003,086590,Gagnon; Jeffrey C,15,0,15,0
1653300646239,WCWP 10A,004,086591,Gagnon; Jeffrey C,15,0,15,0
1653300646239,WCWP 10A,005,086592,Gagnon; Jeffrey C,15,0,15,0
1653300646239,WCWP 10A,006,086593,Gagnon; Jeffrey C,15,0,15,0
1653300646239,WCWP 10A,007,086594,Gagnon; Jeffrey C,15,0,15,0
1653300646239,WCWP 10A,008,086595,Gagnon; Jeffrey C,15,0,15,0
1653300646239,WCWP 10A,009,086596,Gagnon; Jeffrey C,15,0,15,0
1653300646239,WCWP 10A,010,086597,Gagnon; Jeffrey C,15,0,15,0
1653300646239,WCWP 10A,011,086598,Gagnon; Jeffrey C,20,0,20,0
1653300646239,WCWP 10A,012,086599,Gagnon; Jeffrey C,20,0,20,0
1653300646239,WCWP 10A,013,086600,Gagnon; Jeffrey C,20,0,20,0
1653300646239,WCWP 10A,014,086601,Gagnon; Jeffrey C,20,0,20,0
1653300646239,WCWP 10A,015,086602,Gagnon; Jeffrey C,20,0,20,0
1653300646239,WCWP 10A,016,086603,Gagnon; Jeffrey C,20,0,20,0
1653300646239,WCWP 10A,017,086604,Gagnon; Jeffrey C,20,0,20,0
1653300646239,WCWP 10A,018,086605,Gagnon; Jeffrey C,19,0,20,1
1653300646239,WCWP 10A,019,086606,Gagnon; Jeffrey C,19,0,20,1
1653300646239,WCWP 10A,020,086607,Gagnon; Jeffrey C,20,0,20,0
1653300646239,WCWP 10A,021,086608,Gagnon; Jeffrey C,20,0,20,0
1653300646239,WCWP 10A,022,086609,Gagnon; Jeffrey C,20,0,20,0
1653300646239,WCWP 10A,023,086610,Gagnon; Jeffrey C,19,0,20,1
1653300646239,WCWP 10A,024,086611,Gagnon; Jeffrey C,20,0,20,0
1653300646239,WCWP 10A,025,086612,Gagnon; Jeffrey C,0,0,0,0
1653300646239,WCWP 10A,026,086613,Gagnon; Jeffrey C,0,0,0,0
1653300646239,WCWP 10A,027,086614,Gagnon; Jeffrey C,0,0,0,0
1653300646239,WCWP 10A,028,086615,Gagnon; Jeffrey C,0,0,0,0
1653300646239,WCWP 10A,029,086616,Gagnon; Jeffrey C,0,0,0,0
1653300646239,WCWP 10A,030,086617,Gagnon; Jeffrey C,15,0,15,0
1653300646239,WCWP 10A,031,086618,Gagnon; Jeffrey C,15,0,15,0
1653300646239,WCWP 10A,032,093687,Gagnon; Jeffrey C,15,0,15,0
1653300646239,WCWP 10A,033,093688,Gagnon; Jeffrey C,15,0,15,0
1653300646239,WCWP 10A,034,093689,Gagnon; Jeffrey C,0,0,0,0
1653300646239,WCWP 10A,035,093690,Gagnon; Jeffrey C,0,0,0,0
1653300646858,WCWP 10B,003,086621,Gagnon; Jeffrey C,0,0,0,0
1653300646858,WCWP 10B,004,086622,Gagnon; Jeffrey C,16,0,20,4
1653300646858,WCWP 10B,005,086623,Gagnon; Jeffrey C,18,0,20,2
1653300646858,WCWP 10B,006,086624,Gagnon; Jeffrey C,20,0,20,0
1653300646858,WCWP 10B,007,086625,Gagnon; Jeffrey C,0,0,0,0
1653300647382,WCWP 100,A00,086626,McCleary; Keith Long,20,0,20,0
1653300647382,WCWP 100,B00,086627,McCleary; Keith Long,20,0,20,0
1653300647382,WCWP 100,C00,086628,McCleary; Keith Long,18,0,20,2
1653300647382,WCWP 100,D00,086629,Twohig; Niall Ivan,17,0,20,3
1653300647382,WCWP 100,E00,086630,Twohig; Niall Ivan,17,0,20,3
1653300647382,WCWP 100,F00,086631,Twohig; Niall Ivan,18,0,20,2
1653300647382,WCWP 100,G00,086632,Young; Mark T,20,0,20,0
1653300647382,WCWP 100,H00,086633,Young; Mark T,20,0,20,0
1653300705723,AAS 10,A01,085689,Butler; Elizabeth Annette,28,0,34,6
1653300705723,AAS 10,A02,085690,Butler; Elizabeth Annette,34,0,34,0
1653300706250,AAS 170,A00,085691,Butler; Elizabeth Annette,30,0,32,2
1653300706774,AIP 197,001,085683,Staff,100,0,100,0
1653300706774,AIP 197,002,085684,Rao; Ramesh R,50,0,50,0
1653300707309,AIP 197DC,001,085696,Anderson; Patrick W.,27,0,27,0
1653300707847,AIP 197T,A00,085685,Anderson; Patrick W.,15,0,15,0
1653300708383,ANAR 100,A00,094326,Fortier; Jana,22,0,25,3
1653300708909,ANAR 104,A01,085846,Staff,13,0,15,2
1653300709435,ANAR 120,A00,085847,Staff,15,0,15,0
1653300709962,ANAR 143,A00,094288,Staff,31,0,32,1
1653300710485,ANBI 100,A00,085849,Marchetto; Maria Carolina,31,0,34,3
1653300711008,ANBI 112,A00,085850,Marchetto; Maria Carolina,21,0,28,7
1653300711535,ANBI 118,A00,085851,Fox; Patrick Keolu Ozer,32,0,32,0
1653300712068,ANBI 136,A00,085852,Semendeferi; Ekaterini,20,0,22,2
1653300712590,ANBI 141,A00,085854,Gagneux; Pascal,186,0,192,6
1653300713114,ANBI 145,A00,085855,Staff,30,0,32,2
1653300713638,ANBI 175,A00,085857,Staff,30,0,32,2
1653300714162,ANSC 104,A00,094290,Yeh; Rihan Wen Xin,40,0,46,6
1653300714686,ANSC 105,A00,085859,Olivas Hernandez; Olga Lid,36,0,37,1
1653300715210,ANSC 120,A00,085860,Jassal; Aftab,51,0,56,5
1653300715733,ANSC 121,A00,085861,Staff,29,0,32,3
1653300716780,ANSC 148,A00,085866,Staff,71,0,73,2
1653300717329,ANSC 169,A00,085869,Fortier; Jana,23,0,25,2
1653300717855,ANSC 175,A00,085871,Pedersen; David,28,0,32,4
1653300718378,ANTH 1,A00,085803,Varma; Saiba,146,0,146,0
1653300718903,ANTH 2,A01,085805,Staff,43,0,44,1
1653300718903,ANTH 2,A02,085806,Staff,42,0,44,2
1653300718903,ANTH 2,A03,085807,Staff,44,0,44,0
1653300718903,ANTH 2,A04,085808,Staff,44,0,44,0
1653300718903,ANTH 2,A05,085809,Staff,40,0,40,0
1653300719426,ANTH 4,A01,085811,Yeh; Rihan Wen Xin,32,0,32,0
1653300719426,ANTH 4,A02,095113,Yeh; Rihan Wen Xin,32,0,32,0
1653300719426,ANTH 4,A03,095114,Yeh; Rihan Wen Xin,32,0,32,0
1653300719426,ANTH 4,A04,095115,Yeh; Rihan Wen Xin,34,0,34,0
1653300719951,ANTH 10,A00,085814,Stewart; Alexander B,215,0,216,1
1653300720482,ANTH 21,A01,085816,Kang; Byung Chu,35,0,35,0
1653300720482,ANTH 21,A02,085817,Kang; Byung Chu,35,0,35,0
1653300720482,ANTH 21,A03,085818,Kang; Byung Chu,35,0,35,0
1653300720482,ANTH 21,A04,085819,Kang; Byung Chu,35,0,35,0
1653300720482,ANTH 21,A05,085820,Kang; Byung Chu,33,0,35,2
1653300720482,ANTH 21,A06,085821,Kang; Byung Chu,33,0,35,2
1653300720482,ANTH 21,A07,085822,Kang; Byung Chu,35,0,35,0
1653300720482,ANTH 21,A08,085823,Kang; Byung Chu,35,0,35,0
1653300720482,ANTH 21,A09,085824,Kang; Byung Chu,0,0,0,0
1653300720482,ANTH 21,A10,085825,Kang; Byung Chu,0,0,0,0
1653300720482,ANTH 21,A11,095111,Kang; Byung Chu,30,0,30,0
1653300720482,ANTH 21,A12,095112,Kang; Byung Chu,30,0,30,0
1653300720482,ANTH 21,B01,085827,Staff,36,0,36,0
1653300720482,ANTH 21,B02,085828,Staff,36,0,36,0
1653300720482,ANTH 21,B03,085829,Staff,36,0,36,0
1653300720482,ANTH 21,B04,085830,Staff,38,0,38,0
1653300721011,ANTH 23,A01,085832,Stewart; Alexander B,31,0,31,0
1653300721011,ANTH 23,A02,085833,Stewart; Alexander B,31,0,31,0
1653300721011,ANTH 23,A03,085834,Stewart; Alexander B,31,0,31,0
1653300721011,ANTH 23,A04,085835,Stewart; Alexander B,31,0,31,0
1653300721011,ANTH 23,A05,085836,Stewart; Alexander B,31,0,31,0
1653300721011,ANTH 23,A06,085837,Stewart; Alexander B,0,0,0,0
1653300721011,ANTH 23,A07,085838,Stewart; Alexander B,0,0,0,0
1653300721535,ANTH 87,A00,085842,Staff,20,0,20,0
1653300721535,ANTH 87,B00,085843,Staff,20,0,20,0
1653300722061,ANTH 101,A01,085873,Goldstein; Paul S,33,0,36,3
1653300722061,ANTH 101,A02,085874,Goldstein; Paul S,33,0,36,3
1653300722061,ANTH 101,A03,085875,Goldstein; Paul S,36,0,36,0
1653300722061,ANTH 101,A04,085876,Goldstein; Paul S,36,0,38,2
1653300722584,ANTH 105,A00,085877,Staff,39,0,40,1
1653300723107,ANTH 108,A00,085878,Staff,31,0,32,1
1653300723634,ANTH 192,A00,094234,Kaiser; Bronwyn Nicole & Non; Amy L,20,0,20,0
1653300724161,ANTH 196A,A00,085879,Varma; Saiba,20,0,20,0
1653300724701,AWP 3,001,085697,Staff,13,0,13,0
1653300724701,AWP 3,002,085698,Staff,13,0,13,0
1653300724701,AWP 3,003,085699,Staff,13,0,13,0
1653300724701,AWP 3,004,085700,Staff,0,0,0,0
1653300724701,AWP 3,005,085701,Staff,0,0,0,0
1653300724701,AWP 3,006,085703,Staff,0,0,0,0
1653300724701,AWP 3,007,085704,Staff,13,0,13,0
1653300724701,AWP 3,008,085707,Staff,0,0,0,0
1653300724701,AWP 3,009,085709,Staff,13,0,13,0
1653300724701,AWP 3,010,085710,Staff,13,0,13,0
1653300724701,AWP 3,011,085711,Staff,0,0,0,0
1653300724701,AWP 3,012,085712,Staff,0,0,0,0
1653300724701,AWP 3,013,085713,Staff,13,0,13,0
1653300724701,AWP 3,014,085715,Staff,13,0,13,0
1653300724701,AWP 3,015,085717,Staff,13,0,13,0
1653300724701,AWP 3,016,085719,Staff,13,0,13,0
1653300724701,AWP 3,017,085720,Staff,13,0,13,0
1653300724701,AWP 3,018,085721,Staff,13,0,13,0
1653300724701,AWP 3,019,085722,Staff,13,0,13,0
1653300724701,AWP 3,020,085723,Staff,13,0,13,0
1653300724701,AWP 3,021,085724,Staff,13,0,13,0
1653300724701,AWP 3,022,085725,Staff,13,0,13,0
1653300724701,AWP 3,023,085726,Staff,13,0,13,0
1653300724701,AWP 3,024,085727,Staff,13,0,13,0
1653300724701,AWP 3,025,085728,Staff,13,0,13,0
1653300724701,AWP 3,026,085729,Staff,13,0,13,0
1653300724701,AWP 3,027,085730,Staff,13,0,13,0
1653300724701,AWP 3,028,085731,Staff,13,0,13,0
1653300724701,AWP 3,029,085732,Staff,13,0,13,0
1653300724701,AWP 3,030,085733,Staff,13,0,13,0
1653300724701,AWP 3,031,085734,Staff,13,0,13,0
1653300724701,AWP 3,032,085735,Staff,13,0,13,0
1653300724701,AWP 3,033,085736,Staff,13,0,13,0
1653300724701,AWP 3,034,085737,Staff,13,0,13,0
1653300724701,AWP 3,035,085738,Staff,13,0,13,0
1653300724701,AWP 3,036,085739,Staff,13,0,13,0
1653300724701,AWP 3,037,085740,Staff,13,0,13,0
1653300724701,AWP 3,038,085741,Staff,13,0,13,0
1653300724701,AWP 3,039,085742,Staff,13,0,13,0
1653300724701,AWP 3,040,085743,Staff,13,0,13,0
1653300724701,AWP 3,041,085744,Staff,13,0,13,0
1653300724701,AWP 3,042,085745,Staff,13,0,13,0
1653300724701,AWP 3,043,085746,Staff,13,0,13,0
1653300724701,AWP 3,044,085747,Staff,13,0,13,0
1653300724701,AWP 3,045,085748,Staff,13,0,13,0
1653300724701,AWP 3,046,085749,Staff,13,0,13,0
1653300724701,AWP 3,047,085750,Staff,13,0,13,0
1653300724701,AWP 3,048,085751,Staff,13,0,13,0
1653300724701,AWP 3,049,085752,Staff,13,0,13,0
1653300724701,AWP 3,050,085753,Staff,13,0,13,0
1653300724701,AWP 3,051,085754,Staff,13,0,13,0
1653300724701,AWP 3,052,085755,Staff,0,0,0,0
1653300724701,AWP 3,053,085756,Staff,13,0,13,0
1653300724701,AWP 3,054,085757,Staff,0,0,0,0
1653300724701,AWP 3,055,085758,Staff,13,0,13,0
1653300724701,AWP 3,056,085759,Staff,13,0,13,0
1653300724701,AWP 3,057,085760,Staff,13,0,13,0
1653300724701,AWP 3,058,085761,Staff,13,0,13,0
1653300724701,AWP 3,059,085762,Staff,13,0,13,0
1653300724701,AWP 3,060,085763,Staff,13,0,13,0
1653300724701,AWP 3,061,085764,Staff,13,0,13,0
1653300724701,AWP 3,062,085765,Staff,13,0,13,0
1653300724701,AWP 3,063,085766,Staff,13,0,13,0
1653300724701,AWP 3,064,085767,Staff,13,0,13,0
1653300724701,AWP 3,065,085768,Staff,13,0,13,0
1653300724701,AWP 3,066,085769,Staff,0,0,0,0
1653300725226,AWP 4A,001,085770,Staff,0,0,0,0
1653300725226,AWP 4A,002,085771,Staff,13,0,13,0
1653300725226,AWP 4A,003,085772,Staff,13,0,13,0
1653300725226,AWP 4A,004,085773,Staff,13,0,13,0
1653300725226,AWP 4A,005,085774,Staff,0,0,0,0
1653300725226,AWP 4A,006,085775,Staff,13,0,13,0
1653300725226,AWP 4A,007,085776,Staff,0,0,0,0
1653300725226,AWP 4A,008,085777,Staff,0,0,0,0
1653300725226,AWP 4A,009,085778,Staff,0,0,0,0
1653300725226,AWP 4A,010,085779,Staff,13,0,13,0
1653300725226,AWP 4A,011,085780,Staff,13,0,13,0
1653300725226,AWP 4A,012,085781,Staff,0,0,0,0
1653300725226,AWP 4A,013,085782,Staff,13,0,13,0
1653300725226,AWP 4A,014,085783,Staff,13,0,13,0
1653300725226,AWP 4A,015,085784,Staff,13,0,13,0
1653300725226,AWP 4A,016,085785,Staff,13,0,13,0
1653300725226,AWP 4A,017,085786,Staff,13,0,13,0
1653300725226,AWP 4A,018,085787,Staff,0,0,0,0
1653300725226,AWP 4A,019,085788,Staff,13,0,13,0
1653300725226,AWP 4A,020,085789,Staff,13,0,13,0
1653300725226,AWP 4A,021,085790,Staff,0,0,0,0
1653300725226,AWP 4A,022,085791,Staff,13,0,13,0
1653300725226,AWP 4A,023,085792,Staff,0,0,0,0
1653300725226,AWP 4A,024,085793,Staff,0,0,0,0
1653300725226,AWP 4A,025,085794,Staff,13,0,13,0
1653300725226,AWP 4A,026,085795,Staff,13,0,13,0
1653300725226,AWP 4A,027,085796,Staff,13,0,13,0
1653300725226,AWP 4A,028,085797,Staff,13,0,13,0
1653300725226,AWP 4A,029,085798,Staff,0,0,0,0
1653300725226,AWP 4A,030,085799,Staff,0,0,0,0
1653300725226,AWP 4A,031,093835,Staff,0,0,0,0
1653300725749,AWP 4B,001,085800,Staff,0,0,0,0
1653300725749,AWP 4B,002,085801,Staff,0,0,0,0
1653300726272,BENG 2,A00,085936,Wheeler; Bruce Christopher,28,0,30,2
1653300726801,BENG 110,A01,085939,Mc Culloch; Andrew Douglas,20,0,30,10
1653300726801,BENG 110,A02,085940,Mc Culloch; Andrew Douglas,18,0,30,12
1653300726801,BENG 110,A03,085941,Mc Culloch; Andrew Douglas,27,0,30,3
1653300727326,BENG 119A,A01,085943,Wheeler; Bruce Christopher,29,0,30,1
1653300727857,BENG 122A,A01,085945,Cauwenberghs; Gert,18,0,25,7
1653300727857,BENG 122A,A02,085946,Cauwenberghs; Gert,22,0,25,3
1653300727857,BENG 122A,A03,085947,Cauwenberghs; Gert,22,0,25,3
1653300728384,BENG 126A,A01,085949,Wheeler; Bruce Christopher,30,0,30,0
1653300728911,BENG 127A,A01,085951,Wheeler; Bruce Christopher,28,0,30,2
1653300729435,BENG 128A,A01,085953,Wheeler; Bruce Christopher,29,0,30,1
1653300729959,BENG 134,A01,085955,Smarr; Benjamin,0,0,0,0
1653300730484,BENG 135,A00,085956,Wheeler; Bruce Christopher,23,0,30,7
1653300731007,BENG 141,A00,085958,Lal; Ratnesh,20,0,30,10
1653300731531,BENG 147A,A01,085963,Wheeler; Bruce Christopher,30,0,30,0
1653300732054,BENG 148A,A01,085967,Wheeler; Bruce Christopher,30,0,30,0
1653300732578,BENG 149A,A01,085969,Wheeler; Bruce Christopher,30,0,30,0
1653300733105,BENG 161A,A01,085971,Fraley; Stephanie I.,20,0,25,5
1653300733105,BENG 161A,A02,085972,Fraley; Stephanie I.,13,0,25,12
1653300733105,BENG 161A,A03,085973,Fraley; Stephanie I.,9,0,25,16
1653300733639,BENG 162,A01,085975,Mali; Prashant Gulab Ram,0,0,35,35
1653300733639,BENG 162,A02,085976,Mali; Prashant Gulab Ram,26,0,35,9
1653300734164,BENG 166A,A00,085977,Sah; Robert Lie-Yuan,0,0,0,0
1653300734690,BENG 169A,A01,085982,Wheeler; Bruce Christopher,28,0,30,2
1653300735231,BENG 179A,A01,085984,Wheeler; Bruce Christopher,30,0,30,0
1653300735756,BENG 183,A01,085986,Zhong; Sheng,13,0,30,17
1653300735756,BENG 183,A02,085987,Zhong; Sheng,15,0,30,15
1653300735756,BENG 183,A03,085988,Zhong; Sheng,20,0,30,10
1653300736282,BENG 187B,A00,085989,Wheeler; Bruce Christopher,105,0,170,65
1653300736812,BENG 196,001,094047,Engler; Adam J.,9999,0,9999,0
1653300737336,BIBC 100,A01,092918,Huffaker; Alisa,0,0,19,19
1653300737336,BIBC 100,A02,092919,Huffaker; Alisa,19,0,19,0
1653300737336,BIBC 100,A03,092920,Huffaker; Alisa,18,0,19,1
1653300737336,BIBC 100,A04,092921,Huffaker; Alisa,18,0,19,1
1653300737336,BIBC 100,A05,092922,Huffaker; Alisa,19,0,19,0
1653300737336,BIBC 100,A06,092923,Huffaker; Alisa,18,0,19,1
1653300737336,BIBC 100,A07,092924,Huffaker; Alisa,10,0,19,9
1653300737336,BIBC 100,A08,092925,Huffaker; Alisa,17,0,19,2
1653300737336,BIBC 100,A09,092926,Huffaker; Alisa,19,0,19,0
1653300737336,BIBC 100,A10,092927,Huffaker; Alisa,11,0,19,8
1653300737861,BIBC 102,A01,092997,Schmelz; Eric Alexander,16,0,19,3
1653300737861,BIBC 102,A02,092998,Schmelz; Eric Alexander,5,0,19,14
1653300737861,BIBC 102,A03,092999,Schmelz; Eric Alexander,1,0,19,18
1653300737861,BIBC 102,A04,093000,Schmelz; Eric Alexander,17,0,19,2
1653300737861,BIBC 102,A05,093001,Schmelz; Eric Alexander,9,0,19,10
1653300737861,BIBC 102,A06,093002,Schmelz; Eric Alexander,16,0,19,3
1653300737861,BIBC 102,A07,093003,Schmelz; Eric Alexander,19,0,19,0
1653300737861,BIBC 102,A08,093004,Schmelz; Eric Alexander,19,0,19,0
1653300737861,BIBC 102,A09,093005,Schmelz; Eric Alexander,14,0,19,5
1653300737861,BIBC 102,B01,093064,Coleman; Aaron B.,19,0,19,0
1653300737861,BIBC 102,B02,093065,Coleman; Aaron B.,17,0,19,2
1653300737861,BIBC 102,B03,093066,Coleman; Aaron B.,16,0,19,3
1653300737861,BIBC 102,B04,093067,Coleman; Aaron B.,11,0,19,8
1653300737861,BIBC 102,B05,093068,Coleman; Aaron B.,18,0,19,1
1653300737861,BIBC 102,B06,093069,Coleman; Aaron B.,16,0,19,3
1653300737861,BIBC 102,B07,093070,Coleman; Aaron B.,19,0,19,0
1653300737861,BIBC 102,B08,093071,Coleman; Aaron B.,15,0,19,4
1653300737861,BIBC 102,B09,093072,Coleman; Aaron B.,17,0,19,2
1653300738388,BIBC 103,A01,089887,Bozinovic; Goran,19,0,24,5
1653300738388,BIBC 103,A02,089888,Bozinovic; Goran,23,0,24,1
1653300738388,BIBC 103,B01,089890,Burg; Michael,1,0,24,23
1653300738388,BIBC 103,B02,089891,Burg; Michael,20,0,24,4
1653300738388,BIBC 103,C01,089893,Beyhan; Sinem,14,0,24,10
1653300738388,BIBC 103,C02,089894,Beyhan; Sinem,22,0,24,2
1653300738388,BIBC 103,D01,089896,Coleman; Aaron B.,10,0,24,14
1653300738388,BIBC 103,D02,089897,Coleman; Aaron B.,22,0,24,2
1653300738914,BIBC 194,A00,089898,Hui; Enfu,16,0,27,11
1653300739445,BICD 100,A01,092396,Smith; Laurie,21,0,22,1
1653300739445,BICD 100,A02,092397,Smith; Laurie,22,0,22,0
1653300739445,BICD 100,A03,092398,Smith; Laurie,21,0,22,1
1653300739445,BICD 100,A04,092399,Smith; Laurie,22,0,22,0
1653300739445,BICD 100,A05,092400,Smith; Laurie,21,0,22,1
1653300739445,BICD 100,A06,092401,Smith; Laurie,22,0,22,0
1653300739445,BICD 100,A07,092402,Smith; Laurie,22,0,22,0
1653300739445,BICD 100,A08,092403,Smith; Laurie,22,0,22,0
1653300739445,BICD 100,B01,093073,Mueller; Liam O'Connor,21,0,22,1
1653300739445,BICD 100,B02,093074,Mueller; Liam O'Connor,22,0,22,0
1653300739445,BICD 100,B03,093075,Mueller; Liam O'Connor,22,0,22,0
1653300739445,BICD 100,B04,093076,Mueller; Liam O'Connor,22,0,22,0
1653300739445,BICD 100,B05,093077,Mueller; Liam O'Connor,22,0,22,0
1653300739445,BICD 100,B06,093078,Mueller; Liam O'Connor,22,0,22,0
1653300739445,BICD 100,B07,093079,Mueller; Liam O'Connor,21,0,22,1
1653300739445,BICD 100,B08,093080,Mueller; Liam O'Connor,22,0,22,0
1653300739445,BICD 100,C01,093021,McDonnell; Lisa Marie,21,0,22,1
1653300739445,BICD 100,C02,093022,McDonnell; Lisa Marie,20,0,22,2
1653300739445,BICD 100,C03,093023,McDonnell; Lisa Marie,22,0,22,0
1653300739445,BICD 100,C04,093024,McDonnell; Lisa Marie,22,0,22,0
1653300739445,BICD 100,C05,093025,McDonnell; Lisa Marie,22,0,22,0
1653300739445,BICD 100,C06,093026,McDonnell; Lisa Marie,22,0,22,0
1653300739445,BICD 100,C07,093027,McDonnell; Lisa Marie,20,0,22,2
1653300739445,BICD 100,C08,093028,McDonnell; Lisa Marie,22,0,22,0
1653300739445,BICD 100,D01,093081,Day; Christopher D,22,0,22,0
1653300739445,BICD 100,D02,093082,Day; Christopher D,17,0,22,5
1653300739445,BICD 100,D03,093083,Day; Christopher D,21,0,22,1
1653300739445,BICD 100,D04,093084,Day; Christopher D,19,0,22,3
1653300739445,BICD 100,D05,093085,Day; Christopher D,22,0,22,0
1653300739445,BICD 100,D06,093086,Day; Christopher D,20,0,22,2
1653300739445,BICD 100,D07,093087,Day; Christopher D,19,0,22,3
1653300739445,BICD 100,D08,093088,Day; Christopher D,20,0,22,2
1653300739988,BICD 110,A01,093089,Kiger; Amy,29,0,32,3
1653300739988,BICD 110,A02,093091,Kiger; Amy,32,0,32,0
1653300739988,BICD 110,A03,093092,Kiger; Amy,31,0,32,1
1653300739988,BICD 110,A04,093093,Kiger; Amy,31,0,32,1
1653300739988,BICD 110,A05,093094,Kiger; Amy,26,0,32,6
1653300739988,BICD 110,A06,093095,Kiger; Amy,31,0,32,1
1653300739988,BICD 110,A07,093096,Kiger; Amy,31,0,32,1
1653300739988,BICD 110,B01,093029,Grossman; Emily N,21,0,32,11
1653300739988,BICD 110,B02,093030,Grossman; Emily N,28,0,32,4
1653300739988,BICD 110,B03,093031,Grossman; Emily N,32,0,32,0
1653300739988,BICD 110,B04,093032,Grossman; Emily N,28,0,32,4
1653300739988,BICD 110,B05,093033,Grossman; Emily N,26,0,32,6
1653300739988,BICD 110,B06,093034,Grossman; Emily N,19,0,32,13
1653300739988,BICD 110,B07,093035,Grossman; Emily N,20,0,32,12
1653300740516,BICD 140,A01,093097,Zuniga; Elina I,19,0,32,13
1653300740516,BICD 140,A02,093098,Zuniga; Elina I,17,0,32,15
1653300740516,BICD 140,A03,093099,Zuniga; Elina I,30,0,32,2
1653300740516,BICD 140,A04,093100,Zuniga; Elina I,32,0,32,0
1653300740516,BICD 140,A05,093101,Zuniga; Elina I,29,0,32,3
1653300740516,BICD 140,A06,093102,Zuniga; Elina I,27,0,32,5
1653300741045,BIEB 102,A01,092528,Butler; Shannon Rhey,22,0,27,5
1653300741045,BIEB 102,A02,092529,Butler; Shannon Rhey,17,0,27,10
1653300741045,BIEB 102,A03,092530,Butler; Shannon Rhey,24,0,27,3
1653300741045,BIEB 102,A04,092531,Butler; Shannon Rhey,26,0,27,1
1653300741045,BIEB 102,A05,092532,Butler; Shannon Rhey,25,0,27,2
1653300741045,BIEB 102,A06,092533,Butler; Shannon Rhey,24,0,27,3
1653300741045,BIEB 102,A07,092534,Butler; Shannon Rhey,23,0,27,4
1653300741568,BIEB 121,A00,089907,Holway; David A.,0,0,32,32
1653300742091,BIEB 126,A01,092974,Kohn; Joshua R,24,0,27,3
1653300742091,BIEB 126,A02,092975,Kohn; Joshua R,26,0,27,1
1653300742091,BIEB 126,A03,092976,Kohn; Joshua R,23,0,27,4
1653300742091,BIEB 126,A04,092977,Kohn; Joshua R,25,0,27,2
1653300742091,BIEB 126,A05,092978,Kohn; Joshua R,27,0,27,0
1653300742624,BIEB 146,A01,093054,Petrie; Katherine Lynn,1,0,27,26
1653300742624,BIEB 146,A02,093055,Petrie; Katherine Lynn,4,0,27,23
1653300742624,BIEB 146,A03,093056,Petrie; Katherine Lynn,0,0,27,27
1653300742624,BIEB 146,A04,093057,Petrie; Katherine Lynn,0,0,27,27
1653300742624,BIEB 146,A05,093058,Petrie; Katherine Lynn,20,0,27,7
1653300742624,BIEB 146,A06,093059,Petrie; Katherine Lynn,26,0,27,1
1653300742624,BIEB 146,A07,093060,Petrie; Katherine Lynn,16,0,27,11
1653300742624,BIEB 146,A08,093061,Petrie; Katherine Lynn,25,0,27,2
1653300742624,BIEB 146,A09,093062,Petrie; Katherine Lynn,17,0,27,10
1653300743149,BIEB 150,A01,093103,Rennison; Diana,16,0,27,11
1653300743149,BIEB 150,A02,093104,Rennison; Diana,21,0,27,6
1653300743149,BIEB 150,A03,093105,Rennison; Diana,26,0,27,1
1653300743149,BIEB 150,A04,093106,Rennison; Diana,24,0,27,3
1653300743149,BIEB 150,A05,093107,Rennison; Diana,25,0,27,2
1653300743149,BIEB 150,A06,093108,Rennison; Diana,27,0,27,0
1653300743686,BIEB 158,A01,094057,Reese; Aspen Taylor & Jackrel; Sara,31,0,32,1
1653300743686,BIEB 158,A02,094058,Reese; Aspen Taylor & Jackrel; Sara,28,0,32,4
1653300743686,BIEB 158,A03,094059,Reese; Aspen Taylor & Jackrel; Sara,31,0,32,1
1653300743686,BIEB 158,A04,094060,Reese; Aspen Taylor & Jackrel; Sara,32,0,32,0
1653300744215,BIEB 174,A01,092465,Cleland; Elsa Eleanor & Barton; Andrew David,27,0,27,0
1653300744215,BIEB 174,A02,092466,Cleland; Elsa Eleanor & Barton; Andrew David,27,0,27,0
1653300744215,BIEB 174,A03,092467,Cleland; Elsa Eleanor & Barton; Andrew David,23,0,27,4
1653300744215,BIEB 174,A04,092468,Cleland; Elsa Eleanor & Barton; Andrew David,20,0,27,7
1653300744215,BIEB 174,A05,092469,Cleland; Elsa Eleanor & Barton; Andrew David,25,0,27,2
1653300744215,BIEB 174,A06,092470,Cleland; Elsa Eleanor & Barton; Andrew David,27,0,27,0
1653300744215,BIEB 174,A07,092471,Cleland; Elsa Eleanor & Barton; Andrew David,25,0,27,2
1653300744744,BILD 1,A01,092884,Pickett; Brooke Elizabeth,16,0,19,3
1653300744744,BILD 1,A02,092885,Pickett; Brooke Elizabeth,19,0,19,0
1653300744744,BILD 1,A03,092886,Pickett; Brooke Elizabeth,19,0,19,0
1653300744744,BILD 1,A04,092887,Pickett; Brooke Elizabeth,18,0,19,1
1653300744744,BILD 1,A05,092888,Pickett; Brooke Elizabeth,19,0,19,0
1653300744744,BILD 1,A06,092889,Pickett; Brooke Elizabeth,19,0,19,0
1653300744744,BILD 1,A07,092890,Pickett; Brooke Elizabeth,17,0,19,2
1653300744744,BILD 1,B01,092891,Pekkurnaz Banghart; Gulcin,19,0,19,0
1653300744744,BILD 1,B02,092892,Pekkurnaz Banghart; Gulcin,16,0,19,3
1653300744744,BILD 1,B03,092893,Pekkurnaz Banghart; Gulcin,19,0,19,0
1653300744744,BILD 1,B04,092894,Pekkurnaz Banghart; Gulcin,19,0,19,0
1653300744744,BILD 1,B05,092895,Pekkurnaz Banghart; Gulcin,17,0,19,2
1653300744744,BILD 1,B06,092896,Pekkurnaz Banghart; Gulcin,19,0,19,0
1653300744744,BILD 1,B07,092897,Pekkurnaz Banghart; Gulcin,19,0,19,0
1653300744744,BILD 1,C01,092421,Meaders; Clara Leigh,18,0,19,1
1653300744744,BILD 1,C02,092422,Meaders; Clara Leigh,18,0,19,1
1653300744744,BILD 1,C03,092423,Meaders; Clara Leigh,17,0,19,2
1653300744744,BILD 1,C04,092424,Meaders; Clara Leigh,16,0,19,3
1653300744744,BILD 1,C05,092425,Meaders; Clara Leigh,19,0,19,0
1653300744744,BILD 1,C06,092426,Meaders; Clara Leigh,19,0,19,0
1653300744744,BILD 1,C07,092427,Meaders; Clara Leigh,19,0,19,0
1653300744744,BILD 1,D01,092428,Meaders; Clara Leigh,14,0,19,5
1653300744744,BILD 1,D02,092429,Meaders; Clara Leigh,19,0,19,0
1653300744744,BILD 1,D03,092430,Meaders; Clara Leigh,19,0,19,0
1653300744744,BILD 1,D04,092431,Meaders; Clara Leigh,19,0,19,0
1653300744744,BILD 1,D05,092432,Meaders; Clara Leigh,19,0,19,0
1653300744744,BILD 1,D06,092433,Meaders; Clara Leigh,19,0,19,0
1653300744744,BILD 1,D07,092434,Meaders; Clara Leigh,19,0,19,0
1653300744744,BILD 1,E01,092445,Cooper; Andrew Michael,19,0,19,0
1653300744744,BILD 1,E02,092446,Cooper; Andrew Michael,19,0,19,0
1653300744744,BILD 1,E03,092447,Cooper; Andrew Michael,19,0,19,0
1653300744744,BILD 1,E04,092448,Cooper; Andrew Michael,19,0,19,0
1653300744744,BILD 1,E05,092449,Cooper; Andrew Michael,17,0,19,2
1653300744744,BILD 1,E06,092450,Cooper; Andrew Michael,19,0,19,0
1653300744744,BILD 1,E07,092451,Cooper; Andrew Michael,19,0,19,0
1653300745276,BILD 2,A01,092822,Glasgow; Stacey Marie,25,0,25,0
1653300745276,BILD 2,A02,092823,Glasgow; Stacey Marie,24,0,25,1
1653300745276,BILD 2,A03,092824,Glasgow; Stacey Marie,24,0,25,1
1653300745276,BILD 2,A04,092825,Glasgow; Stacey Marie,25,0,25,0
1653300745276,BILD 2,A05,092826,Glasgow; Stacey Marie,25,0,25,0
1653300745276,BILD 2,A06,092827,Glasgow; Stacey Marie,25,0,25,0
1653300745276,BILD 2,A07,092828,Glasgow; Stacey Marie,25,0,25,0
1653300745276,BILD 2,B01,092830,Owens; Melinda Tsao-Ying,25,0,25,0
1653300745276,BILD 2,B02,092831,Owens; Melinda Tsao-Ying,21,0,25,4
1653300745276,BILD 2,B03,092832,Owens; Melinda Tsao-Ying,23,0,25,2
1653300745276,BILD 2,B04,092833,Owens; Melinda Tsao-Ying,25,0,25,0
1653300745276,BILD 2,B05,092834,Owens; Melinda Tsao-Ying,24,0,25,1
1653300745276,BILD 2,B06,092835,Owens; Melinda Tsao-Ying,21,0,25,4
1653300745276,BILD 2,B07,092836,Owens; Melinda Tsao-Ying,25,0,25,0
1653300745276,BILD 2,C01,092668,Owens; Melinda Tsao-Ying,24,0,25,1
1653300745276,BILD 2,C02,092669,Owens; Melinda Tsao-Ying,23,0,25,2
1653300745276,BILD 2,C03,092670,Owens; Melinda Tsao-Ying,22,0,25,3
1653300745276,BILD 2,C04,092671,Owens; Melinda Tsao-Ying,25,0,25,0
1653300745276,BILD 2,C05,092672,Owens; Melinda Tsao-Ying,25,0,25,0
1653300745276,BILD 2,C06,092673,Owens; Melinda Tsao-Ying,24,0,25,1
1653300745276,BILD 2,C07,092674,Owens; Melinda Tsao-Ying,25,0,25,0
1653300745810,BILD 3,A01,092454,Stockwell; Sarah R,17,0,19,2
1653300745810,BILD 3,A02,092455,Stockwell; Sarah R,17,0,19,2
1653300745810,BILD 3,A03,092456,Stockwell; Sarah R,18,0,19,1
1653300745810,BILD 3,A04,092457,Stockwell; Sarah R,19,0,19,0
1653300745810,BILD 3,A05,092458,Stockwell; Sarah R,19,0,19,0
1653300745810,BILD 3,A06,092459,Stockwell; Sarah R,18,0,19,1
1653300745810,BILD 3,A07,092460,Stockwell; Sarah R,18,0,19,1
1653300745810,BILD 3,A08,092461,Stockwell; Sarah R,19,0,19,0
1653300745810,BILD 3,A09,092462,Stockwell; Sarah R,19,0,19,0
1653300745810,BILD 3,B01,092479,Stockwell; Sarah R,19,0,19,0
1653300745810,BILD 3,B02,092480,Stockwell; Sarah R,18,0,19,1
1653300745810,BILD 3,B03,092481,Stockwell; Sarah R,18,0,19,1
1653300745810,BILD 3,B04,092482,Stockwell; Sarah R,19,0,19,0
1653300745810,BILD 3,B05,092483,Stockwell; Sarah R,19,0,19,0
1653300745810,BILD 3,B06,092484,Stockwell; Sarah R,19,0,19,0
1653300745810,BILD 3,B07,092485,Stockwell; Sarah R,19,0,19,0
1653300745810,BILD 3,B08,092486,Stockwell; Sarah R,18,0,19,1
1653300745810,BILD 3,B09,092487,Stockwell; Sarah R,18,0,19,1
1653300745810,BILD 3,C01,092412,Butler; Shannon Rhey,18,0,19,1
1653300745810,BILD 3,C02,092413,Butler; Shannon Rhey,15,0,19,4
1653300745810,BILD 3,C03,092414,Butler; Shannon Rhey,19,0,19,0
1653300745810,BILD 3,C04,092415,Butler; Shannon Rhey,19,0,19,0
1653300745810,BILD 3,C05,092416,Butler; Shannon Rhey,19,0,19,0
1653300745810,BILD 3,C06,092417,Butler; Shannon Rhey,19,0,19,0
1653300745810,BILD 3,C07,092418,Butler; Shannon Rhey,19,0,19,0
1653300745810,BILD 3,C08,092419,Butler; Shannon Rhey,19,0,19,0
1653300745810,BILD 3,C09,092420,Butler; Shannon Rhey,19,0,19,0
1653300745810,BILD 3,D01,092898,Reuther; Keefe,18,0,19,1
1653300745810,BILD 3,D02,092899,Reuther; Keefe,19,0,19,0
1653300745810,BILD 3,D03,092900,Reuther; Keefe,19,0,19,0
1653300745810,BILD 3,D04,092901,Reuther; Keefe,19,0,19,0
1653300745810,BILD 3,D05,092902,Reuther; Keefe,19,0,19,0
1653300745810,BILD 3,D06,092903,Reuther; Keefe,19,0,19,0
1653300745810,BILD 3,D07,092904,Reuther; Keefe,18,0,19,1
1653300745810,BILD 3,D08,092905,Reuther; Keefe,19,0,19,0
1653300745810,BILD 3,D09,092906,Reuther; Keefe,19,0,19,0
1653300746333,BILD 4,A01,089840,Mel; Stephanie,0,0,0,0
1653300746333,BILD 4,A02,089841,Mel; Stephanie,0,0,0,0
1653300746333,BILD 4,A03,089842,Mel; Stephanie,0,0,0,0
1653300746333,BILD 4,A04,089843,Mel; Stephanie,0,0,0,0
1653300746333,BILD 4,A05,089844,Mel; Stephanie,0,0,0,0
1653300746333,BILD 4,A06,089845,Mel; Stephanie,0,0,0,0
1653300746333,BILD 4,A07,089846,Mel; Stephanie,0,0,0,0
1653300746333,BILD 4,A08,089847,Mel; Stephanie,0,0,0,0
1653300746333,BILD 4,A09,089848,Mel; Stephanie,0,0,0,0
1653300746333,BILD 4,A10,089849,Mel; Stephanie,0,0,0,0
1653300746333,BILD 4,A11,089850,Mel; Stephanie,0,0,0,0
1653300746333,BILD 4,A12,089851,Mel; Stephanie,0,0,0,0
1653300746333,BILD 4,A13,089852,Mel; Stephanie,0,0,0,0
1653300746333,BILD 4,A14,089853,Mel; Stephanie,0,0,0,0
1653300746333,BILD 4,A15,089854,Mel; Stephanie,0,0,0,0
1653300746333,BILD 4,A16,089855,Mel; Stephanie,0,0,0,0
1653300746333,BILD 4,B01,089857,Lo; Stanley M.,0,0,0,0
1653300746333,BILD 4,B02,089858,Lo; Stanley M.,0,0,0,0
1653300746333,BILD 4,B03,089859,Lo; Stanley M.,0,0,0,0
1653300746333,BILD 4,B04,089860,Lo; Stanley M.,0,0,0,0
1653300746333,BILD 4,B05,089861,Lo; Stanley M.,0,0,0,0
1653300746333,BILD 4,B06,089862,Lo; Stanley M.,0,0,0,0
1653300746333,BILD 4,B07,089863,Lo; Stanley M.,0,0,0,0
1653300746333,BILD 4,B08,089864,Lo; Stanley M.,0,0,0,0
1653300746333,BILD 4,B09,089865,Lo; Stanley M.,0,0,0,0
1653300746333,BILD 4,B10,089866,Lo; Stanley M.,0,0,0,0
1653300746333,BILD 4,B11,089867,Lo; Stanley M.,0,0,0,0
1653300746333,BILD 4,B12,089868,Lo; Stanley M.,0,0,0,0
1653300746333,BILD 4,B13,089869,Lo; Stanley M.,0,0,0,0
1653300746333,BILD 4,B14,089870,Lo; Stanley M.,0,0,0,0
1653300746333,BILD 4,B15,089871,Lo; Stanley M.,0,0,0,0
1653300746333,BILD 4,B16,089872,Lo; Stanley M.,0,0,0,0
1653300746860,BILD 5,A01,092907,Reuther; Keefe,31,0,32,1
1653300746860,BILD 5,A02,092908,Reuther; Keefe,30,0,32,2
1653300747384,BILD 10,A01,092909,Gustafson-Brown; Cindy,27,0,27,0
1653300747384,BILD 10,A02,092910,Gustafson-Brown; Cindy,27,0,27,0
1653300747384,BILD 10,A03,092911,Gustafson-Brown; Cindy,27,0,27,0
1653300747384,BILD 10,A04,092912,Gustafson-Brown; Cindy,27,0,27,0
1653300747384,BILD 10,A05,092913,Gustafson-Brown; Cindy,25,0,27,2
1653300747384,BILD 10,A06,092914,Gustafson-Brown; Cindy,26,0,27,1
1653300747384,BILD 10,A07,092915,Gustafson-Brown; Cindy,27,0,27,0
1653300747384,BILD 10,A08,092916,Gustafson-Brown; Cindy,27,0,27,0
1653300747384,BILD 10,A09,092917,Gustafson-Brown; Cindy,27,0,27,0
1653300747909,BILD 20,A01,092956,Rana; Brinda Kanti,24,0,27,3
1653300747909,BILD 20,A02,092957,Rana; Brinda Kanti,24,0,27,3
1653300747909,BILD 20,A03,092958,Rana; Brinda Kanti,27,0,27,0
1653300747909,BILD 20,A04,092959,Rana; Brinda Kanti,27,0,27,0
1653300748437,BILD 32,A01,092990,Burg; Michael,27,0,27,0
1653300748437,BILD 32,A02,092991,Burg; Michael,26,0,27,1
1653300748437,BILD 32,A03,092992,Burg; Michael,27,0,27,0
1653300748437,BILD 32,A04,092993,Burg; Michael,26,0,27,1
1653300748437,BILD 32,A05,092994,Burg; Michael,27,0,27,0
1653300748437,BILD 32,A06,092995,Burg; Michael,27,0,27,0
1653300748437,BILD 32,A07,092996,Burg; Michael,27,0,27,0
1653300748961,BILD 60,A01,092392,Hammond; LaTisha Marie,24,0,24,0
1653300748961,BILD 60,A02,092393,Hammond; LaTisha Marie,24,0,24,0
1653300748961,BILD 60,B01,092394,Macagno; Eduardo R.,23,0,24,1
1653300748961,BILD 60,B02,092395,Macagno; Eduardo R.,24,0,24,0
1653300749487,BILD 62,A01,092949,Aljadeff; Johnatan,31,0,32,1
1653300749487,BILD 62,A02,092950,Aljadeff; Johnatan,32,0,32,0
1653300749487,BILD 62,A03,092951,Aljadeff; Johnatan,32,0,32,0
1653300750014,BILD 80,A00,089880,Pogliano; Joseph,27,0,30,3
1653300750559,BIMM 100,A01,092435,Pasquinelli; Amy,32,0,32,0
1653300750559,BIMM 100,A02,092436,Pasquinelli; Amy,30,0,32,2
1653300750559,BIMM 100,A03,092437,Pasquinelli; Amy,32,0,32,0
1653300750559,BIMM 100,A04,092438,Pasquinelli; Amy,31,0,32,1
1653300750559,BIMM 100,A05,092439,Pasquinelli; Amy,32,0,32,0
1653300750559,BIMM 100,A06,092440,Pasquinelli; Amy,32,0,32,0
1653300750559,BIMM 100,A07,092441,Pasquinelli; Amy,32,0,32,0
1653300750559,BIMM 100,A08,092442,Pasquinelli; Amy,32,0,32,0
1653300750559,BIMM 100,A09,092443,Pasquinelli; Amy,32,0,32,0
1653300750559,BIMM 100,A10,092444,Pasquinelli; Amy,32,0,32,0
1653300750559,BIMM 100,B01,092518,Pruneda-Paz; Jose L.,26,0,32,6
1653300750559,BIMM 100,B02,092519,Pruneda-Paz; Jose L.,19,0,32,13
1653300750559,BIMM 100,B03,092520,Pruneda-Paz; Jose L.,20,0,32,12
1653300750559,BIMM 100,B04,092521,Pruneda-Paz; Jose L.,24,0,32,8
1653300750559,BIMM 100,B05,092522,Pruneda-Paz; Jose L.,23,0,32,9
1653300750559,BIMM 100,B06,092523,Pruneda-Paz; Jose L.,24,0,32,8
1653300750559,BIMM 100,B07,092524,Pruneda-Paz; Jose L.,28,0,32,4
1653300750559,BIMM 100,B08,092525,Pruneda-Paz; Jose L.,25,0,32,7
1653300750559,BIMM 100,B09,092526,Pruneda-Paz; Jose L.,26,0,32,6
1653300750559,BIMM 100,B10,092527,Pruneda-Paz; Jose L.,24,0,32,8
1653300751082,BIMM 101,A01,089915,Rusert; Jessica Marie,22,0,24,2
1653300751082,BIMM 101,A02,089916,Rusert; Jessica Marie,21,0,24,3
1653300751082,BIMM 101,A03,089917,Rusert; Jessica Marie,21,0,24,3
1653300751082,BIMM 101,A04,089918,Rusert; Jessica Marie,20,0,24,4
1653300751082,BIMM 101,B01,089920,Grossman; Emily N,0,0,24,24
1653300751082,BIMM 101,B02,089921,Grossman; Emily N,1,0,24,23
1653300751082,BIMM 101,C01,089923,Day; Christopher D,0,0,24,24
1653300751082,BIMM 101,C02,089924,Day; Christopher D,0,0,24,24
1653300751082,BIMM 101,D01,089926,Cooper; Andrew Michael,18,0,24,6
1653300751082,BIMM 101,D02,089927,Cooper; Andrew Michael,24,0,24,0
1653300751082,BIMM 101,E01,089929,McDonnell; Lisa Marie,1,0,24,23
1653300751082,BIMM 101,E02,089930,McDonnell; Lisa Marie,12,0,24,12
1653300751610,BIMM 110,A01,092472,Tour; Ella,26,0,32,6
1653300751610,BIMM 110,A02,092473,Tour; Ella,23,0,32,9
1653300751610,BIMM 110,A03,092474,Tour; Ella,29,0,32,3
1653300751610,BIMM 110,A04,092475,Tour; Ella,27,0,32,5
1653300751610,BIMM 110,A05,092476,Tour; Ella,32,0,32,0
1653300751610,BIMM 110,A06,092477,Tour; Ella,30,0,32,2
1653300751610,BIMM 110,A07,092478,Tour; Ella,29,0,32,3
1653300752133,BIMM 120,A01,092979,Allen; Eric,28,0,32,4
1653300752133,BIMM 120,A02,092980,Allen; Eric,1,0,32,31
1653300752133,BIMM 120,A03,092981,Allen; Eric,14,0,32,18
1653300752133,BIMM 120,A04,092982,Allen; Eric,27,0,32,5
1653300752133,BIMM 120,A05,092983,Allen; Eric,30,0,32,2
1653300752133,BIMM 120,A06,092984,Allen; Eric,29,0,32,3
1653300752133,BIMM 120,A07,092985,Allen; Eric,20,0,32,12
1653300752133,BIMM 120,A08,092986,Allen; Eric,30,0,32,2
1653300752133,BIMM 120,A09,092987,Allen; Eric,30,0,32,2
1653300752133,BIMM 120,A10,092988,Allen; Eric,30,0,32,2
1653300752133,BIMM 120,A11,092989,Allen; Eric,32,0,32,0
1653300752662,BIMM 121,A01,089934,Petrie; Katherine Lynn,0,0,24,24
1653300752662,BIMM 121,A02,089935,Petrie; Katherine Lynn,0,0,24,24
1653300752662,BIMM 121,B01,089937,Pickett; Brooke Elizabeth,0,0,24,24
1653300752662,BIMM 121,B02,089938,Pickett; Brooke Elizabeth,0,0,24,24
1653300752662,BIMM 121,C01,089940,Pirino; Giorgia,0,0,24,24
1653300752662,BIMM 121,C02,089941,Pirino; Giorgia,0,0,24,24
1653300752662,BIMM 121,C03,089942,Pirino; Giorgia,0,0,24,24
1653300752662,BIMM 121,C04,089943,Pirino; Giorgia,0,0,24,24
1653300753188,BIMM 122,A01,093006,Russell; Alistair B,18,0,32,14
1653300753188,BIMM 122,A02,093007,Russell; Alistair B,16,0,32,16
1653300753188,BIMM 122,A03,093008,Russell; Alistair B,26,0,32,6
1653300753188,BIMM 122,A04,093009,Russell; Alistair B,32,0,32,0
1653300753188,BIMM 122,A05,093010,Russell; Alistair B,30,0,32,2
1653300753713,BIMM 124,A01,092404,Gustafson-Brown; Cindy,26,0,32,6
1653300753713,BIMM 124,A02,092405,Gustafson-Brown; Cindy,29,0,32,3
1653300753713,BIMM 124,A03,092406,Gustafson-Brown; Cindy,30,0,32,2
1653300753713,BIMM 124,A04,092407,Gustafson-Brown; Cindy,32,0,32,0
1653300753713,BIMM 124,A05,092408,Gustafson-Brown; Cindy,28,0,32,4
1653300753713,BIMM 124,A06,092409,Gustafson-Brown; Cindy,31,0,32,1
1653300753713,BIMM 124,A07,092410,Gustafson-Brown; Cindy,32,0,32,0
1653300754242,BIMM 140,A01,089947,Suel; Gurol Mehmet & Hao; Nan,16,0,27,11
1653300754242,BIMM 140,A02,089948,Suel; Gurol Mehmet & Hao; Nan,24,0,27,3
1653300754242,BIMM 140,A03,089949,Suel; Gurol Mehmet & Hao; Nan,21,0,27,6
1653300754242,BIMM 140,A04,089950,Suel; Gurol Mehmet & Hao; Nan,25,0,27,2
1653300754242,BIMM 140,A05,089951,Suel; Gurol Mehmet & Hao; Nan,24,0,27,3
1653300754855,BIMM 143,A01,089953,Grant; Barry J,0,0,40,40
1653300754855,BIMM 143,B01,089955,Fan; Chun Chieh,39,0,40,1
1653300754855,BIMM 143,C01,089957,Bozinovic; Goran,29,0,40,11
1653300755379,BIMM 194,A00,089958,Hasty; Jeff M,15,0,27,12
1653300755379,BIMM 194,B00,089959,Golden; James W,19,0,27,8
1653300755379,BIMM 194,C00,089960,Lykke-Andersen; Jens,2,0,27,25
1653300755379,BIMM 194,D00,094317,Golden; Susan S.,25,0,27,2
1653300755909,BIPN 100,A01,093011,Cooke; James Edward,7,0,19,12
1653300755909,BIPN 100,A02,093012,Cooke; James Edward,10,0,19,9
1653300755909,BIPN 100,A03,093013,Cooke; James Edward,8,0,19,11
1653300755909,BIPN 100,A04,093014,Cooke; James Edward,12,0,19,7
1653300755909,BIPN 100,A05,093015,Cooke; James Edward,17,0,19,2
1653300755909,BIPN 100,A06,093016,Cooke; James Edward,12,0,19,7
1653300755909,BIPN 100,A07,093017,Cooke; James Edward,12,0,19,7
1653300755909,BIPN 100,A08,093018,Cooke; James Edward,18,0,19,1
1653300755909,BIPN 100,A09,093019,Cooke; James Edward,17,0,19,2
1653300755909,BIPN 100,A10,093020,Cooke; James Edward,18,0,19,1
1653300755909,BIPN 100,B01,093036,Reyes Gonzalez; Catalina,17,0,19,2
1653300755909,BIPN 100,B02,093037,Reyes Gonzalez; Catalina,14,0,19,5
1653300755909,BIPN 100,B03,093038,Reyes Gonzalez; Catalina,16,0,19,3
1653300755909,BIPN 100,B04,093039,Reyes Gonzalez; Catalina,19,0,19,0
1653300755909,BIPN 100,B05,093040,Reyes Gonzalez; Catalina,19,0,19,0
1653300755909,BIPN 100,B06,093041,Reyes Gonzalez; Catalina,19,0,19,0
1653300755909,BIPN 100,B07,093042,Reyes Gonzalez; Catalina,14,0,19,5
1653300755909,BIPN 100,B08,093043,Reyes Gonzalez; Catalina,16,0,19,3
1653300755909,BIPN 100,B09,093044,Reyes Gonzalez; Catalina,19,0,19,0
1653300755909,BIPN 100,B10,093045,Reyes Gonzalez; Catalina,19,0,19,0
1653300756432,BIPN 102,A01,093046,Reyes Gonzalez; Catalina,28,0,32,4
1653300756432,BIPN 102,A02,093047,Reyes Gonzalez; Catalina,17,0,32,15
1653300756432,BIPN 102,A05,093050,Reyes Gonzalez; Catalina,29,0,32,3
1653300756432,BIPN 102,A06,093051,Reyes Gonzalez; Catalina,15,0,32,17
1653300756432,BIPN 102,A07,093052,Reyes Gonzalez; Catalina,29,0,32,3
1653300756432,BIPN 102,A08,093053,Reyes Gonzalez; Catalina,31,0,32,1
1653300756959,BIPN 105,A01,089966,Armour; Jon Christopher,0,0,21,21
1653300756959,BIPN 105,A02,089967,Armour; Jon Christopher,0,0,21,21
1653300756959,BIPN 105,A03,089968,Armour; Jon Christopher,3,0,21,18
1653300756959,BIPN 105,A04,089969,Armour; Jon Christopher,10,0,21,11
1653300757483,BIPN 140,A01,092514,Spitzer; Nicholas & Su; Chih-Ying,9,0,19,10
1653300757483,BIPN 140,A02,092515,Spitzer; Nicholas & Su; Chih-Ying,12,0,19,7
1653300757483,BIPN 140,A03,092516,Spitzer; Nicholas & Su; Chih-Ying,11,0,19,8
1653300757483,BIPN 140,A04,092517,Spitzer; Nicholas & Su; Chih-Ying,15,0,19,4
1653300757483,BIPN 140,B01,092952,Banghart; Matthew Ryan,12,0,19,7
1653300757483,BIPN 140,B02,092953,Banghart; Matthew Ryan,19,0,19,0
1653300757483,BIPN 140,B03,092954,Banghart; Matthew Ryan,19,0,19,0
1653300757483,BIPN 140,B04,092955,Banghart; Matthew Ryan,19,0,19,0
1653300758006,BIPN 145,A01,089973,Marino; Marc J,35,0,42,7
1653300758006,BIPN 145,A02,089974,Marino; Marc J,36,0,42,6
1653300758006,BIPN 145,B01,089976,Juavinett; Ashley Lauren,0,0,42,42
1653300758533,BIPN 148,A01,092960,Leutgeb; Jill K.,31,0,32,1
1653300758533,BIPN 148,A02,092961,Leutgeb; Jill K.,25,0,32,7
1653300758533,BIPN 148,A03,092962,Leutgeb; Jill K.,29,0,31,2
1653300758533,BIPN 148,A04,092963,Leutgeb; Jill K.,31,0,31,0
1653300758533,BIPN 148,A05,092964,Leutgeb; Jill K.,31,0,31,0
1653300758533,BIPN 148,A06,094351,Leutgeb; Jill K.,26,0,31,5
1653300758533,BIPN 148,A07,092966,Leutgeb; Jill K.,26,0,31,5
1653300758533,BIPN 148,A08,092967,Leutgeb; Jill K.,26,0,31,5
1653300759067,BIPN 189,A00,090665,Gentner; Tim,0,0,25,25
1653300759595,BIPN 194,A00,089978,Pekkurnaz Banghart; Gulcin,17,0,27,10
1653300759595,BIPN 194,B00,089979,Leutgeb; Stefan,24,0,27,3
1653300760120,BISP 194,A00,089980,Wertheim; Joel Okrent,8,0,27,19
1653300760648,CAT 1,A01,086671,Bronstein; Phoebe Malan,17,0,17,0
1653300760648,CAT 1,A02,086672,Bronstein; Phoebe Malan,13,0,17,4
1653300760648,CAT 1,A03,086673,Bronstein; Phoebe Malan,17,0,17,0
1653300760648,CAT 1,A04,086674,Bronstein; Phoebe Malan,15,0,17,2
1653300760648,CAT 1,A05,086675,Bronstein; Phoebe Malan,17,0,17,0
1653300760648,CAT 1,A06,086676,Bronstein; Phoebe Malan,17,0,17,0
1653300760648,CAT 1,A07,086677,Bronstein; Phoebe Malan,16,0,17,1
1653300760648,CAT 1,A08,086678,Bronstein; Phoebe Malan,17,0,17,0
1653300760648,CAT 1,A09,086679,Bronstein; Phoebe Malan,16,0,17,1
1653300760648,CAT 1,A10,086680,Bronstein; Phoebe Malan,17,0,17,0
1653300760648,CAT 1,A11,086681,Bronstein; Phoebe Malan,16,0,17,1
1653300760648,CAT 1,A12,086682,Bronstein; Phoebe Malan,17,0,17,0
1653300760648,CAT 1,A13,086683,Bronstein; Phoebe Malan,17,0,17,0
1653300760648,CAT 1,A14,086684,Bronstein; Phoebe Malan,17,0,17,0
1653300760648,CAT 1,A15,086685,Bronstein; Phoebe Malan,17,0,17,0
1653300760648,CAT 1,A16,086686,Bronstein; Phoebe Malan,17,0,17,0
1653300760648,CAT 1,B01,086688,Bigham; David Joseph,17,0,17,0
1653300760648,CAT 1,B02,086689,Bigham; David Joseph,16,0,17,1
1653300760648,CAT 1,B03,086690,Bigham; David Joseph,17,0,17,0
1653300760648,CAT 1,B04,086691,Bigham; David Joseph,17,0,17,0
1653300760648,CAT 1,B05,086692,Bigham; David Joseph,16,0,17,1
1653300760648,CAT 1,B06,086693,Bigham; David Joseph,17,0,17,0
1653300760648,CAT 1,B07,086694,Bigham; David Joseph,17,0,17,0
1653300760648,CAT 1,B08,086695,Bigham; David Joseph,17,0,17,0
1653300760648,CAT 1,B09,086696,Bigham; David Joseph,17,0,17,0
1653300760648,CAT 1,B10,086697,Bigham; David Joseph,17,0,17,0
1653300760648,CAT 1,B11,086698,Bigham; David Joseph,17,0,17,0
1653300760648,CAT 1,B12,086699,Bigham; David Joseph,17,0,17,0
1653300760648,CAT 1,B13,086700,Bigham; David Joseph,15,0,17,2
1653300760648,CAT 1,B14,086701,Bigham; David Joseph,17,0,17,0
1653300760648,CAT 1,C01,086703,Algaze; Guillermo,17,0,17,0
1653300760648,CAT 1,C02,086704,Algaze; Guillermo,17,0,17,0
1653300760648,CAT 1,C03,086705,Algaze; Guillermo,17,0,17,0
1653300760648,CAT 1,C04,086706,Algaze; Guillermo,17,0,17,0
1653300760648,CAT 1,C05,086707,Algaze; Guillermo,17,0,17,0
1653300760648,CAT 1,C06,086708,Algaze; Guillermo,17,0,17,0
1653300760648,CAT 1,C07,086709,Algaze; Guillermo,17,0,17,0
1653300760648,CAT 1,C08,086710,Algaze; Guillermo,17,0,17,0
1653300760648,CAT 1,C09,086711,Algaze; Guillermo,17,0,17,0
1653300760648,CAT 1,C10,086712,Algaze; Guillermo,17,0,17,0
1653300760648,CAT 1,C11,086713,Algaze; Guillermo,17,0,17,0
1653300760648,CAT 1,C12,086714,Algaze; Guillermo,17,0,17,0
1653300760648,CAT 1,C13,086715,Algaze; Guillermo,17,0,17,0
1653300760648,CAT 1,C14,086716,Algaze; Guillermo,16,0,17,1
1653300760648,CAT 1,C15,086717,Algaze; Guillermo,17,0,17,0
1653300760648,CAT 1,C16,086718,Algaze; Guillermo,16,0,17,1
1653300760648,CAT 1,D01,086720,Staff,17,0,17,0
1653300760648,CAT 1,D02,086721,Staff,17,0,17,0
1653300760648,CAT 1,D03,086722,Staff,17,0,17,0
1653300760648,CAT 1,D04,086723,Staff,17,0,17,0
1653300760648,CAT 1,D05,086724,Staff,16,0,17,1
1653300760648,CAT 1,D06,086725,Staff,16,0,17,1
1653300760648,CAT 1,D07,086726,Staff,17,0,17,0
1653300760648,CAT 1,D08,086727,Staff,17,0,17,0
1653300760648,CAT 1,D09,086728,Staff,16,0,17,1
1653300760648,CAT 1,D10,086729,Staff,17,0,17,0
1653300760648,CAT 1,D11,086730,Staff,17,0,17,0
1653300760648,CAT 1,D12,086731,Staff,17,0,17,0
1653300760648,CAT 1,D13,086732,Staff,17,0,17,0
1653300760648,CAT 1,D14,086733,Staff,17,0,17,0
1653300761178,CAT 3,A01,086735,Gumm; Elizabeth Ashley,14,0,15,1
1653300761178,CAT 3,A02,086736,Gumm; Elizabeth Ashley,14,0,15,1
1653300761178,CAT 3,A03,086737,Gumm; Elizabeth Ashley,15,0,15,0
1653300761178,CAT 3,A04,086738,Gumm; Elizabeth Ashley,15,0,15,0
1653300761178,CAT 3,A05,086739,Gumm; Elizabeth Ashley,15,0,15,0
1653300761178,CAT 3,A06,086740,Gumm; Elizabeth Ashley,15,0,15,0
1653300761705,CAT 124,A01,086742,Staff,15,0,15,0
1653300762229,CAT 125R,A01,094882,Staff,14,0,16,2
1653300762229,CAT 125R,A02,086745,Staff,16,0,16,0
1653300762229,CAT 125R,A03,086746,Staff,14,0,16,2
1653300762229,CAT 125R,A04,086747,Staff,13,0,16,3
1653300762229,CAT 125R,A05,086748,Staff,15,0,16,1
1653300762229,CAT 125R,A06,086749,Staff,12,0,16,4
1653300762229,CAT 125R,A07,086750,Staff,14,0,16,2
1653300762229,CAT 125R,A08,094883,Staff,14,0,16,2
1653300762229,CAT 125R,A09,094884,Staff,16,0,16,0
1653300762229,CAT 125R,A10,094885,Staff,15,0,16,1
1653300762229,CAT 125R,A14,086761,Staff,15,0,16,1
1653300762229,CAT 125R,A15,086762,Staff,16,0,16,0
1653300762229,CAT 125R,A16,086763,Staff,13,0,16,3
1653300762229,CAT 125R,A17,086764,Staff,14,0,16,2
1653300762229,CAT 125R,A18,086765,Staff,14,0,16,2
1653300762229,CAT 125R,A19,086766,Staff,14,0,16,2
1653300762753,CCS 101,A00,088353,Staff,29,0,35,6
1653300763277,CENG 4,A01,086204,Bae; Jinhye,30,0,30,0
1653300763277,CENG 4,A02,086205,Bae; Jinhye,30,0,30,0
1653300763277,CENG 4,B01,086207,Drews; Aaron,30,0,30,0
1653300763277,CENG 4,B02,086208,Drews; Aaron,30,0,30,0
1653300763814,CENG 15,A01,086210,Lubarda; Vlado,63,0,65,2
1653300763814,CENG 15,B01,086212,Lubarda; Vlado,65,0,65,0
1653300764351,CENG 100,A00,086213,Chen; Zheng,147,0,150,3
1653300764875,CENG 101A,A00,086214,Bae; Jinhye,142,0,150,8
1653300765408,CENG 120,A00,086215,Opatkiewicz; Justin Paul,125,0,150,25
1653300765933,CENG 122,A00,086216,Opatkiewicz; Justin Paul,137,0,150,13
1653300766456,CGS 2A,A01,086271,Shelby; Karen Lee,12,0,15,3
1653300766456,CGS 2A,A02,086272,Shelby; Karen Lee,13,0,15,2
1653300766456,CGS 2A,A03,086273,Shelby; Karen Lee,14,0,15,1
1653300766456,CGS 2A,A04,086274,Shelby; Karen Lee,15,0,15,0
1653300766981,CGS 100A,A00,086275,Perez; Roy,26,0,32,6
1653300767503,CGS 101,A00,086276,Shelby; Karen Lee,30,0,30,0
1653300768030,CGS 106,A00,086277,Shelby; Karen Lee,24,0,30,6
1653300768569,CGS 119,A00,086279,Nguyen; Hoang Tan,27,0,30,3
1653300769094,CGS 121,A00,086280,Martin Sandino; Amanda Maria Yoland,19,0,20,1
1653300769636,CGS 122,A00,086281,Whitley; Leila Marie,20,0,20,0
1653300770165,CGS 123,A00,086282,Staff,0,0,0,0
1653300770688,CGS 127,A00,086283,Whitley; Leila Marie,15,0,15,0
1653300771215,CGS 130,A00,086284,Martin Sandino; Amanda Maria Yoland,15,0,15,0
1653300771745,CGS 187,A00,086285,Perez; Roy,15,0,16,1
1653300772271,CGS 190,A00,086286,Staff,5,0,5,0
1653300772795,CHEM 4,A01,089669,Bussey; Thomas J,40,0,40,0
1653300772795,CHEM 4,A02,089670,Bussey; Thomas J,42,0,42,0
1653300772795,CHEM 4,A03,089671,Bussey; Thomas J,40,0,42,2
1653300772795,CHEM 4,A04,089672,Bussey; Thomas J,42,0,42,0
1653300772795,CHEM 4,A05,089673,Bussey; Thomas J,40,0,42,2
1653300772795,CHEM 4,A06,089674,Bussey; Thomas J,40,0,42,2
1653300772795,CHEM 4,A07,089675,Bussey; Thomas J,42,0,42,0
1653300772795,CHEM 4,A08,089676,Bussey; Thomas J,42,0,42,0
1653300772795,CHEM 4,A09,089677,Bussey; Thomas J,41,0,41,0
1653300772795,CHEM 4,A10,089678,Bussey; Thomas J,40,0,40,0
1653300773337,CHEM 6A,A01,092734,Pomeroy; Robert S.,4,0,4,0
1653300773337,CHEM 6A,A02,092735,Pomeroy; Robert S.,4,0,4,0
1653300773337,CHEM 6A,A03,092736,Pomeroy; Robert S.,4,0,4,0
1653300773337,CHEM 6A,A04,092737,Pomeroy; Robert S.,4,0,4,0
1653300773337,CHEM 6A,A05,092738,Pomeroy; Robert S.,4,0,4,0
1653300773337,CHEM 6A,A06,092739,Pomeroy; Robert S.,4,0,4,0
1653300773337,CHEM 6A,A07,092740,Pomeroy; Robert S.,4,0,4,0
1653300773337,CHEM 6A,A08,092741,Pomeroy; Robert S.,4,0,4,0
1653300773337,CHEM 6A,A09,092742,Pomeroy; Robert S.,0,0,0,0
1653300773337,CHEM 6A,B01,092744,Schurmeier; Kimberly,4,0,4,0
1653300773337,CHEM 6A,B02,092746,Schurmeier; Kimberly,4,0,4,0
1653300773337,CHEM 6A,B03,092749,Schurmeier; Kimberly,4,0,4,0
1653300773337,CHEM 6A,B04,092751,Schurmeier; Kimberly,4,0,4,0
1653300773337,CHEM 6A,B05,092753,Schurmeier; Kimberly,4,0,4,0
1653300773337,CHEM 6A,B06,092755,Schurmeier; Kimberly,3,0,4,1
1653300773337,CHEM 6A,B07,092756,Schurmeier; Kimberly,4,0,4,0
1653300773337,CHEM 6A,B08,092757,Schurmeier; Kimberly,4,0,4,0
1653300773337,CHEM 6A,B09,092758,Schurmeier; Kimberly,0,0,0,0
1653300773337,CHEM 6A,C01,092805,Schurmeier; Kimberly,4,0,4,0
1653300773337,CHEM 6A,C02,092806,Schurmeier; Kimberly,4,0,4,0
1653300773337,CHEM 6A,C03,092807,Schurmeier; Kimberly,4,0,4,0
1653300773337,CHEM 6A,C04,092808,Schurmeier; Kimberly,4,0,4,0
1653300773337,CHEM 6A,C05,092809,Schurmeier; Kimberly,4,0,4,0
1653300773337,CHEM 6A,C06,092810,Schurmeier; Kimberly,4,0,4,0
1653300773337,CHEM 6A,C07,092811,Schurmeier; Kimberly,4,0,4,0
1653300773337,CHEM 6A,C08,092812,Schurmeier; Kimberly,4,0,4,0
1653300773337,CHEM 6A,C09,092813,Schurmeier; Kimberly,0,0,0,0
1653300773337,CHEM 6A,D01,092837,Stallings; Dontarie M,4,0,4,0
1653300773337,CHEM 6A,D02,092838,Stallings; Dontarie M,4,0,4,0
1653300773337,CHEM 6A,D03,092839,Stallings; Dontarie M,4,0,4,0
1653300773337,CHEM 6A,D04,092840,Stallings; Dontarie M,4,0,4,0
1653300773337,CHEM 6A,D05,092841,Stallings; Dontarie M,4,0,4,0
1653300773337,CHEM 6A,D06,092842,Stallings; Dontarie M,4,0,4,0
1653300773337,CHEM 6A,D07,092843,Stallings; Dontarie M,4,0,4,0
1653300773337,CHEM 6A,D08,092844,Stallings; Dontarie M,4,0,4,0
1653300773337,CHEM 6A,D09,092845,Stallings; Dontarie M,0,0,0,0
1653300773337,CHEM 6A,E01,092796,Brydges; Stacey,4,0,4,0
1653300773337,CHEM 6A,E02,092797,Brydges; Stacey,3,0,4,1
1653300773337,CHEM 6A,E03,092798,Brydges; Stacey,4,0,4,0
1653300773337,CHEM 6A,E04,092799,Brydges; Stacey,3,0,4,1
1653300773337,CHEM 6A,E05,092800,Brydges; Stacey,4,0,4,0
1653300773337,CHEM 6A,E06,092801,Brydges; Stacey,4,0,4,0
1653300773337,CHEM 6A,E07,092802,Brydges; Stacey,4,0,4,0
1653300773337,CHEM 6A,E08,092803,Brydges; Stacey,4,0,4,0
1653300773337,CHEM 6A,E09,092804,Brydges; Stacey,0,0,0,0
1653300773337,CHEM 6A,F01,092759,Brydges; Stacey,4,0,4,0
1653300773337,CHEM 6A,F02,092760,Brydges; Stacey,4,0,4,0
1653300773337,CHEM 6A,F03,092761,Brydges; Stacey,3,0,4,1
1653300773337,CHEM 6A,F04,092762,Brydges; Stacey,4,0,4,0
1653300773337,CHEM 6A,F05,092763,Brydges; Stacey,4,0,4,0
1653300773337,CHEM 6A,F06,092764,Brydges; Stacey,4,0,4,0
1653300773337,CHEM 6A,F07,092765,Brydges; Stacey,4,0,4,0
1653300773337,CHEM 6A,F08,092766,Brydges; Stacey,4,0,4,0
1653300773337,CHEM 6A,F09,092767,Brydges; Stacey,0,0,0,0
1653300773337,CHEM 6A,G01,092774,Zid; Brian M,0,0,4,4
1653300773337,CHEM 6A,G02,092775,Zid; Brian M,2,0,4,2
1653300773337,CHEM 6A,G03,092776,Zid; Brian M,2,0,4,2
1653300773337,CHEM 6A,G04,092777,Zid; Brian M,2,0,4,2
1653300773337,CHEM 6A,G05,092778,Zid; Brian M,4,0,4,0
1653300773337,CHEM 6A,G06,092779,Zid; Brian M,4,0,4,0
1653300773337,CHEM 6A,G07,092780,Zid; Brian M,3,0,4,1
1653300773337,CHEM 6A,G08,092781,Zid; Brian M,3,0,4,1
1653300773337,CHEM 6A,G09,092782,Zid; Brian M,0,0,0,0
1653300773337,CHEM 6A,H01,092846,Stallings; Dontarie M,4,0,4,0
1653300773337,CHEM 6A,H02,092847,Stallings; Dontarie M,3,0,4,1
1653300773337,CHEM 6A,H03,092848,Stallings; Dontarie M,4,0,4,0
1653300773337,CHEM 6A,H04,092849,Stallings; Dontarie M,4,0,4,0
1653300773337,CHEM 6A,H05,092850,Stallings; Dontarie M,4,0,4,0
1653300773337,CHEM 6A,H06,092851,Stallings; Dontarie M,3,0,4,1
1653300773337,CHEM 6A,H07,092852,Stallings; Dontarie M,4,0,4,0
1653300773337,CHEM 6A,H08,092853,Stallings; Dontarie M,3,0,4,1
1653300773337,CHEM 6A,H09,092854,Stallings; Dontarie M,0,0,0,0
1653300773337,CHEM 6A,I01,092814,Staff,0,0,0,0
1653300773337,CHEM 6A,I02,092815,Staff,0,0,0,0
1653300773337,CHEM 6A,I04,092816,Staff,0,0,0,0
1653300773337,CHEM 6A,I05,092817,Staff,0,0,0,0
1653300773337,CHEM 6A,I06,092818,Staff,0,0,0,0
1653300773337,CHEM 6A,I07,092819,Staff,0,0,0,0
1653300773337,CHEM 6A,I08,092820,Staff,0,0,0,0
1653300773337,CHEM 6A,I09,092821,Staff,0,0,0,0
1653300773861,CHEM 6AH,A01,092793,Paesani; Francesco,15,0,16,1
1653300773861,CHEM 6AH,A02,092794,Paesani; Francesco,16,0,16,0
1653300773861,CHEM 6AH,A03,092795,Paesani; Francesco,16,0,16,0
1653300774384,CHEM 6B,A01,092691,Hopkins; Patrycja Anna,21,0,25,4
1653300774384,CHEM 6B,A02,092692,Hopkins; Patrycja Anna,23,0,25,2
1653300774384,CHEM 6B,A03,092693,Hopkins; Patrycja Anna,25,0,25,0
1653300774384,CHEM 6B,A04,092694,Hopkins; Patrycja Anna,0,0,0,0
1653300774384,CHEM 6B,A05,092695,Hopkins; Patrycja Anna,24,0,25,1
1653300774384,CHEM 6B,A06,092696,Hopkins; Patrycja Anna,22,0,25,3
1653300774384,CHEM 6B,A07,092697,Hopkins; Patrycja Anna,24,0,25,1
1653300774907,CHEM 6C,A01,092708,Albizati; Kim F.,31,0,38,7
1653300774907,CHEM 6C,A02,092709,Albizati; Kim F.,32,0,38,6
1653300774907,CHEM 6C,A03,092710,Albizati; Kim F.,37,0,38,1
1653300774907,CHEM 6C,A04,092711,Albizati; Kim F.,36,0,38,2
1653300774907,CHEM 6C,A05,092712,Albizati; Kim F.,0,0,0,0
1653300774907,CHEM 6C,A06,092714,Albizati; Kim F.,33,0,38,5
1653300774907,CHEM 6C,A07,092715,Albizati; Kim F.,32,0,38,6
1653300774907,CHEM 6C,A08,092716,Albizati; Kim F.,37,0,38,1
1653300774907,CHEM 6C,A09,092717,Albizati; Kim F.,38,0,38,0
1653300775434,CHEM 7L,A01,089692,Leigh; Brian,11,0,19,8
1653300775434,CHEM 7L,A02,089693,Leigh; Brian,23,0,24,1
1653300775434,CHEM 7L,A03,089694,Leigh; Brian,24,0,24,0
1653300775434,CHEM 7L,A04,089695,Leigh; Brian,24,0,24,0
1653300775434,CHEM 7L,A05,089696,Leigh; Brian,23,0,24,1
1653300775434,CHEM 7L,A06,089697,Leigh; Brian,22,0,24,2
1653300775434,CHEM 7L,A07,089698,Leigh; Brian,21,0,21,0
1653300775434,CHEM 7L,A08,089699,Leigh; Brian,17,0,24,7
1653300775434,CHEM 7L,A09,089700,Leigh; Brian,23,0,24,1
1653300775434,CHEM 7L,A10,089701,Leigh; Brian,0,0,0,0
1653300775434,CHEM 7L,B01,089703,Leigh; Brian,18,0,24,6
1653300775434,CHEM 7L,B02,089704,Leigh; Brian,18,0,24,6
1653300775434,CHEM 7L,B03,089705,Leigh; Brian,23,0,24,1
1653300775434,CHEM 7L,B04,089706,Leigh; Brian,20,0,21,1
1653300775434,CHEM 7L,B05,089707,Leigh; Brian,17,0,24,7
1653300775434,CHEM 7L,B06,089708,Leigh; Brian,17,0,24,7
1653300775434,CHEM 7L,B07,089709,Leigh; Brian,17,0,24,7
1653300775434,CHEM 7L,B08,089710,Leigh; Brian,21,0,24,3
1653300775434,CHEM 7L,B09,089711,Leigh; Brian,21,0,24,3
1653300775434,CHEM 7L,B10,089712,Leigh; Brian,0,0,0,0
1653300775434,CHEM 7L,C01,089714,Staff,23,0,24,1
1653300775434,CHEM 7L,C02,089715,Staff,22,0,24,2
1653300775434,CHEM 7L,C03,089716,Staff,23,0,24,1
1653300775434,CHEM 7L,C04,089717,Staff,24,0,24,0
1653300775434,CHEM 7L,C05,089718,Staff,21,0,24,3
1653300775434,CHEM 7L,C06,089719,Staff,22,0,24,2
1653300775434,CHEM 7L,C07,089720,Staff,23,0,24,1
1653300775434,CHEM 7L,C08,089721,Staff,24,0,24,0
1653300775434,CHEM 7L,C09,089722,Staff,24,0,24,0
1653300775434,CHEM 7L,C10,089723,Staff,0,0,0,0
1653300775969,CHEM 40A,A01,092871,Schmidt; Valerie A,31,0,31,0
1653300775969,CHEM 40A,A02,092872,Schmidt; Valerie A,31,0,31,0
1653300775969,CHEM 40A,A03,092873,Schmidt; Valerie A,31,0,31,0
1653300775969,CHEM 40A,A04,092874,Schmidt; Valerie A,0,0,0,0
1653300775969,CHEM 40A,A05,092875,Schmidt; Valerie A,31,0,31,0
1653300775969,CHEM 40A,A06,092876,Schmidt; Valerie A,29,0,31,2
1653300775969,CHEM 40A,A07,092877,Schmidt; Valerie A,31,0,31,0
1653300775969,CHEM 40A,A08,092878,Schmidt; Valerie A,28,0,28,0
1653300775969,CHEM 40A,B01,089726,Lam; Tin Yiu,31,0,31,0
1653300775969,CHEM 40A,B02,089727,Lam; Tin Yiu,31,0,31,0
1653300775969,CHEM 40A,B03,089728,Lam; Tin Yiu,31,0,31,0
1653300775969,CHEM 40A,B04,089729,Lam; Tin Yiu,30,0,31,1
1653300775969,CHEM 40A,B05,089730,Lam; Tin Yiu,31,0,31,0
1653300775969,CHEM 40A,B06,089731,Lam; Tin Yiu,30,0,31,1
1653300775969,CHEM 40A,B07,089732,Lam; Tin Yiu,29,0,31,2
1653300775969,CHEM 40A,B08,089733,Lam; Tin Yiu,0,0,0,0
1653300775969,CHEM 40A,C01,092718,Albizati; Kim F.,17,0,31,14
1653300775969,CHEM 40A,C02,092719,Albizati; Kim F.,24,0,31,7
1653300775969,CHEM 40A,C03,092720,Albizati; Kim F.,12,0,31,19
1653300775969,CHEM 40A,C04,092721,Albizati; Kim F.,24,0,31,7
1653300775969,CHEM 40A,C05,092722,Albizati; Kim F.,21,0,31,10
1653300775969,CHEM 40A,C06,092723,Albizati; Kim F.,24,0,31,7
1653300775969,CHEM 40A,C07,092724,Albizati; Kim F.,30,0,31,1
1653300775969,CHEM 40A,C08,092725,Albizati; Kim F.,0,0,0,0
1653300775969,CHEM 40A,D01,092863,Yang; Jerry,28,0,31,3
1653300775969,CHEM 40A,D02,092864,Yang; Jerry,28,0,31,3
1653300775969,CHEM 40A,D03,092865,Yang; Jerry,31,0,31,0
1653300775969,CHEM 40A,D04,092866,Yang; Jerry,31,0,31,0
1653300775969,CHEM 40A,D05,092867,Yang; Jerry,0,0,0,0
1653300775969,CHEM 40A,D06,092868,Yang; Jerry,31,0,31,0
1653300775969,CHEM 40A,D07,092869,Yang; Jerry,31,0,31,0
1653300775969,CHEM 40A,D08,092870,Yang; Jerry,31,0,31,0
1653300776495,CHEM 40B,A01,092698,Oconnor; Joseph M.,24,0,34,10
1653300776495,CHEM 40B,A02,092699,Oconnor; Joseph M.,34,0,34,0
1653300776495,CHEM 40B,A03,092700,Oconnor; Joseph M.,0,0,0,0
1653300776495,CHEM 40B,A04,092701,Oconnor; Joseph M.,30,0,34,4
1653300776495,CHEM 40B,A05,092702,Oconnor; Joseph M.,33,0,34,1
1653300776495,CHEM 40B,A06,092703,Oconnor; Joseph M.,34,0,34,0
1653300776495,CHEM 40B,A07,092704,Oconnor; Joseph M.,32,0,34,2
1653300776495,CHEM 40B,A08,092705,Oconnor; Joseph M.,33,0,34,1
1653300776495,CHEM 40B,A09,092706,Oconnor; Joseph M.,34,0,34,0
1653300777029,CHEM 40C,A01,089739,Lam; Tin Yiu,0,0,0,0
1653300777029,CHEM 40C,A02,089740,Lam; Tin Yiu,0,0,0,0
1653300777029,CHEM 40C,A03,089741,Lam; Tin Yiu,0,0,0,0
1653300777029,CHEM 40C,A04,089742,Lam; Tin Yiu,13,0,34,21
1653300777029,CHEM 40C,A05,089743,Lam; Tin Yiu,32,0,34,2
1653300777029,CHEM 40C,A06,089744,Lam; Tin Yiu,31,0,34,3
1653300777557,CHEM 41A,A01,093840,Ternansky; Robert J.,29,0,33,4
1653300777557,CHEM 41A,A02,093841,Ternansky; Robert J.,32,0,33,1
1653300777557,CHEM 41A,A03,093842,Ternansky; Robert J.,33,0,33,0
1653300777557,CHEM 41A,A04,093843,Ternansky; Robert J.,30,0,33,3
1653300777557,CHEM 41A,A05,093844,Ternansky; Robert J.,31,0,33,2
1653300777557,CHEM 41A,A06,093845,Ternansky; Robert J.,27,0,27,0
1653300777557,CHEM 41A,A07,093846,Ternansky; Robert J.,32,0,33,1
1653300777557,CHEM 41A,A08,093847,Ternansky; Robert J.,33,0,33,0
1653300778085,CHEM 43A,A01,089746,Klosterman; Jeremy K,11,0,24,13
1653300778085,CHEM 43A,A02,089747,Klosterman; Jeremy K,16,0,24,8
1653300778085,CHEM 43A,A03,089748,Klosterman; Jeremy K,21,0,24,3
1653300778085,CHEM 43A,A04,089749,Klosterman; Jeremy K,22,0,24,2
1653300778085,CHEM 43A,A05,089750,Klosterman; Jeremy K,23,0,24,1
1653300778085,CHEM 43A,A06,089751,Klosterman; Jeremy K,8,0,24,16
1653300778085,CHEM 43A,A07,089752,Klosterman; Jeremy K,17,0,24,7
1653300778085,CHEM 43A,A08,089753,Klosterman; Jeremy K,16,0,24,8
1653300778085,CHEM 43A,A09,089754,Klosterman; Jeremy K,21,0,24,3
1653300778085,CHEM 43A,A10,089755,Klosterman; Jeremy K,21,0,24,3
1653300778085,CHEM 43A,A11,089756,Klosterman; Jeremy K,0,0,0,0
1653300778085,CHEM 43A,A12,089757,Klosterman; Jeremy K,0,0,0,0
1653300778085,CHEM 43A,A13,089758,Klosterman; Jeremy K,0,0,0,0
1653300778085,CHEM 43A,B01,089760,Klosterman; Jeremy K,0,0,0,0
1653300778085,CHEM 43A,B02,089761,Klosterman; Jeremy K,0,0,0,0
1653300778085,CHEM 43A,B03,089762,Klosterman; Jeremy K,16,0,24,8
1653300778085,CHEM 43A,B04,089763,Klosterman; Jeremy K,22,0,24,2
1653300778085,CHEM 43A,B05,089764,Klosterman; Jeremy K,23,0,24,1
1653300778085,CHEM 43A,B06,089765,Klosterman; Jeremy K,23,0,24,1
1653300778085,CHEM 43A,B07,089766,Klosterman; Jeremy K,17,0,24,7
1653300778085,CHEM 43A,B08,089767,Klosterman; Jeremy K,23,0,24,1
1653300778085,CHEM 43A,B09,089768,Klosterman; Jeremy K,24,0,24,0
1653300778085,CHEM 43A,B10,089769,Klosterman; Jeremy K,23,0,24,1
1653300778085,CHEM 43A,B11,089770,Klosterman; Jeremy K,22,0,24,2
1653300778085,CHEM 43A,B12,089771,Klosterman; Jeremy K,21,0,24,3
1653300778607,CHEM 87,A00,089772,Bussey; Thomas J,20,0,20,0
1653300779131,CHEM 96,A00,089773,Bussey; Thomas J,20,0,25,5
1653300779662,CHEM 100A,A01,089775,Pomeroy; Robert S.,22,0,24,2
1653300779662,CHEM 100A,A02,089776,Pomeroy; Robert S.,19,0,24,5
1653300779662,CHEM 100A,A03,089777,Pomeroy; Robert S.,13,0,24,11
1653300779662,CHEM 100A,A04,089778,Pomeroy; Robert S.,18,0,24,6
1653300779662,CHEM 100A,A05,089779,Pomeroy; Robert S.,19,0,24,5
1653300779662,CHEM 100A,A06,089780,Pomeroy; Robert S.,24,0,24,0
1653300779662,CHEM 100A,A07,089781,Pomeroy; Robert S.,0,0,0,0
1653300780183,CHEM 105A,A01,089783,Young; Mark,0,0,39,39
1653300780183,CHEM 105A,B01,089785,Young; Mark,26,0,39,13
1653300780709,CHEM 108,A01,089787,Ghosh; Gourisankar,1,0,22,21
1653300780709,CHEM 108,A02,089788,Ghosh; Gourisankar,6,0,22,16
1653300780709,CHEM 108,B01,089790,Ghosh; Gourisankar,13,0,22,9
1653300780709,CHEM 108,B02,089791,Ghosh; Gourisankar,20,0,22,2
1653300781235,CHEM 109,A01,089793,Hamaoka; Brent Y,4,0,22,18
1653300781235,CHEM 109,A02,089794,Hamaoka; Brent Y,10,0,22,12
1653300781235,CHEM 109,B01,089796,Hamaoka; Brent Y,6,0,22,16
1653300781235,CHEM 109,B02,089797,Hamaoka; Brent Y,18,0,22,4
1653300781763,CHEM 114A,A01,092855,Toor; Navtej,21,0,25,4
1653300781763,CHEM 114A,A02,092856,Toor; Navtej,25,0,25,0
1653300781763,CHEM 114A,A03,092857,Toor; Navtej,19,0,25,6
1653300781763,CHEM 114A,A04,092858,Toor; Navtej,24,0,25,1
1653300781763,CHEM 114A,A05,092859,Toor; Navtej,0,0,0,0
1653300781763,CHEM 114A,A06,092860,Toor; Navtej,14,0,25,11
1653300781763,CHEM 114A,A07,092861,Toor; Navtej,24,0,25,1
1653300781763,CHEM 114A,A08,092862,Toor; Navtej,24,0,25,1
1653300782285,CHEM 116,A01,092707,Ferguson; Fleur,7,0,35,28
1653300782285,CHEM 116,A02,094887,Ferguson; Fleur,31,0,35,4
1653300782832,CHEM 120A,A01,092785,Schimpf; Alina M,16,0,28,12
1653300782832,CHEM 120A,A02,092786,Schimpf; Alina M,26,0,28,2
1653300782832,CHEM 120A,A03,092787,Schimpf; Alina M,20,0,28,8
1653300782832,CHEM 120A,A04,092788,Schimpf; Alina M,27,0,28,1
1653300782832,CHEM 120A,A05,092789,Schimpf; Alina M,27,0,28,1
1653300782832,CHEM 120A,A06,092790,Schimpf; Alina M,0,0,0,0
1653300782832,CHEM 120A,A07,092791,Schimpf; Alina M,15,0,28,13
1653300782832,CHEM 120A,A08,092792,Schimpf; Alina M,0,0,0,0
1653300783368,CHEM 126A,A01,092768,Schoeneberg; Johannes,16,0,35,19
1653300783368,CHEM 126A,A02,092769,Schoeneberg; Johannes,35,0,35,0
1653300783368,CHEM 126A,A03,092770,Schoeneberg; Johannes,29,0,35,6
1653300783368,CHEM 126A,A04,092771,Schoeneberg; Johannes,0,0,0,0
1653300783368,CHEM 126A,A05,092772,Schoeneberg; Johannes,30,0,35,5
1653300783368,CHEM 126A,A06,092773,Schoeneberg; Johannes,33,0,35,2
1653300783892,CHEM 130,A01,092685,Sinha; Amitabha,28,0,38,10
1653300783892,CHEM 130,A02,092686,Sinha; Amitabha,31,0,38,7
1653300783892,CHEM 130,A03,092687,Sinha; Amitabha,34,0,38,4
1653300784416,CHEM 142,A00,089803,Esko; Jeffrey D. & Godula; Kamil,9,0,46,37
1653300784938,CHEM 143C,A01,089805,Ternansky; Robert J.,17,0,22,5
1653300784938,CHEM 143C,A02,089806,Ternansky; Robert J.,18,0,22,4
1653300784938,CHEM 143C,A03,089807,Ternansky; Robert J.,19,0,22,3
1653300784938,CHEM 143C,A04,089808,Ternansky; Robert J.,20,0,22,2
1653300785466,CHEM 152,A00,089809,Romero; Nathan A & Schmidt; Valerie A,35,0,40,5
1653300785993,CHEM 171,A01,092688,Slade; Jonathan,35,0,45,10
1653300785993,CHEM 171,A02,092689,Slade; Jonathan,44,0,45,1
1653300785993,CHEM 171,A03,092690,Slade; Jonathan,45,0,45,0
1653300786516,CHEM 186,A00,089811,Paesani; Francesco,9,0,15,6
1653300787041,CHIN 10AD,A01,086223,Staff,13,0,13,0
1653300787041,CHIN 10AD,A02,086224,Staff,12,0,13,1
1653300787041,CHIN 10AD,B01,086227,Staff,14,0,15,1
1653300787566,CHIN 10AM,A01,086230,Chen; Pei-Chia,16,0,16,0
1653300787566,CHIN 10AM,A02,086231,Chen; Pei-Chia,16,0,16,0
1653300788092,CHIN 10AN,A01,086234,Xu; Li,14,0,14,0
1653300788092,CHIN 10AN,A02,086235,Xu; Li,14,0,14,0
1653300788092,CHIN 10AN,B01,086240,Xu; Li,14,0,14,0
1653300788092,CHIN 10AN,B02,086242,Xu; Li,0,0,0,0
1653300788092,CHIN 10AN,C01,086245,Xu; Li,14,0,14,0
1653300788092,CHIN 10AN,C02,086246,Xu; Li,14,0,14,0
1653300788615,CHIN 20AD,A01,086248,Wang; Xiao,14,0,14,0
1653300788615,CHIN 20AD,A02,086249,Wang; Xiao,14,0,14,0
1653300788615,CHIN 20AD,B01,086251,Wang; Xiao,13,0,14,1
1653300788615,CHIN 20AD,B02,086252,Wang; Xiao,14,0,14,0
1653300789137,CHIN 20AM,A01,086254,Wang; Xiao,11,0,14,3
1653300789137,CHIN 20AM,A02,086255,Wang; Xiao,13,0,14,1
1653300789137,CHIN 20AM,B01,086257,Staff,15,0,15,0
1653300789666,CHIN 20AN,A01,086259,Anderson; Qin-Hong,11,0,12,1
1653300789666,CHIN 20AN,A02,086260,Anderson; Qin-Hong,12,0,12,0
1653300789666,CHIN 20AN,A03,086261,Anderson; Qin-Hong,0,0,0,0
1653300789666,CHIN 20AN,B01,086263,Anderson; Qin-Hong,12,0,13,1
1653300789666,CHIN 20AN,B02,086264,Anderson; Qin-Hong,13,0,13,0
1653300790193,CHIN 100AM,A00,086265,Anderson; Qin-Hong,20,0,20,0
1653300790719,CHIN 100AN,A00,086266,Chen; Pei-Chia,17,0,20,3
1653300791242,CHIN 185A,A00,086268,Staff,20,0,20,0
1653300791773,COGS 1,A01,087834,Barrera; Steven James,57,0,60,3
1653300791773,COGS 1,A02,087835,Barrera; Steven James,52,0,60,8
1653300791773,COGS 1,A03,087836,Barrera; Steven James,57,0,60,3
1653300791773,COGS 1,A04,087837,Barrera; Steven James,59,0,60,1
1653300791773,COGS 1,A05,087838,Barrera; Steven James,60,0,60,0
1653300791773,COGS 1,A06,087839,Barrera; Steven James,59,0,60,1
1653300791773,COGS 1,A07,087840,Barrera; Steven James,54,0,57,3
1653300792305,COGS 2,A01,087842,Boyle; Mary E. T.,64,0,64,0
1653300792305,COGS 2,A02,087843,Boyle; Mary E. T.,61,0,64,3
1653300792305,COGS 2,A03,087844,Boyle; Mary E. T.,64,0,64,0
1653300792846,COGS 3,A01,094312,Boyle; Mary E. T.,30,0,35,5
1653300792846,COGS 3,A02,094313,Boyle; Mary E. T.,33,0,35,2
1653300792846,COGS 3,A03,094314,Boyle; Mary E. T.,35,0,35,0
1653300792846,COGS 3,A04,094315,Boyle; Mary E. T.,35,0,35,0
1653300792846,COGS 3,A05,094316,Boyle; Mary E. T.,35,0,35,0
1653300793370,COGS 8,A01,087846,Staff,35,0,35,0
1653300793896,COGS 10,A01,094357,Hollan; James D.,53,0,60,7
1653300793896,COGS 10,A02,094358,Hollan; James D.,58,0,60,2
1653300793896,COGS 10,A03,094359,Hollan; James D.,59,0,60,1
1653300793896,COGS 10,A04,094360,Hollan; James D.,60,0,60,0
1653300793896,COGS 10,A05,094361,Hollan; James D.,60,0,60,0
1653300794451,COGS 11,A01,087848,Boyle; Mary E. T.,46,0,47,1
1653300794451,COGS 11,A02,087849,Boyle; Mary E. T.,44,0,47,3
1653300794451,COGS 11,A03,087850,Boyle; Mary E. T.,46,0,46,0
1653300794991,COGS 13,A01,087852,Davis; Joshua Daniel,56,0,60,4
1653300794991,COGS 13,A02,087853,Davis; Joshua Daniel,55,0,60,5
1653300794991,COGS 13,A03,087854,Davis; Joshua Daniel,57,0,60,3
1653300794991,COGS 13,A04,087855,Davis; Joshua Daniel,58,0,60,2
1653300795520,COGS 14A,A01,087857,Creel; Sarah,58,0,65,7
1653300795520,COGS 14A,A02,087858,Creel; Sarah,62,0,65,3
1653300795520,COGS 14A,A03,087859,Creel; Sarah,63,0,65,2
1653300795520,COGS 14A,A04,087860,Creel; Sarah,63,0,65,2
1653300796042,COGS 14B,A01,087862,Hoffman; Drew Ellen,56,0,60,4
1653300796042,COGS 14B,A02,087863,Hoffman; Drew Ellen,53,0,60,7
1653300796042,COGS 14B,A03,087864,Hoffman; Drew Ellen,60,0,60,0
1653300796568,COGS 15,A01,087866,Bergen; Benjamin,60,0,60,0
1653300796568,COGS 15,A02,087867,Bergen; Benjamin,59,0,60,1
1653300797097,COGS 17,A01,087869,Johnson; Christine M.,55,0,60,5
1653300797097,COGS 17,A02,087870,Johnson; Christine M.,58,0,60,2
1653300797097,COGS 17,A03,087871,Johnson; Christine M.,55,0,60,5
1653300797097,COGS 17,A04,087872,Johnson; Christine M.,60,0,60,0
1653300797097,COGS 17,A05,087873,Johnson; Christine M.,59,0,60,1
1653300797097,COGS 17,A06,087874,Johnson; Christine M.,60,0,60,0
1653300797625,COGS 18,A01,087876,Fleischer; Jason G,22,0,35,13
1653300797625,COGS 18,A02,087877,Fleischer; Jason G,31,0,35,4
1653300797625,COGS 18,A03,087878,Fleischer; Jason G,33,0,35,2
1653300797625,COGS 18,A04,087879,Fleischer; Jason G,33,0,35,2
1653300797625,COGS 18,A05,087880,Fleischer; Jason G,28,0,35,7
1653300797625,COGS 18,A06,087881,Fleischer; Jason G,34,0,35,1
1653300797625,COGS 18,A07,087882,Fleischer; Jason G,33,0,35,2
1653300797625,COGS 18,A08,087883,Fleischer; Jason G,31,0,35,4
1653300797625,COGS 18,A09,087884,Fleischer; Jason G,33,0,35,2
1653300798154,COGS 20,A01,090761,Borgo; David Garcia,5,0,5,0
1653300798154,COGS 20,A02,090762,Borgo; David Garcia,5,0,5,0
1653300798154,COGS 20,A03,090763,Borgo; David Garcia,5,0,5,0
1653300798681,COGS 87,A00,087885,Deak; Gedeon O.,20,0,20,0
1653300798681,COGS 87,B00,087886,Fleischer; Jason G,20,0,20,0
1653300799206,COGS 100,A01,087892,Kirsh; David Joel,56,0,60,4
1653300799206,COGS 100,A02,087893,Kirsh; David Joel,54,0,60,6
1653300799206,COGS 100,A03,087894,Kirsh; David Joel,54,0,60,6
1653300799206,COGS 100,A04,087895,Kirsh; David Joel,51,0,60,9
1653300799206,COGS 100,A05,087896,Kirsh; David Joel,48,0,60,12
1653300799730,COGS 101A,A01,087898,Hoffman; Drew Ellen,48,0,60,12
1653300799730,COGS 101A,A02,087899,Hoffman; Drew Ellen,58,0,60,2
1653300799730,COGS 101A,A03,087900,Hoffman; Drew Ellen,55,0,60,5
1653300799730,COGS 101A,A04,087901,Hoffman; Drew Ellen,58,0,60,2
1653300799730,COGS 101A,A05,087902,Hoffman; Drew Ellen,59,0,60,1
1653300799730,COGS 101A,A06,087903,Hoffman; Drew Ellen,56,0,60,4
1653300800259,COGS 101B,A01,087905,Barrera; Steven James,30,0,60,30
1653300800259,COGS 101B,A02,087906,Barrera; Steven James,52,0,60,8
1653300800259,COGS 101B,A03,087907,Barrera; Steven James,54,0,60,6
1653300800783,COGS 101C,A01,094240,Cooperrider; Kensy A,70,0,75,5
1653300800783,COGS 101C,A02,094241,Cooperrider; Kensy A,73,0,75,2
1653300801326,COGS 102A,A01,087909,Scott; Taylor Jackson,58,0,60,2
1653300801326,COGS 102A,A02,087910,Scott; Taylor Jackson,51,0,60,9
1653300801853,COGS 107A,A01,087912,Rangel; Lara M,51,0,60,9
1653300801853,COGS 107A,A02,087913,Rangel; Lara M,54,0,60,6
1653300801853,COGS 107A,A03,087914,Rangel; Lara M,47,0,60,13
1653300801853,COGS 107A,A04,087915,Rangel; Lara M,53,0,60,7
1653300801853,COGS 107A,A05,087916,Rangel; Lara M,55,0,60,5
1653300801853,COGS 107A,A06,087917,Rangel; Lara M,50,0,60,10
1653300802388,COGS 108,A01,087919,Fleischer; Jason G,14,0,60,46
1653300802388,COGS 108,A02,087920,Fleischer; Jason G,25,0,60,35
1653300802388,COGS 108,A03,087921,Fleischer; Jason G,40,0,60,20
1653300802388,COGS 108,A04,087922,Fleischer; Jason G,40,0,60,20
1653300802388,COGS 108,A05,087923,Fleischer; Jason G,48,0,60,12
1653300802388,COGS 108,A06,087924,Fleischer; Jason G,55,0,60,5
1653300802388,COGS 108,A07,087925,Fleischer; Jason G,42,0,57,15
1653300802913,COGS 110,A01,087927,Deak; Gedeon O.,30,0,35,5
1653300802913,COGS 110,A02,087928,Deak; Gedeon O.,33,0,35,2
1653300803441,COGS 116,A01,094228,Greene; Deanna Jacquelyn,51,0,52,1
1653300803441,COGS 116,A02,094229,Greene; Deanna Jacquelyn,52,0,52,0
1653300803441,COGS 116,A03,094230,Greene; Deanna Jacquelyn,50,0,52,2
1653300803969,COGS 118B,A01,087930,De Sa; Virginia,24,0,35,11
1653300803969,COGS 118B,A02,087931,De Sa; Virginia,28,0,35,7
1653300803969,COGS 118B,A03,087932,De Sa; Virginia,18,0,35,17
1653300803969,COGS 118B,A04,087933,De Sa; Virginia,29,0,35,6
1653300803969,COGS 118B,A05,087934,De Sa; Virginia,27,0,35,8
1653300803969,COGS 118B,A06,087935,De Sa; Virginia,27,0,35,8
1653300804496,COGS 120,A01,087937,Xia; Haijun,38,0,50,12
1653300804496,COGS 120,A02,087938,Xia; Haijun,32,0,50,18
1653300804496,COGS 120,A03,087939,Xia; Haijun,26,0,50,24
1653300804496,COGS 120,A04,087940,Xia; Haijun,1,0,50,49
1653300805019,COGS 128,A01,087944,Scott; Taylor Jackson,11,0,56,45
1653300805546,COGS 143,A01,087947,Johnson; Christine M.,23,0,40,17
1653300806074,COGS 153,A00,087949,Davis; Joshua Daniel,46,0,75,29
1653300806600,COGS 160,A00,087950,Deak; Gedeon O.,20,0,20,0
1653300806600,COGS 160,B00,094232,Saygin; Ayse P,40,0,40,0
1653300807131,COGS 175,A01,094238,Staff,27,0,40,13
1653300807658,COGS 187A,A01,087958,Kirsh; David Joel,22,0,50,28
1653300807658,COGS 187A,A02,087959,Kirsh; David Joel,30,0,50,20
1653300807658,COGS 187A,A03,087960,Kirsh; David Joel,34,0,45,11
1653300808262,COGS 190A,A00,087961,Staff,9999,0,9999,0
1653300808796,COGS 194,A00,087962,Hill; Seth J,9999,0,9999,0
1653300809320,COMM 10,A02,090628,Schmidt; Thomas Rainer,1,0,5,4
1653300809320,COMM 10,A03,090629,Schmidt; Thomas Rainer,3,0,5,2
1653300809320,COMM 10,A04,090630,Schmidt; Thomas Rainer,4,0,5,1
1653300809320,COMM 10,A05,090631,Schmidt; Thomas Rainer,4,0,5,1
1653300809320,COMM 10,A06,090632,Schmidt; Thomas Rainer,5,0,5,0
1653300809320,COMM 10,A07,090633,Schmidt; Thomas Rainer,5,0,5,0
1653300809320,COMM 10,A08,090634,Schmidt; Thomas Rainer,5,0,5,0
1653300809320,COMM 10,A09,090635,Schmidt; Thomas Rainer,5,0,5,0
1653300809320,COMM 10,A10,090636,Schmidt; Thomas Rainer,2,0,5,3
1653300809320,COMM 10,A11,090637,Schmidt; Thomas Rainer,4,0,5,1
1653300809320,COMM 10,A12,094013,Schmidt; Thomas Rainer,2,0,5,3
1653300809320,COMM 10,A13,094014,Schmidt; Thomas Rainer,5,0,5,0
1653300809320,COMM 10,A14,094015,Schmidt; Thomas Rainer,4,0,5,1
1653300809320,COMM 10,A15,094016,Schmidt; Thomas Rainer,5,0,5,0
1653300809843,COMM 100A,A01,090639,Irani; Lilly C,5,0,5,0
1653300809843,COMM 100A,A02,090640,Irani; Lilly C,4,0,5,1
1653300809843,COMM 100A,A03,090641,Irani; Lilly C,5,0,5,0
1653300809843,COMM 100A,A04,090642,Irani; Lilly C,3,0,5,2
1653300809843,COMM 100A,A05,090643,Irani; Lilly C,3,0,5,2
1653300809843,COMM 100A,A06,090644,Irani; Lilly C,4,0,5,1
1653300809843,COMM 100A,A07,090645,Irani; Lilly C,5,0,5,0
1653300809843,COMM 100A,A08,090646,Irani; Lilly C,5,0,5,0
1653300809843,COMM 100A,A09,090647,Irani; Lilly C,5,0,5,0
1653300809843,COMM 100A,A10,090648,Irani; Lilly C,5,0,5,0
1653300809843,COMM 100A,A11,090649,Irani; Lilly C,3,0,5,2
1653300809843,COMM 100A,A12,090650,Irani; Lilly C,5,0,5,0
1653300810371,COMM 101,A01,090652,Halm; Gavin Patrick,14,0,15,1
1653300810371,COMM 101,A02,090653,Halm; Gavin Patrick,14,0,15,1
1653300810371,COMM 101,A03,090654,Halm; Gavin Patrick,12,0,15,3
1653300810371,COMM 101,A04,090655,Halm; Gavin Patrick,13,0,15,2
1653300810894,COMM 101D,A00,090656,Halm; Gavin Patrick,14,0,15,1
1653300811420,COMM 101K,A00,090657,Ahn; Patricia Jeehyun,16,0,20,4
1653300811944,COMM 101T,A00,093701,Staff,20,0,20,0
1653300812467,COMM 102C,A01,090660,Staff,4,0,6,2
1653300812467,COMM 102C,A02,090661,Staff,6,0,6,0
1653300812467,COMM 102C,A03,090662,Staff,4,0,6,2
1653300812992,COMM 103D,A00,090663,Davis; Zeinabu I.,38,0,40,2
1653300813515,COMM 106E,A00,090667,Geiger; Richard Stuart,26,0,30,4
1653300814040,COMM 106G,A00,090668,Cordoba Azcarate; Matilde,25,0,30,5
1653300814568,COMM 108G,A00,090670,Walkover; Lillian B,30,0,30,0
1653300815091,COMM 109I,A00,090671,Tanaka; Stefan A.,30,0,30,0
1653300815614,COMM 109N,A00,094205,Hallin; Daniel C,25,0,30,5
1653300816139,COMM 110G,A00,090672,Whitworth-Smith; Andrew C,45,0,50,5
1653300816666,COMM 111P,A00,090673,Conner; Thomas Hartnell,27,0,30,3
1653300817200,COMM 111T,A00,090674,Iatarola; Briana Marie,27,0,30,3
1653300817726,COMM 124A,A00,090677,Sims; Christopher O,79,0,80,1
1653300818249,COMM 131,A00,090678,Fields; Gary,22,0,25,3
1653300818772,COMM 134,A00,090679,Kidman; Shawna F,16,0,25,9
1653300819297,COMM 146,A00,090680,Staff,22,0,25,3
1653300819820,COMM 166,A00,094493,Staff,24,0,25,1
1653300820347,COMM 172,A00,094066,Staff,23,0,25,2
1653300820874,COMM 182,A00,094063,Staff,25,0,25,0
1653300821406,COMM 190,A00,090686,Kidman; Shawna F,17,0,23,6
1653300821406,COMM 190,B00,090687,Irani; Lilly C,0,0,0,0
1653300821406,COMM 190,C00,090688,Keith; Kerry,21,0,23,2
1653300821406,COMM 190,D00,090689,Zilberg; Elana,23,0,23,0
1653300821929,COMM 194,A00,091600,Hill; Seth J,9999,0,9999,0
1653300822459,COMM 196A,A00,090690,Schmidt; Thomas Rainer,0,0,0,0
1653300822991,COMM 198,001,091397,Ahn; Patricia Jeehyun,9999,0,9999,0
1653300822991,COMM 198,002,091398,Alac; Morana,9999,0,9999,0
1653300822991,COMM 198,003,091399,Anderson; Patrick W.,9999,0,9999,0
1653300822991,COMM 198,004,091400,Boateng; Boatema,9999,0,9999,0
1653300822991,COMM 198,005,091401,Booker; Angela N,9999,0,9999,0
1653300822991,COMM 198,008,091402,Cordoba Azcarate; Matilde,9999,0,9999,0
1653300822991,COMM 198,009,091403,Davis; Zeinabu I.,9999,0,9999,0
1653300822991,COMM 198,010,091404,Dewaard; Andrew Michael,9999,0,9999,0
1653300822991,COMM 198,011,091405,Dominguez Rubio; Fernando,9999,0,9999,0
1653300822991,COMM 198,012,091406,Fattal; Alexander Leor,9999,0,9999,0
1653300822991,COMM 198,013,091407,Fields; Gary,9999,0,9999,0
1653300822991,COMM 198,014,091408,Gates; Kelly,9999,0,9999,0
1653300822991,COMM 198,015,091409,Goldfarb; Brian,9999,0,9999,0
1653300822991,COMM 198,018,091410,Hill; Erin Truesdell,9999,0,9999,0
1653300822991,COMM 198,019,091411,Horwitz; Robert B,9999,0,9999,0
1653300822991,COMM 198,021,091412,Irani; Lilly C,9999,0,9999,0
1653300822991,COMM 198,022,091413,Jack; Caroline Sarah,9999,0,9999,0
1653300822991,COMM 198,023,091414,Kidman; Shawna F,9999,0,9999,0
1653300822991,COMM 198,024,091415,Martinico; Daniel J,9999,0,9999,0
1653300822991,COMM 198,026,091416,Schmidt; Thomas Rainer,9999,0,9999,0
1653300822991,COMM 198,027,091417,Serlin; David,9999,0,9999,0
1653300822991,COMM 198,028,091418,Sims; Christopher O,9999,0,9999,0
1653300822991,COMM 198,029,091419,Tanaka; Stefan A.,9999,0,9999,0
1653300822991,COMM 198,030,091420,Zilberg; Elana,9999,0,9999,0
1653300822991,COMM 198,031,091421,Walkover; Lillian B,9999,0,9999,0
1653300822991,COMM 198,032,091422,Geiger; Richard Stuart,9999,0,9999,0
1653300823517,CSE 8A,A50,089985,Soosai Raj; Adalbert Geral,7,0,10,3
1653300823517,CSE 8A,A51,089986,Soosai Raj; Adalbert Geral,1,0,10,9
1653300823517,CSE 8A,A52,089987,Soosai Raj; Adalbert Geral,5,0,10,5
1653300823517,CSE 8A,A53,089988,Soosai Raj; Adalbert Geral,9,0,10,1
1653300823517,CSE 8A,B50,089990,Soosai Raj; Adalbert Geral,0,0,10,10
1653300823517,CSE 8A,B51,089991,Soosai Raj; Adalbert Geral,5,0,10,5
1653300823517,CSE 8A,B52,089992,Soosai Raj; Adalbert Geral,5,0,10,5
1653300823517,CSE 8A,B53,089993,Soosai Raj; Adalbert Geral,9,0,10,1
1653300823517,CSE 8A,C50,089995,Lerner; Sorin,0,0,10,10
1653300823517,CSE 8A,C51,089996,Lerner; Sorin,6,0,10,4
1653300823517,CSE 8A,C52,089997,Lerner; Sorin,9,0,10,1
1653300823517,CSE 8A,C53,089998,Lerner; Sorin,8,0,10,2
1653300824040,CSE 8B,A01,090000,Ochoa; Benjamin Lawrence,94,0,100,6
1653300824570,CSE 11,A01,090002,Cao; Yingjun,39,0,49,10
1653300824570,CSE 11,B01,090004,Cao; Yingjun,45,0,49,4
1653300824570,CSE 11,C01,090006,Cao; Yingjun,35,0,49,14
1653300825096,CSE 12,A01,090008,Staff,73,0,73,0
1653300825096,CSE 12,B01,090010,Staff,67,0,73,6
1653300825096,CSE 12,C01,090012,Staff,60,0,73,13
1653300825625,CSE 15L,A01,090014,Politz; Joseph Gibbs,4,0,10,6
1653300825625,CSE 15L,A02,090015,Politz; Joseph Gibbs,7,0,10,3
1653300825625,CSE 15L,A03,090016,Politz; Joseph Gibbs,9,0,10,1
1653300825625,CSE 15L,A04,090017,Politz; Joseph Gibbs,9,0,10,1
1653300825625,CSE 15L,A05,090018,Politz; Joseph Gibbs,9,0,10,1
1653300825625,CSE 15L,B01,090020,Politz; Joseph Gibbs,8,0,10,2
1653300825625,CSE 15L,B02,090021,Politz; Joseph Gibbs,6,0,10,4
1653300825625,CSE 15L,B03,090022,Politz; Joseph Gibbs,7,0,10,3
1653300825625,CSE 15L,B04,090023,Politz; Joseph Gibbs,7,0,10,3
1653300825625,CSE 15L,B05,090024,Politz; Joseph Gibbs,7,0,10,3
1653300826170,CSE 20,A01,090026,Staff,204,0,210,6
1653300826694,CSE 21,A01,090028,Impagliazzo; Russell,0,0,0,0
1653300826694,CSE 21,A02,094488,Impagliazzo; Russell,0,0,0,0
1653300826694,CSE 21,A03,094489,Impagliazzo; Russell,0,0,0,0
1653300827218,CSE 30,A01,092463,Muller; P Keith,73,0,100,27
1653300827218,CSE 30,A02,092464,Staff,97,0,100,3
1653300827752,CSE 87,A00,094193,Moshiri; Alexander Niema,20,0,20,0
1653300828275,CSE 95,A00,090030,Minnes Kemp; Mor Mia,35,0,35,0
1653300828275,CSE 95,B00,093883,Minnes Kemp; Mor Mia,35,0,35,0
1653300828275,CSE 95,C00,093885,Minnes Kemp; Mor Mia,35,0,35,0
1653300828803,CSE 100,A01,090033,Moshiri; Alexander Niema,68,0,114,46
1653300829342,CSE 100R,A01,093837,Moshiri; Alexander Niema,334,0,350,16
1653300829869,CSE 101,A01,090035,Saha; Barna,152,0,237,85
1653300830396,CSE 103,A01,090037,Freund; Yoav,60,0,75,15
1653300830933,CSE 105,A01,090039,Lovett; Shachar,201,0,225,24
1653300831475,CSE 106,A50,090042,Paturi; Ramamohan,11,0,30,19
1653300832013,CSE 107,A01,090044,Bellare; Mihir,94,0,120,26
1653300832539,CSE 110,A50,090047,Powell; Thomas Allan,39,0,50,11
1653300832539,CSE 110,A51,090048,Powell; Thomas Allan,39,0,50,11
1653300832539,CSE 110,A52,090049,Powell; Thomas Allan,48,0,50,2
1653300832539,CSE 110,A53,090050,Powell; Thomas Allan,49,0,50,1
1653300832539,CSE 110,A54,090051,Powell; Thomas Allan,45,0,50,5
1653300832539,CSE 110,A55,090052,Powell; Thomas Allan,50,0,50,0
1653300832539,CSE 110,A56,090053,Powell; Thomas Allan,49,0,50,1
1653300832539,CSE 110,A57,090054,Powell; Thomas Allan,41,0,45,4
1653300833061,CSE 118,A00,094897,Weibel; Nadir,0,0,0,0
1653300833587,CSE 120,A01,090056,Voelker; Geoffrey M.,226,0,300,74
1653300834127,CSE 124,A01,090058,Porter; George M,123,0,189,66
1653300834655,CSE 127,A01,090060,Savage; Stefan,46,0,189,143
1653300835180,CSE 130,A01,090062,Polikarpova; Nadezhda,171,0,189,18
1653300835707,CSE 132A,A01,090064,Deutsch; Alin Bernard,46,0,189,143
1653300836234,CSE 140,A01,090068,Eldon; John,169,0,196,27
1653300836234,CSE 140,B01,090070,Orailoglu; Alex,48,0,49,1
1653300836788,CSE 140L,A01,090072,Eldon; John,161,0,192,31
1653300836788,CSE 140L,B01,090075,Orailoglu; Alex,44,0,49,5
1653300837333,CSE 142,A01,090078,Porter; Leonard Emerson,86,0,146,60
1653300837333,CSE 142,B01,090080,Porter; Leonard Emerson,107,0,146,39
1653300837859,CSE 142L,A01,090082,Swanson; Steven James,48,0,146,98
1653300837859,CSE 142L,B01,090084,Swanson; Steven James,120,0,146,26
1653300838389,CSE 151B,A01,090088,Cottrell; Garrison W,258,0,328,70
1653300838913,CSE 152A,A01,090090,Chandraker; Manmohan Krishna,153,0,189,36
1653300839440,CSE 158,A01,090092,McAuley; Julian John,84,0,197,113
1653300839967,CSE 158R,A01,090094,McAuley; Julian John,306,0,353,47
1653300840493,CSE 167,A01,090096,Chern; Albert Ren-Haur,165,0,189,24
1653300841016,CSE 170,A01,090098,Vaccaro; Kristen Marie,20,0,20,0
1653300841016,CSE 170,A02,090099,Vaccaro; Kristen Marie,14,0,20,6
1653300841016,CSE 170,A03,090100,Vaccaro; Kristen Marie,14,0,20,6
1653300841016,CSE 170,A04,090101,Vaccaro; Kristen Marie,14,0,20,6
1653300841016,CSE 170,A05,090102,Vaccaro; Kristen Marie,18,0,20,2
1653300841549,CSE 190,A00,090103,Shalev; Aaron D,40,0,40,0
1653300841549,CSE 190,B00,090104,Vaccaro; Kristen Marie,100,0,100,0
1653300841549,CSE 190,C00,090105,Pannuto; Patrick William,25,0,25,0
1653300842104,CSE 191,A00,093848,Minnes Kemp; Mor Mia,9999,0,9999,0
1653300842635,CSE 193,A01,090107,Elsherif; May Elhussein,49,0,49,0
1653300843168,CSE 194,A01,090109,Munyaka; Imani N. S.,20,0,49,29
1653300843718,CSS 1,A01,086486,Staff,22,0,24,2
1653300843718,CSS 1,A02,086487,Staff,21,0,24,3
1653300843718,CSS 1,A03,086488,Staff,20,0,24,4
1653300843718,CSS 1,A04,086489,Staff,23,0,24,1
1653300844249,DOC 1,A01,086773,Solomon; Amanda Lee Albaniel,0,0,0,0
1653300844249,DOC 1,A02,086774,Solomon; Amanda Lee Albaniel,0,0,0,0
1653300844249,DOC 1,A03,086775,Solomon; Amanda Lee Albaniel,5,0,6,1
1653300844249,DOC 1,A04,086776,Solomon; Amanda Lee Albaniel,6,0,6,0
1653300844249,DOC 1,A05,086777,Solomon; Amanda Lee Albaniel,6,0,6,0
1653300844249,DOC 1,A06,086778,Solomon; Amanda Lee Albaniel,6,0,6,0
1653300844249,DOC 1,A07,086779,Solomon; Amanda Lee Albaniel,5,0,6,1
1653300844249,DOC 1,A08,086849,Solomon; Amanda Lee Albaniel,6,0,6,0
1653300844249,DOC 1,A09,086780,Solomon; Amanda Lee Albaniel,6,0,6,0
1653300844249,DOC 1,A10,086781,Solomon; Amanda Lee Albaniel,6,0,6,0
1653300844249,DOC 1,A11,086782,Solomon; Amanda Lee Albaniel,5,0,6,1
1653300844249,DOC 1,A12,086783,Solomon; Amanda Lee Albaniel,6,0,6,0
1653300844249,DOC 1,A13,086784,Solomon; Amanda Lee Albaniel,6,0,6,0
1653300844249,DOC 1,A14,086785,Solomon; Amanda Lee Albaniel,6,0,6,0
1653300844249,DOC 1,A15,086786,Solomon; Amanda Lee Albaniel,6,0,6,0
1653300844249,DOC 1,A16,086787,Solomon; Amanda Lee Albaniel,6,0,6,0
1653300844249,DOC 1,A17,086788,Solomon; Amanda Lee Albaniel,0,0,0,0
1653300844249,DOC 1,A18,086789,Solomon; Amanda Lee Albaniel,0,0,0,0
1653300844249,DOC 1,B01,086791,Solomon; Amanda Lee Albaniel,6,0,6,0
1653300844249,DOC 1,B02,086792,Solomon; Amanda Lee Albaniel,6,0,6,0
1653300844249,DOC 1,B03,086793,Solomon; Amanda Lee Albaniel,6,0,6,0
1653300844249,DOC 1,B04,086794,Solomon; Amanda Lee Albaniel,6,0,6,0
1653300844249,DOC 1,B05,086795,Solomon; Amanda Lee Albaniel,3,0,6,3
1653300844249,DOC 1,B06,086796,Solomon; Amanda Lee Albaniel,6,0,6,0
1653300844249,DOC 1,B07,086797,Solomon; Amanda Lee Albaniel,6,0,6,0
1653300844249,DOC 1,B08,086798,Solomon; Amanda Lee Albaniel,6,0,6,0
1653300844249,DOC 1,B09,086799,Solomon; Amanda Lee Albaniel,6,0,6,0
1653300844249,DOC 1,B10,086800,Solomon; Amanda Lee Albaniel,6,0,6,0
1653300844249,DOC 1,B11,086801,Solomon; Amanda Lee Albaniel,5,0,6,1
1653300844249,DOC 1,B12,086802,Solomon; Amanda Lee Albaniel,6,0,6,0
1653300844249,DOC 1,B13,086803,Solomon; Amanda Lee Albaniel,6,0,6,0
1653300844249,DOC 1,B14,086804,Solomon; Amanda Lee Albaniel,6,0,6,0
1653300844249,DOC 1,B15,086805,Solomon; Amanda Lee Albaniel,5,0,6,1
1653300844249,DOC 1,B16,086806,Solomon; Amanda Lee Albaniel,6,0,6,0
1653300844249,DOC 1,B17,086807,Solomon; Amanda Lee Albaniel,0,0,0,0
1653300844249,DOC 1,B18,086808,Solomon; Amanda Lee Albaniel,0,0,0,0
1653300844249,DOC 1,C01,086810,Strom; Megan C.,6,0,6,0
1653300844249,DOC 1,C02,086811,Strom; Megan C.,5,0,6,1
1653300844249,DOC 1,C03,086812,Strom; Megan C.,6,0,6,0
1653300844249,DOC 1,C04,086813,Strom; Megan C.,5,0,6,1
1653300844249,DOC 1,C05,086814,Strom; Megan C.,5,0,6,1
1653300844249,DOC 1,C06,086815,Strom; Megan C.,6,0,6,0
1653300844249,DOC 1,C07,086816,Strom; Megan C.,6,0,6,0
1653300844249,DOC 1,C08,086817,Strom; Megan C.,6,0,6,0
1653300844249,DOC 1,C09,086818,Strom; Megan C.,6,0,6,0
1653300844249,DOC 1,C10,086819,Strom; Megan C.,6,0,6,0
1653300844249,DOC 1,C11,086820,Strom; Megan C.,6,0,6,0
1653300844249,DOC 1,C12,086821,Strom; Megan C.,6,0,6,0
1653300844249,DOC 1,C13,086822,Strom; Megan C.,6,0,6,0
1653300844249,DOC 1,C14,086823,Strom; Megan C.,6,0,6,0
1653300844249,DOC 1,C15,086824,Strom; Megan C.,6,0,6,0
1653300844249,DOC 1,C16,086825,Strom; Megan C.,6,0,6,0
1653300844249,DOC 1,C17,086826,Strom; Megan C.,0,0,0,0
1653300844249,DOC 1,C18,086827,Strom; Megan C.,0,0,0,0
1653300844249,DOC 1,D01,086829,Strom; Megan C.,6,0,6,0
1653300844249,DOC 1,D02,086830,Strom; Megan C.,6,0,6,0
1653300844249,DOC 1,D03,086831,Strom; Megan C.,5,0,6,1
1653300844249,DOC 1,D04,086832,Strom; Megan C.,6,0,6,0
1653300844249,DOC 1,D05,086833,Strom; Megan C.,6,0,6,0
1653300844249,DOC 1,D06,086834,Strom; Megan C.,6,0,6,0
1653300844249,DOC 1,D07,086835,Strom; Megan C.,6,0,6,0
1653300844249,DOC 1,D08,086836,Strom; Megan C.,6,0,6,0
1653300844249,DOC 1,D09,086837,Strom; Megan C.,0,0,0,0
1653300844249,DOC 1,D10,086838,Strom; Megan C.,0,0,0,0
1653300844249,DOC 1,D11,086839,Strom; Megan C.,6,0,6,0
1653300844249,DOC 1,D12,086840,Strom; Megan C.,6,0,6,0
1653300844249,DOC 1,D13,086841,Strom; Megan C.,6,0,6,0
1653300844249,DOC 1,D14,086842,Strom; Megan C.,5,0,6,1
1653300844249,DOC 1,D15,086843,Strom; Megan C.,6,0,6,0
1653300844249,DOC 1,D16,086844,Strom; Megan C.,5,0,6,1
1653300844781,DOC 100D,A00,086845,Pass; Natalye Joann,0,0,0,0
1653300844781,DOC 100D,B00,086846,Pass; Natalye Joann,21,0,25,4
1653300844781,DOC 100D,C00,086847,Pass; Natalye Joann,23,0,25,2
1653300845311,DSC 10,A01,088092,Tiefenbruck; Janine LoBue,13,0,15,2
1653300845311,DSC 10,B01,088095,Tiefenbruck; Janine LoBue,9,0,15,6
1653300845311,DSC 10,C01,088098,Rampure; Suraj,0,0,15,15
1653300845836,DSC 20,A01,088101,Langlois; Marina,148,0,150,2
1653300846372,DSC 30,A01,088105,Langlois; Marina,74,0,75,1
1653300846893,DSC 40A,A01,088107,Rampure; Suraj,97,0,100,3
1653300846893,DSC 40A,B01,088109,Rampure; Suraj,99,0,100,1
1653300847418,DSC 40B,A01,088111,Eldridge; Justin Matthew,73,0,75,2
1653300847418,DSC 40B,B01,088113,Wang; Yusu,75,0,75,0
1653300847945,DSC 80,A01,088115,Eldridge; Justin Matthew,95,0,100,5
1653300848471,DSC 95,A01,088117,Langlois; Marina,20,0,20,0
1653300849000,DSC 96,A00,088118,Liao; Soohyun Nam,50,0,50,0
1653300849523,DSC 100,A01,088120,Salimi; Babak,164,0,175,11
1653300850051,DSC 102,A01,094320,Kumar; Arun Kumar,77,0,125,48
1653300850607,DSC 180A,A01,088124,Fraenkel; Aaron Mcmillan,0,0,0,0
1653300850607,DSC 180A,A02,088125,Fraenkel; Aaron Mcmillan,0,0,0,0
1653300850607,DSC 180A,A03,088126,Fraenkel; Aaron Mcmillan,0,0,0,0
1653300850607,DSC 180A,A04,088127,Fraenkel; Aaron Mcmillan,0,0,0,0
1653300850607,DSC 180A,A05,088128,Fraenkel; Aaron Mcmillan,0,0,0,0
1653300850607,DSC 180A,A06,088129,Fraenkel; Aaron Mcmillan,0,0,0,0
1653300850607,DSC 180A,A07,088130,Fraenkel; Aaron Mcmillan,0,0,0,0
1653300850607,DSC 180A,A08,088131,Fraenkel; Aaron Mcmillan,0,0,0,0
1653300850607,DSC 180A,A09,088132,Fraenkel; Aaron Mcmillan,0,0,0,0
1653300850607,DSC 180A,A10,088133,Fraenkel; Aaron Mcmillan,0,0,0,0
1653300850607,DSC 180A,A11,088134,Fraenkel; Aaron Mcmillan,0,0,0,0
1653300850607,DSC 180A,A12,088135,Fraenkel; Aaron Mcmillan,0,0,0,0
1653300850607,DSC 180A,A13,088136,Fraenkel; Aaron Mcmillan,0,0,0,0
1653300850607,DSC 180A,A14,088137,Fraenkel; Aaron Mcmillan,0,0,0,0
1653300850607,DSC 180A,A15,088138,Fraenkel; Aaron Mcmillan,0,0,0,0
1653300850607,DSC 180A,B01,088141,Fraenkel; Aaron Mcmillan,0,0,0,0
1653300850607,DSC 180A,B02,088142,Fraenkel; Aaron Mcmillan,0,0,0,0
1653300850607,DSC 180A,B03,088143,Fraenkel; Aaron Mcmillan,0,0,0,0
1653300850607,DSC 180A,B04,088144,Fraenkel; Aaron Mcmillan,0,0,0,0
1653300850607,DSC 180A,B05,088145,Fraenkel; Aaron Mcmillan,0,0,0,0
1653300850607,DSC 180A,B06,088146,Fraenkel; Aaron Mcmillan,0,0,0,0
1653300850607,DSC 180A,B07,088147,Fraenkel; Aaron Mcmillan,0,0,0,0
1653300850607,DSC 180A,B08,088148,Fraenkel; Aaron Mcmillan,0,0,0,0
1653300850607,DSC 180A,B09,088149,Fraenkel; Aaron Mcmillan,0,0,0,0
1653300850607,DSC 180A,B10,088150,Fraenkel; Aaron Mcmillan,0,0,0,0
1653300850607,DSC 180A,B11,088151,Fraenkel; Aaron Mcmillan,0,0,0,0
1653300850607,DSC 180A,B12,088152,Fraenkel; Aaron Mcmillan,0,0,0,0
1653300850607,DSC 180A,B13,088153,Fraenkel; Aaron Mcmillan,0,0,0,0
1653300850607,DSC 180A,B14,088154,Fraenkel; Aaron Mcmillan,0,0,0,0
1653300850607,DSC 180A,B15,088155,Fraenkel; Aaron Mcmillan,0,0,0,0
1653300851131,DSC 190,A01,088158,Mishne; Gal,48,0,50,2
1653300851131,DSC 190,B01,088160,Silberman; Jack,16,0,21,5
1653300851658,DSC 197,001,088161,Eldridge; Justin Matthew,9999,0,9999,0
1653300852189,DSGN 1,A01,087888,Meyer; Michael Wayne,49,0,53,4
1653300852189,DSGN 1,A02,087889,Meyer; Michael Wayne,47,0,53,6
1653300852189,DSGN 1,A03,087890,Meyer; Michael Wayne,43,0,53,10
1653300852740,DSGN 100,A01,087983,Dow; Steven P,39,0,40,1
1653300852740,DSGN 100,A02,087984,Dow; Steven P,40,0,40,0
1653300852740,DSGN 100,A03,087985,Dow; Steven P,34,0,40,6
1653300853271,DSGN 118,A01,087987,Xia; Haijun,55,0,60,5
1653300853271,DSGN 118,A02,087988,Xia; Haijun,56,0,60,4
1653300853794,DSGN 119,A00,087989,Staff,51,0,70,19
1653300854329,ECE 5,A01,090699,Morris; Karcher William,0,0,0,0
1653300854329,ECE 5,A02,090700,Morris; Karcher William,0,0,0,0
1653300854329,ECE 5,A03,090701,Morris; Karcher William,0,0,0,0
1653300854329,ECE 5,A04,090702,Morris; Karcher William,0,0,0,0
1653300854329,ECE 5,A05,090703,Morris; Karcher William,0,0,0,0
1653300854329,ECE 5,A06,090704,Morris; Karcher William,0,0,0,0
1653300854871,ECE 15,A01,090706,Schurgers; Curt,0,0,0,0
1653300854871,ECE 15,A02,090707,Schurgers; Curt,0,0,0,0
1653300855411,ECE 16,A01,090709,Khoshabeh; Ramsin,24,0,30,6
1653300855934,ECE 17,A01,090711,Gilja; Vikash,55,0,60,5
1653300856462,ECE 25,A50,090714,Liu; Zhaowei,0,0,0,0
1653300856462,ECE 25,A51,090715,Liu; Zhaowei,0,0,0,0
1653300856462,ECE 25,A52,090716,Liu; Zhaowei,0,0,0,0
1653300856989,ECE 30,A50,094300,Mir Arabbaygi; Siavash,25,0,30,5
1653300856989,ECE 30,A51,094301,Mir Arabbaygi; Siavash,29,0,30,1
1653300856989,ECE 30,A52,094302,Mir Arabbaygi; Siavash,27,0,30,3
1653300856989,ECE 30,A53,094303,Mir Arabbaygi; Siavash,29,0,30,1
1653300856989,ECE 30,A54,094304,Mir Arabbaygi; Siavash,25,0,25,0
1653300857514,ECE 35,A50,090720,Schurgers; Curt,0,0,0,0
1653300857514,ECE 35,A51,090721,Schurgers; Curt,0,0,0,0
1653300857514,ECE 35,A52,090722,Schurgers; Curt,0,0,0,0
1653300857514,ECE 35,A53,090723,Schurgers; Curt,0,0,0,0
1653300857514,ECE 35,A54,090724,Schurgers; Curt,0,0,0,0
1653300857514,ECE 35,A55,090725,Schurgers; Curt,0,0,0,0
1653300857514,ECE 35,B50,090729,Schurgers; Curt,0,0,0,0
1653300857514,ECE 35,B51,090730,Schurgers; Curt,0,0,0,0
1653300857514,ECE 35,B52,090731,Schurgers; Curt,0,0,0,0
1653300857514,ECE 35,B53,090732,Schurgers; Curt,0,0,0,0
1653300857514,ECE 35,B54,090733,Schurgers; Curt,0,0,0,0
1653300857514,ECE 35,B55,090734,Schurgers; Curt,0,0,0,0
1653300858042,ECE 45,A01,090736,Franceschetti; Massimo,56,0,57,1
1653300858042,ECE 45,A02,090737,Franceschetti; Massimo,50,0,58,8
1653300858573,ECE 65,A50,090741,Baghdadchi; Saharnaz,13,0,15,2
1653300858573,ECE 65,A51,090742,Baghdadchi; Saharnaz,5,0,10,5
1653300858573,ECE 65,A52,090743,Baghdadchi; Saharnaz,14,0,15,1
1653300858573,ECE 65,A53,090744,Baghdadchi; Saharnaz,8,0,10,2
1653300858573,ECE 65,A54,094865,Baghdadchi; Saharnaz,14,0,15,1
1653300858573,ECE 65,A55,094866,Baghdadchi; Saharnaz,9,0,10,1
1653300858573,ECE 65,A56,094867,Baghdadchi; Saharnaz,14,0,15,1
1653300858573,ECE 65,A57,094868,Baghdadchi; Saharnaz,15,0,15,0
1653300858573,ECE 65,A58,094869,Baghdadchi; Saharnaz,10,0,10,0
1653300859120,ECE 100,A01,090746,Baghdadchi; Saharnaz,16,0,20,4
1653300859120,ECE 100,A02,090747,Baghdadchi; Saharnaz,20,0,20,0
1653300859120,ECE 100,A03,090748,Baghdadchi; Saharnaz,18,0,20,2
1653300859120,ECE 100,A04,090749,Baghdadchi; Saharnaz,20,0,20,0
1653300859120,ECE 100,A05,090750,Baghdadchi; Saharnaz,18,0,20,2
1653300859120,ECE 100,A06,090751,Baghdadchi; Saharnaz,18,0,20,2
1653300859120,ECE 100,A07,090752,Baghdadchi; Saharnaz,20,0,20,0
1653300859651,ECE 101,A01,090754,Siegel; Paul H.,62,0,75,13
1653300859651,ECE 101,A02,090755,Siegel; Paul H.,71,0,75,4
1653300860184,ECE 102,A00,090756,Hsueh; Tzu-Chien,57,0,75,18
1653300860717,ECE 103,A01,090767,Lo; Yu-Hwa,45,0,50,5
1653300861262,ECE 107,A01,090769,Lomakin; Vitaliy,72,0,75,3
1653300861900,ECE 109,A01,090771,Zeger; Kenneth A.,176,0,180,4
1653300862424,ECE 111,A01,090774,Koushanfar; Farinaz,100,0,120,20
1653300862950,ECE 121A,A50,090777,Esmaili; Gholamreza,17,0,24,7
1653300862950,ECE 121A,A51,090778,Esmaili; Gholamreza,9,0,24,15
1653300862950,ECE 121A,A52,090779,Esmaili; Gholamreza,22,0,24,2
1653300863473,ECE 128A,A00,090780,Staff,40,0,70,30
1653300863997,ECE 135A,A00,090781,Kuzum; Duygu,30,0,30,0
1653300864521,ECE 143,A00,090782,Unpingco; Jose H.,0,0,0,2
1653300865044,ECE 148,A01,090784,Staff,32,0,32,0
1653300865568,ECE 155,A01,090786,Milstein; Laurence B.,16,0,20,4
1653300866092,ECE 158A,A01,090788,Franceschetti; Massimo,56,0,65,9
1653300866615,ECE 161A,A01,090790,Rao; Bhaskar D.,103,0,115,12
1653300867142,ECE 164,A00,090791,Hall; Drew A.,87,0,115,28
1653300867669,ECE 166,A50,090796,Rebeiz; Gabriel,6,0,12,6
1653300867669,ECE 166,A51,090797,Rebeiz; Gabriel,9,0,12,3
1653300867669,ECE 166,A52,090799,Rebeiz; Gabriel,1,0,12,11
1653300867669,ECE 166,A53,090800,Rebeiz; Gabriel,6,0,12,6
1653300867669,ECE 166,A54,094335,Rebeiz; Gabriel,11,0,12,1
1653300867669,ECE 166,A55,094336,Rebeiz; Gabriel,12,0,12,0
1653300867669,ECE 166,A56,094349,Rebeiz; Gabriel,13,0,15,2
1653300867669,ECE 166,A57,094350,Rebeiz; Gabriel,14,0,15,1
1653300868197,ECE 171A,A01,090802,Atanasov; Nikolay A.,45,0,60,15
1653300868721,ECE 171B,A01,090804,Shi; Yuanyuan,44,0,50,6
1653300869248,ECE 174,A01,090806,Pal; Piya,125,0,146,21
1653300869773,ECE 182,A01,090808,Lomakin; Vitaliy,23,0,23,0
1653300870301,ECE 187,A00,090809,Liu; Zhaowei,19,0,20,1
1653300870825,ECE 196,A00,090812,Morris; Karcher William,19,0,24,5
1653300870825,ECE 196,B00,094833,Morris; Karcher William,24,0,24,0
1653300871346,ECE 197,001,090813,Sievenpiper; Daniel F.,9999,0,9999,0
1653300871870,ECON 1,A01,092535,Staff,0,0,0,0
1653300871870,ECON 1,A02,092536,Staff,0,0,0,0
1653300871870,ECON 1,A03,092537,Staff,0,0,0,0
1653300871870,ECON 1,A04,092538,Staff,0,0,0,0
1653300871870,ECON 1,A05,092539,Staff,0,0,0,0
1653300871870,ECON 1,B01,092540,Ma; Alyson Chan,42,0,45,3
1653300871870,ECON 1,B02,092541,Ma; Alyson Chan,45,0,45,0
1653300871870,ECON 1,B03,092542,Ma; Alyson Chan,45,0,45,0
1653300871870,ECON 1,B04,092543,Ma; Alyson Chan,40,0,40,0
1653300871870,ECON 1,B05,092544,Ma; Alyson Chan,40,0,40,0
1653300871870,ECON 1,C01,092545,Tocoian; Oana,0,0,0,0
1653300871870,ECON 1,C02,092546,Tocoian; Oana,0,0,0,0
1653300871870,ECON 1,C03,092547,Tocoian; Oana,0,0,0,0
1653300871870,ECON 1,C04,092548,Tocoian; Oana,0,0,0,0
1653300871870,ECON 1,D01,094253,Levkoff; Steven B.,41,0,45,4
1653300871870,ECON 1,D02,094254,Levkoff; Steven B.,44,0,45,1
1653300871870,ECON 1,D03,094255,Levkoff; Steven B.,45,0,45,0
1653300871870,ECON 1,D04,094256,Levkoff; Steven B.,36,0,40,4
1653300871870,ECON 1,D05,094257,Levkoff; Steven B.,40,0,40,0
1653300872396,ECON 2,A01,092549,Staff,0,0,0,0
1653300872396,ECON 2,A02,092550,Staff,0,0,0,0
1653300872396,ECON 2,A03,092551,Staff,0,0,0,0
1653300872922,ECON 4,A01,092554,Levkoff; Steven B.,29,0,30,1
1653300872922,ECON 4,A02,092555,Levkoff; Steven B.,27,0,30,3
1653300872922,ECON 4,A03,092556,Levkoff; Steven B.,30,0,30,0
1653300873454,ECON 100A,A01,092557,Newhouse; Herbert S,23,0,30,7
1653300873454,ECON 100A,A02,092558,Newhouse; Herbert S,28,0,30,2
1653300873454,ECON 100A,A03,092559,Newhouse; Herbert S,29,0,30,1
1653300873454,ECON 100A,A04,092560,Newhouse; Herbert S,35,0,35,0
1653300873454,ECON 100A,B01,092561,Newhouse; Herbert S,20,0,30,10
1653300873454,ECON 100A,B02,092562,Newhouse; Herbert S,28,0,30,2
1653300873454,ECON 100A,B03,092563,Newhouse; Herbert S,15,0,30,15
1653300873454,ECON 100A,B04,092564,Newhouse; Herbert S,35,0,35,0
1653300873989,ECON 100B,A01,092565,Galperti; Simone,27,0,30,3
1653300873989,ECON 100B,A02,092566,Galperti; Simone,18,0,20,2
1653300873989,ECON 100B,A03,094496,Staff,27,0,30,3
1653300873989,ECON 100B,A04,094497,Staff,16,0,20,4
1653300873989,ECON 100B,B01,092567,Galperti; Simone,16,0,25,9
1653300874522,ECON 100C,A01,092569,Du; Songzi,62,0,75,13
1653300874522,ECON 100C,B01,092570,Du; Songzi,70,0,75,5
1653300874522,ECON 100C,B02,094258,Du; Songzi,75,0,75,0
1653300875048,ECON 100CH,A00,088284,Andreoni; James,20,0,20,0
1653300875572,ECON 109,A01,092572,Watson; Joel Christopher,68,0,75,7
1653300875572,ECON 109,B01,092573,Watson; Joel Christopher,68,0,75,7
1653300876121,ECON 110A,A01,092574,Alon; Titan Michael,12,0,25,13
1653300876121,ECON 110A,A02,092575,Alon; Titan Michael,24,0,25,1
1653300876121,ECON 110A,B01,092576,Alon; Titan Michael,24,0,25,1
1653300876121,ECON 110A,B02,092577,Alon; Titan Michael,25,0,25,0
1653300876649,ECON 110B,A01,092578,Trottner; Fabian Gunter We,16,0,25,9
1653300876649,ECON 110B,A02,094054,Trottner; Fabian Gunter We,23,0,25,2
1653300876649,ECON 110B,B01,092579,Trottner; Fabian Gunter We,7,0,25,18
1653300876649,ECON 110B,B02,094055,Trottner; Fabian Gunter We,24,0,25,1
1653300877184,ECON 116,A00,088291,Lowes; Sara Rachel,58,0,70,12
1653300877709,ECON 120A,A01,092580,Elliott; Graham,18,0,25,7
1653300877709,ECON 120A,A02,092581,Elliott; Graham,22,0,25,3
1653300877709,ECON 120A,B01,092582,Elliott; Graham,18,0,25,7
1653300877709,ECON 120A,B02,092583,Elliott; Graham,20,0,25,5
1653300877709,ECON 120A,C01,092584,Tocoian; Oana,27,0,30,3
1653300877709,ECON 120A,C02,092585,Tocoian; Oana,28,0,30,2
1653300877709,ECON 120A,C03,092586,Tocoian; Oana,40,0,40,0
1653300878232,ECON 120B,A01,092587,Candido; Maria Teresa,58,0,70,12
1653300878232,ECON 120B,A02,092588,Candido; Maria Teresa,51,0,60,9
1653300878232,ECON 120B,A03,092589,Candido; Maria Teresa,56,0,60,4
1653300878759,ECON 120C,A01,092590,Candido; Maria Teresa,48,0,60,12
1653300878759,ECON 120C,A02,092591,Candido; Maria Teresa,59,0,60,1
1653300878759,ECON 120C,A03,094310,Candido; Maria Teresa,73,0,75,2
1653300879282,ECON 121,A00,088298,Vogl; Tom Saul,36,0,50,14
1653300879813,ECON 130,A00,088299,Staff,59,0,75,16
1653300880336,ECON 131,A00,088300,Jacobsen; Mark,129,0,150,21
1653300880336,ECON 131,B00,088301,Jacobsen; Mark,15,0,30,15
1653300880875,ECON 152,A00,088302,Fadlon; Yizhak,34,0,50,16
1653300880875,ECON 152,B00,088303,Fadlon; Yizhak,49,0,50,1
1653300881399,ECON 168,A00,088304,Staff,54,0,60,6
1653300881933,ECON 191B,A00,088312,Galperti; Simone,20,0,20,0
1653300882470,EDS 25,A01,087581,Staff,9,0,10,1
1653300882470,EDS 25,A02,087582,Staff,10,0,10,0
1653300882470,EDS 25,A03,087583,Staff,7,0,10,3
1653300882470,EDS 25,A04,087584,Staff,10,0,10,0
1653300882997,EDS 31,A00,087585,Bussey; Thomas J,9,0,10,1
1653300883520,EDS 110R,A01,087597,Cohen; Shana R,43,0,50,7
1653300883520,EDS 110R,B01,093579,Cohen; Shana R,10,0,10,0
1653300884044,EDS 113,A00,087598,Staff,45,0,50,5
1653300884570,EDS 114,A01,088091,Eguchi; Emi,17,0,20,3
1653300884570,EDS 114,A02,087600,Eguchi; Emi,19,0,20,1
1653300885095,EDS 117,A01,087603,Chung; Luz Marina,25,0,35,10
1653300885095,EDS 117,A02,087604,Chung; Luz Marina,34,0,35,1
1653300885629,EDS 124AR,A01,087606,Simon; Elizabeth A,0,0,19,19
1653300885629,EDS 124AR,A02,087607,Simon; Elizabeth A,13,0,19,6
1653300885629,EDS 124AR,A03,087608,Simon; Elizabeth A,15,0,19,4
1653300885629,EDS 124AR,A04,087609,Simon; Elizabeth A,4,0,19,15
1653300885629,EDS 124AR,B01,087611,Simon; Elizabeth A,14,0,19,5
1653300885629,EDS 124AR,B02,087612,Simon; Elizabeth A,18,0,19,1
1653300885629,EDS 124AR,B03,087613,Simon; Elizabeth A,18,0,19,1
1653300885629,EDS 124AR,B04,087614,Simon; Elizabeth A,19,0,19,0
1653300885629,EDS 124AR,C01,094210,Simon; Elizabeth A,6,0,6,0
1653300885629,EDS 124AR,C02,094211,Simon; Elizabeth A,6,0,6,0
1653300885629,EDS 124AR,C03,094212,Simon; Elizabeth A,6,0,6,0
1653300885629,EDS 124AR,C04,094213,Simon; Elizabeth A,6,0,6,0
1653300885629,EDS 124AR,D01,094215,Simon; Elizabeth A,6,0,6,0
1653300885629,EDS 124AR,D02,094216,Simon; Elizabeth A,6,0,6,0
1653300885629,EDS 124AR,D03,094217,Simon; Elizabeth A,6,0,6,0
1653300885629,EDS 124AR,D04,094218,Simon; Elizabeth A,6,0,6,0
1653300886152,EDS 124BR,A00,087615,Eguchi; Emi,65,0,75,10
1653300886152,EDS 124BR,B00,093580,Eguchi; Emi,25,0,25,0
1653300886675,EDS 125,A00,087616,Jones; Gabrielle Anastasia,51,0,60,9
1653300887198,EDS 129A,A01,087618,Heinzman; Erica M.,43,0,50,7
1653300887722,EDS 130,A01,087620,Holtzman; Caren Lynn,17,0,20,3
1653300887722,EDS 130,A02,087621,Holtzman; Caren Lynn,20,0,20,0
1653300887722,EDS 130,A03,087622,Holtzman; Caren Lynn,20,0,20,0
1653300888247,EDS 131,A01,087624,Wishard Guerra; Alison G.,37,0,40,3
1653300888773,EDS 133,A01,087627,Bintliff; Amy S.V.,17,0,20,3
1653300888773,EDS 133,A02,087628,Bintliff; Amy S.V.,19,0,20,1
1653300889297,EDS 139,A00,087629,Holtzman; Caren Lynn,55,0,60,5
1653300889297,EDS 139,B00,087630,Heinzman; Erica M.,51,0,60,9
1653300889297,EDS 139,C00,087631,Bintliff; Amy S.V.,57,0,60,3
1653300889297,EDS 139,D00,087632,Wishard Guerra; Alison G.,58,0,60,2
1653300889297,EDS 139,E00,087633,Holtzman; Caren Lynn,30,0,30,0
1653300889297,EDS 139,F00,094886,Staff,25,0,25,0
1653300889825,EDS 146,A01,094220,Staff,25,0,25,0
1653300890366,EDS 164R,A01,087644,Wishard Guerra; Alison G.,37,0,40,3
1653300890366,EDS 164R,B01,093582,Wishard Guerra; Alison G.,20,0,20,0
1653300890889,EDS 190,A00,087645,Bresser; Bernard George,20,0,20,0
1653300890889,EDS 190,B00,087646,Pappas; Elizabeth,20,0,20,0
1653300890889,EDS 190,C00,087647,Scharton; Susan Michelle,20,0,20,0
1653300890889,EDS 190,E00,087648,Staff,20,0,20,0
1653300891412,ENG 10,A00,086288,Staff,30,0,30,0
1653300891412,ENG 10,B00,086289,Staff,30,0,30,0
1653300891933,ENG 15,A01,086291,Staff,35,0,35,0
1653300892461,ENG 20,A00,086292,Evdokimenko; Ekaterina,33,0,35,2
1653300892986,ENG 100D,A00,086293,Ngo; Anh-Thu T.,45,0,50,5
1653300892986,ENG 100D,B00,094309,Staff,46,0,50,4
1653300893515,ENG 100L,A00,086295,Kleissl; Jan,6,0,6,0
1653300893515,ENG 100L,B00,086296,Bratton; Maryann,8,0,8,0
1653300893515,ENG 100L,C00,086297,Nguyen; Truong Quang,10,0,10,0
1653300893515,ENG 100L,E00,086299,de Oliveira; Mauricio,8,0,8,0
1653300893515,ENG 100L,F00,086300,Goldberg; Charles G.,6,0,6,0
1653300893515,ENG 100L,G00,086301,Bratton; Maryann,6,0,6,0
1653300893515,ENG 100L,H00,086302,Staff,6,0,6,0
1653300894044,ENVR 30,A01,093565,Staff,29,0,30,1
1653300894044,ENVR 30,A02,093567,Staff,28,0,30,2
1653300894044,ENVR 30,A03,093568,Staff,25,0,30,5
1653300894044,ENVR 30,A04,093569,Staff,30,0,30,0
1653300894044,ENVR 30,A05,093570,Staff,29,0,30,1
1653300894044,ENVR 30,A06,093566,Staff,29,0,30,1
1653300894576,ENVR 102,A00,093571,Daly; Heather Marie,25,0,30,5
1653300895644,ERC 1,A01,092328,Herbst; Matthew,20,0,20,0
1653300895644,ERC 1,A02,092330,Herbst; Matthew,20,0,20,0
1653300895644,ERC 1,A03,092331,Herbst; Matthew,20,0,20,0
1653300895644,ERC 1,A04,092332,Herbst; Matthew,20,0,20,0
1653300895644,ERC 1,A05,092333,Herbst; Matthew,20,0,20,0
1653300895644,ERC 1,A06,092334,Herbst; Matthew,20,0,20,0
1653300896167,ERC 2,A01,092336,Rahimi; Babak,20,0,20,0
1653300896167,ERC 2,A02,092337,Rahimi; Babak,20,0,20,0
1653300896167,ERC 2,A03,092338,Rahimi; Babak,20,0,20,0
1653300896167,ERC 2,A04,092339,Rahimi; Babak,20,0,20,0
1653300896710,ERC 20,A00,092340,Evans; Ivan T,30,0,30,0
1653300896710,ERC 20,B00,092341,Evans; Ivan T,30,0,30,0
1653300897233,ERC 87,A00,093850,Herbst; Matthew,20,0,20,0
1653300897771,ERC 92,A00,092342,Staff,1,0,1,0
1653300897771,ERC 92,B00,092343,Staff,1,0,1,0
1653300897771,ERC 92,C00,092344,Staff,1,0,1,0
1653300897771,ERC 92,D00,092345,Staff,1,0,1,0
1653300897771,ERC 92,E00,092346,Staff,1,0,1,0
1653300897771,ERC 92,F00,092347,Staff,1,0,1,0
1653300898298,ESYS 90,A00,086303,Teranes; Jane,12,0,12,0
1653300898825,ESYS 101,A01,086305,Taylor; Jennifer Rebecca & Diaz; Julia Michelle,25,0,27,2
1653300898825,ESYS 101,A02,086306,Taylor; Jennifer Rebecca & Diaz; Julia Michelle,15,0,27,12
1653300898825,ESYS 101,A03,086307,Taylor; Jennifer Rebecca & Diaz; Julia Michelle,21,0,27,6
1653300898825,ESYS 101,A04,086308,Taylor; Jennifer Rebecca & Diaz; Julia Michelle,27,0,27,0
1653300899347,ESYS 187A,A01,086310,Teranes; Jane,38,0,40,2
1653300899347,ESYS 187A,B01,086312,Teranes; Jane,30,0,40,10
1653300899871,ETHN 1,A01,086314,Frank; Ross H.,15,0,15,0
1653300899871,ETHN 1,A02,086315,Frank; Ross H.,15,0,15,0
1653300899871,ETHN 1,A03,086316,Frank; Ross H.,14,0,15,1
1653300899871,ETHN 1,A04,086317,Frank; Ross H.,15,0,15,0
1653300899871,ETHN 1,A05,086318,Frank; Ross H.,15,0,15,0
1653300899871,ETHN 1,A06,086319,Frank; Ross H.,13,0,15,2
1653300899871,ETHN 1,A07,086320,Frank; Ross H.,15,0,15,0
1653300899871,ETHN 1,A08,086321,Frank; Ross H.,14,0,15,1
1653300899871,ETHN 1,A09,086322,Frank; Ross H.,15,0,15,0
1653300899871,ETHN 1,A10,086323,Frank; Ross H.,15,0,15,0
1653300899871,ETHN 1,A11,086324,Frank; Ross H.,15,0,15,0
1653300899871,ETHN 1,A12,086325,Frank; Ross H.,15,0,15,0
1653300899871,ETHN 1,A13,086326,Frank; Ross H.,15,0,15,0
1653300899871,ETHN 1,A14,086327,Frank; Ross H.,15,0,15,0
1653300899871,ETHN 1,A15,086328,Frank; Ross H.,15,0,15,0
1653300899871,ETHN 1,A16,086329,Frank; Ross H.,15,0,15,0
1653300900396,ETHN 100A,A00,086330,Patel; Shaista,41,0,48,7
1653300900919,ETHN 103,A00,086331,Perreira; Christopher Michael,63,0,70,7
1653300901441,ETHN 104,A00,086332,Staff,0,0,0,0
1653300901969,ETHN 106,A00,086333,Staff,0,0,0,0
1653300902517,ETHN 121,A00,086341,Sasaki; Christen T,20,0,28,8
1653300903039,ETHN 139,A00,086342,Ruiz; Ariana,16,0,20,4
1653300903577,ETHN 144M,A00,086343,Jolivette; Andrew J,66,0,70,4
1653300904098,ETHN 159,A00,088427,Graham; Jessica Lynn,0,0,0,0
1653300904646,ETHN 163E,A00,086344,Patel; Shaista,37,0,40,3
1653300905170,ETHN 178R,A00,090798,Borgo; David Garcia,15,0,20,5
1653300905695,ETHN 187,A00,086345,Perez; Roy,14,0,16,2
1653300906220,EXPR 100,A00,085686,Staff,9999,0,9999,0
1653300906754,FMPH 40,A00,086370,Emory; Kristen,70,0,75,5
1653300906754,FMPH 40,B00,086371,Romero; Sally Ann Dominick,71,0,75,4
1653300907282,FMPH 101,A00,086372,Brouwer; Kimberly,43,0,55,12
1653300907805,FMPH 102,A50,094498,Rana; Brinda Kanti,42,0,55,13
1653300908328,FMPH 110,A00,086374,Zoumas-Morse; Christine E.,61,0,65,4
1653300908853,FMPH 120,A00,086375,Nguyen-Grozavu; France T.,45,0,65,20
1653300908853,FMPH 120,B00,086376,Nguyen-Grozavu; France T.,60,0,65,5
1653300909382,FMPH 130,A00,086377,Staff,48,0,65,17
1653300910431,FMPH 161,A00,086379,Zoumas-Morse; Christine E.,58,0,65,7
1653300910976,FMPH 191,A00,086380,Harrell; Maralee Mae,58,0,60,2
1653300911499,FMPH 196A,A00,086381,Binkin; Nancy Jeanne,0,0,0,0
1653300912037,GLBH 20,A00,086407,Walkover; Lillian B,85,0,90,5
1653300912576,GLBH 100,A00,086408,Staff,55,0,56,1
1653300912576,GLBH 100,B00,086409,Wu; Hua,52,0,56,4
1653300912576,GLBH 100,D00,086411,Staff,38,0,40,2
1653300913099,GLBH 103,A00,086412,Hannah; Seth Donal,48,0,50,2
1653300913636,GLBH 105,A00,086413,Olivas Hernandez; Olga Lid,36,0,38,2
1653300914167,GLBH 106,A00,086414,Kayser; Georgia Lyn,40,0,40,0
1653300914691,GLBH 111,A01,094330,Burgos; Jose L.,0,0,0,0
1653300914691,GLBH 111,B01,094332,Burgos; Jose L.,0,0,0,0
1653300915292,GLBH 148,A00,086415,Staff,69,0,73,4
1653300915817,GLBH 181,A00,086417,Burgos; Jose L.,144,0,146,2
1653300916339,GSS 20,A00,094269,Staff,73,0,75,2
1653300916867,HDS 1,A01,086423,Staff,24,0,25,1
1653300916867,HDS 1,A02,086424,Staff,24,0,25,1
1653300916867,HDS 1,A03,086425,Staff,23,0,25,2
1653300916867,HDS 1,A04,086426,Staff,25,0,25,0
1653300916867,HDS 1,A05,086427,Staff,24,0,25,1
1653300916867,HDS 1,A06,086428,Staff,25,0,25,0
1653300916867,HDS 1,A07,086429,Staff,30,0,30,0
1653300917393,HDS 60,A01,086431,Staff,23,0,25,2
1653300917920,HDS 111,A00,086432,Staff,73,0,80,7
1653300918449,HDS 121,A01,086434,Deak; Gedeon O.,11,0,15,4
1653300918449,HDS 121,A02,086435,Deak; Gedeon O.,13,0,15,2
1653300918976,HDS 150,A00,086436,Staff,25,0,25,0
1653300918976,HDS 150,B00,086437,Staff,25,0,25,0
1653300919501,HDS 173,A00,086439,Staff,27,0,30,3
1653300920023,HDS 181,A01,086441,Staff,30,0,30,0
1653300920556,HDS 191,A01,086443,Staff,25,0,25,0
1653300921081,HIEA 129,A00,088057,Schneewind; Sarah,0,0,0,0
1653300921619,HIEA 137,A00,088058,Lu; Weijing,53,0,55,2
1653300922151,HIEA 144,A00,088059,Henry; Todd A.,43,0,45,2
1653300922692,HIEA 171,A00,088060,Lu; Weijing,15,0,15,0
1653300923219,HIEU 102,A00,088061,Watts; Edward J.,0,0,0,0
1653300923746,HIEU 107,A00,088062,Caciola; Nancy A,0,0,0,0
1653300924269,HIEU 108,A00,088063,Balberg; Mira,53,0,60,7
1653300924802,HIEU 128,A00,088064,Neuheiser; Joerg,0,0,0,0
1653300925326,HIEU 144,A00,094327,Staff,48,0,50,2
1653300925850,HIEU 149,A00,088065,Devereux; Andrew W,38,0,45,7
1653300926381,HIEU 154,A00,088066,Biess; Frank Peter,58,0,65,7
1653300926904,HIGL 114,A00,088067,Edington; Claire Ellen,53,0,55,2
1653300927429,HILA 119,A00,088068,Vitz; Matthew,49,0,51,2
1653300927963,HILA 122,A00,088069,Widener; Daniel,61,0,65,4
1653300928503,HILD 2A,A01,088024,Hanna; Mark G.,28,0,28,0
1653300928503,HILD 2A,A02,088025,Hanna; Mark G.,25,0,25,0
1653300928503,HILD 2A,A03,088026,Hanna; Mark G.,27,0,28,1
1653300928503,HILD 2A,A04,088027,Hanna; Mark G.,28,0,28,0
1653300928503,HILD 2A,A05,088028,Hanna; Mark G.,28,0,28,0
1653300928503,HILD 2A,A06,088029,Hanna; Mark G.,28,0,28,0
1653300929033,HILD 7A,A01,088031,Graham; Jessica Lynn,28,0,28,0
1653300929033,HILD 7A,A02,088032,Graham; Jessica Lynn,27,0,28,1
1653300929033,HILD 7A,A03,088033,Graham; Jessica Lynn,27,0,28,1
1653300929033,HILD 7A,A04,088034,Graham; Jessica Lynn,26,0,28,2
1653300929033,HILD 7A,A05,088035,Graham; Jessica Lynn,26,0,28,2
1653300929033,HILD 7A,A06,088037,Graham; Jessica Lynn,22,0,28,6
1653300929033,HILD 7A,A07,088038,Graham; Jessica Lynn,28,0,28,0
1653300929033,HILD 7A,A08,088039,Graham; Jessica Lynn,28,0,28,0
1653300929033,HILD 7A,A09,088040,Graham; Jessica Lynn,27,0,28,1
1653300929033,HILD 7A,A10,088041,Graham; Jessica Lynn,28,0,28,0
1653300929033,HILD 7A,A11,088042,Graham; Jessica Lynn,28,0,28,0
1653300929033,HILD 7A,A12,088043,Graham; Jessica Lynn,28,0,28,0
1653300929558,HILD 10,A01,088045,Muscolino; Micah S,27,0,28,1
1653300929558,HILD 10,A02,088046,Muscolino; Micah S,27,0,28,1
1653300929558,HILD 10,A03,088047,Muscolino; Micah S,28,0,28,0
1653300929558,HILD 10,A04,088048,Muscolino; Micah S,27,0,28,1
1653300929558,HILD 10,A05,088049,Muscolino; Micah S,28,0,28,0
1653300929558,HILD 10,A06,088050,Muscolino; Micah S,27,0,28,1
1653300930082,HILD 30,A01,088052,Edington; Claire Ellen,24,0,28,4
1653300930082,HILD 30,A02,088053,Edington; Claire Ellen,28,0,28,0
1653300930608,HILD 41,A01,088055,Devereux; Andrew W,28,0,28,0
1653300930608,HILD 41,A02,088056,Devereux; Andrew W,28,0,28,0
1653300931132,HINE 116,A00,088070,Kayali; Hasan,47,0,50,3
1653300931688,HINE 144,A00,088071,Provence; Michael,40,0,45,5
1653300932214,HISC 106,A00,088072,Pineda De Avila; Nydia,47,0,50,3
1653300932740,HISC 115,A00,088073,Gere; Catherina M.,103,0,110,7
1653300933263,HITO 87,A00,094352,Patterson; Patrick H.,20,0,20,0
1653300933263,HITO 87,C00,094354,Patterson; Patrick H.,20,0,20,0
1653300933263,HITO 87,B00,094353,Hanna; Mark G.,20,0,20,0
1653300933786,HITO 100,A00,088074,Hanna; Mark G.,8,0,12,4
1653300934312,HITO 193,A00,091603,Hill; Seth J,9999,0,9999,0
1653300934837,HITO 196,A00,088075,Hendrickson; Gerald M.,20,0,20,0
1653300935365,HIUS 108B,A00,088076,Klann; Mary Cameron,48,0,51,3
1653300935916,HIUS 112,A00,088077,Plant; Rebecca Jo,144,0,148,4
1653300936447,HIUS 152A,A00,088078,Vandevelde; Kenneth Joseph,40,0,45,5
1653300936972,HIUS 155,A00,088079,Alvarez; Luis A,37,0,45,8
1653300937502,HIUS 183,A00,088080,Graham; Jessica Lynn,19,0,20,1
1653300938033,HUM 3,A01,087224,West; Geoffrey Scott,27,0,28,1
1653300938033,HUM 3,A02,087225,West; Geoffrey Scott,28,0,28,0
1653300938033,HUM 3,A03,087226,West; Geoffrey Scott,26,0,28,2
1653300938033,HUM 3,A04,087227,West; Geoffrey Scott,27,0,28,1
1653300938033,HUM 3,A05,087228,West; Geoffrey Scott,27,0,28,1
1653300938033,HUM 3,A06,087229,West; Geoffrey Scott,24,0,28,4
1653300938033,HUM 3,A07,087230,West; Geoffrey Scott,27,0,28,1
1653300938033,HUM 3,A08,087231,West; Geoffrey Scott,28,0,28,0
1653300938033,HUM 3,B01,087233,Staff,28,0,28,0
1653300938033,HUM 3,B02,087234,Staff,28,0,28,0
1653300938033,HUM 3,B03,087235,Staff,28,0,28,0
1653300938033,HUM 3,B04,087236,Staff,28,0,28,0
1653300938033,HUM 3,B05,087237,Staff,28,0,28,0
1653300938033,HUM 3,B06,087238,Staff,28,0,28,0
1653300938033,HUM 3,B07,087239,Staff,0,0,0,0
1653300938033,HUM 3,B08,087240,Staff,0,0,0,0
1653300938033,HUM 3,B09,087241,Staff,30,0,30,0
1653300938033,HUM 3,B10,087242,Staff,28,0,30,2
1653300938033,HUM 3,C01,087244,Patterson; Patrick H.,0,0,0,0
1653300938033,HUM 3,C02,087245,Patterson; Patrick H.,0,0,0,0
1653300938033,HUM 3,C03,087246,Patterson; Patrick H.,23,0,28,5
1653300938033,HUM 3,C04,087247,Patterson; Patrick H.,28,0,28,0
1653300938033,HUM 3,C05,087248,Patterson; Patrick H.,27,0,28,1
1653300938033,HUM 3,C06,087249,Patterson; Patrick H.,25,0,28,3
1653300938033,HUM 3,C07,087250,Patterson; Patrick H.,27,0,28,1
1653300938033,HUM 3,C08,087251,Patterson; Patrick H.,28,0,28,0
1653300938033,HUM 3,C09,087252,Patterson; Patrick H.,28,0,28,0
1653300938033,HUM 3,C10,087253,Patterson; Patrick H.,27,0,28,1
1653300938033,HUM 3,D01,087255,Lyon; Antony J.,24,0,28,4
1653300938033,HUM 3,D02,087256,Lyon; Antony J.,28,0,28,0
1653300938033,HUM 3,D03,087257,Lyon; Antony J.,0,0,0,0
1653300938033,HUM 3,D04,087258,Lyon; Antony J.,0,0,0,0
1653300938033,HUM 3,D05,087259,Lyon; Antony J.,27,0,28,1
1653300938033,HUM 3,D06,087260,Lyon; Antony J.,28,0,28,0
1653300938033,HUM 3,D07,087261,Lyon; Antony J.,21,0,28,7
1653300938033,HUM 3,D08,087262,Lyon; Antony J.,20,0,28,8
1653300938033,HUM 3,D09,087263,Lyon; Antony J.,28,0,28,0
1653300938033,HUM 3,D10,087264,Lyon; Antony J.,27,0,28,1
1653300938033,HUM 3,D11,087265,Lyon; Antony J.,30,0,30,0
1653300938033,HUM 3,D12,087266,Lyon; Antony J.,30,0,30,0
1653300938033,HUM 3,D13,087267,Lyon; Antony J.,26,0,28,2
1653300938033,HUM 3,D14,087268,Lyon; Antony J.,25,0,28,3
1653300938557,INTL 101,A01,088176,Day; Joel Keith,19,0,20,1
1653300938557,INTL 101,A02,088177,Day; Joel Keith,20,0,20,0
1653300938557,INTL 101,A03,088178,Day; Joel Keith,17,0,20,3
1653300938557,INTL 101,A04,088179,Day; Joel Keith,19,0,20,1
1653300938557,INTL 101,A05,088180,Day; Joel Keith,19,0,20,1
1653300938557,INTL 101,A06,088181,Day; Joel Keith,18,0,20,2
1653300939079,INTL 102,A01,088183,Walter; Barbara Florence,19,0,20,1
1653300939079,INTL 102,A02,088184,Walter; Barbara Florence,19,0,20,1
1653300939079,INTL 102,A03,088185,Walter; Barbara Florence,18,0,20,2
1653300939079,INTL 102,A04,088186,Walter; Barbara Florence,16,0,20,4
1653300939079,INTL 102,A05,088187,Walter; Barbara Florence,19,0,20,1
1653300939079,INTL 102,A06,088188,Walter; Barbara Florence,19,0,20,1
1653300939605,INTL 190,A00,088189,Auerbach; Bradford C,0,0,0,0
1653300939605,INTL 190,B00,088190,Auerbach; Bradford C,0,0,0,0
1653300939605,INTL 190,C00,088191,Fortier; Jana,0,0,0,0
1653300939605,INTL 190,D00,088192,Kshatriya; Krista C,0,0,0,0
1653300939605,INTL 190,E00,088193,Nadkarni; Vidya,0,0,0,0
1653300939605,INTL 190,F00,088194,Scott; Jeffrey F,0,0,0,0
1653300939605,INTL 190,G00,088195,Segui; Alan S,0,0,0,0
1653300939605,INTL 190,H00,088196,Segui; Alan S,0,0,0,0
1653300940149,INTL 190H,A00,088197,Gibson; Clark C,0,0,0,0
1653300940718,JAPN 10A,A01,086851,Maruyama; Rie,15,0,15,0
1653300940718,JAPN 10A,A02,086852,Maruyama; Rie,15,0,15,0
1653300940718,JAPN 10A,B01,086854,Staff,13,0,13,0
1653300940718,JAPN 10A,B02,086855,Staff,13,0,13,0
1653300940718,JAPN 10A,C01,086857,McKee; Mayumi Mochizuki,13,0,13,0
1653300940718,JAPN 10A,C02,086858,McKee; Mayumi Mochizuki,11,0,13,2
1653300940718,JAPN 10A,D01,086860,Sato; Kyoko,13,0,13,0
1653300940718,JAPN 10A,D02,086861,Sato; Kyoko,13,0,13,0
1653300940718,JAPN 10A,E01,086863,Kamioka; Sachiko,12,0,13,1
1653300940718,JAPN 10A,E02,086864,Kamioka; Sachiko,12,0,13,1
1653300940718,JAPN 10A,F01,086866,Sato; Kyoko,13,0,13,0
1653300940718,JAPN 10A,F02,086867,Sato; Kyoko,13,0,13,0
1653300940718,JAPN 10A,G01,086869,Maruyama; Rie,8,0,13,5
1653300940718,JAPN 10A,G02,086870,Maruyama; Rie,13,0,13,0
1653300940718,JAPN 10A,H01,086872,Kamioka; Sachiko,12,0,13,1
1653300940718,JAPN 10A,H02,086873,Kamioka; Sachiko,11,0,13,2
1653300940718,JAPN 10A,I01,086875,Staff,12,0,13,1
1653300940718,JAPN 10A,I02,086876,Staff,13,0,13,0
1653300940718,JAPN 10A,J01,086878,McKee; Mayumi Mochizuki,12,0,13,1
1653300940718,JAPN 10A,J02,086879,McKee; Mayumi Mochizuki,13,0,13,0
1653300940718,JAPN 10A,K01,086881,Inada; Minori,13,0,13,0
1653300940718,JAPN 10A,K02,086882,Inada; Minori,12,0,13,1
1653300940718,JAPN 10A,L01,086884,Tipton; Yuko,13,0,13,0
1653300940718,JAPN 10A,L02,086885,Tipton; Yuko,13,0,13,0
1653300940718,JAPN 10A,M01,086887,Inada; Minori,12,0,13,1
1653300940718,JAPN 10A,M02,086888,Inada; Minori,13,0,13,0
1653300940718,JAPN 10A,N01,086890,McKee; Mayumi Mochizuki,13,0,13,0
1653300940718,JAPN 10A,N02,086891,McKee; Mayumi Mochizuki,11,0,13,2
1653300940718,JAPN 10A,O01,086893,Staff,13,0,13,0
1653300940718,JAPN 10A,O02,086894,Staff,12,0,13,1
1653300940718,JAPN 10A,P01,086896,Tipton; Yuko,15,0,15,0
1653300940718,JAPN 10A,P02,086897,Tipton; Yuko,15,0,15,0
1653300941257,JAPN 20A,A01,086899,Simpson; Junko Tokuda,11,0,13,2
1653300941257,JAPN 20A,A02,086900,Simpson; Junko Tokuda,12,0,13,1
1653300941257,JAPN 20A,B01,086902,Takeda; Izumi,11,0,13,2
1653300941257,JAPN 20A,B02,086903,Takeda; Izumi,12,0,13,1
1653300941257,JAPN 20A,C01,086905,Ross; Kayoko F,12,0,13,1
1653300941257,JAPN 20A,C02,086906,Ross; Kayoko F,12,0,13,1
1653300941257,JAPN 20A,D01,086908,Takeda; Izumi,10,0,13,3
1653300941257,JAPN 20A,D02,086909,Takeda; Izumi,13,0,13,0
1653300941257,JAPN 20A,E01,086911,Maruyama; Rie,11,0,13,2
1653300941257,JAPN 20A,E02,086912,Maruyama; Rie,11,0,13,2
1653300941257,JAPN 20A,F01,086914,Kamioka; Sachiko,7,0,13,6
1653300941257,JAPN 20A,F02,086915,Kamioka; Sachiko,9,0,13,4
1653300941257,JAPN 20A,G01,086917,Ross; Kayoko F,13,0,13,0
1653300941257,JAPN 20A,G02,086918,Ross; Kayoko F,12,0,13,1
1653300941780,JAPN 130A,A01,086920,Simpson; Junko Tokuda,6,0,10,4
1653300941780,JAPN 130A,A02,086921,Simpson; Junko Tokuda,5,0,10,5
1653300941780,JAPN 130A,B01,086923,Ross; Kayoko F,9,0,10,1
1653300941780,JAPN 130A,B02,086924,Ross; Kayoko F,9,0,10,1
1653300942313,JAPN 135A,A00,086925,Inada; Minori,14,0,15,1
1653300942313,JAPN 135A,B00,086926,Takeda; Izumi,15,0,15,0
1653300942868,JAPN 140A,A00,086927,Sato; Kyoko,19,0,20,1
1653300943391,JWSP 1,A01,086445,Shuster; Alana,15,0,15,0
1653300943391,JWSP 1,A02,086446,Shuster; Alana,15,0,15,0
1653300943912,JWSP 104,A01,086448,Shuster; Alana,15,0,15,0
1653300944450,LATI 10,A01,093588,Kennemore; Amy Michelle,31,0,32,1
1653300944450,LATI 10,A02,093589,Kennemore; Amy Michelle,32,0,32,0
1653300944450,LATI 10,A03,093590,Kennemore; Amy Michelle,32,0,32,0
1653300944985,LATI 50,A01,093592,Kokinis; Troy Andreas,32,0,32,0
1653300944985,LATI 50,A02,093593,Kokinis; Troy Andreas,31,0,32,1
1653300944985,LATI 50,A03,093595,Kokinis; Troy Andreas,32,0,32,0
1653300945512,LATI 122A,A00,093649,Andrews; Abigail Leslie,0,0,0,0
1653300946045,LATI 180,A00,093597,Staff,36,0,40,4
1653300946574,LIAB 1A,A00,087085,Saab; Dima,13,0,14,1
1653300946574,LIAB 1A,B00,087086,Saab; Dima,13,0,14,1
1653300946574,LIAB 1A,C00,087087,Saab; Dima,14,0,14,0
1653300946574,LIAB 1A,D00,087088,El Cheddadi; Youniss,14,0,14,0
1653300947101,LIAB 1AX,A00,087089,Akjeje; Abdelhak,28,0,28,0
1653300947101,LIAB 1AX,B00,087091,Akjeje; Abdelhak,28,0,28,0
1653300947625,LIAB 1D,A00,087093,El Cheddadi; Youniss,13,0,14,1
1653300947625,LIAB 1D,B00,087094,El Cheddadi; Youniss,12,0,14,2
1653300948173,LIAB 1DX,A00,087095,Akjeje; Abdelhak,27,0,28,1
1653300948714,LIDS 19,001,095098,Goodall; Grant Todd,9999,0,9999,0
1653300948714,LIDS 19,002,095099,Goodall; Grant Todd,9999,0,9999,0
1653300948714,LIDS 19,003,095100,Goodall; Grant Todd,9999,0,9999,0
1653300948714,LIDS 19,004,095101,Goodall; Grant Todd,9999,0,9999,0
1653300948714,LIDS 19,005,095102,Goodall; Grant Todd,9999,0,9999,0
1653300948714,LIDS 19,006,095103,Goodall; Grant Todd,9999,0,9999,0
1653300948714,LIDS 19,007,095104,Goodall; Grant Todd,9999,0,9999,0
1653300948714,LIDS 19,008,095105,Goodall; Grant Todd,9999,0,9999,0
1653300948714,LIDS 19,009,095106,Goodall; Grant Todd,9999,0,9999,0
1653300948714,LIDS 19,010,095107,Goodall; Grant Todd,9999,0,9999,0
1653300948714,LIDS 19,011,095108,Goodall; Grant Todd,9999,0,9999,0
1653300948714,LIDS 19,012,095109,Goodall; Grant Todd,9999,0,9999,0
1653300949252,LIFR 1A,A00,087097,Goodall; Grant Todd,13,0,14,1
1653300949252,LIFR 1A,B00,087098,Goodall; Grant Todd,13,0,14,1
1653300949252,LIFR 1A,C00,087099,Goodall; Grant Todd,12,0,14,2
1653300949252,LIFR 1A,D00,087100,Goodall; Grant Todd,12,0,14,2
1653300949252,LIFR 1A,E00,087101,Goodall; Grant Todd,14,0,14,0
1653300949252,LIFR 1A,F00,087102,Goodall; Grant Todd,13,0,14,1
1653300949780,LIFR 1AX,A00,087103,Goodall; Grant Todd,27,0,28,1
1653300949780,LIFR 1AX,B00,087104,Goodall; Grant Todd,27,0,28,1
1653300949780,LIFR 1AX,C00,087105,Goodall; Grant Todd,25,0,28,3
1653300950304,LIFR 1B,A00,087106,Goodall; Grant Todd,14,0,14,0
1653300950304,LIFR 1B,B00,087107,Goodall; Grant Todd,13,0,14,1
1653300950304,LIFR 1B,C00,087108,Goodall; Grant Todd,13,0,14,1
1653300950304,LIFR 1B,D00,087109,Goodall; Grant Todd,13,0,14,1
1653300950829,LIFR 1BX,A00,087110,Goodall; Grant Todd,26,0,28,2
1653300950829,LIFR 1BX,B00,087111,Goodall; Grant Todd,26,0,28,2
1653300951370,LIFR 1D,A00,087112,Goodall; Grant Todd,14,0,14,0
1653300951370,LIFR 1D,B00,087113,Goodall; Grant Todd,12,0,14,2
1653300951370,LIFR 1D,C00,087114,Goodall; Grant Todd,11,0,14,3
1653300951370,LIFR 1D,D00,087115,Goodall; Grant Todd,10,0,14,4
1653300951904,LIFR 1DX,A00,087116,Goodall; Grant Todd,26,0,28,2
1653300951904,LIFR 1DX,B00,087117,Goodall; Grant Todd,23,0,28,5
1653300952430,LIFR 11,A00,087118,Goodall; Grant Todd,10,0,10,0
1653300952962,LIGM 1A,A00,087119,Riebeling; Elke,14,0,14,0
1653300952962,LIGM 1A,B00,087120,Riebeling; Elke,14,0,14,0
1653300952962,LIGM 1A,C00,087121,Riebeling; Elke,12,0,14,2
1653300952962,LIGM 1A,D00,087122,Riebeling; Elke,14,0,14,0
1653300952962,LIGM 1A,E00,087123,Riebeling; Elke,14,0,14,0
1653300953508,LIGM 1AX,A00,087124,Riebeling; Elke,28,0,28,0
1653300953508,LIGM 1AX,B00,087125,Riebeling; Elke,28,0,28,0
1653300953508,LIGM 1AX,C00,087126,Riebeling; Elke,27,0,28,1
1653300954035,LIGM 1D,A00,087127,Riebeling; Elke,14,0,14,0
1653300954035,LIGM 1D,B00,087128,Riebeling; Elke,12,0,14,2
1653300954585,LIGM 1DX,A00,087129,Riebeling; Elke,26,0,28,2
1653300955110,LIGM 11,A00,087130,Goodall; Grant Todd,10,0,10,0
1653300955637,LIGN 5,A00,087005,Goodall; Grant Todd,74,0,75,1
1653300956163,LIGN 7,A00,087006,Mayberry; Rachel,139,0,146,7
1653300956689,LIGN 8,A00,087007,McIntosh; Justin Daniel,244,0,250,6
1653300957223,LIGN 17,A00,087008,Kehler; Andrew Scott,218,0,220,2
1653300957761,LIGN 101,A01,087010,Styler; William Francis,29,0,30,1
1653300957761,LIGN 101,A02,087011,Styler; William Francis,29,0,30,1
1653300957761,LIGN 101,A03,087012,Styler; William Francis,29,0,30,1
1653300957761,LIGN 101,A04,087013,Styler; William Francis,29,0,30,1
1653300958290,LIGN 110,A01,087015,Garellek; Marc,29,0,30,1
1653300958290,LIGN 110,A02,087016,Garellek; Marc,26,0,30,4
1653300958290,LIGN 110,A03,087017,Garellek; Marc,26,0,30,4
1653300958290,LIGN 110,A04,087018,Garellek; Marc,28,0,30,2
1653300958814,LIGN 121,A01,087020,Drake; Emily C,23,0,25,2
1653300958814,LIGN 121,A02,087021,Drake; Emily C,24,0,25,1
1653300959340,LIGN 150,A00,093702,Staff,71,0,75,4
1653300959863,LIGN 152,A00,087023,Caballero; Gabriela Hernandez,16,0,20,4
1653300960389,LIGN 154,A00,087024,Kluender; Robert,70,0,70,0
1653300960918,LIGN 167,A00,087025,Bergen; Leon,70,0,100,30
1653300961461,LIGN 187,A00,087026,McIntosh; Justin Daniel,20,0,20,0
1653300961984,LIHL 112F,A00,086505,Alicio; Atilio,25,0,28,3
1653300962512,LIHL 114F,A00,086506,Staff,21,0,28,7
1653300963035,LIHL 117F,A00,086508,Sadegholvad; Elham,20,0,20,0
1653300963571,LIHL 118,A00,086509,Staff,25,0,28,3
1653300964094,LIHL 119F,A00,086510,Staff,26,0,28,2
1653300964623,LIHL 124F,A00,086511,Staff,27,0,28,1
1653300965157,LIHL 132F,A00,086512,Alicio; Atilio,28,0,28,0
1653300965687,LIIT 1A,A00,087131,Riebeling; Elke,14,0,14,0
1653300965687,LIIT 1A,B00,087132,Riebeling; Elke,14,0,14,0
1653300965687,LIIT 1A,C00,087133,Riebeling; Elke,12,0,14,2
1653300965687,LIIT 1A,D00,087134,Riebeling; Elke,14,0,14,0
1653300966211,LIIT 1AX,A00,087135,Riebeling; Elke,28,0,28,0
1653300966211,LIIT 1AX,B00,087136,Riebeling; Elke,26,0,28,2
1653300966756,LIPO 1A,A00,087137,Paladini; Denise,14,0,14,0
1653300966756,LIPO 1A,B00,087138,Paladini; Denise,10,0,14,4
1653300967303,LIPO 1AX,A00,087139,De Abreu; Cassia,18,0,22,4
1653300967303,LIPO 1AX,B00,087140,De Abreu; Cassia,22,0,22,0
1653300967829,LIPO 1D,A00,087141,Paladini; Denise,10,0,14,4
1653300968357,LIPO 1DX,A00,087143,De Abreu; Cassia,10,0,14,4
1653300968953,LISL 1A,A00,087145,Lott; Margaret S.,10,0,14,4
1653300968953,LISL 1A,B00,087146,Lott; Margaret S.,14,0,14,0
1653300968953,LISL 1A,C00,087147,Lott; Margaret S.,10,0,14,4
1653300968953,LISL 1A,D00,087148,Lott; Margaret S.,11,0,14,3
1653300968953,LISL 1A,E00,087149,Lott; Margaret S.,13,0,14,1
1653300968953,LISL 1A,F00,087150,Lott; Margaret S.,12,0,14,2
1653300968953,LISL 1A,G00,087151,Lott; Margaret S.,13,0,14,1
1653300968953,LISL 1A,H00,087152,Lott; Margaret S.,13,0,14,1
1653300969483,LISL 1AX,A00,087153,Lott; Margaret S.,28,0,28,0
1653300969483,LISL 1AX,B00,087154,Lott; Margaret S.,25,0,28,3
1653300969483,LISL 1AX,C00,087155,Lott; Margaret S.,25,0,28,3
1653300969483,LISL 1AX,D00,087156,Lott; Margaret S.,24,0,28,4
1653300970007,LISL 1B,A00,087157,Lott; Margaret S.,13,0,14,1
1653300970007,LISL 1B,B00,087158,Lott; Margaret S.,12,0,14,2
1653300970007,LISL 1B,C00,087159,Lott; Margaret S.,11,0,14,3
1653300970007,LISL 1B,D00,087160,Lott; Margaret S.,13,0,14,1
1653300970007,LISL 1B,E00,087161,Lott; Margaret S.,13,0,14,1
1653300970007,LISL 1B,F00,087162,Lott; Margaret S.,13,0,14,1
1653300970532,LISL 1BX,A00,087163,Lott; Margaret S.,23,0,28,5
1653300970532,LISL 1BX,B00,087164,Lott; Margaret S.,26,0,28,2
1653300970532,LISL 1BX,C00,087165,Lott; Margaret S.,28,0,28,0
1653300971061,LISL 1D,A00,087166,Lott; Margaret S.,14,0,14,0
1653300971061,LISL 1D,B00,087167,Lott; Margaret S.,14,0,14,0
1653300971061,LISL 1D,C00,087168,Lott; Margaret S.,8,0,14,6
1653300971061,LISL 1D,D00,087169,Lott; Margaret S.,13,0,14,1
1653300971589,LISL 1DX,A00,087170,Lott; Margaret S.,23,0,28,5
1653300971589,LISL 1DX,B00,087171,Lott; Margaret S.,26,0,28,2
1653300972119,LISP 1A,001,087172,Munoz Sanchez; Alicia,13,0,14,1
1653300972119,LISP 1A,002,087173,Munoz Sanchez; Alicia,12,0,14,2
1653300972119,LISP 1A,003,087174,Munoz Sanchez; Alicia,13,0,14,1
1653300972119,LISP 1A,004,087175,Munoz Sanchez; Alicia,12,0,14,2
1653300972119,LISP 1A,005,087176,Munoz Sanchez; Alicia,10,0,14,4
1653300972119,LISP 1A,006,087177,Munoz Sanchez; Alicia,12,0,14,2
1653300972119,LISP 1A,007,087178,Munoz Sanchez; Alicia,12,0,14,2
1653300972119,LISP 1A,008,087179,Munoz Sanchez; Alicia,14,0,14,0
1653300972643,LISP 1AX,A00,087180,Munoz Sanchez; Alicia,27,0,28,1
1653300972643,LISP 1AX,B00,087181,Munoz Sanchez; Alicia,24,0,28,4
1653300972643,LISP 1AX,C00,087182,Munoz Sanchez; Alicia,25,0,28,3
1653300972643,LISP 1AX,D00,087183,Munoz Sanchez; Alicia,25,0,28,3
1653300973169,LISP 1B,001,087184,Munoz Sanchez; Alicia,14,0,14,0
1653300973169,LISP 1B,002,087185,Munoz Sanchez; Alicia,14,0,14,0
1653300973169,LISP 1B,003,087186,Munoz Sanchez; Alicia,11,0,14,3
1653300973169,LISP 1B,004,087187,Munoz Sanchez; Alicia,12,0,14,2
1653300973169,LISP 1B,005,087188,Munoz Sanchez; Alicia,13,0,14,1
1653300973169,LISP 1B,006,087189,Munoz Sanchez; Alicia,13,0,14,1
1653300973169,LISP 1B,007,087190,Munoz Sanchez; Alicia,14,0,14,0
1653300973169,LISP 1B,008,087191,Munoz Sanchez; Alicia,13,0,14,1
1653300973169,LISP 1B,009,087192,Munoz Sanchez; Alicia,14,0,14,0
1653300973169,LISP 1B,010,087193,Munoz Sanchez; Alicia,13,0,14,1
1653300973169,LISP 1B,011,087194,Munoz Sanchez; Alicia,14,0,14,0
1653300973698,LISP 1BX,A00,087195,Munoz Sanchez; Alicia,28,0,28,0
1653300973698,LISP 1BX,B00,087196,Munoz Sanchez; Alicia,26,0,28,2
1653300973698,LISP 1BX,C00,087197,Munoz Sanchez; Alicia,26,0,28,2
1653300973698,LISP 1BX,D00,087198,Munoz Sanchez; Alicia,26,0,28,2
1653300973698,LISP 1BX,E00,087199,Munoz Sanchez; Alicia,28,0,28,0
1653300974232,LISP 1D,001,087200,Munoz Sanchez; Alicia,13,0,14,1
1653300974232,LISP 1D,002,087201,Munoz Sanchez; Alicia,14,0,14,0
1653300974232,LISP 1D,003,087202,Munoz Sanchez; Alicia,8,0,14,6
1653300974232,LISP 1D,004,087203,Munoz Sanchez; Alicia,5,0,14,9
1653300974232,LISP 1D,005,087204,Munoz Sanchez; Alicia,11,0,14,3
1653300974232,LISP 1D,006,087205,Munoz Sanchez; Alicia,13,0,14,1
1653300974232,LISP 1D,007,087206,Munoz Sanchez; Alicia,13,0,14,1
1653300974232,LISP 1D,008,087207,Munoz Sanchez; Alicia,13,0,14,1
1653300974232,LISP 1D,009,087208,Munoz Sanchez; Alicia,14,0,14,0
1653300974232,LISP 1D,010,087209,Munoz Sanchez; Alicia,12,0,14,2
1653300974232,LISP 1D,011,087210,Munoz Sanchez; Alicia,13,0,14,1
1653300974232,LISP 1D,012,087211,Munoz Sanchez; Alicia,14,0,14,0
1653300974232,LISP 1D,013,087212,Munoz Sanchez; Alicia,14,0,14,0
1653300974232,LISP 1D,014,087213,Munoz Sanchez; Alicia,14,0,14,0
1653300974762,LISP 1DX,A00,087214,Munoz Sanchez; Alicia,27,0,28,1
1653300974762,LISP 1DX,B00,087215,Munoz Sanchez; Alicia,23,0,28,5
1653300974762,LISP 1DX,C00,087216,Munoz Sanchez; Alicia,23,0,28,5
1653300974762,LISP 1DX,D00,087217,Munoz Sanchez; Alicia,25,0,28,3
1653300974762,LISP 1DX,E00,087218,Munoz Sanchez; Alicia,27,0,28,1
1653300974762,LISP 1DX,F00,087219,Munoz Sanchez; Alicia,25,0,28,3
1653300974762,LISP 1DX,G00,087220,Munoz Sanchez; Alicia,28,0,28,0
1653300975286,LISP 15,A00,087221,Munoz Sanchez; Alicia,19,0,20,1
1653300975809,LISP 18,A00,087222,Munoz Sanchez; Alicia,15,0,20,5
1653300976331,LTAM 110,A00,087352,Chacon; Gloria Elizabeth,35,0,40,5
1653300976856,LTCS 87,A00,094011,Nguyen; Hoang Tan,19,0,20,1
1653300977391,LTCS 111,A00,087353,Vitkus; Daniel J.,40,0,40,0
1653300977915,LTCS 119,A00,087354,Nguyen; Hoang Tan,29,0,30,1
1653300978439,LTCS 130,A00,087355,Kim; Joo Ok,37,0,40,3
1653300978962,LTCS 165,A00,087356,Kim; Joo Ok,38,0,40,2
1653300979497,LTEA 120A,A00,087357,Fiss; Geraldine Anna,291,0,300,9
1653300980035,LTEA 140,A00,094009,Lee; Jin-Kyung,28,0,32,4
1653300980582,LTEA 142,A00,087358,Lee; Jin-Kyung,102,0,120,18
1653300981105,LTEN 21,A01,087275,Lampert-Weissig; Lisa,25,0,25,0
1653300981105,LTEN 21,A02,087276,Lampert-Weissig; Lisa,25,0,25,0
1653300981105,LTEN 21,A03,087277,Lampert-Weissig; Lisa,25,0,25,0
1653300981105,LTEN 21,A04,087278,Lampert-Weissig; Lisa,25,0,25,0
1653300981630,LTEN 25,A01,087280,Johnson; Sara E.,25,0,25,0
1653300981630,LTEN 25,A02,087281,Johnson; Sara E.,25,0,25,0
1653300981630,LTEN 25,A03,087282,Johnson; Sara E.,23,0,25,2
1653300981630,LTEN 25,A04,087283,Johnson; Sara E.,25,0,25,0
1653300982158,LTEN 29,A01,087285,Ruiz; Ariana,24,0,25,1
1653300982158,LTEN 29,A02,087286,Ruiz; Ariana,25,0,25,0
1653300982158,LTEN 29,A03,087287,Ruiz; Ariana,24,0,25,1
1653300982158,LTEN 29,A04,087288,Ruiz; Ariana,24,0,25,1
1653300982687,LTEN 107,A00,087359,Lampert-Weissig; Lisa,39,0,40,1
1653300983216,LTEN 117,A00,087360,Vitkus; Daniel J.,40,0,40,0
1653300983740,LTEN 127,A00,087361,Loose; Margaret,38,0,40,2
1653300984264,LTEN 142,A00,094010,Loose; Margaret,38,0,40,2
1653300984787,LTEN 148,A00,087363,Walkiewicz; Kathryn A,40,0,40,0
1653300985309,LTEN 152,A00,087364,Walkiewicz; Kathryn A,37,0,40,3
1653300985833,LTEN 180,A00,087365,Ruiz; Ariana,18,0,20,2
1653300986364,LTFR 2A,A01,087290,Ploye; Catherine,23,0,25,2
1653300986899,LTFR 2B,A01,087292,Ploye; Catherine,25,0,25,0
1653300987442,LTFR 104,A00,087366,Ploye; Catherine,25,0,25,0
1653300987966,LTFR 116,A00,087367,Zhiri; Oumelbanine,13,0,15,2
1653300988493,LTGK 1,A00,087293,Myerston Santana; Jacobo,27,0,30,3
1653300989016,LTGK 103,A00,087368,duBois; Page Ann,14,0,15,1
1653300989552,LTGM 2A,A01,087295,Fischer-Grunski; Eva K,24,0,25,1
1653300990075,LTIT 2A,A01,087297,De Marchi Gherini; Adriana,24,0,25,1
1653300990622,LTKO 1A,A01,087299,Staff,24,0,25,1
1653300990622,LTKO 1A,B01,087301,Staff,25,0,25,0
1653300990622,LTKO 1A,C01,087303,Staff,25,0,25,0
1653300990622,LTKO 1A,D01,087305,Staff,25,0,25,0
1653300990622,LTKO 1A,E01,087307,Staff,24,0,25,1
1653300990622,LTKO 1A,F01,087309,Staff,25,0,25,0
1653300990622,LTKO 1A,G01,087311,Staff,25,0,25,0
1653300990622,LTKO 1A,H01,087313,Staff,24,0,25,1
1653300990622,LTKO 1A,I01,087315,Staff,25,0,25,0
1653300991175,LTKO 2A,A01,087317,Staff,24,0,25,1
1653300991175,LTKO 2A,B01,087319,Staff,22,0,25,3
1653300991175,LTKO 2A,C01,087321,Lee; Jeyseon,24,0,25,1
1653300991710,LTKO 130,A00,087369,Lee; Jeyseon,25,0,25,0
1653300992238,LTLA 1,A00,087322,Murray; Kourtney Kristine,38,0,40,2
1653300992765,LTLA 100,A00,087371,Kelting; Edward William,23,0,25,2
1653300993289,LTRU 1A,A01,087324,Wells; Patricia Rebecca,23,0,25,2
1653300993818,LTRU 2A,A01,087326,Wells; Patricia Rebecca,20,0,20,0
1653300994345,LTRU 104B,A01,087373,Wells; Patricia Rebecca,14,0,15,1
1653300994896,LTSP 2A,A01,087328,Staff,25,0,25,0
1653300994896,LTSP 2A,B01,087330,Staff,22,0,25,3
1653300994896,LTSP 2A,C01,087332,Staff,22,0,25,3
1653300995433,LTSP 2B,A01,087334,Staff,22,0,25,3
1653300995433,LTSP 2B,B01,087336,Staff,19,0,25,6
1653300995958,LTSP 2D,A00,087337,Staff,25,0,25,0
1653300995958,LTSP 2D,B00,087338,Staff,25,0,25,0
1653300995958,LTSP 2D,C00,087339,Staff,25,0,25,0
1653300996483,LTSP 100A,A00,087374,Arcos Herrera; Carol,23,0,25,2
1653300997005,LTSP 116,A00,087375,Blanco; John D,29,0,30,1
1653300997532,LTSP 140,A00,087376,Chacon; Gloria Elizabeth,30,0,30,0
1653300998059,LTSP 175,A00,087377,Arcos Herrera; Carol,30,0,30,0
1653300998593,LTTH 150,A00,087379,Cohen; Alain J. J.,40,0,40,0
1653300999121,LTWL 19A,A00,087340,Myerston Santana; Jacobo,39,0,40,1
1653300999670,LTWL 87,A00,094012,Lampert-Weissig; Lisa,20,0,20,0
1653301000202,LTWL 116,A00,087380,Nguyen; Hoang Tan,60,0,60,0
1653301000726,LTWL 120,A00,087381,Fiss; Geraldine Anna,37,0,40,3
1653301001268,LTWL 172,A00,087382,De Marchi Gherini; Adriana,40,0,40,0
1653301001806,LTWL 180,A00,087383,Kontje; Todd Curtis,39,0,40,1
1653301002345,LTWL 194,A00,087384,Suzuki; Erin M.,31,0,32,1
1653301002882,LTWR 8A,A01,087342,Jemc; Jaclyn,24,0,25,1
1653301002882,LTWR 8A,A02,087343,Jemc; Jaclyn,25,0,25,0
1653301002882,LTWR 8A,A03,087344,Jemc; Jaclyn,24,0,25,1
1653301002882,LTWR 8A,A04,087345,Jemc; Jaclyn,24,0,25,1
1653301003409,LTWR 8C,A01,087348,Forbes; Camille,25,0,25,0
1653301003409,LTWR 8C,A02,087349,Forbes; Camille,25,0,25,0
1653301003409,LTWR 8C,A03,087350,Forbes; Camille,25,0,25,0
1653301003409,LTWR 8C,A04,087351,Forbes; Camille,23,0,25,2
1653301003943,LTWR 100,A00,087385,Staff,12,0,15,3
1653301004484,LTWR 102,A00,087386,Staff,14,0,15,1
1653301005025,LTWR 115,A00,087387,Carroll; Amy Sara,24,0,30,6
1653301005558,LTWR 119,A00,087388,Staff,22,0,30,8
1653301006090,LTWR 140,A00,087389,Carroll; Amy Sara,37,0,40,3
1653301006631,LTWR 194,A00,087390,Som; Brandon D,35,0,40,5
1653301007158,MAE 2,A01,090334,Anderson; Mark Ronald,8,0,8,0
1653301007158,MAE 2,A02,090335,Anderson; Mark Ronald,8,0,8,0
1653301007158,MAE 2,A03,090336,Anderson; Mark Ronald,8,0,8,0
1653301007158,MAE 2,A04,090337,Anderson; Mark Ronald,8,0,8,0
1653301007158,MAE 2,A05,090338,Anderson; Mark Ronald,8,0,8,0
1653301007158,MAE 2,A06,090339,Anderson; Mark Ronald,8,0,8,0
1653301007158,MAE 2,A07,090340,Anderson; Mark Ronald,8,0,8,0
1653301007158,MAE 2,A08,090341,Anderson; Mark Ronald,7,0,8,1
1653301007158,MAE 2,A09,090342,Anderson; Mark Ronald,8,0,8,0
1653301007689,MAE 3,A01,090344,Delson; Nathan Joseph,21,0,22,1
1653301007689,MAE 3,A02,090345,Delson; Nathan Joseph,20,0,22,2
1653301007689,MAE 3,A03,090346,Delson; Nathan Joseph,21,0,22,1
1653301007689,MAE 3,A04,090347,Delson; Nathan Joseph,22,0,22,0
1653301007689,MAE 3,B01,090349,Qi; Huihui,18,0,22,4
1653301007689,MAE 3,B02,090350,Qi; Huihui,17,0,22,5
1653301007689,MAE 3,B03,090351,Qi; Huihui,20,0,22,2
1653301007689,MAE 3,B04,090352,Qi; Huihui,19,0,22,3
1653301008215,MAE 8,A01,090354,Pham; Hieu Tan,182,0,185,3
1653301008767,MAE 11,A00,090355,Nomura; Keiko K.,155,0,165,10
1653301009293,MAE 20,A00,090356,Bandaru; Prabhakar,160,0,160,0
1653301009293,MAE 20,B00,090357,Evdokimenko; Ekaterina,145,0,160,15
1653301009817,MAE 21,A01,090359,Cai; Shengqiang,8,0,9,1
1653301009817,MAE 21,A02,090360,Cai; Shengqiang,9,0,9,0
1653301009817,MAE 21,A03,090361,Cai; Shengqiang,6,0,9,3
1653301009817,MAE 21,A04,090362,Cai; Shengqiang,7,0,9,2
1653301009817,MAE 21,A05,090363,Cai; Shengqiang,0,0,0,0
1653301009817,MAE 21,A06,090364,Cai; Shengqiang,9,0,9,0
1653301009817,MAE 21,A07,090365,Cai; Shengqiang,9,0,9,0
1653301009817,MAE 21,A08,090366,Cai; Shengqiang,8,0,9,1
1653301009817,MAE 21,A09,090367,Cai; Shengqiang,8,0,9,1
1653301009817,MAE 21,A10,090368,Cai; Shengqiang,0,0,0,0
1653301009817,MAE 21,A11,090369,Cai; Shengqiang,9,0,9,0
1653301009817,MAE 21,A12,090370,Cai; Shengqiang,8,0,9,1
1653301010343,MAE 30A,A00,090371,Lal; Ratnesh,72,0,75,3
1653301010878,MAE 40,A00,090372,Bitmead; Robert R.,167,0,175,8
1653301011402,MAE 101A,A00,090373,Bahadori; Mohammad Yousef,105,0,115,10
1653301011932,MAE 101C,A00,090374,Poulikakos; Lisa Voula,41,0,110,69
1653301011932,MAE 101C,B00,090375,Chen; Renkun,96,0,110,14
1653301012455,MAE 104,A00,090376,Sanchez; Antonio Luis,78,0,120,42
1653301012980,MAE 105,A00,090377,Saintillan; David,154,0,170,16
1653301013508,MAE 107,A00,090378,Lindsey; Stephanie,104,0,110,6
1653301013508,MAE 107,B00,090379,Tolley; Michael Thomas,85,0,110,25
1653301014033,MAE 118,A00,090380,Krasheninnikov; Sergei,27,0,45,18
1653301014557,MAE 131A,A00,090381,Ghazinejad; Maziar,70,0,75,5
1653301015084,MAE 133,A00,090382,Frazier; Michael,26,0,33,7
1653301015614,MAE 143A,A00,090383,de Oliveira; Mauricio,74,0,100,26
1653301016135,MAE 144,A00,090384,Bewley; Thomas R,50,0,70,20
1653301016664,MAE 148,A01,091597,Staff,32,0,32,0
1653301017192,MAE 150,A00,090385,Friend; James Robert,69,0,90,21
1653301017192,MAE 150,B00,090386,Ghazinejad; Maziar,4,0,90,86
1653301017728,MAE 152,A00,090387,Tynan; George Robert,0,0,16,16
1653301017728,MAE 152,B00,090388,Tynan; George Robert,0,0,16,16
1653301017728,MAE 152,C00,090389,Tynan; George Robert,0,0,16,16
1653301017728,MAE 152,D00,090390,Tynan; George Robert,0,0,16,16
1653301018250,MAE 156A,A01,090392,Delson; Nathan Joseph,2,0,12,10
1653301018250,MAE 156A,A02,090393,Delson; Nathan Joseph,1,0,12,11
1653301018250,MAE 156A,A03,090394,Delson; Nathan Joseph,4,0,12,8
1653301018784,MAE 170,A01,090396,Lubarda; Marko,14,0,30,16
1653301018784,MAE 170,A02,090397,Lubarda; Marko,19,0,30,11
1653301018784,MAE 170,A03,090398,Lubarda; Marko,28,0,30,2
1653301018784,MAE 170,A04,090399,Lubarda; Marko,20,0,30,10
1653301018784,MAE 170,B01,090401,Diagne; Mamadou Lamine,30,0,30,0
1653301018784,MAE 170,B02,090402,Diagne; Mamadou Lamine,27,0,30,3
1653301018784,MAE 170,B03,090403,Diagne; Mamadou Lamine,28,0,30,2
1653301018784,MAE 170,B04,090404,Diagne; Mamadou Lamine,28,0,30,2
1653301019311,MAE 180A,A00,090405,McEneaney; William Michael,110,0,125,15
1653301019845,MAE 181,A00,090406,Bahadori; Mohammad Yousef,46,0,60,14
1653301020367,MAE 190,A00,090407,Anderson; Mark Ronald,27,0,45,18
1653301020893,MAE 191,A01,090409,Qi; Huihui,25,0,32,7
1653301021419,MATH 2,A01,089123,Hammock; Frances H,0,0,0,0
1653301021419,MATH 2,B01,089126,Hammock; Frances H,0,0,0,0
1653301021419,MATH 2,C01,089129,Hammock; Frances H,0,0,0,0
1653301021419,MATH 2,D01,094201,Harel; Guershon,0,0,0,0
1653301021957,MATH 3C,A01,089132,Bowers; Adam R.,0,0,0,0
1653301021957,MATH 3C,A02,089133,Bowers; Adam R.,0,0,0,0
1653301021957,MATH 3C,A03,089134,Bowers; Adam R.,0,0,0,0
1653301021957,MATH 3C,A04,089135,Bowers; Adam R.,0,0,0,0
1653301021957,MATH 3C,A05,089136,Bowers; Adam R.,0,0,0,0
1653301021957,MATH 3C,A06,089137,Bowers; Adam R.,0,0,0,0
1653301021957,MATH 3C,A07,089138,Bowers; Adam R.,0,0,0,0
1653301021957,MATH 3C,A08,089139,Bowers; Adam R.,0,0,0,0
1653301021957,MATH 3C,A09,089140,Bowers; Adam R.,0,0,0,0
1653301021957,MATH 3C,A10,089141,Bowers; Adam R.,0,0,0,0
1653301021957,MATH 3C,A11,089142,Bowers; Adam R.,0,0,0,0
1653301021957,MATH 3C,A12,089143,Bowers; Adam R.,0,0,0,0
1653301021957,MATH 3C,A13,089144,Bowers; Adam R.,0,0,0,0
1653301021957,MATH 3C,A14,089145,Bowers; Adam R.,0,0,0,0
1653301021957,MATH 3C,A15,089146,Bowers; Adam R.,0,0,0,0
1653301021957,MATH 3C,A16,089147,Bowers; Adam R.,0,0,0,0
1653301021957,MATH 3C,A17,089148,Bowers; Adam R.,0,0,0,0
1653301021957,MATH 3C,A18,089149,Bowers; Adam R.,0,0,0,0
1653301021957,MATH 3C,A19,089150,Bowers; Adam R.,0,0,0,0
1653301021957,MATH 3C,A20,089151,Bowers; Adam R.,0,0,0,0
1653301021957,MATH 3C,A21,089152,Bowers; Adam R.,0,0,0,0
1653301021957,MATH 3C,A22,089153,Bowers; Adam R.,0,0,0,0
1653301021957,MATH 3C,A23,089154,Bowers; Adam R.,0,0,0,0
1653301021957,MATH 3C,A24,089155,Bowers; Adam R.,0,0,0,0
1653301021957,MATH 3C,B01,089158,Staff,0,0,0,0
1653301021957,MATH 3C,B02,089159,Staff,0,0,0,0
1653301021957,MATH 3C,B03,089160,Staff,0,0,0,0
1653301021957,MATH 3C,B04,089161,Staff,0,0,0,0
1653301021957,MATH 3C,C01,094244,Staff,0,0,0,0
1653301021957,MATH 3C,C02,094245,Staff,0,0,0,0
1653301021957,MATH 3C,C03,094246,Staff,0,0,0,0
1653301021957,MATH 3C,C04,094247,Staff,0,0,0,0
1653301022585,MATH 4C,A01,089164,Staff,0,0,0,0
1653301022585,MATH 4C,A02,089165,Staff,0,0,0,0
1653301022585,MATH 4C,A03,089166,Staff,0,0,0,0
1653301022585,MATH 4C,B01,089169,Ganzberger; Geoffrey Michael,0,0,0,0
1653301022585,MATH 4C,B02,089170,Ganzberger; Geoffrey Michael,0,0,0,0
1653301022585,MATH 4C,B03,089171,Ganzberger; Geoffrey Michael,0,0,0,0
1653301022585,MATH 4C,C01,089174,Ganzberger; Geoffrey Michael,0,0,0,0
1653301022585,MATH 4C,C02,089175,Ganzberger; Geoffrey Michael,0,0,0,0
1653301022585,MATH 4C,C03,089176,Ganzberger; Geoffrey Michael,0,0,0,0
1653301022585,MATH 4C,D01,094249,Ganzberger; Geoffrey Michael,0,0,0,0
1653301022585,MATH 4C,D02,094250,Ganzberger; Geoffrey Michael,0,0,0,0
1653301022585,MATH 4C,D03,094251,Ganzberger; Geoffrey Michael,0,0,0,0
1653301023112,MATH 10A,A01,089179,Jin; Muzhi,5,0,5,0
1653301023112,MATH 10A,A02,089180,Jin; Muzhi,5,0,5,0
1653301023112,MATH 10A,A03,089181,Jin; Muzhi,4,0,5,1
1653301023112,MATH 10A,A04,089182,Jin; Muzhi,4,0,5,1
1653301023112,MATH 10A,A05,089183,Jin; Muzhi,5,0,5,0
1653301023112,MATH 10A,A06,089184,Jin; Muzhi,5,0,5,0
1653301023112,MATH 10A,A07,089185,Jin; Muzhi,5,0,5,0
1653301023112,MATH 10A,A08,089186,Jin; Muzhi,5,0,5,0
1653301023112,MATH 10A,B01,089188,Stevens; Laura Jeanne,1,0,5,4
1653301023112,MATH 10A,B02,089189,Stevens; Laura Jeanne,4,0,5,1
1653301023112,MATH 10A,B03,089190,Stevens; Laura Jeanne,4,0,5,1
1653301023112,MATH 10A,B04,089191,Stevens; Laura Jeanne,5,0,5,0
1653301023112,MATH 10A,B05,089192,Stevens; Laura Jeanne,4,0,5,1
1653301023112,MATH 10A,B06,089193,Stevens; Laura Jeanne,5,0,5,0
1653301023112,MATH 10A,B07,089194,Stevens; Laura Jeanne,5,0,5,0
1653301023112,MATH 10A,B08,089195,Stevens; Laura Jeanne,4,0,5,1
1653301023112,MATH 10A,C01,089197,Jin; Muzhi,1,0,5,4
1653301023112,MATH 10A,C02,089198,Jin; Muzhi,5,0,5,0
1653301023112,MATH 10A,C03,089199,Jin; Muzhi,5,0,5,0
1653301023112,MATH 10A,C04,089200,Jin; Muzhi,5,0,5,0
1653301023112,MATH 10A,C05,089201,Jin; Muzhi,5,0,5,0
1653301023112,MATH 10A,C06,089202,Jin; Muzhi,5,0,5,0
1653301023112,MATH 10A,D01,089204,Upton; James Thomas,4,0,5,1
1653301023112,MATH 10A,D02,089205,Upton; James Thomas,5,0,5,0
1653301023112,MATH 10A,D03,089206,Upton; James Thomas,5,0,5,0
1653301023112,MATH 10A,D04,089207,Upton; James Thomas,5,0,5,0
1653301023112,MATH 10A,E01,089211,Greenfeld; Be'Eri,5,0,5,0
1653301023112,MATH 10A,E02,089212,Greenfeld; Be'Eri,3,0,5,2
1653301023112,MATH 10A,E03,089213,Greenfeld; Be'Eri,4,0,5,1
1653301023112,MATH 10A,E04,089214,Greenfeld; Be'Eri,5,0,5,0
1653301023112,MATH 10A,E05,089215,Greenfeld; Be'Eri,5,0,5,0
1653301023112,MATH 10A,E06,089216,Greenfeld; Be'Eri,5,0,5,0
1653301023645,MATH 10B,A01,089218,Stevens; Laura Jeanne,7,0,8,1
1653301023645,MATH 10B,A02,089219,Stevens; Laura Jeanne,7,0,8,1
1653301023645,MATH 10B,A03,089220,Stevens; Laura Jeanne,8,0,8,0
1653301023645,MATH 10B,A04,089221,Stevens; Laura Jeanne,6,0,8,2
1653301023645,MATH 10B,A05,089222,Stevens; Laura Jeanne,2,0,8,6
1653301023645,MATH 10B,A06,089223,Stevens; Laura Jeanne,0,0,8,8
1653301023645,MATH 10B,A07,089224,Stevens; Laura Jeanne,6,0,8,2
1653301023645,MATH 10B,A08,089225,Stevens; Laura Jeanne,4,0,8,4
1653301023645,MATH 10B,B01,089227,Staff,8,0,8,0
1653301023645,MATH 10B,B02,089228,Staff,8,0,8,0
1653301023645,MATH 10B,B03,089229,Staff,7,0,8,1
1653301023645,MATH 10B,B04,089230,Staff,8,0,8,0
1653301023645,MATH 10B,B05,089231,Staff,8,0,8,0
1653301023645,MATH 10B,B06,089232,Staff,8,0,8,0
1653301023645,MATH 10B,B07,089233,Staff,8,0,8,0
1653301023645,MATH 10B,B08,089234,Staff,8,0,8,0
1653301023645,MATH 10B,C01,089236,McKinley; Gweneth Anne,4,0,8,4
1653301023645,MATH 10B,C02,089237,McKinley; Gweneth Anne,8,0,8,0
1653301023645,MATH 10B,C03,089238,McKinley; Gweneth Anne,8,0,8,0
1653301023645,MATH 10B,C04,089239,McKinley; Gweneth Anne,8,0,8,0
1653301023645,MATH 10B,C05,089240,McKinley; Gweneth Anne,8,0,8,0
1653301023645,MATH 10B,C06,089241,McKinley; Gweneth Anne,8,0,8,0
1653301024178,MATH 10C,A01,089243,Staff,13,0,20,7
1653301024178,MATH 10C,A02,089244,Staff,20,0,20,0
1653301024178,MATH 10C,A03,089245,Staff,18,0,20,2
1653301024178,MATH 10C,A04,089246,Staff,20,0,20,0
1653301024178,MATH 10C,A05,089247,Staff,19,0,20,1
1653301024178,MATH 10C,A06,089248,Staff,20,0,20,0
1653301024178,MATH 10C,A07,094505,Staff,20,0,20,0
1653301024178,MATH 10C,A08,094506,Staff,20,0,20,0
1653301024178,MATH 10C,B01,089250,Staff,19,0,20,1
1653301024178,MATH 10C,B02,089251,Staff,19,0,20,1
1653301024178,MATH 10C,B03,089252,Staff,14,0,20,6
1653301024178,MATH 10C,B04,089253,Staff,20,0,20,0
1653301024178,MATH 10C,B05,089254,Staff,20,0,20,0
1653301024178,MATH 10C,B06,089255,Staff,18,0,20,2
1653301024703,MATH 11,A01,089258,Rava; Denise,1,0,15,14
1653301024703,MATH 11,A02,089260,Rava; Denise,9,0,15,6
1653301024703,MATH 11,A03,089263,Rava; Denise,10,0,15,5
1653301024703,MATH 11,A04,089265,Rava; Denise,13,0,15,2
1653301024703,MATH 11,A05,089267,Rava; Denise,10,0,15,5
1653301024703,MATH 11,A06,089269,Rava; Denise,14,0,15,1
1653301024703,MATH 11,A07,089271,Rava; Denise,14,0,15,1
1653301024703,MATH 11,A08,089273,Rava; Denise,13,0,15,2
1653301024703,MATH 11,B01,089279,Staff,4,0,15,11
1653301024703,MATH 11,B02,089281,Staff,14,0,15,1
1653301024703,MATH 11,B03,089283,Staff,14,0,15,1
1653301024703,MATH 11,B04,089284,Staff,15,0,15,0
1653301024703,MATH 11,B05,089286,Staff,14,0,15,1
1653301024703,MATH 11,B06,089288,Staff,15,0,15,0
1653301024703,MATH 11,B07,089289,Staff,14,0,15,1
1653301024703,MATH 11,B08,089290,Staff,14,0,15,1
1653301025244,MATH 18,A01,089303,Anzaldo; Leesa B,5,0,10,5
1653301025244,MATH 18,A02,089304,Anzaldo; Leesa B,6,0,10,4
1653301025244,MATH 18,A03,089305,Anzaldo; Leesa B,10,0,10,0
1653301025244,MATH 18,A04,089306,Anzaldo; Leesa B,8,0,10,2
1653301025244,MATH 18,A05,089307,Anzaldo; Leesa B,10,0,10,0
1653301025244,MATH 18,A06,089308,Anzaldo; Leesa B,9,0,10,1
1653301025244,MATH 18,A07,089309,Anzaldo; Leesa B,10,0,10,0
1653301025244,MATH 18,A08,089310,Anzaldo; Leesa B,10,0,10,0
1653301025244,MATH 18,A09,089311,Anzaldo; Leesa B,10,0,10,0
1653301025244,MATH 18,A10,089312,Anzaldo; Leesa B,10,0,10,0
1653301025244,MATH 18,A11,089313,Anzaldo; Leesa B,9,0,10,1
1653301025244,MATH 18,A12,089314,Anzaldo; Leesa B,10,0,10,0
1653301025244,MATH 18,A13,089315,Anzaldo; Leesa B,9,0,10,1
1653301025244,MATH 18,A14,089316,Anzaldo; Leesa B,10,0,10,0
1653301025244,MATH 18,A15,089317,Anzaldo; Leesa B,9,0,10,1
1653301025244,MATH 18,A16,089318,Anzaldo; Leesa B,10,0,10,0
1653301025244,MATH 18,A17,089319,Anzaldo; Leesa B,9,0,10,1
1653301025244,MATH 18,A18,089320,Anzaldo; Leesa B,10,0,10,0
1653301025244,MATH 18,A19,089321,Anzaldo; Leesa B,0,0,0,0
1653301025244,MATH 18,A20,089322,Anzaldo; Leesa B,0,0,0,0
1653301025244,MATH 18,A21,089323,Anzaldo; Leesa B,9,0,10,1
1653301025244,MATH 18,A22,089324,Anzaldo; Leesa B,7,0,10,3
1653301025244,MATH 18,A23,089325,Anzaldo; Leesa B,10,0,10,0
1653301025244,MATH 18,A24,089326,Anzaldo; Leesa B,9,0,10,1
1653301025244,MATH 18,B01,089329,Staff,13,0,13,0
1653301025244,MATH 18,B02,089330,Staff,12,0,13,1
1653301025244,MATH 18,B03,089331,Staff,12,0,13,1
1653301025244,MATH 18,B04,089332,Staff,13,0,13,0
1653301025244,MATH 18,B05,089333,Staff,12,0,13,1
1653301025244,MATH 18,C01,089336,Staff,13,0,13,0
1653301025244,MATH 18,C02,089337,Staff,11,0,13,2
1653301025244,MATH 18,C03,089338,Staff,0,0,0,0
1653301025244,MATH 18,C04,089339,Staff,0,0,0,0
1653301025244,MATH 18,C05,089340,Staff,0,0,0,1
1653301025244,MATH 18,D01,094194,Staff,0,0,0,0
1653301025244,MATH 18,D02,094195,Staff,0,0,0,0
1653301025244,MATH 18,D03,094196,Staff,0,0,0,0
1653301025244,MATH 18,D04,094197,Staff,0,0,0,0
1653301025244,MATH 18,D05,094198,Staff,0,0,0,0
1653301025777,MATH 20A,A01,089343,Staff,5,0,5,0
1653301025777,MATH 20A,A02,089344,Staff,5,0,5,0
1653301025777,MATH 20A,A03,089345,Staff,5,0,5,0
1653301025777,MATH 20A,B01,089347,Suk; Andrew Hoon,2,0,3,1
1653301025777,MATH 20A,B02,089348,Suk; Andrew Hoon,3,0,3,0
1653301025777,MATH 20A,B03,089349,Suk; Andrew Hoon,3,0,3,0
1653301025777,MATH 20A,B04,089350,Suk; Andrew Hoon,3,0,3,0
1653301025777,MATH 20A,B05,089351,Suk; Andrew Hoon,3,0,3,0
1653301025777,MATH 20A,B06,089352,Suk; Andrew Hoon,2,0,3,1
1653301025777,MATH 20A,B07,089353,Suk; Andrew Hoon,3,0,3,0
1653301025777,MATH 20A,B08,089354,Suk; Andrew Hoon,3,0,3,0
1653301025777,MATH 20A,B09,089355,Suk; Andrew Hoon,3,0,3,0
1653301025777,MATH 20A,B10,089356,Suk; Andrew Hoon,3,0,3,0
1653301025777,MATH 20A,B11,089357,Suk; Andrew Hoon,3,0,3,0
1653301025777,MATH 20A,B12,089358,Suk; Andrew Hoon,3,0,3,0
1653301025777,MATH 20A,B13,089359,Suk; Andrew Hoon,2,0,3,1
1653301025777,MATH 20A,B14,089360,Suk; Andrew Hoon,3,0,3,0
1653301025777,MATH 20A,B15,089361,Suk; Andrew Hoon,3,0,3,0
1653301025777,MATH 20A,B16,089362,Suk; Andrew Hoon,3,0,3,0
1653301025777,MATH 20A,B17,089363,Suk; Andrew Hoon,3,0,3,0
1653301025777,MATH 20A,B18,089364,Suk; Andrew Hoon,0,0,0,0
1653301025777,MATH 20A,B19,089365,Suk; Andrew Hoon,3,0,3,0
1653301025777,MATH 20A,B20,089366,Suk; Andrew Hoon,3,0,3,0
1653301025777,MATH 20A,B21,089367,Suk; Andrew Hoon,3,0,3,0
1653301025777,MATH 20A,B22,089368,Suk; Andrew Hoon,3,0,3,0
1653301025777,MATH 20A,B23,089369,Suk; Andrew Hoon,3,0,3,0
1653301025777,MATH 20A,B24,089370,Suk; Andrew Hoon,3,0,3,0
1653301026311,MATH 20B,A01,089372,Quarfoot; David James,8,0,8,0
1653301026311,MATH 20B,A02,089373,Quarfoot; David James,8,0,8,0
1653301026311,MATH 20B,A03,089374,Quarfoot; David James,7,0,8,1
1653301026311,MATH 20B,A04,089375,Quarfoot; David James,7,0,8,1
1653301026311,MATH 20B,A05,089376,Quarfoot; David James,0,0,0,0
1653301026311,MATH 20B,A06,089377,Quarfoot; David James,0,0,0,0
1653301026311,MATH 20B,A07,089378,Quarfoot; David James,0,0,0,0
1653301026311,MATH 20B,A08,089379,Quarfoot; David James,0,0,0,0
1653301026311,MATH 20B,A09,089380,Quarfoot; David James,0,0,0,0
1653301026311,MATH 20B,A10,089381,Quarfoot; David James,0,0,0,0
1653301026311,MATH 20B,A11,089382,Quarfoot; David James,0,0,0,0
1653301026311,MATH 20B,A12,089383,Quarfoot; David James,0,0,0,0
1653301026311,MATH 20B,A13,089384,Quarfoot; David James,0,0,0,0
1653301026311,MATH 20B,A14,089385,Quarfoot; David James,0,0,0,0
1653301026311,MATH 20B,A15,089386,Quarfoot; David James,0,0,0,0
1653301026311,MATH 20B,A16,089387,Quarfoot; David James,0,0,0,0
1653301026311,MATH 20B,A17,089388,Quarfoot; David James,8,0,8,0
1653301026311,MATH 20B,A18,089389,Quarfoot; David James,8,0,8,0
1653301026311,MATH 20B,A19,089390,Quarfoot; David James,8,0,8,0
1653301026311,MATH 20B,A20,089391,Quarfoot; David James,8,0,8,0
1653301026311,MATH 20B,A21,089392,Quarfoot; David James,8,0,8,0
1653301026311,MATH 20B,A22,089393,Quarfoot; David James,7,0,8,1
1653301026311,MATH 20B,A23,089394,Quarfoot; David James,7,0,8,1
1653301026311,MATH 20B,A24,089395,Quarfoot; David James,8,0,8,0
1653301026311,MATH 20B,B01,089397,Lahiri; Aranya,7,0,10,3
1653301026311,MATH 20B,B02,089398,Lahiri; Aranya,10,0,10,0
1653301026311,MATH 20B,B03,089399,Lahiri; Aranya,10,0,10,0
1653301026311,MATH 20B,B04,089400,Lahiri; Aranya,10,0,10,0
1653301026311,MATH 20B,B05,089401,Lahiri; Aranya,10,0,10,0
1653301026311,MATH 20B,C01,089403,Lahiri; Aranya,0,0,0,0
1653301026311,MATH 20B,C02,089404,Lahiri; Aranya,8,0,10,2
1653301026311,MATH 20B,C03,089405,Lahiri; Aranya,10,0,10,0
1653301026311,MATH 20B,C04,089406,Lahiri; Aranya,9,0,10,1
1653301026311,MATH 20B,C05,089407,Lahiri; Aranya,9,0,10,1
1653301026847,MATH 20C,A01,089409,Um; Ko Woon,10,0,10,0
1653301026847,MATH 20C,A02,089410,Um; Ko Woon,10,0,10,0
1653301026847,MATH 20C,A03,089411,Um; Ko Woon,9,0,10,1
1653301026847,MATH 20C,A04,089412,Um; Ko Woon,9,0,10,1
1653301026847,MATH 20C,A05,089413,Um; Ko Woon,10,0,10,0
1653301026847,MATH 20C,A06,089414,Um; Ko Woon,9,0,10,1
1653301026847,MATH 20C,A07,094270,Um; Ko Woon,10,0,10,0
1653301026847,MATH 20C,A08,094271,Um; Ko Woon,10,0,10,0
1653301026847,MATH 20C,A09,094272,Um; Ko Woon,7,0,10,3
1653301026847,MATH 20C,A10,094273,Um; Ko Woon,10,0,10,0
1653301026847,MATH 20C,A11,094274,Um; Ko Woon,10,0,10,0
1653301026847,MATH 20C,A12,094275,Um; Ko Woon,8,0,10,2
1653301026847,MATH 20C,A13,094276,Um; Ko Woon,10,0,10,0
1653301026847,MATH 20C,A14,094277,Um; Ko Woon,10,0,10,0
1653301026847,MATH 20C,A15,094278,Um; Ko Woon,10,0,10,0
1653301026847,MATH 20C,A16,094279,Um; Ko Woon,10,0,10,0
1653301026847,MATH 20C,B03,089418,Zhang; Ming,7,0,15,8
1653301026847,MATH 20C,B04,089419,Zhang; Ming,13,0,15,2
1653301026847,MATH 20C,B05,089420,Zhang; Ming,13,0,15,2
1653301026847,MATH 20C,C01,089423,Staff,15,0,15,0
1653301026847,MATH 20C,C02,089424,Staff,15,0,15,0
1653301026847,MATH 20C,C03,089425,Staff,15,0,15,0
1653301026847,MATH 20C,C04,089426,Staff,15,0,15,0
1653301026847,MATH 20C,C05,089427,Staff,15,0,15,0
1653301026847,MATH 20C,D04,089433,Zhang; Ming,13,0,15,2
1653301026847,MATH 20C,D05,089434,Zhang; Ming,15,0,15,0
1653301026847,MATH 20C,E01,089439,Staff,15,0,15,0
1653301026847,MATH 20C,E02,089440,Staff,15,0,15,0
1653301026847,MATH 20C,E03,089441,Staff,15,0,15,0
1653301026847,MATH 20C,E04,089442,Staff,15,0,15,0
1653301026847,MATH 20C,E05,089443,Staff,15,0,15,0
1653301026847,MATH 20C,E06,089444,Staff,15,0,15,0
1653301026847,MATH 20C,A17,094280,Um; Ko Woon,0,0,0,0
1653301026847,MATH 20C,A18,094281,Um; Ko Woon,0,0,0,0
1653301026847,MATH 20C,A19,094282,Um; Ko Woon,0,0,0,0
1653301026847,MATH 20C,A20,094283,Um; Ko Woon,0,0,0,0
1653301026847,MATH 20C,A21,094284,Um; Ko Woon,0,0,0,0
1653301026847,MATH 20C,A22,094285,Um; Ko Woon,0,0,0,0
1653301026847,MATH 20C,A23,094286,Um; Ko Woon,0,0,0,0
1653301026847,MATH 20C,A24,094287,Um; Ko Woon,0,0,0,0
1653301026847,MATH 20C,B01,089416,Zhang; Ming,0,0,0,0
1653301026847,MATH 20C,B02,089417,Zhang; Ming,0,0,0,0
1653301026847,MATH 20C,D01,089430,Zhang; Ming,0,0,0,0
1653301026847,MATH 20C,D02,089431,Zhang; Ming,0,0,0,0
1653301026847,MATH 20C,D03,089432,Zhang; Ming,0,0,0,0
1653301027374,MATH 20D,A01,089455,Lee; Kisun,11,0,25,14
1653301027374,MATH 20D,A02,089456,Lee; Kisun,24,0,25,1
1653301027374,MATH 20D,A03,089457,Lee; Kisun,24,0,25,1
1653301027374,MATH 20D,A04,089458,Lee; Kisun,25,0,25,0
1653301027374,MATH 20D,A05,089459,Lee; Kisun,25,0,25,0
1653301027374,MATH 20D,A06,089460,Lee; Kisun,25,0,25,0
1653301027374,MATH 20D,B01,089463,Lee; Kisun,20,0,25,5
1653301027374,MATH 20D,B02,089464,Lee; Kisun,25,0,25,0
1653301027374,MATH 20D,B03,089465,Lee; Kisun,24,0,25,1
1653301027374,MATH 20D,B04,089466,Lee; Kisun,25,0,25,0
1653301027374,MATH 20D,B05,089467,Lee; Kisun,23,0,25,2
1653301027374,MATH 20D,B06,089468,Lee; Kisun,24,0,25,1
1653301027374,MATH 20D,C01,089471,Staff,23,0,25,2
1653301027374,MATH 20D,C02,089472,Staff,25,0,25,0
1653301027374,MATH 20D,C03,089473,Staff,25,0,25,0
1653301027374,MATH 20D,C04,089474,Staff,25,0,25,0
1653301027374,MATH 20D,C05,089475,Staff,25,0,25,0
1653301027374,MATH 20D,C06,089476,Staff,25,0,25,0
1653301027901,MATH 20E,A01,089479,Eggers; John Dietrich,17,0,24,7
1653301027901,MATH 20E,A02,089480,Eggers; John Dietrich,24,0,25,1
1653301027901,MATH 20E,A03,089481,Eggers; John Dietrich,25,0,25,0
1653301027901,MATH 20E,A04,089482,Eggers; John Dietrich,25,0,25,0
1653301027901,MATH 20E,A05,089483,Eggers; John Dietrich,19,0,25,6
1653301027901,MATH 20E,A06,089484,Eggers; John Dietrich,25,0,25,0
1653301027901,MATH 20E,A07,089485,Eggers; John Dietrich,24,0,25,1
1653301027901,MATH 20E,A08,089486,Eggers; John Dietrich,24,0,25,1
1653301027901,MATH 20E,B01,089488,Staff,15,0,25,10
1653301027901,MATH 20E,B02,089489,Staff,21,0,25,4
1653301027901,MATH 20E,B03,089490,Staff,25,0,25,0
1653301027901,MATH 20E,B04,089491,Staff,25,0,25,0
1653301027901,MATH 20E,B05,089492,Staff,24,0,25,1
1653301027901,MATH 20E,B06,089493,Staff,24,0,25,1
1653301027901,MATH 20E,B07,089494,Staff,25,0,25,0
1653301027901,MATH 20E,B08,089495,Staff,25,0,25,0
1653301027901,MATH 20E,C01,089497,Staff,23,0,25,2
1653301027901,MATH 20E,C02,089498,Staff,25,0,25,0
1653301027901,MATH 20E,C03,089499,Staff,25,0,25,0
1653301027901,MATH 20E,C04,089500,Staff,25,0,25,0
1653301027901,MATH 20E,C05,089501,Staff,25,0,25,0
1653301027901,MATH 20E,C06,089502,Staff,25,0,25,0
1653301027901,MATH 20E,C07,089503,Staff,25,0,25,0
1653301027901,MATH 20E,C08,089504,Staff,25,0,25,0
1653301028429,MATH 31AH,A01,089506,Rabin; Jeffrey Mark,35,0,35,0
1653301028429,MATH 31AH,A02,089507,Rabin; Jeffrey Mark,35,0,35,0
1653301028954,MATH 87,A00,094827,Meyer; David A.,20,0,20,0
1653301029480,MATH 96,A00,094836,Kane; Daniel Mertz,11,0,30,19
1653301030008,MATH 100A,A01,089509,Kedlaya; Kiran S.,23,0,30,7
1653301030008,MATH 100A,A02,089510,Kedlaya; Kiran S.,28,0,30,2
1653301030008,MATH 100A,B01,089512,Greenfeld; Be'Eri,24,0,30,6
1653301030008,MATH 100A,B02,089513,Greenfeld; Be'Eri,30,0,30,0
1653301030535,MATH 102,A01,089515,Hodges; Reuven Moses,25,0,30,5
1653301030535,MATH 102,A02,089516,Hodges; Reuven Moses,30,0,30,0
1653301030535,MATH 102,A03,089517,Hodges; Reuven Moses,30,0,30,0
1653301030535,MATH 102,A04,089518,Hodges; Reuven Moses,29,0,30,1
1653301030535,MATH 102,B01,089520,Hodges; Reuven Moses,29,0,30,1
1653301030535,MATH 102,B02,089521,Hodges; Reuven Moses,29,0,30,1
1653301030535,MATH 102,B03,089522,Hodges; Reuven Moses,29,0,30,1
1653301030535,MATH 102,B04,089523,Hodges; Reuven Moses,30,0,30,0
1653301031060,MATH 103A,A01,089525,Staff,27,0,30,3
1653301031060,MATH 103A,A02,089526,Staff,30,0,30,0
1653301031060,MATH 103A,B01,089528,Seward; Brandon M.,9,0,30,21
1653301031060,MATH 103A,B02,089529,Seward; Brandon M.,22,0,30,8
1653301031060,MATH 103A,C01,089531,Staff,27,0,30,3
1653301031060,MATH 103A,C02,089532,Staff,28,0,30,2
1653301031060,MATH 103A,D01,089534,Staff,28,0,30,2
1653301031060,MATH 103A,D02,089535,Staff,28,0,30,2
1653301031604,MATH 109,A01,089537,Chung; Kwun,9,0,10,1
1653301031604,MATH 109,A02,089538,Chung; Kwun,10,0,10,0
1653301031604,MATH 109,B01,089540,Belmont; Eva Kinoshita,9,0,10,1
1653301031604,MATH 109,B02,089541,Belmont; Eva Kinoshita,6,0,10,4
1653301031604,MATH 109,C01,089543,Chow; Bennett,8,0,10,2
1653301031604,MATH 109,C02,089544,Chow; Bennett,10,0,10,0
1653301031604,MATH 109,D01,089546,Chung; Kwun,9,0,10,1
1653301031604,MATH 109,D02,089547,Chung; Kwun,9,0,10,1
1653301031604,MATH 109,E01,089549,Schweinsberg; Jason,6,0,10,4
1653301031604,MATH 109,E02,089550,Schweinsberg; Jason,10,0,10,0
1653301032132,MATH 110,A01,089552,Wenzl; Hans G,27,0,35,8
1653301032132,MATH 110,A02,089553,Wenzl; Hans G,33,0,35,2
1653301032656,MATH 111A,A01,089555,Meyer; David A.,0,0,0,1
1653301033190,MATH 120A,A01,089557,Manners; Frederick,30,0,35,5
1653301033190,MATH 120A,A02,089558,Manners; Frederick,33,0,35,2
1653301033719,MATH 140A,A01,089560,Seward; Brandon M.,25,0,30,5
1653301033719,MATH 140A,A02,089561,Seward; Brandon M.,29,0,30,1
1653301033719,MATH 140A,B01,089563,Chan; Pak Yeung,30,0,30,0
1653301033719,MATH 140A,B02,089564,Chan; Pak Yeung,22,0,30,8
1653301034258,MATH 142A,A01,089566,Staff,29,0,30,1
1653301034258,MATH 142A,A02,089567,Staff,29,0,30,1
1653301034258,MATH 142A,B01,089569,Staff,30,0,30,0
1653301034258,MATH 142A,B02,089570,Staff,29,0,30,1
1653301034258,MATH 142A,C01,089572,Staff,26,0,30,4
1653301034258,MATH 142A,C02,089573,Staff,29,0,30,1
1653301034258,MATH 142A,D01,089575,Eggers; John Dietrich,15,0,30,15
1653301034258,MATH 142A,D02,089576,Eggers; John Dietrich,27,0,30,3
1653301034782,MATH 144,A01,089578,Bejenaru; Ioan,29,0,30,1
1653301035316,MATH 150A,A01,089580,Chow; Bennett,29,0,35,6
1653301035316,MATH 150A,A02,089581,Chow; Bennett,34,0,35,1
1653301036366,MATH 153,A01,094204,Harel; Guershon,33,0,35,2
1653301036889,MATH 154,A01,089590,Verstraete; Jacques Allan,3,0,30,27
1653301036889,MATH 154,A02,089591,Verstraete; Jacques Allan,23,0,30,7
1653301036889,MATH 154,A03,089592,Verstraete; Jacques Allan,28,0,30,2
1653301036889,MATH 154,A04,089593,Verstraete; Jacques Allan,26,0,30,4
1653301037413,MATH 155A,A01,089595,Buss; Samuel R,22,0,35,13
1653301037413,MATH 155A,A02,089596,Buss; Samuel R,32,0,35,3
1653301037958,MATH 160A,A01,089598,Manners; Frederick,28,0,35,7
1653301037958,MATH 160A,A02,094207,Manners; Frederick,34,0,35,1
1653301038502,MATH 170A,A01,089600,Liu; Shuang,24,0,25,1
1653301038502,MATH 170A,A02,089601,Liu; Shuang,24,0,25,1
1653301038502,MATH 170A,A03,089602,Liu; Shuang,24,0,25,1
1653301038502,MATH 170A,A04,089603,Liu; Shuang,23,0,25,2
1653301038502,MATH 170A,B01,089605,Dumitriu; Ioana,8,0,25,17
1653301038502,MATH 170A,B02,089606,Dumitriu; Ioana,20,0,25,5
1653301038502,MATH 170A,B03,089607,Dumitriu; Ioana,21,0,25,4
1653301038502,MATH 170A,B04,089608,Dumitriu; Ioana,25,0,25,0
1653301039023,MATH 173A,A01,089610,Cloninger; Alexander,0,0,35,35
1653301039023,MATH 173A,A02,089611,Cloninger; Alexander,2,0,35,33
1653301039023,MATH 173A,A03,089612,Cloninger; Alexander,20,0,35,15
1653301039550,MATH 174,A01,089614,Cheng; Li-Tien,23,0,25,2
1653301039550,MATH 174,A02,089615,Cheng; Li-Tien,25,0,25,0
1653301040082,MATH 180A,A01,089617,Jekel; David Andrew,0,0,25,25
1653301040082,MATH 180A,A02,089618,Jekel; David Andrew,23,0,25,2
1653301040082,MATH 180A,A03,089619,Jekel; David Andrew,22,0,25,3
1653301040082,MATH 180A,A04,089620,Jekel; David Andrew,22,0,25,3
1653301040082,MATH 180A,A05,089621,Jekel; David Andrew,24,0,25,1
1653301040082,MATH 180A,A06,089622,Jekel; David Andrew,23,0,25,2
1653301040082,MATH 180A,B01,089624,Agarwal; Pooja,23,0,25,2
1653301040082,MATH 180A,B02,089625,Agarwal; Pooja,24,0,25,1
1653301040082,MATH 180A,B03,089626,Agarwal; Pooja,22,0,25,3
1653301040082,MATH 180A,B04,089627,Agarwal; Pooja,25,0,25,0
1653301040082,MATH 180A,B05,089628,Agarwal; Pooja,24,0,25,1
1653301040082,MATH 180A,B06,089629,Agarwal; Pooja,25,0,25,0
1653301040082,MATH 180A,C01,089631,Staff,22,0,25,3
1653301040082,MATH 180A,C02,089632,Staff,25,0,25,0
1653301040082,MATH 180A,C03,089633,Staff,25,0,25,0
1653301040082,MATH 180A,C04,089634,Staff,25,0,25,0
1653301040623,MATH 180C,A01,089636,Fitzsimmons; Patrick J,4,0,25,21
1653301040623,MATH 180C,A02,089637,Fitzsimmons; Patrick J,21,0,25,4
1653301041145,MATH 181B,A01,089639,Rava; Denise,31,0,35,4
1653301041145,MATH 181B,A02,089640,Rava; Denise,34,0,35,1
1653301041145,MATH 181B,A03,089641,Rava; Denise,31,0,35,4
1653301041145,MATH 181B,A04,089642,Rava; Denise,35,0,35,0
1653301041670,MATH 183,A01,089644,Staff,10,0,25,15
1653301041670,MATH 183,A02,089645,Staff,23,0,25,2
1653301041670,MATH 183,A03,089646,Staff,23,0,25,2
1653301041670,MATH 183,A04,089647,Staff,25,0,25,0
1653301041670,MATH 183,A05,089648,Staff,19,0,25,6
1653301041670,MATH 183,A06,089649,Staff,22,0,25,3
1653301041670,MATH 183,A07,089650,Staff,25,0,25,0
1653301041670,MATH 183,A08,089651,Staff,25,0,25,0
1653301042222,MATH 184,A01,089653,Kane; Daniel Mertz,24,0,30,6
1653301042222,MATH 184,A02,089654,Kane; Daniel Mertz,30,0,30,0
1653301042222,MATH 184,A03,089655,Kane; Daniel Mertz,30,0,30,0
1653301042222,MATH 184,A04,089656,Kane; Daniel Mertz,30,0,30,0
1653301042750,MATH 187A,A01,089658,Bucur; Alina Ioana,0,0,25,25
1653301042750,MATH 187A,A02,089659,Bucur; Alina Ioana,12,0,25,13
1653301042750,MATH 187A,A03,089660,Bucur; Alina Ioana,0,0,25,25
1653301042750,MATH 187A,A04,089661,Bucur; Alina Ioana,17,0,25,8
1653301043276,MATH 187B,A01,089663,Bucur; Alina Ioana,28,0,35,7
1653301043276,MATH 187B,A02,089664,Bucur; Alina Ioana,34,0,35,1
1653301043802,MATH 188,A01,094817,Sam; Steven V,33,0,35,2
1653301044331,MATH 190A,A01,089666,Sam; Steven V,21,0,35,14
1653301044867,MATH 196,A00,089667,Spolaor; Luca,33,0,45,12
1653301045407,MCWP 40,004,093486,Wastal; Carrie King,0,0,3,3
1653301045407,MCWP 40,005,093487,Wastal; Carrie King,0,0,3,3
1653301045407,MCWP 40,006,093488,Wastal; Carrie King,3,0,3,0
1653301045407,MCWP 40,007,093489,Wastal; Carrie King,3,0,3,0
1653301045407,MCWP 40,008,093490,Wastal; Carrie King,2,0,3,1
1653301045407,MCWP 40,009,093491,Wastal; Carrie King,2,0,3,1
1653301045407,MCWP 40,013,093495,Wastal; Carrie King,3,0,3,0
1653301045407,MCWP 40,014,093496,Wastal; Carrie King,0,0,3,3
1653301045407,MCWP 40,015,093497,Wastal; Carrie King,3,0,3,0
1653301045407,MCWP 40,016,093498,Wastal; Carrie King,3,0,3,0
1653301045407,MCWP 40,017,093499,Wastal; Carrie King,3,0,3,0
1653301045407,MCWP 40,018,093500,Wastal; Carrie King,1,0,3,2
1653301045407,MCWP 40,020,093502,Wastal; Carrie King,0,0,0,0
1653301045407,MCWP 40,021,093503,Wastal; Carrie King,3,0,3,0
1653301045407,MCWP 40,022,093504,Wastal; Carrie King,2,0,3,1
1653301045407,MCWP 40,023,093505,Wastal; Carrie King,2,0,3,1
1653301045407,MCWP 40,024,093506,Wastal; Carrie King,2,0,3,1
1653301045407,MCWP 40,026,093508,Wastal; Carrie King,3,0,3,0
1653301045407,MCWP 40,027,093509,Wastal; Carrie King,3,0,3,0
1653301045407,MCWP 40,028,093510,Wastal; Carrie King,3,0,3,0
1653301045407,MCWP 40,029,093511,Wastal; Carrie King,3,0,3,0
1653301045407,MCWP 40,030,093512,Wastal; Carrie King,2,0,3,1
1653301045407,MCWP 40,032,093514,Wastal; Carrie King,2,0,3,1
1653301045407,MCWP 40,033,093515,Wastal; Carrie King,3,0,3,0
1653301045407,MCWP 40,034,093516,Wastal; Carrie King,3,0,3,0
1653301045407,MCWP 40,035,093517,Wastal; Carrie King,3,0,3,0
1653301045407,MCWP 40,038,093520,Wastal; Carrie King,2,0,3,1
1653301045407,MCWP 40,039,093521,Wastal; Carrie King,3,0,3,0
1653301045407,MCWP 40,041,093523,Wastal; Carrie King,2,0,3,1
1653301045407,MCWP 40,042,093524,Wastal; Carrie King,3,0,3,0
1653301045407,MCWP 40,043,093525,Wastal; Carrie King,0,0,0,0
1653301045407,MCWP 40,049,093531,Wastal; Carrie King,2,0,3,1
1653301045407,MCWP 40,050,093532,Wastal; Carrie King,3,0,3,0
1653301045407,MCWP 40,051,093533,Wastal; Carrie King,3,0,3,0
1653301045933,MCWP 50,001,093534,Wastal; Carrie King,0,0,0,0
1653301045933,MCWP 50,002,093535,Wastal; Carrie King,0,0,3,3
1653301045933,MCWP 50,003,093536,Wastal; Carrie King,0,0,3,3
1653301045933,MCWP 50,004,093537,Wastal; Carrie King,0,0,3,3
1653301045933,MCWP 50,005,093538,Wastal; Carrie King,0,0,3,3
1653301045933,MCWP 50,006,093539,Wastal; Carrie King,2,0,3,1
1653301045933,MCWP 50,007,093540,Wastal; Carrie King,0,0,3,3
1653301045933,MCWP 50,008,093541,Wastal; Carrie King,0,0,3,3
1653301045933,MCWP 50,009,093542,Wastal; Carrie King,0,0,3,3
1653301045933,MCWP 50,010,093543,Wastal; Carrie King,0,0,3,3
1653301045933,MCWP 50,013,093546,Wastal; Carrie King,1,0,3,2
1653301045933,MCWP 50,014,093547,Wastal; Carrie King,0,0,3,3
1653301045933,MCWP 50,015,093548,Wastal; Carrie King,0,0,3,3
1653301045933,MCWP 50,016,093549,Wastal; Carrie King,0,0,0,0
1653301046480,MCWP 125,A00,093550,Wilson; Marion E.,3,0,3,0
1653301046480,MCWP 125,B00,093551,Guillen; Melinda,3,0,3,0
1653301046480,MCWP 125,C00,093552,Guillen; Melinda,3,0,3,0
1653301046480,MCWP 125,D00,093553,Guillen; Melinda,3,0,3,0
1653301046480,MCWP 125,E00,093554,Miller; Elizabeth Deen,3,0,3,0
1653301046480,MCWP 125,F00,093555,Miller; Elizabeth Deen,3,0,3,0
1653301046480,MCWP 125,G00,093556,Miller; Elizabeth Deen,3,0,3,0
1653301047004,MGT 3,A00,087704,Wagner; Timothy Ryan,90,0,90,0
1653301047527,MGT 4,A01,087706,Levkoff; Steven B.,2,0,3,1
1653301047527,MGT 4,A02,087707,Levkoff; Steven B.,3,0,3,0
1653301047527,MGT 4,A03,092659,Levkoff; Steven B.,1,0,4,3
1653301048059,MGT 5,A00,087708,Houskeeper; Robert,194,0,196,2
1653301048584,MGT 12,A00,087709,Pecore; Joseph P.,91,0,100,9
1653301048584,MGT 12,B00,087710,Lindenberger; Wade Douglas,91,0,100,9
1653301049136,MGT 16,A00,087711,Campbell; Robert Harold,108,0,110,2
1653301049136,MGT 16,B00,087712,Campbell; Robert Harold,110,0,110,0
1653301049136,MGT 16,C00,087713,Lindenberger; Wade Douglas,100,0,110,10
1653301049136,MGT 16,D00,087714,Lindenberger; Wade Douglas,107,0,110,3
1653301049136,MGT 16,E00,094819,Buchanan; Harold G,99,0,100,1
1653301049671,MGT 18,A00,087715,McKay; Michael J,88,0,90,2
1653301049671,MGT 18,B00,087716,McKay; Michael J,90,0,90,0
1653301049671,MGT 18,C00,087717,McKay; Michael J,88,0,90,2
1653301049671,MGT 18,D00,087718,McKay; Mary A,90,0,90,0
1653301049671,MGT 18,E00,087719,McKay; Mary A,87,0,90,3
1653301050195,MGT 45,A00,087720,Pecore; Joseph P.,136,0,150,14
1653301050195,MGT 45,B00,087721,Pecore; Joseph P.,140,0,150,10
1653301050719,MGT 52,A00,087722,Deal; Jennifer Jean,83,0,90,7
1653301051243,MGT 71,A00,087723,August; Terrence,60,0,90,30
1653301052325,MGT 103,A00,087726,Ehrich; Kristine R,86,0,90,4
1653301052325,MGT 103,B00,087727,Ehrich; Kristine R,89,0,90,1
1653301052325,MGT 103,C00,087728,Eberhard; Craig A,89,0,90,1
1653301052325,MGT 103,D00,087729,Eberhard; Craig A,88,0,90,2
1653301052325,MGT 103,E00,087730,Demill; Burritt,75,0,90,15
1653301052325,MGT 103,F00,087731,Bates; Kenneth Walter,81,0,90,9
1653301052325,MGT 103,G00,087732,Bates; Kenneth Walter,88,0,90,2
1653301052850,MGT 105,A00,087733,Campbell; Robert Harold,102,0,120,18
1653301053386,MGT 106,A00,087734,Eberhard; Craig A,81,0,90,9
1653301053918,MGT 108R,A00,087735,Amir; On,84,0,90,6
1653301054445,MGT 109,A00,087736,Staff,77,0,90,13
1653301054988,MGT 112,A00,087737,Somasundaram; Tyagarajan,89,0,90,1
1653301054988,MGT 112,B00,087738,Somasundaram; Tyagarajan,86,0,90,4
1653301054988,MGT 112,C00,087739,Ehrich; Kristine R,86,0,90,4
1653301054988,MGT 112,D00,087740,Zimmermann; Carsten,65,0,90,25
1653301055525,MGT 121A,A00,087741,Wang; Helen Shan,65,0,70,5
1653301055525,MGT 121A,B00,087742,Wang; Helen Shan,64,0,70,6
1653301056051,MGT 131A,A00,087743,Houskeeper; Robert,146,0,150,4
1653301056578,MGT 132,A00,087744,Blakley; Bruce,88,0,90,2
1653301057105,MGT 134,A00,087745,Houskeeper; Robert,84,0,90,6
1653301057632,MGT 135,A00,087746,Anderson; John Charles,83,0,90,7
1653301058156,MGT 139,A00,087747,Perols; Johan Lars,88,0,90,2
1653301058681,MGT 153,A00,087748,Perols; Johan Lars,82,0,90,8
1653301058681,MGT 153,B00,087749,Phiroz; Zal Navroze,75,0,90,15
1653301058681,MGT 153,C00,087750,Phiroz; Zal Navroze,87,0,90,3
1653301059226,MGT 162R,A00,087751,Gneezy; Uri,64,0,90,26
1653301059757,MGT 164,A00,087752,McKay; Mary A,90,0,90,0
1653301059757,MGT 164,B00,087753,Meyer; Alison Bloomfield,0,0,0,0
1653301059757,MGT 164,C00,087754,Smith; Pamela Karen,82,0,90,8
1653301060292,MGT 166,A00,087755,Moran; Cathleen L.,89,0,90,1
1653301060292,MGT 166,B00,087756,Moran; Cathleen L.,90,0,90,0
1653301060292,MGT 166,C00,087757,Moran; Cathleen L.,90,0,90,0
1653301060292,MGT 166,D00,087758,Demill; Burritt,56,0,90,34
1653301060827,MGT 167,A00,087759,Klaas; Jeffrey David,88,0,90,2
1653301060827,MGT 167,B00,087760,Jacob; Jo Dee C,83,0,90,7
1653301061354,MGT 171,A00,087761,Phiroz; Zal Navroze,85,0,90,5
1653301061897,MGT 172,A00,087762,Hedges; Kathleen & Royal; Rebecca,96,0,100,4
1653301061897,MGT 172,B00,087763,Hedges; Kathleen,79,0,90,11
1653301061897,MGT 172,C00,087764,Zimmermann; Carsten,90,0,90,0
1653301062434,MGT 172R,A00,094888,Erat; Sanjiv,90,0,90,0
1653301062966,MGT 173,A00,087765,Hayes; Sherry Lorine,80,0,100,20
1653301063500,MGT 175,A00,087766,Gopal; Christopher S.,84,0,90,6
1653301064023,MGT 181,A00,087767,Buchanan; Harold G,114,0,120,6
1653301064023,MGT 181,B00,087768,Buchanan; Harold G,110,0,120,10
1653301064023,MGT 181,C00,087769,Bliss; Barbara Ann,109,0,120,11
1653301065084,MGT 185,A00,087771,Dunn; Louis Jean,83,0,90,7
1653301065627,MGT 187,A00,087772,Dunn; Louis Jean,138,0,146,8
1653301066159,MMW 11,A01,086931,duBois; Page Ann,4,0,4,0
1653301066159,MMW 11,A02,086932,duBois; Page Ann,4,0,4,0
1653301066159,MMW 11,A03,086933,duBois; Page Ann,3,0,4,1
1653301066159,MMW 11,A04,086934,duBois; Page Ann,3,0,4,1
1653301066159,MMW 11,A05,086935,duBois; Page Ann,4,0,4,0
1653301066159,MMW 11,A06,086936,duBois; Page Ann,3,0,4,1
1653301066159,MMW 11,A07,086937,duBois; Page Ann,4,0,4,0
1653301066159,MMW 11,A08,086938,duBois; Page Ann,4,0,4,0
1653301066159,MMW 11,A09,086939,duBois; Page Ann,4,0,4,0
1653301066159,MMW 11,A10,086940,duBois; Page Ann,4,0,4,0
1653301066159,MMW 11,A11,086941,duBois; Page Ann,4,0,4,0
1653301066159,MMW 11,A12,093877,duBois; Page Ann,3,0,4,1
1653301066705,MMW 11R,A01,093852,Herbst; Matthew,4,0,4,0
1653301066705,MMW 11R,A02,093853,Herbst; Matthew,4,0,4,0
1653301066705,MMW 11R,A03,093854,Herbst; Matthew,4,0,4,0
1653301066705,MMW 11R,A04,093855,Herbst; Matthew,4,0,4,0
1653301066705,MMW 11R,A05,093856,Herbst; Matthew,4,0,4,0
1653301066705,MMW 11R,A06,093857,Herbst; Matthew,4,0,4,0
1653301066705,MMW 11R,A07,093858,Herbst; Matthew,4,0,4,0
1653301066705,MMW 11R,A08,093859,Herbst; Matthew,4,0,4,0
1653301066705,MMW 11R,A09,093860,Herbst; Matthew,4,0,4,0
1653301066705,MMW 11R,A10,093861,Herbst; Matthew,4,0,4,0
1653301066705,MMW 11R,A11,093862,Herbst; Matthew,4,0,4,0
1653301066705,MMW 11R,A12,093863,Herbst; Matthew,4,0,4,0
1653301066705,MMW 11R,B01,093865,Herbst; Matthew,4,0,4,0
1653301066705,MMW 11R,B02,093866,Herbst; Matthew,4,0,4,0
1653301066705,MMW 11R,B03,093867,Herbst; Matthew,4,0,4,0
1653301066705,MMW 11R,B04,093868,Herbst; Matthew,4,0,4,0
1653301066705,MMW 11R,B05,093869,Herbst; Matthew,4,0,4,0
1653301066705,MMW 11R,B06,093870,Herbst; Matthew,4,0,4,0
1653301066705,MMW 11R,B07,093871,Herbst; Matthew,4,0,4,0
1653301066705,MMW 11R,B08,093872,Herbst; Matthew,4,0,4,0
1653301066705,MMW 11R,B09,093873,Herbst; Matthew,4,0,4,0
1653301066705,MMW 11R,B10,093874,Herbst; Matthew,4,0,4,0
1653301066705,MMW 11R,B11,093875,Herbst; Matthew,4,0,4,0
1653301066705,MMW 11R,B12,093876,Herbst; Matthew,4,0,4,0
1653301067248,MMW 14,A01,086968,Chang; Edmond Yi-Teh,28,0,28,0
1653301067248,MMW 14,A02,086969,Chang; Edmond Yi-Teh,27,0,28,1
1653301067248,MMW 14,A03,086970,Chang; Edmond Yi-Teh,21,0,28,7
1653301067248,MMW 14,A04,086971,Chang; Edmond Yi-Teh,27,0,28,1
1653301067248,MMW 14,A05,086972,Chang; Edmond Yi-Teh,26,0,28,2
1653301067248,MMW 14,A06,086973,Chang; Edmond Yi-Teh,28,0,28,0
1653301067248,MMW 14,A07,086974,Chang; Edmond Yi-Teh,27,0,28,1
1653301067248,MMW 14,A08,086975,Chang; Edmond Yi-Teh,25,0,28,3
1653301067248,MMW 14,A09,086976,Chang; Edmond Yi-Teh,0,0,0,0
1653301067248,MMW 14,A10,086977,Chang; Edmond Yi-Teh,27,0,28,1
1653301067248,MMW 14,A11,086978,Chang; Edmond Yi-Teh,26,0,28,2
1653301067248,MMW 14,A12,086979,Chang; Edmond Yi-Teh,27,0,28,1
1653301067248,MMW 14,A13,086980,Chang; Edmond Yi-Teh,28,0,28,0
1653301067786,MMW 121,A01,086982,Chang; Edmond Yi-Teh,0,0,0,0
1653301067786,MMW 121,A02,086983,Chang; Edmond Yi-Teh,0,0,0,0
1653301067786,MMW 121,A03,086984,Chang; Edmond Yi-Teh,2,0,4,2
1653301067786,MMW 121,A04,086985,Chang; Edmond Yi-Teh,4,0,4,0
1653301067786,MMW 121,A05,086986,Chang; Edmond Yi-Teh,4,0,4,0
1653301067786,MMW 121,A06,086987,Chang; Edmond Yi-Teh,4,0,4,0
1653301067786,MMW 121,A07,086988,Chang; Edmond Yi-Teh,4,0,4,0
1653301067786,MMW 121,A08,086989,Chang; Edmond Yi-Teh,4,0,4,0
1653301067786,MMW 121,B01,086991,Patterson; Patrick H.,4,0,4,0
1653301067786,MMW 121,B02,086992,Patterson; Patrick H.,4,0,4,0
1653301067786,MMW 121,B03,086993,Patterson; Patrick H.,4,0,4,0
1653301067786,MMW 121,B04,086994,Patterson; Patrick H.,3,0,4,1
1653301067786,MMW 121,B05,086995,Patterson; Patrick H.,4,0,4,0
1653301067786,MMW 121,B06,086996,Patterson; Patrick H.,4,0,4,0
1653301067786,MMW 121,B07,086997,Patterson; Patrick H.,4,0,4,0
1653301067786,MMW 121,B08,086998,Patterson; Patrick H.,4,0,4,0
1653301067786,MMW 121,B09,086999,Patterson; Patrick H.,4,0,4,0
1653301067786,MMW 121,B10,087000,Patterson; Patrick H.,4,0,4,0
1653301067786,MMW 121,B11,087001,Patterson; Patrick H.,0,0,0,0
1653301067786,MMW 121,B12,087002,Patterson; Patrick H.,0,0,0,0
1653301068319,MUS 1A,A01,090497,Staff,19,0,20,1
1653301068319,MUS 1A,A02,090498,Staff,13,0,20,7
1653301068319,MUS 1A,A03,090499,Staff,18,0,20,2
1653301068319,MUS 1A,A04,090500,Staff,19,0,20,1
1653301068319,MUS 1A,A05,090501,Staff,20,0,20,0
1653301068319,MUS 1A,A06,090502,Staff,20,0,20,0
1653301068319,MUS 1A,B01,090504,Staff,18,0,20,2
1653301068319,MUS 1A,B02,090505,Staff,20,0,20,0
1653301068319,MUS 1A,B03,090506,Staff,18,0,20,2
1653301068319,MUS 1A,B04,090507,Staff,18,0,20,2
1653301068319,MUS 1A,B05,090508,Staff,16,0,20,4
1653301068319,MUS 1A,B06,090509,Staff,20,0,20,0
1653301068848,MUS 2A,A01,090511,Carlson; Erik Norman,19,0,20,1
1653301069377,MUS 2AK,A00,090512,Ohnishi; Takae,24,0,25,1
1653301069377,MUS 2AK,B00,090513,Ohnishi; Takae,15,0,15,0
1653301069901,MUS 4,A01,090515,Staff,24,0,25,1
1653301069901,MUS 4,A02,090516,Staff,24,0,25,1
1653301069901,MUS 4,A03,090517,Staff,22,0,25,3
1653301069901,MUS 4,A04,090518,Staff,24,0,25,1
1653301069901,MUS 4,A05,090519,Staff,25,0,25,0
1653301069901,MUS 4,A06,090520,Staff,25,0,25,0
1653301069901,MUS 4,A07,090521,Staff,24,0,25,1
1653301069901,MUS 4,A08,090522,Staff,24,0,25,1
1653301070430,MUS 5,A01,090524,Staff,20,0,20,0
1653301070430,MUS 5,A02,090525,Staff,18,0,20,2
1653301070430,MUS 5,A03,090526,Staff,20,0,20,0
1653301070430,MUS 5,A04,090527,Staff,20,0,20,0
1653301070430,MUS 5,A05,090528,Staff,19,0,20,1
1653301070963,MUS 6,A01,090530,Staff,22,0,25,3
1653301070963,MUS 6,A02,090531,Staff,25,0,25,0
1653301070963,MUS 6,A03,090532,Staff,25,0,25,0
1653301070963,MUS 6,A04,090533,Staff,23,0,25,2
1653301071492,MUS 8,A01,090535,Kenyatta; Kamau,17,0,25,8
1653301071492,MUS 8,A02,090536,Kenyatta; Kamau,19,0,25,6
1653301071492,MUS 8,A03,090537,Kenyatta; Kamau,17,0,25,8
1653301071492,MUS 8,A04,090538,Kenyatta; Kamau,21,0,25,4
1653301072019,MUS 12,A01,090540,Narucki; Susan M,20,0,20,0
1653301072019,MUS 12,A02,090541,Narucki; Susan M,20,0,20,0
1653301072019,MUS 12,A03,090542,Narucki; Susan M,17,0,20,3
1653301072552,MUS 15,A01,090544,Staff,21,0,25,4
1653301072552,MUS 15,A02,090545,Staff,23,0,25,2
1653301072552,MUS 15,A03,090546,Staff,24,0,25,1
1653301072552,MUS 15,A04,090547,Staff,22,0,25,3
1653301072552,MUS 15,A05,090548,Staff,25,0,25,0
1653301072552,MUS 15,A06,090549,Staff,24,0,25,1
1653301073083,MUS 19R,A01,090551,Britt; King James,17,0,20,3
1653301073083,MUS 19R,A02,090552,Britt; King James,19,0,20,1
1653301073083,MUS 19R,A03,090553,Britt; King James,20,0,20,0
1653301073083,MUS 19R,A04,090554,Britt; King James,19,0,20,1
1653301073083,MUS 19R,A05,090555,Britt; King James,20,0,20,0
1653301073083,MUS 19R,A06,090556,Britt; King James,18,0,20,2
1653301073083,MUS 19R,A07,090557,Britt; King James,19,0,20,1
1653301073083,MUS 19R,A08,090558,Britt; King James,19,0,20,1
1653301073083,MUS 19R,A09,090559,Britt; King James,20,0,20,0
1653301073083,MUS 19R,A10,090560,Britt; King James,20,0,20,0
1653301073083,MUS 19R,B01,090562,Britt; King James,10,0,10,0
1653301073083,MUS 19R,B02,090563,Britt; King James,10,0,10,0
1653301073083,MUS 19R,B03,090564,Britt; King James,10,0,10,0
1653301073083,MUS 19R,B04,090565,Britt; King James,10,0,10,0
1653301073083,MUS 19R,B05,090566,Britt; King James,10,0,10,0
1653301073083,MUS 19R,B06,090567,Britt; King James,10,0,10,0
1653301073083,MUS 19R,B07,090568,Britt; King James,10,0,10,0
1653301073083,MUS 19R,B08,090569,Britt; King James,10,0,10,0
1653301073083,MUS 19R,B09,090570,Britt; King James,10,0,10,0
1653301073083,MUS 19R,B10,090571,Britt; King James,10,0,10,0
1653301073615,MUS 20,A01,090573,Borgo; David Garcia,12,0,15,3
1653301073615,MUS 20,A02,090574,Borgo; David Garcia,14,0,15,1
1653301073615,MUS 20,A03,090575,Borgo; David Garcia,13,0,15,2
1653301074145,MUS 32,001,094074,Staff,10,0,10,0
1653301074145,MUS 32,002,094075,Kenyatta; Kamau,10,0,10,0
1653301074145,MUS 32,003,094076,Curtis; Charles Rector,10,0,10,0
1653301074145,MUS 32,005,094078,Terrazas Perez; Wilfrido D,10,0,10,0
1653301074145,MUS 32,006,094079,Ohnishi; Takae,10,0,10,0
1653301074145,MUS 32,007,094080,Burr; Anthony I,10,0,10,0
1653301074145,MUS 32,008,094081,Carlson; Erik Norman,10,0,10,0
1653301074145,MUS 32,009,094082,Dresser; Mark Stuart,10,0,10,0
1653301074145,MUS 32,011,094084,Richards; Stephanie F,10,0,10,0
1653301074145,MUS 32,012,094085,Borgo; David Garcia,10,0,10,0
1653301074145,MUS 32,013,094086,Paganos Koukakis; Dimitrios,10,0,10,0
1653301074145,MUS 32,014,094087,Jones; Michael David,10,0,10,0
1653301074670,MUS 32V,A00,094355,Zazueta Cervera; Miguel Angel,10,0,10,0
1653301074670,MUS 32V,B00,094089,Flores; Mariana,10,0,10,0
1653301075207,MUS 32VM,A00,094090,Zazueta Cervera; Miguel Angel,15,0,15,0
1653301075733,MUS 33A,A00,090576,Liang; Lei,24,0,25,1
1653301076352,MUS 43,A00,090577,Burr; Anthony I,92,0,100,8
1653301076892,MUS 95C,B00,094829,Staff,28,0,30,2
1653301077425,MUS 95D,A00,090579,Staff,30,0,30,0
1653301077948,MUS 95E,A00,090580,Staff,30,0,30,0
1653301078471,MUS 95G,A00,090581,Anderson; Kenneth,384,0,395,11
1653301078471,MUS 95G,B00,090582,Anderson; Kenneth,393,0,395,2
1653301078998,MUS 95JC,A00,090583,Kenyatta; Kamau,35,0,35,0
1653301079522,MUS 95L,A00,090584,Staff,30,0,30,0
1653301080059,MUS 95W,A00,090585,Seshadri; Kartik,60,0,60,0
1653301080059,MUS 95W,B00,090586,Seshadri; Kartik,30,0,30,0
1653301080582,MUS 101A,A01,090588,Staff,29,0,30,1
1653301081112,MUS 103A,A00,090589,Ung; Chinary,15,0,15,0
1653301081636,MUS 107,A00,090590,Terrazas Perez; Wilfrido D,30,0,30,0
1653301082162,MUS 111,A00,090591,Yadegari; Shahrokh D,124,0,130,6
1653301082688,MUS 114,A00,090592,Curtis; Charles Rector,117,0,125,8
1653301083217,MUS 120A,A01,090594,Cimini; Amy Marie,29,0,30,1
1653301083741,MUS 126R,A00,090595,Borgo; David Garcia,106,0,115,9
1653301084269,MUS 130,A00,090596,Ohnishi; Takae,30,0,30,0
1653301084792,MUS 132,001,094091,Nourai; Keyarash,10,0,10,0
1653301084792,MUS 132,002,094093,Kenyatta; Kamau,10,0,10,0
1653301084792,MUS 132,003,094094,Curtis; Charles Rector,10,0,10,0
1653301084792,MUS 132,005,094096,Terrazas Perez; Wilfrido D,10,0,10,0
1653301084792,MUS 132,006,094097,Ohnishi; Takae,10,0,10,0
1653301084792,MUS 132,007,094098,Burr; Anthony I,10,0,10,0
1653301084792,MUS 132,008,094099,Carlson; Erik Norman,10,0,10,0
1653301084792,MUS 132,009,094100,Dresser; Mark Stuart,10,0,10,0
1653301084792,MUS 132,011,094102,Richards; Stephanie F,10,0,10,0
1653301084792,MUS 132,012,094103,Borgo; David Garcia,10,0,10,0
1653301084792,MUS 132,013,094104,Jones; Michael David,10,0,10,0
1653301084792,MUS 132,014,094105,Staff,10,0,10,0
1653301085316,MUS 132V,A00,094106,Narucki; Susan M,15,0,15,0
1653301085840,MUS 134,A00,090597,Staff,30,0,30,0
1653301086366,MUS 137A,A00,090598,Kenyatta; Kamau,30,0,30,0
1653301086893,MUS 143,A00,090599,Staff,26,0,30,4
1653301087945,MUS 173,A00,090600,Britt; King James,19,0,30,11
1653301088471,MUS 174A,A00,090601,Staff,8,0,15,7
1653301089520,NANO 4,A01,088199,Vazquez Mena; Oscar,20,0,20,0
1653301089520,NANO 4,B01,088201,Vazquez Mena; Oscar,20,0,20,0
1653301089520,NANO 4,C01,088203,Vazquez Mena; Oscar,20,0,20,0
1653301090049,NANO 15,A01,088205,Lubarda; Vlado,50,0,50,0
1653301090049,NANO 15,B01,088207,Lubarda; Vlado,50,0,50,0
1653301090573,NANO 20L,A00,088208,Sirbuly; Donald,27,0,30,3
1653301090573,NANO 20L,B00,088209,Sirbuly; Donald,29,0,30,1
1653301091097,NANO 100L,A00,088210,Vecchio; Kenneth S,24,0,30,6
1653301091621,NANO 102,A00,088211,Tao; Andrea Rae,94,0,100,6
1653301092146,NANO 110,A00,088212,Pascal; Tod A,99,0,100,1
1653301092670,NANO 111,A00,088213,Fenning; David,45,0,50,5
1653301093221,NANO 117,A00,088214,Cubukcu; Ertugrul,71,0,75,4
1653301093756,NANO 119,A00,088215,Vazquez Mena; Oscar,50,0,50,0
1653301094298,NANO 159,A00,088216,Wang; Joseph,33,0,40,7
1653301094823,NANO 181,A01,088218,Ong; Shyue Ping,22,0,25,3
1653301095347,PHIL 1,A00,090815,Sher; Gila,57,0,60,3
1653301095878,PHIL 10,A01,090817,Grush; Rick Scott,37,0,40,3
1653301095878,PHIL 10,A02,090818,Grush; Rick Scott,37,0,40,3
1653301095878,PHIL 10,A03,090819,Grush; Rick Scott,38,0,40,2
1653301095878,PHIL 10,A04,090820,Grush; Rick Scott,40,0,40,0
1653301095878,PHIL 10,A05,090821,Grush; Rick Scott,38,0,40,2
1653301095878,PHIL 10,A06,090822,Grush; Rick Scott,39,0,40,1
1653301096406,PHIL 12,A01,090824,Bechtel; William,20,0,25,5
1653301096406,PHIL 12,A02,090825,Bechtel; William,24,0,25,1
1653301096406,PHIL 12,A03,090826,Bechtel; William,25,0,25,0
1653301096406,PHIL 12,A04,090827,Bechtel; William,25,0,25,0
1653301096938,PHIL 13,A01,090829,Wonderly; Monique L.,25,0,25,0
1653301096938,PHIL 13,A02,090830,Wonderly; Monique L.,24,0,25,1
1653301096938,PHIL 13,A03,090831,Wonderly; Monique L.,24,0,25,1
1653301096938,PHIL 13,A04,090832,Wonderly; Monique L.,25,0,25,0
1653301097470,PHIL 27,A01,090834,Harrell; Maralee Mae,23,0,35,12
1653301097470,PHIL 27,A02,090835,Harrell; Maralee Mae,35,0,35,0
1653301097470,PHIL 27,A03,090836,Harrell; Maralee Mae,33,0,35,2
1653301097470,PHIL 27,A04,090837,Harrell; Maralee Mae,33,0,35,2
1653301097470,PHIL 27,A05,090838,Harrell; Maralee Mae,35,0,35,0
1653301097470,PHIL 27,A06,090839,Harrell; Maralee Mae,35,0,35,0
1653301098002,PHIL 28,A01,090841,Bazargan-Forward; Saba,31,0,35,4
1653301098002,PHIL 28,A02,090842,Bazargan-Forward; Saba,31,0,35,4
1653301098002,PHIL 28,A03,090843,Bazargan-Forward; Saba,35,0,35,0
1653301098002,PHIL 28,A04,090844,Bazargan-Forward; Saba,30,0,35,5
1653301098002,PHIL 28,A05,090845,Bazargan-Forward; Saba,33,0,35,2
1653301098002,PHIL 28,A06,090846,Bazargan-Forward; Saba,34,0,35,1
1653301098002,PHIL 28,A07,090847,Bazargan-Forward; Saba,32,0,35,3
1653301098002,PHIL 28,A08,090848,Bazargan-Forward; Saba,33,0,35,2
1653301098530,PHIL 31,A00,090849,Johnson; Monte,59,0,60,1
1653301099063,PHIL 100,A00,090852,Nelkin; Dana Kay,28,0,35,7
1653301099599,PHIL 110,A00,090853,Johnson; Monte,29,0,30,1
1653301100126,PHIL 120,A00,090854,Rickless; Samuel Charles,23,0,35,12
1653301100650,PHIL 123,A00,090855,Sher; Gila,38,0,40,2
1653301101177,PHIL 131,A00,090856,Cohen; Jonathan David,34,0,35,1
1653301101721,PHIL 132,A00,090857,Carr; Jennifer Rose,33,0,35,2
1653301102244,PHIL 138,A00,090858,Brink; David O.,34,0,40,6
1653301102770,PHIL 147,A00,090860,Fulkerson; Matthew Todd,33,0,35,2
1653301103308,PHIL 150,A00,090861,Bechtel; William,36,0,40,4
1653301103850,PHIL 155,A00,090862,Vargas; Manuel Rogelio,38,0,40,2
1653301104385,PHIL 165,A00,090863,Rickless; Samuel Charles,59,0,70,11
1653301104909,PHIL 172,A00,090864,Bazargan-Forward; Saba,37,0,40,3
1653301105433,PHIL 173,A00,090865,Wonderly; Monique L.,33,0,40,7
1653301105959,PHYS 1A,A00,088555,Koslover; Elena F,354,0,362,8
1653301105959,PHYS 1A,B00,088556,Koslover; Elena F,343,0,362,19
1653301105959,PHYS 1A,C00,088557,Shpyrko; Oleg,326,0,362,36
1653301106542,PHYS 1AL,001,088558,Tsai; Philbert S,30,0,30,0
1653301106542,PHYS 1AL,002,088559,Tsai; Philbert S,30,0,30,0
1653301106542,PHYS 1AL,003,088560,Tsai; Philbert S,23,0,30,7
1653301106542,PHYS 1AL,004,088561,Tsai; Philbert S,26,0,30,4
1653301106542,PHYS 1AL,005,088562,Tsai; Philbert S,24,0,30,6
1653301106542,PHYS 1AL,006,088563,Tsai; Philbert S,30,0,30,0
1653301106542,PHYS 1AL,007,088564,Tsai; Philbert S,26,0,30,4
1653301106542,PHYS 1AL,008,088565,Tsai; Philbert S,29,0,30,1
1653301106542,PHYS 1AL,009,088566,Tsai; Philbert S,28,0,30,2
1653301106542,PHYS 1AL,010,088567,Tsai; Philbert S,30,0,30,0
1653301106542,PHYS 1AL,011,088568,Tsai; Philbert S,29,0,30,1
1653301106542,PHYS 1AL,012,088569,Tsai; Philbert S,29,0,30,1
1653301106542,PHYS 1AL,013,088570,Tsai; Philbert S,30,0,30,0
1653301106542,PHYS 1AL,014,088571,Tsai; Philbert S,29,0,30,1
1653301106542,PHYS 1AL,015,088572,Tsai; Philbert S,23,0,30,7
1653301106542,PHYS 1AL,016,088573,Tsai; Philbert S,28,0,30,2
1653301106542,PHYS 1AL,017,088574,Tsai; Philbert S,29,0,30,1
1653301106542,PHYS 1AL,018,088575,Tsai; Philbert S,28,0,30,2
1653301106542,PHYS 1AL,019,088576,Tsai; Philbert S,26,0,30,4
1653301106542,PHYS 1AL,020,088577,Tsai; Philbert S,29,0,30,1
1653301106542,PHYS 1AL,021,088578,Tsai; Philbert S,30,0,30,0
1653301106542,PHYS 1AL,022,088579,Tsai; Philbert S,30,0,30,0
1653301106542,PHYS 1AL,023,088580,Tsai; Philbert S,30,0,30,0
1653301106542,PHYS 1AL,024,088581,Tsai; Philbert S,30,0,30,0
1653301106542,PHYS 1AL,025,088582,Tsai; Philbert S,26,0,30,4
1653301106542,PHYS 1AL,026,088583,Tsai; Philbert S,29,0,30,1
1653301106542,PHYS 1AL,027,088584,Tsai; Philbert S,28,0,30,2
1653301106542,PHYS 1AL,028,088585,Tsai; Philbert S,30,0,30,0
1653301106542,PHYS 1AL,029,088586,Tsai; Philbert S,27,0,30,3
1653301106542,PHYS 1AL,030,088587,Tsai; Philbert S,29,0,30,1
1653301106542,PHYS 1AL,031,088588,Tsai; Philbert S,30,0,30,0
1653301106542,PHYS 1AL,032,088589,Tsai; Philbert S,30,0,30,0
1653301106542,PHYS 1AL,033,088590,Tsai; Philbert S,30,0,30,0
1653301106542,PHYS 1AL,034,088591,Tsai; Philbert S,30,0,30,0
1653301106542,PHYS 1AL,035,088592,Tsai; Philbert S,29,0,30,1
1653301106542,PHYS 1AL,036,088593,Tsai; Philbert S,30,0,30,0
1653301107095,PHYS 1B,A00,088594,Groisman; Alexander,351,0,360,9
1653301107619,PHYS 1BL,001,088595,Tsai; Philbert S,30,0,30,0
1653301107619,PHYS 1BL,002,088596,Tsai; Philbert S,25,0,30,5
1653301107619,PHYS 1BL,003,088597,Tsai; Philbert S,27,0,30,3
1653301107619,PHYS 1BL,004,088598,Tsai; Philbert S,30,0,30,0
1653301107619,PHYS 1BL,005,088599,Tsai; Philbert S,29,0,30,1
1653301107619,PHYS 1BL,006,088600,Tsai; Philbert S,25,0,30,5
1653301107619,PHYS 1BL,007,088601,Tsai; Philbert S,30,0,30,0
1653301107619,PHYS 1BL,008,088602,Tsai; Philbert S,29,0,30,1
1653301107619,PHYS 1BL,009,088603,Tsai; Philbert S,30,0,30,0
1653301107619,PHYS 1BL,010,088604,Tsai; Philbert S,30,0,30,0
1653301107619,PHYS 1BL,011,088605,Tsai; Philbert S,28,0,30,2
1653301107619,PHYS 1BL,012,088606,Tsai; Philbert S,26,0,30,4
1653301108151,PHYS 1C,A00,088607,Tsai; Philbert S,334,0,360,26
1653301108693,PHYS 1CL,001,088608,Tsai; Philbert S,30,0,30,0
1653301108693,PHYS 1CL,002,088609,Tsai; Philbert S,24,0,30,6
1653301108693,PHYS 1CL,003,088610,Tsai; Philbert S,24,0,30,6
1653301108693,PHYS 1CL,004,088611,Tsai; Philbert S,29,0,30,1
1653301108693,PHYS 1CL,005,088612,Tsai; Philbert S,17,0,30,13
1653301108693,PHYS 1CL,006,088613,Tsai; Philbert S,19,0,30,11
1653301108693,PHYS 1CL,007,088614,Tsai; Philbert S,30,0,30,0
1653301108693,PHYS 1CL,008,088615,Tsai; Philbert S,26,0,30,4
1653301108693,PHYS 1CL,009,088616,Tsai; Philbert S,27,0,30,3
1653301108693,PHYS 1CL,010,088617,Tsai; Philbert S,29,0,30,1
1653301108693,PHYS 1CL,011,088618,Tsai; Philbert S,27,0,30,3
1653301108693,PHYS 1CL,012,088619,Tsai; Philbert S,24,0,30,6
1653301109217,PHYS 2A,A01,092602,Meyertholen; Andrew D.,26,0,30,4
1653301109217,PHYS 2A,A02,092603,Meyertholen; Andrew D.,28,0,30,2
1653301109217,PHYS 2A,A03,092604,Meyertholen; Andrew D.,29,0,30,1
1653301109217,PHYS 2A,A04,092605,Meyertholen; Andrew D.,30,0,30,0
1653301109217,PHYS 2A,A05,092606,Meyertholen; Andrew D.,29,0,30,1
1653301109217,PHYS 2A,A06,092607,Meyertholen; Andrew D.,29,0,30,1
1653301109217,PHYS 2A,A07,092608,Meyertholen; Andrew D.,30,0,30,0
1653301109217,PHYS 2A,A08,092609,Meyertholen; Andrew D.,30,0,30,0
1653301109217,PHYS 2A,A09,092610,Meyertholen; Andrew D.,27,0,30,3
1653301109217,PHYS 2A,A10,092611,Meyertholen; Andrew D.,30,0,30,0
1653301109217,PHYS 2A,A11,092612,Meyertholen; Andrew D.,30,0,30,0
1653301109217,PHYS 2A,A12,094499,Meyertholen; Andrew D.,27,0,30,3
1653301109745,PHYS 2B,A01,092613,Branson; James G,28,0,30,2
1653301109745,PHYS 2B,A02,092614,Branson; James G,29,0,30,1
1653301109745,PHYS 2B,A03,092615,Branson; James G,30,0,30,0
1653301109745,PHYS 2B,A04,092616,Branson; James G,30,0,30,0
1653301109745,PHYS 2B,A05,092617,Branson; James G,29,0,30,1
1653301109745,PHYS 2B,A06,092618,Branson; James G,29,0,30,1
1653301109745,PHYS 2B,A07,092619,Branson; James G,29,0,30,1
1653301109745,PHYS 2B,A08,092620,Branson; James G,0,0,0,0
1653301109745,PHYS 2B,A09,092621,Branson; James G,0,0,0,0
1653301109745,PHYS 2B,A10,092622,Branson; James G,0,0,0,0
1653301109745,PHYS 2B,A11,092623,Branson; James G,0,0,0,0
1653301109745,PHYS 2B,A12,092624,Branson; James G,30,0,30,0
1653301110276,PHYS 2C,A01,092625,Barreiro Guerrero; Julio,27,0,30,3
1653301110276,PHYS 2C,A02,092626,Barreiro Guerrero; Julio,28,0,30,2
1653301110276,PHYS 2C,A03,092627,Barreiro Guerrero; Julio,29,0,30,1
1653301110276,PHYS 2C,A04,092628,Barreiro Guerrero; Julio,29,0,30,1
1653301110276,PHYS 2C,A05,092629,Barreiro Guerrero; Julio,30,0,30,0
1653301110276,PHYS 2C,A06,092630,Barreiro Guerrero; Julio,30,0,30,0
1653301110276,PHYS 2C,A07,092631,Barreiro Guerrero; Julio,30,0,30,0
1653301110276,PHYS 2C,A08,092632,Barreiro Guerrero; Julio,30,0,30,0
1653301110276,PHYS 2C,A09,092633,Barreiro Guerrero; Julio,29,0,30,1
1653301110276,PHYS 2C,A10,092634,Barreiro Guerrero; Julio,29,0,30,1
1653301110276,PHYS 2C,A11,092635,Barreiro Guerrero; Julio,27,0,30,3
1653301110276,PHYS 2C,A12,092636,Barreiro Guerrero; Julio,29,0,30,1
1653301110276,PHYS 2C,B01,092637,Barreiro Guerrero; Julio,29,0,30,1
1653301110276,PHYS 2C,B02,092638,Barreiro Guerrero; Julio,30,0,30,0
1653301110276,PHYS 2C,B03,092639,Barreiro Guerrero; Julio,28,0,30,2
1653301110276,PHYS 2C,B04,092640,Barreiro Guerrero; Julio,29,0,30,1
1653301110276,PHYS 2C,B05,092641,Barreiro Guerrero; Julio,26,0,30,4
1653301110276,PHYS 2C,B06,092642,Barreiro Guerrero; Julio,28,0,30,2
1653301110276,PHYS 2C,B07,092643,Barreiro Guerrero; Julio,29,0,30,1
1653301110276,PHYS 2C,B08,092644,Barreiro Guerrero; Julio,30,0,30,0
1653301110276,PHYS 2C,B09,092645,Barreiro Guerrero; Julio,29,0,30,1
1653301110276,PHYS 2C,B10,092646,Barreiro Guerrero; Julio,29,0,30,1
1653301110276,PHYS 2C,B11,092647,Barreiro Guerrero; Julio,30,0,30,0
1653301110276,PHYS 2C,B12,092648,Barreiro Guerrero; Julio,30,0,30,0
1653301110825,PHYS 2CL,A01,088625,Du; Chunhui,26,0,30,4
1653301110825,PHYS 2CL,A02,088626,Du; Chunhui,29,0,30,1
1653301110825,PHYS 2CL,A03,088627,Du; Chunhui,21,0,30,9
1653301110825,PHYS 2CL,A04,088628,Du; Chunhui,30,0,30,0
1653301110825,PHYS 2CL,A05,088629,Du; Chunhui,29,0,30,1
1653301110825,PHYS 2CL,A06,088630,Du; Chunhui,24,0,30,6
1653301110825,PHYS 2CL,A07,088631,Du; Chunhui,28,0,30,2
1653301110825,PHYS 2CL,A08,088632,Du; Chunhui,28,0,30,2
1653301110825,PHYS 2CL,A09,088633,Du; Chunhui,24,0,30,6
1653301110825,PHYS 2CL,A10,088634,Du; Chunhui,29,0,30,1
1653301110825,PHYS 2CL,A11,088635,Du; Chunhui,27,0,30,3
1653301110825,PHYS 2CL,A12,088636,Du; Chunhui,30,0,30,0
1653301111349,PHYS 2D,A01,092649,Hirsch; Jorge Eduardo,30,0,30,0
1653301111349,PHYS 2D,A02,092650,Hirsch; Jorge Eduardo,28,0,30,2
1653301111349,PHYS 2D,A03,092651,Hirsch; Jorge Eduardo,30,0,30,0
1653301111349,PHYS 2D,A04,092652,Hirsch; Jorge Eduardo,30,0,30,0
1653301111349,PHYS 2D,A05,092653,Hirsch; Jorge Eduardo,30,0,30,0
1653301111349,PHYS 2D,A06,092654,Hirsch; Jorge Eduardo,30,0,30,0
1653301111873,PHYS 2DL,A01,088639,Butov; Leonid,7,0,16,9
1653301111873,PHYS 2DL,A02,088640,Butov; Leonid,13,0,16,3
1653301111873,PHYS 2DL,A03,094501,Butov; Leonid,13,0,16,3
1653301111873,PHYS 2DL,A04,094502,Butov; Leonid,16,0,16,0
1653301112400,PHYS 4C,A01,092655,Averitt; Richard Douglas,28,0,30,2
1653301112400,PHYS 4C,A02,092656,Averitt; Richard Douglas,30,0,30,0
1653301112400,PHYS 4C,A03,092657,Averitt; Richard Douglas,30,0,30,0
1653301112400,PHYS 4C,A04,092658,Staff,30,0,30,0
1653301112947,PHYS 5,A01,092662,Konopacky; Quinn Morgan,197,0,200,3
1653301113480,PHYS 10,A01,092663,Tytler; David Robert,191,0,192,1
1653301114017,PHYS 100A,A01,092660,Shpyrko; Oleg,114,0,120,6
1653301114553,PHYS 110A,A01,092664,Arovas; Daniel P,116,0,120,4
1653301115079,PHYS 122,A01,088647,Yang; Liang,30,0,40,10
1653301115603,PHYS 130B,A01,092661,Grover; Tarun,106,0,120,14
1653301116127,PHYS 139,A00,088649,Kuti; Julius,19,0,20,1
1653301116664,PHYS 140A,A01,092665,Shotwell; Brian,105,0,120,15
1653301117200,PHYS 161,A01,092666,Fuller; George Michael,46,0,65,19
1653301117726,PHYS 163,A01,092667,Keres; Dusan,48,0,50,2
1653301118250,PHYS 175,A00,088653,Dudko; Olga,18,0,20,2
1653301118781,PHYS 191,A00,088654,Shpyrko; Oleg,26,0,30,4
1653301119303,POLI 11D,A01,090896,Ferree; Karen E,29,0,30,1
1653301119303,POLI 11D,A02,090897,Ferree; Karen E,28,0,30,2
1653301119303,POLI 11D,A03,090899,Ferree; Karen E,28,0,30,2
1653301119303,POLI 11D,A04,090900,Ferree; Karen E,29,0,30,1
1653301119849,POLI 12D,A01,090902,Roeder; Philip G,26,0,30,4
1653301119849,POLI 12D,A02,090903,Roeder; Philip G,27,0,30,3
1653301119849,POLI 12D,A05,090906,Roeder; Philip G,28,0,30,2
1653301119849,POLI 12D,A06,090907,Roeder; Philip G,30,0,30,0
1653301120374,POLI 13DR,A01,090909,Forman; Fonna,26,0,30,4
1653301120374,POLI 13DR,A02,090910,Forman; Fonna,30,0,30,0
1653301120374,POLI 13DR,A03,090911,Forman; Fonna,28,0,30,2
1653301120374,POLI 13DR,A04,090912,Forman; Fonna,30,0,30,0
1653301120374,POLI 13DR,A05,090913,Forman; Fonna,28,0,30,2
1653301120374,POLI 13DR,A06,090914,Forman; Fonna,34,0,34,0
1653301120915,POLI 27,A01,090916,Elgin; Samuel Zincke,23,0,30,7
1653301120915,POLI 27,A02,090917,Elgin; Samuel Zincke,26,0,30,4
1653301120915,POLI 27,A03,090918,Elgin; Samuel Zincke,30,0,30,0
1653301120915,POLI 27,A04,090919,Elgin; Samuel Zincke,28,0,30,2
1653301120915,POLI 27,A05,090920,Elgin; Samuel Zincke,24,0,30,6
1653301120915,POLI 27,A06,090921,Elgin; Samuel Zincke,29,0,30,1
1653301121443,POLI 28,A01,090923,Elgin; Samuel Zincke,23,0,30,7
1653301121443,POLI 28,A02,090924,Elgin; Samuel Zincke,26,0,30,4
1653301121443,POLI 28,A05,090927,Elgin; Samuel Zincke,23,0,30,7
1653301121443,POLI 28,A06,090928,Elgin; Samuel Zincke,23,0,30,7
1653301121966,POLI 30D,A01,090930,Desposato; Scott,22,0,24,2
1653301121966,POLI 30D,A02,090931,Desposato; Scott,22,0,24,2
1653301121966,POLI 30D,A03,090932,Desposato; Scott,23,0,24,1
1653301121966,POLI 30D,A04,090933,Desposato; Scott,24,0,24,0
1653301121966,POLI 30D,A05,090934,Desposato; Scott,23,0,24,1
1653301121966,POLI 30D,A06,090935,Desposato; Scott,24,0,24,0
1653301122493,POLI 100G,A00,090936,Fletcher; Nathan,199,0,208,9
1653301123028,POLI 100V,A00,090937,Gause; LaGina,111,0,115,4
1653301123551,POLI 100W,A00,090938,Paglayan; Agustina,161,0,165,4
1653301124075,POLI 104A,A00,090940,Smith; Glenn Chatmas,186,0,195,9
1653301124599,POLI 104F,A00,090941,Smith; Glenn Chatmas,11,0,19,8
1653301125123,POLI 104M,A00,090942,Stephens; Mattheus E,156,0,165,9
1653301125647,POLI 110A,A00,090943,Wiens; David,39,0,44,5
1653301126171,POLI 110F,A00,090944,Elgin; Samuel Zincke,50,0,50,0
1653301126696,POLI 113A,A00,090945,Magagna; Victor Valentine,469,0,475,6
1653301126696,POLI 113A,B00,090946,Magagna; Victor Valentine,467,0,475,8
1653301127219,POLI 117R,A00,090947,Forman; Fonna,16,0,40,24
1653301127744,POLI 120E,A00,090948,Strom; Kaare,47,0,50,3
1653301128270,POLI 120G,A00,090949,Fisk; David Lee,110,0,115,5
1653301128794,POLI 120H,A00,090950,Fisk; David Lee,111,0,115,4
1653301129317,POLI 133A,A00,090951,Naoi; Megumi,156,0,165,9
1653301129943,POLI 135,A00,090952,Fisk; David Lee,111,0,115,4
1653301130469,POLI 142J,A00,090953,Slantchev; Branislav,45,0,50,5
1653301130994,POLI 143,A00,090954,Gartzke; Erik,111,0,115,4
1653301131520,POLI 149,A00,090955,Joseph; Michael F,152,0,165,13
1653301132044,POLI 151,A00,090956,Schneider; Christina,92,0,100,8
1653301132568,POLI 165,A00,090957,Warren; Scott,45,0,50,5
1653301133091,POLI 178,A00,090958,Joseph; Michael F,34,0,50,16
1653301133617,POLI 191A,A00,090959,Forman; Fonna & Hoston; Germaine,25,0,25,0
1653301134141,POLI 194,A00,090960,Hill; Seth J,9999,0,9999,0
1653301134664,POLI 194SD,A00,090961,Nichter; Maysa,9999,0,9999,0
1653301135198,POLI 197SD,001,090962,Nichter; Maysa,9999,0,9999,0
1653301135737,PSYC 1,A00,088391,Ferreira; Victor,194,0,200,6
1653301136261,PSYC 2,A00,093916,Moranton; Nirelia Melbina-,192,0,195,3
1653301136784,PSYC 3,A00,088392,Pilegard; Celeste Cristine,221,0,225,4
1653301137311,PSYC 6,A00,088393,McCullough; Michael E,198,0,200,2
1653301137842,PSYC 7,A00,088394,Powell; Lindsey Jane,196,0,200,4
1653301138381,PSYC 60,A01,088397,Lowe; Angela Beth,12,0,25,13
1653301138381,PSYC 60,A02,088398,Lowe; Angela Beth,25,0,25,0
1653301138381,PSYC 60,A03,088399,Lowe; Angela Beth,24,0,25,1
1653301138381,PSYC 60,A04,088400,Lowe; Angela Beth,23,0,25,2
1653301138381,PSYC 60,A05,088401,Lowe; Angela Beth,24,0,25,1
1653301138381,PSYC 60,A06,088402,Lowe; Angela Beth,25,0,25,0
1653301138381,PSYC 60,A07,088403,Lowe; Angela Beth,24,0,25,1
1653301138381,PSYC 60,B01,088405,Rickard; Timothy C.,25,0,25,0
1653301138381,PSYC 60,B02,088406,Rickard; Timothy C.,25,0,25,0
1653301138381,PSYC 60,B03,088407,Rickard; Timothy C.,25,0,25,0
1653301138381,PSYC 60,B04,088408,Rickard; Timothy C.,23,0,25,2
1653301138381,PSYC 60,B05,088410,Rickard; Timothy C.,24,0,25,1
1653301138381,PSYC 60,B06,088411,Rickard; Timothy C.,24,0,25,1
1653301138381,PSYC 60,B07,088412,Rickard; Timothy C.,24,0,25,1
1653301138927,PSYC 70,A01,088414,Pilegard; Celeste Cristine,17,0,25,8
1653301138927,PSYC 70,A02,088415,Pilegard; Celeste Cristine,24,0,25,1
1653301138927,PSYC 70,A03,088416,Pilegard; Celeste Cristine,25,0,25,0
1653301138927,PSYC 70,A04,088417,Pilegard; Celeste Cristine,25,0,25,0
1653301138927,PSYC 70,A05,088418,Pilegard; Celeste Cristine,22,0,25,3
1653301138927,PSYC 70,A06,088419,Pilegard; Celeste Cristine,19,0,25,6
1653301139470,PSYC 71,A01,088421,Lowe; Angela Beth,15,0,25,10
1653301139470,PSYC 71,A02,088422,Lowe; Angela Beth,21,0,25,4
1653301139470,PSYC 71,B01,088424,Steiner; Eric Tomas,20,0,25,5
1653301139470,PSYC 71,B02,088425,Steiner; Eric Tomas,23,0,25,2
1653301140003,PSYC 87,A00,093915,Gorman; Michael R.,20,0,20,0
1653301140527,PSYC 88,A00,088426,Dobkins; Karen R.,61,0,65,4
1653301141062,PSYC 100,A00,088428,Chapman; Eddie Nathaniel,125,0,170,45
1653301141618,PSYC 101,A00,088429,Heyman; Gail D.,148,0,170,22
1653301142171,PSYC 102,A00,093917,Moranton; Nirelia Melbina-,162,0,170,8
1653301142722,PSYC 104,A00,088430,Fine; Rachel,163,0,175,12
1653301143245,PSYC 116A,A01,088433,Lang; Ariel,25,0,25,0
1653301143795,PSYC 122,A00,088434,Miller; Cory T.,103,0,115,12
1653301144340,PSYC 125,A00,088436,Rose; Fred E.,90,0,120,30
1653301144894,PSYC 134,A00,088437,Kaye; Walter H.,235,0,250,15
1653301145423,PSYC 137,A00,088438,Fine; Rachel,210,0,216,6
1653301145969,PSYC 145,A00,093918,Staff,73,0,90,17
1653301146493,PSYC 147,A00,088441,Wong; Lauren Hitomi,120,0,146,26
1653301147018,PSYC 154,A00,093919,Lacefield; Katharine I,270,0,295,25
1653301147542,PSYC 158,A00,088443,Willis; Jarryd Thomas,250,0,295,45
1653301148099,PSYC 162,A00,088444,Wixted; John T,210,0,225,15
1653301148624,PSYC 167,A00,088445,Walker; Caren Michelle,0,0,30,30
1653301149161,PSYC 168,A00,088446,Chapman; Eddie Nathaniel,222,0,250,28
1653301149697,PSYC 171,A00,088447,Mukku; Dhananjaya,66,0,75,9
1653301150221,PSYC 178,A00,088448,Glaser; Dale,105,0,120,15
1653301150755,PSYC 179,A00,088449,Lacefield; Katharine I,193,0,250,57
1653301151282,PSYC 181,A00,088450,Anagnostaras; Stephan,284,0,300,16
1653301151806,PSYC 189,A00,088451,Gentner; Tim,19,0,31,12
1653301152361,PSYC 193,A00,088452,Gremel; Christina M,19,0,20,1
1653301152361,PSYC 193,B00,088453,Staff,19,0,20,1
1653301152918,PSYC 193L,A01,088455,Staff,33,0,35,2
1653301153463,PSYC 194A,A01,088461,Heyman; Gail D.,35,0,35,0
1653301154007,RELI 1,A01,086478,Kalleres; Dayna,20,0,20,0
1653301154007,RELI 1,A02,086479,Kalleres; Dayna,19,0,20,1
1653301154534,RELI 147,A00,088409,Caciola; Nancy A,0,0,0,0
1653301155079,REV 1,A01,092308,Leigh; Brian,24,0,24,0
1653301155079,REV 1,A02,092310,Leigh; Brian,24,0,24,0
1653301155079,REV 1,A03,092312,Leigh; Brian,24,0,24,0
1653301155079,REV 1,A04,092314,Leigh; Brian,24,0,24,0
1653301155079,REV 1,A05,092316,Leigh; Brian,24,0,24,0
1653301155603,REV 2,A01,092318,Staff,28,0,28,0
1653301155603,REV 2,A02,092319,Staff,28,0,28,0
1653301156138,REV 20,A00,092320,Staff,40,0,40,0
1653301156672,REV 87,A00,092321,Lyon; Antony J.,20,0,20,0
1653301157198,SE 1,A01,088674,Van Den Einde; Yael Dahlia,48,0,48,0
1653301157198,SE 1,A02,088675,Van Den Einde; Yael Dahlia,47,0,48,1
1653301157198,SE 1,A03,088676,Van Den Einde; Yael Dahlia,46,0,48,2
1653301157746,SE 101A,A00,088677,Morrison; Machel Leigh,191,0,200,9
1653301158298,SE 101C,A00,088678,Zhu; Qiang,137,0,145,8
1653301158827,SE 125,A00,088679,Conte; Joel P,143,0,145,2
1653301159355,SE 130A,A00,088680,Loh; Kenneth J. H.,110,0,115,5
1653301159885,SE 131B,A00,088681,Krysl; Petr,84,0,115,31
1653301160420,SE 142,A01,088683,Staff,11,0,18,7
1653301160420,SE 142,A02,088684,Staff,13,0,18,5
1653301160956,SE 164,A01,088686,Loh; Kenneth J. H.,14,0,16,2
1653301161478,SE 180,A00,088687,Elgamal; Ahmed,66,0,75,9
1653301162012,SE 181,A01,088689,McCartney; John Scott,25,0,30,5
1653301162012,SE 181,A02,088690,McCartney; John Scott,14,0,30,16
1653301162012,SE 181,A03,088691,McCartney; John Scott,25,0,25,0
1653301162012,SE 181,A04,088692,McCartney; John Scott,25,0,25,0
1653301162550,SIO 12,A00,088342,Staff,141,0,146,5
1653301163075,SIO 15,A00,088343,Laske; Gabi,333,0,340,7
1653301163600,SIO 30,A01,092382,Castillo; Paterno R.,28,0,35,7
1653301163600,SIO 30,A02,092383,Castillo; Paterno R.,32,0,35,3
1653301163600,SIO 30,A03,092384,Castillo; Paterno R.,35,0,35,0
1653301163600,SIO 30,A04,092385,Castillo; Paterno R.,35,0,35,0
1653301164131,SIO 40,A00,088345,Barbeau; Katherine,144,0,146,2
1653301164663,SIO 50,A01,088347,Cook; Geoffrey W,11,0,14,3
1653301164663,SIO 50,A02,088348,Cook; Geoffrey W,11,0,14,3
1653301165205,SIO 87,A00,088350,Cook; Geoffrey W,20,0,20,0
1653301165205,SIO 87,B00,088351,Cook; Geoffrey W,20,0,20,0
1653301165205,SIO 87,C00,094017,Gilbert; Jack Anthony,20,0,20,0
1653301165205,SIO 87,D00,094018,Gerwick; William Henry,20,0,20,0
1653301165750,SIO 90,A00,088352,Staff,56,0,60,4
1653301166297,SIO 100,A00,088354,Norris; Richard D. & Gee; Jeffrey S,10,0,20,10
1653301166825,SIO 101,A01,088356,Aluwihare; Lihini & Decima; Moira R.,1,0,30,29
1653301166825,SIO 101,A02,088357,Aluwihare; Lihini & Decima; Moira R.,15,0,30,15
1653301167351,SIO 103,A01,088359,Parnell-Turner; Ross Ernes,21,0,25,4
1653301167899,SIO 105,A00,088360,Driscoll; Neal W.,18,0,20,2
1653301168427,SIO 108,A01,088363,Teranes; Jane,15,0,20,5
1653301168953,SIO 109R,A00,088364,Forman; Fonna,27,0,40,13
1653301169486,SIO 110,A01,088366,Staff,8,0,29,21
1653301170014,SIO 117,A01,088368,Keeling; Ralph F.,31,0,36,5
1653301170561,SIO 123,A00,088369,Allen; Andrew Ellis,61,0,70,9
1653301171087,SIO 132,A01,092386,Hechinger; Ryan F. & Kacev; David,17,0,28,11
1653301171087,SIO 132,A02,092387,Hechinger; Ryan F. & Kacev; David,26,0,28,2
1653301171087,SIO 132,A03,092388,Hechinger; Ryan F. & Kacev; David,28,0,28,0
1653301171087,SIO 132,A04,092389,Hechinger; Ryan F. & Kacev; David,23,0,28,5
1653301171087,SIO 132,A05,092390,Hechinger; Ryan F. & Kacev; David,27,0,28,1
1653301171087,SIO 132,A06,092391,Hechinger; Ryan F. & Kacev; David,27,0,28,1
1653301171616,SIO 136,A01,088373,Kacev; David & Bowman; Jeff Shovlowsky,0,0,5,7
1653301171616,SIO 136,B01,088376,Kacev; David & Bowman; Jeff Shovlowsky,0,0,5,5
1653301172144,SIO 155,A01,088379,Day; James M.D.,1,0,5,4
1653301172672,SIO 170,A00,088380,Cook; Geoffrey W,29,0,30,1
1653301173199,SIO 171,A01,088382,Rudnick; Daniel Lars,37,0,40,3
1653301173723,SIO 175,A01,088384,Merrifield; Mark A,22,0,25,3
1653301174260,SIO 177,A00,088385,Becker; Janet Maria,15,0,20,5
1653301174785,SIO 179,A01,088387,Martz; Todd R.,7,0,15,8
1653301175843,SIO 189,A00,088390,Hamdoun; Amr,35,0,60,25
1653301176365,SIO 194,A00,091602,Hill; Seth J,9999,0,9999,0
1653301176889,SOCE 194,A00,091601,Hill; Seth J,9999,0,9999,0
1653301177413,SOCI 1,A01,093704,Skrentny; John David,19,0,20,1
1653301177413,SOCI 1,A02,093705,Skrentny; John David,20,0,20,0
1653301177413,SOCI 1,A03,093706,Skrentny; John David,18,0,20,2
1653301177413,SOCI 1,A04,093707,Skrentny; John David,19,0,20,1
1653301177413,SOCI 1,A05,093708,Skrentny; John David,17,0,20,3
1653301177413,SOCI 1,A06,093709,Skrentny; John David,20,0,20,0
1653301177413,SOCI 1,A07,093710,Skrentny; John David,20,0,20,0
1653301177413,SOCI 1,A08,093711,Skrentny; John David,20,0,20,0
1653301177413,SOCI 1,A09,093712,Skrentny; John David,20,0,20,0
1653301177413,SOCI 1,A10,093713,Skrentny; John David,20,0,20,0
1653301177413,SOCI 1,A11,093714,Skrentny; John David,20,0,20,0
1653301177937,SOCI 30,A01,093716,Staff,30,0,30,0
1653301177937,SOCI 30,A02,093717,Staff,30,0,30,0
1653301178465,SOCI 60,A01,093719,Staff,17,0,20,3
1653301178465,SOCI 60,A02,093720,Staff,18,0,20,2
1653301178465,SOCI 60,A03,093721,Staff,20,0,20,0
1653301178465,SOCI 60,A04,093722,Staff,20,0,20,0
1653301178987,SOCI 87,A00,093819,Blair-Loy; Mary,20,0,20,0
1653301179516,SOCI 100,A01,093724,Estefan; Michel,15,0,20,5
1653301179516,SOCI 100,A02,093725,Estefan; Michel,5,0,20,15
1653301180039,SOCI 104,A00,093728,Gong; Neil M,22,0,25,3
1653301180567,SOCI 104Q,A00,093729,Staff,23,0,25,2
1653301181101,SOCI 106,A00,093730,Staff,25,0,25,0
1653301181627,SOCI 109,A00,093731,Staff,21,0,25,4
1653301182160,SOCI 110,A00,093732,Binder; Amy,24,0,25,1
1653301183845,SOCI 117,A01,091568,Chung; Luz Marina,29,0,35,6
1653301183845,SOCI 117,A02,091569,Chung; Luz Marina,35,0,35,0
1653301184376,SOCI 118,A00,093735,Staff,0,0,0,0
1653301184921,SOCI 120T,A00,093736,Lampland; Martha,50,0,50,0
1653301184921,SOCI 120T,B00,094832,Staff,69,0,70,1
1653301185461,SOCI 122,A00,093737,Lewis; Kevin Michael,62,0,70,8
1653301185995,SOCI 123,A00,094831,Staff,57,0,65,8
1653301186540,SOCI 125,A00,093738,Staff,115,0,120,5
1653301187071,SOCI 127,A00,094894,Staff,54,0,56,2
1653301187594,SOCI 132,A00,093739,Blair-Loy; Mary,51,0,60,9
1653301188664,SOCI 136F,A00,094830,Staff,45,0,56,11
1653301189192,SOCI 138,A00,093741,Navon; Daniel,117,0,120,3
1653301189742,SOCI 140A,A00,093743,Gong; Neil M,53,0,60,7
1653301190275,SOCI 141,A00,093744,Summers; Valerie R.,111,0,120,9
1653301191335,SOCI 144,A00,093746,Staff,0,0,0,0
1653301193476,SOCI 159,A00,094902,Staff,49,0,50,1
1653301194003,SOCI 160,A00,093750,Staff,0,0,0,0
1653301194531,SOCI 165,A00,093751,Rona-Tas; Akos,43,0,48,5
1653301195054,SOCI 165A,A00,094206,Hallin; Daniel C,3,0,4,1
1653301195589,SOCI 166,A00,093752,Lampland; Martha,52,0,56,4
1653301196122,SOCI 176,A00,093753,Turner; Christena L.,44,0,48,4
1653301196644,SOCI 180,A00,094901,Staff,56,0,56,0
1653301197169,SOCI 185,A00,094903,Staff,55,0,56,1
1653301197692,SOCI 196A,A00,093754,Shafir; Gershon,20,0,20,0
1653301198234,SXTH 1,A01,092351,Bronstein; Phoebe Malan,18,0,18,0
1653301198234,SXTH 1,A02,092352,Bronstein; Phoebe Malan,18,0,18,0
1653301198234,SXTH 1,A03,092353,Bronstein; Phoebe Malan,18,0,18,0
1653301198763,SXTH 20A,A00,092355,Chilukuri; Lakshmi N,56,0,56,0
1653301199298,SYN 2,001,091487,Gladstein; Jill M,13,0,15,2
1653301199298,SYN 2,002,091488,Gladstein; Jill M,14,0,15,1
1653301199298,SYN 2,003,091490,Gladstein; Jill M,12,0,15,3
1653301199298,SYN 2,004,091491,Gladstein; Jill M,15,0,15,0
1653301199298,SYN 2,005,091493,Gladstein; Jill M,15,0,15,0
1653301199298,SYN 2,006,091495,Gladstein; Jill M,15,0,15,0
1653301199298,SYN 2,007,091496,Gladstein; Jill M,15,0,15,0
1653301199298,SYN 2,008,091497,Gladstein; Jill M,14,0,15,1
1653301199298,SYN 2,009,091499,Gladstein; Jill M,13,0,15,2
1653301199298,SYN 2,010,091501,Gladstein; Jill M,13,0,15,2
1653301199298,SYN 2,011,091502,Gladstein; Jill M,13,0,15,2
1653301199298,SYN 2,012,091503,Gladstein; Jill M,15,0,15,0
1653301199298,SYN 2,013,091505,Gladstein; Jill M,13,0,15,2
1653301199298,SYN 2,014,091506,Gladstein; Jill M,12,0,15,3
1653301199298,SYN 2,015,091508,Gladstein; Jill M,14,0,15,1
1653301199298,SYN 2,016,091509,Gladstein; Jill M,12,0,15,3
1653301199298,SYN 2,017,091510,Gladstein; Jill M,14,0,15,1
1653301199298,SYN 2,018,091512,Gladstein; Jill M,15,0,15,0
1653301199298,SYN 2,019,091513,Gladstein; Jill M,15,0,15,0
1653301199298,SYN 2,020,091514,Gladstein; Jill M,15,0,15,0
1653301199298,SYN 2,021,091516,Gladstein; Jill M,12,0,15,3
1653301199298,SYN 2,022,091517,Gladstein; Jill M,13,0,15,2
1653301199298,SYN 2,023,091518,Gladstein; Jill M,15,0,15,0
1653301199298,SYN 2,024,091519,Gladstein; Jill M,15,0,15,0
1653301199298,SYN 2,025,091520,Gladstein; Jill M,11,0,15,4
1653301199298,SYN 2,026,091521,Gladstein; Jill M,15,0,15,0
1653301199298,SYN 2,027,091522,Gladstein; Jill M,0,0,0,0
1653301199298,SYN 2,028,091523,Gladstein; Jill M,0,0,0,0
1653301199298,SYN 2,029,091524,Gladstein; Jill M,0,0,0,0
1653301199298,SYN 2,030,091525,Gladstein; Jill M,0,0,0,0
1653301199298,SYN 2,031,091526,Gladstein; Jill M,14,0,15,1
1653301199298,SYN 2,032,091527,Gladstein; Jill M,15,0,15,0
1653301199298,SYN 2,033,091528,Gladstein; Jill M,0,0,0,0
1653301199298,SYN 2,034,091529,Gladstein; Jill M,15,0,15,0
1653301199298,SYN 2,035,091530,Gladstein; Jill M,15,0,15,0
1653301199298,SYN 2,036,091531,Gladstein; Jill M,15,0,15,0
1653301199298,SYN 2,037,091532,Gladstein; Jill M,15,0,15,0
1653301199298,SYN 2,038,091533,Gladstein; Jill M,15,0,15,0
1653301199298,SYN 2,039,091534,Gladstein; Jill M,15,0,15,0
1653301199298,SYN 2,040,091535,Gladstein; Jill M,15,0,15,0
1653301199823,SYN 100,A01,091537,Gladstein; Jill M,26,0,30,4
1653301199823,SYN 100,B01,091539,Gladstein; Jill M,26,0,30,4
1653301199823,SYN 100,C01,091541,Gladstein; Jill M,26,0,30,4
1653301199823,SYN 100,D01,091543,Gladstein; Jill M,25,0,30,5
1653301199823,SYN 100,E01,091545,Gladstein; Jill M,28,0,30,2
1653301200353,TDAC 1,A00,088922,Walsh; Kim C.,10,0,10,0
1653301200353,TDAC 1,B00,088923,Walsh; Kim C.,8,0,10,2
1653301200353,TDAC 1,C00,088924,Walsh; Kim C.,0,0,10,10
1653301200353,TDAC 1,D00,088925,Walsh; Kim C.,7,0,10,3
1653301200353,TDAC 1,E00,088926,Walsh; Kim C.,2,0,10,8
1653301200353,TDAC 1,F00,088927,Walsh; Kim C.,9,0,10,1
1653301200876,TDAC 101,A00,088972,Harting; Carla Kelso,9,0,10,1
1653301200876,TDAC 101,B00,088973,Salovey; Todd,8,0,10,2
1653301200876,TDAC 101,C00,088974,Walsh; Kim C.,6,0,10,4
1653301201416,TDAC 102,A00,088975,Basso; Beatrice,9,0,10,1
1653301201416,TDAC 102,B00,088976,Basso; Beatrice,7,0,10,3
1653301201940,TDAC 103A,A00,094044,Castro; Robert Jess,32,0,35,3
1653301202471,TDAC 108,A00,088977,Staff,20,0,20,0
1653301202998,TDAC 109,A00,088978,Blair; Kyle Adam,20,0,20,0
1653301203535,TDAC 115,A00,088979,Newcomb; James,20,0,20,0
1653301204059,TDAC 122,A00,088981,Staff,30,0,30,0
1653301204583,TDAC 123,A00,088982,Staff,30,0,30,0
1653301205113,TDDE 1,A01,088929,Benzoni; Elisa,9,0,11,2
1653301205113,TDDE 1,A02,088930,Benzoni; Elisa,11,0,11,0
1653301205113,TDDE 1,A03,088931,Benzoni; Elisa,11,0,11,0
1653301205113,TDDE 1,A04,088932,Benzoni; Elisa,10,0,11,1
1653301205113,TDDE 1,A05,088933,Benzoni; Elisa,11,0,11,0
1653301205639,TDDE 130,A00,088983,Staff,20,0,20,0
1653301206166,TDDE 132,A00,094263,Staff,20,0,20,0
1653301206693,TDDE 169A,A00,094046,Petrovich; Victoria A.,18,0,20,2
1653301207217,TDDM 1,A00,088934,Snaith; Yolande,6,0,10,4
1653301207754,TDDM 5,A00,088935,Smith; Alison D,30,0,30,0
1653301208280,TDDR 101,A00,088986,Powell; Lora,34,0,35,1
1653301208802,TDDR 111,A00,088987,Stalling; Vanessa,24,0,30,6
1653301208802,TDDR 111,B00,094045,Castro; Robert Jess,14,0,16,2
1653301209348,TDDR 190,A00,088988,Stalling; Vanessa,10,0,10,0
1653301209871,TDGE 1,A01,088937,Salovey; Todd,12,0,12,0
1653301209871,TDGE 1,A02,088938,Salovey; Todd,10,0,12,2
1653301209871,TDGE 1,A03,088939,Salovey; Todd,8,0,12,4
1653301209871,TDGE 1,A04,088940,Salovey; Todd,12,0,12,0
1653301209871,TDGE 1,A05,088941,Salovey; Todd,11,0,12,1
1653301209871,TDGE 1,A06,088942,Salovey; Todd,12,0,12,0
1653301210397,TDGE 10,A00,088943,Havis; Allan,191,0,200,9
1653301210921,TDGE 11,A00,088944,Staff,200,0,200,0
1653301211452,TDGE 25,A00,088945,Harting; Carla Kelso,19,0,20,1
1653301211452,TDGE 25,B00,088946,Harting; Carla Kelso,19,0,20,1
1653301211452,TDGE 25,C00,088947,Harting; Carla Kelso,20,0,20,0
1653301211452,TDGE 25,D00,088948,Harting; Carla Kelso,19,0,20,1
1653301211452,TDGE 25,E00,088949,Harting; Carla Kelso,20,0,20,0
1653301211452,TDGE 25,F00,088950,Harting; Carla Kelso,19,0,20,1
1653301211452,TDGE 25,G00,088951,Harting; Carla Kelso,19,0,20,1
1653301211993,TDGE 127,A00,088990,Havis; Allan,188,0,200,12
1653301212518,TDHD 21,A00,088952,Jun; Grace Shin Hae,20,0,20,0
1653301213066,TDHT 10,A00,088953,Power; Jade Yukana,14,0,14,0
1653301213066,TDHT 10,B00,088954,Power; Jade Yukana,13,0,14,1
1653301213588,TDHT 21,A01,088956,Power; Jade Yukana,17,0,18,1
1653301213588,TDHT 21,A02,088957,Power; Jade Yukana,7,0,11,4
1653301213588,TDHT 21,A03,088958,Power; Jade Yukana,11,0,11,0
1653301214122,TDHT 101,A00,088994,Burelle; Julie Sara Veronique,21,0,25,4
1653301214683,TDHT 114,A00,094208,Williams; Madison Mae,47,0,50,3
1653301215210,TDHT 119,A00,094299,Burelle; Julie Sara Veronique,25,0,25,0
1653301215736,TDMV 1,A00,088959,Weinberg; Sadie,23,0,30,7
1653301216266,TDMV 2,A00,088960,Sammartano; Tonnie,27,0,30,3
1653301216266,TDMV 2,B00,094043,Duran; Marcos Antonio,29,0,30,1
1653301216805,TDMV 3,A00,088961,Arcidiacono; Kristin,27,0,30,3
1653301217337,TDMV 110,A00,088995,Wilson; Terry A.,0,0,0,0
1653301217863,TDMV 120,A00,088996,Smith; Alison D,17,0,20,3
1653301218401,TDMV 122,A00,088997,Chaleff; Rebecca,28,0,30,2
1653301218939,TDMV 130,A00,094042,Rincon; Alicia,30,0,30,0
1653301219462,TDMV 138,A00,088998,Jun; Grace Shin Hae,12,0,40,28
1653301219987,TDMV 142,A00,088999,Caligagan; Tony,28,0,40,12
1653301220521,TDMV 143,A00,094041,Foster-King; Sandra,37,0,40,3
1653301221056,TDMV 146,A00,089000,Caligagan; Tony,39,0,40,1
1653301221580,TDPF 160,A00,094264,Snaith; Yolande,30,0,30,0
1653301221580,TDPF 160,B00,094265,Smith; Alison D,30,0,30,0
1653301221580,TDPF 160,C00,094266,Weinberg; Sadie,30,0,30,0
1653301222107,TDPR 6,A01,088963,Benzoni; Elisa,25,0,25,0
1653301222107,TDPR 6,A02,088964,Benzoni; Elisa,25,0,25,0
1653301222630,TDPR 102,A00,089003,Staff,15,0,15,0
1653301223162,TDPR 104,A00,089004,Powell; Lora,15,0,15,0
1653301223706,TDPW 1,A00,088965,Staff,10,0,10,0
1653301223706,TDPW 1,B00,088966,Staff,10,0,10,0
1653301223706,TDPW 1,C00,088967,Staff,9,0,10,1
1653301223706,TDPW 1,D00,088968,Staff,9,0,10,1
1653301223706,TDPW 1,E00,088969,Staff,10,0,10,0
1653301223706,TDPW 1,F00,088970,Staff,9,0,10,1
1653301224227,TDTR 10,A00,088971,Wilson; Terry A.,22,0,25,3
1653301224755,TMC 2,A01,092358,Carver; Leslie J.,20,0,20,0
1653301224755,TMC 2,A02,092359,Carver; Leslie J.,20,0,20,0
1653301224755,TMC 2,A03,092360,Carver; Leslie J.,20,0,20,0
1653301224755,TMC 2,A04,092361,Carver; Leslie J.,20,0,20,0
1653301224755,TMC 2,A05,092362,Carver; Leslie J.,20,0,20,0
1653301224755,TMC 2,A06,092363,Carver; Leslie J.,20,0,20,0
1653301225280,TMC 15,A00,092364,Atkinson; Arthur Laird,20,0,20,0
1653301225802,TMC 20,A00,092365,Carver; Leslie J.,20,0,20,0
1653301226327,TMC 90,A00,092366,Mell; Loren K.,20,0,20,0
1653301226852,TMC 120,A01,092368,Staff,20,0,20,0
1653301227377,USP 1,A01,087520,Kwak; Nancy,19,0,20,1
1653301227377,USP 1,A02,087521,Kwak; Nancy,17,0,20,3
1653301227377,USP 1,A03,087522,Kwak; Nancy,16,0,20,4
1653301227377,USP 1,A04,087523,Kwak; Nancy,19,0,20,1
1653301227904,USP 2,A01,087525,Lerner; Amy M,29,0,30,1
1653301227904,USP 2,A02,087526,Lerner; Amy M,29,0,30,1
1653301228434,USP 4,A00,094267,Polat; Soydan Alihan,16,0,20,4
1653301228434,USP 4,B00,094268,Staff,20,0,20,0
1653301228958,USP 5,A01,087532,Staff,26,0,30,4
1653301228958,USP 5,A02,087533,Staff,27,0,30,3
1653301229483,USP 6,A01,094322,Shvartzberg Carrio; Manuel,20,0,20,0
1653301229483,USP 6,A02,094323,Shvartzberg Carrio; Manuel,20,0,20,0
1653301230008,USP 15,A01,087535,Anderson; William Raymond,20,0,25,5
1653301230008,USP 15,A02,087536,Anderson; William Raymond,23,0,25,2
1653301230531,USP 25,A00,087537,Staff,0,0,7,7
1653301231058,USP 50,A00,087538,Martin; Isaac,38,0,40,2
1653301231580,USP 124,A00,087539,Bussell; Mirle Rabinowitz,26,0,35,9
1653301232104,USP 125,A00,087540,Staff,17,0,23,6
1653301232632,USP 136,A00,087541,Staff,23,0,25,2
1653301233162,USP 144,A00,087542,Staff,136,0,146,10
1653301233692,USP 151,A00,087543,Boomhower; Matthew Charles,18,0,20,2
1653301234216,USP 152,A01,087545,Moeder; Nathan L,17,0,20,3
1653301234216,USP 152,A02,087546,Moeder; Nathan L,20,0,20,0
1653301234739,USP 153,A00,087547,Moden; Kelly Kjestine,27,0,30,3
1653301235276,USP 161,A00,094854,Wartell; Julie Dara,25,0,25,0
1653301235826,USP 169,A00,087548,Bajaj; Ravi Siddharth,30,0,35,5
1653301236355,USP 170,A00,087549,Hinds; Juli Beth,30,0,35,5
1653301236898,USP 171,A00,087550,Lerner; Amy M,38,0,50,12
1653301237532,USP 176,A00,094853,Staff,24,0,25,1
1653301238069,USP 177A,A00,087551,Peerson; Susan,20,0,22,2
1653301238590,USP 184,A00,094324,Shvartzberg Carrio; Manuel,24,0,25,1
1653301239137,USP 185A,A01,087553,Norr; Alex Vaughn,28,0,30,2
1653301239137,USP 185A,B01,087555,Boomhower; Matthew Charles,26,0,30,4
1653301239669,USP 186,A01,087557,Pezzoli; Keith,22,0,25,3
1653301239669,USP 186,A02,087558,Pezzoli; Keith,20,0,25,5
1653301240746,USP 191A,A00,087561,Rothberg; Scott Jacob,18,0,20,2
1653301241293,USP 194,A00,091599,Hill; Seth J,9999,0,9999,0
1653301241842,VIS 1,A01,088809,Tonies; Joshua Vanjaymes,10,0,10,0
1653301241842,VIS 1,A02,088810,Tonies; Joshua Vanjaymes,10,0,10,0
1653301241842,VIS 1,A03,088811,Tonies; Joshua Vanjaymes,3,0,10,7
1653301241842,VIS 1,A04,088812,Tonies; Joshua Vanjaymes,8,0,10,2
1653301241842,VIS 1,A05,088813,Tonies; Joshua Vanjaymes,4,0,10,6
1653301241842,VIS 1,A06,088814,Tonies; Joshua Vanjaymes,6,0,10,4
1653301241842,VIS 1,A07,088815,Tonies; Joshua Vanjaymes,6,0,10,4
1653301241842,VIS 1,A08,088816,Tonies; Joshua Vanjaymes,9,0,10,1
1653301241842,VIS 1,A09,088817,Tonies; Joshua Vanjaymes,8,0,10,2
1653301241842,VIS 1,A10,088818,Tonies; Joshua Vanjaymes,8,0,10,2
1653301241842,VIS 1,A11,088819,Tonies; Joshua Vanjaymes,3,0,10,7
1653301241842,VIS 1,A12,088820,Tonies; Joshua Vanjaymes,6,0,10,4
1653301241842,VIS 1,A13,088821,Tonies; Joshua Vanjaymes,6,0,10,4
1653301241842,VIS 1,A14,088822,Tonies; Joshua Vanjaymes,7,0,10,3
1653301241842,VIS 1,A15,088823,Tonies; Joshua Vanjaymes,7,0,10,3
1653301241842,VIS 1,A16,088824,Tonies; Joshua Vanjaymes,8,0,10,2
1653301242365,VIS 20,A01,088826,Woods; Ann,19,0,20,1
1653301242365,VIS 20,A02,088827,Woods; Ann,20,0,20,0
1653301242365,VIS 20,A03,088828,Woods; Ann,18,0,20,2
1653301242365,VIS 20,A04,088829,Woods; Ann,17,0,20,3
1653301242365,VIS 20,A05,088830,Woods; Ann,20,0,20,0
1653301242365,VIS 20,A06,088831,Woods; Ann,20,0,20,0
1653301242365,VIS 20,A07,088832,Woods; Ann,20,0,20,0
1653301242365,VIS 20,A08,088833,Woods; Ann,20,0,20,0
1653301242365,VIS 20,A09,088834,Woods; Ann,18,0,20,2
1653301242365,VIS 20,A10,088835,Woods; Ann,19,0,20,1
1653301242365,VIS 20,A11,088836,Woods; Ann,20,0,20,0
1653301242365,VIS 20,A12,088837,Woods; Ann,20,0,20,0
1653301242892,VIS 23,A00,088838,Rose; Jordan M,3,0,3,0
1653301243421,VIS 30,A01,088840,Stone; Patricia,11,0,11,0
1653301243421,VIS 30,A02,088841,Stone; Patricia,7,0,11,4
1653301243421,VIS 30,A03,094821,Stone; Patricia,8,0,11,3
1653301243421,VIS 30,A04,094822,Stone; Patricia,11,0,11,0
1653301243948,VIS 41,A01,088844,D'Elena-Tweed; Jessica Erin,9,0,10,1
1653301243948,VIS 41,A02,088845,D'Elena-Tweed; Jessica Erin,9,0,10,1
1653301243948,VIS 41,A03,088846,D'Elena-Tweed; Jessica Erin,9,0,10,1
1653301243948,VIS 41,A04,088847,D'Elena-Tweed; Jessica Erin,9,0,10,1
1653301243948,VIS 41,A05,088848,D'Elena-Tweed; Jessica Erin,10,0,10,0
1653301243948,VIS 41,A06,088849,D'Elena-Tweed; Jessica Erin,10,0,10,0
1653301243948,VIS 41,A07,088850,D'Elena-Tweed; Jessica Erin,10,0,10,0
1653301243948,VIS 41,A08,088851,D'Elena-Tweed; Jessica Erin,10,0,10,0
1653301244501,VIS 60,A01,088853,Sepuya; Paul Mpagi,9,0,10,1
1653301244501,VIS 60,A02,088854,Sepuya; Paul Mpagi,10,0,10,0
1653301244501,VIS 60,A03,088855,Sepuya; Paul Mpagi,10,0,10,0
1653301244501,VIS 60,A04,088856,Sepuya; Paul Mpagi,10,0,10,0
1653301244501,VIS 60,A05,088857,Sepuya; Paul Mpagi,10,0,10,0
1653301244501,VIS 60,A06,088858,Sepuya; Paul Mpagi,10,0,10,0
1653301244501,VIS 60,A07,088859,Sepuya; Paul Mpagi,9,0,10,1
1653301244501,VIS 60,A08,093932,Sepuya; Paul Mpagi,10,0,10,0
1653301245046,VIS 70N,A01,088861,Segade; Alexandro Abraham,8,0,8,0
1653301245046,VIS 70N,A02,088862,Segade; Alexandro Abraham,8,0,8,0
1653301245046,VIS 70N,A03,088863,Segade; Alexandro Abraham,8,0,8,0
1653301245046,VIS 70N,A04,088864,Segade; Alexandro Abraham,8,0,8,0
1653301245046,VIS 70N,A05,088865,Segade; Alexandro Abraham,7,0,8,1
1653301245046,VIS 70N,A06,088866,Segade; Alexandro Abraham,8,0,8,0
1653301245582,VIS 80,A01,088868,Adler; Amy,9,0,10,1
1653301245582,VIS 80,A02,088869,Adler; Amy,8,0,10,2
1653301245582,VIS 80,A03,088870,Adler; Amy,9,0,10,1
1653301245582,VIS 80,A04,088871,Adler; Amy,8,0,10,2
1653301245582,VIS 80,A05,088872,Adler; Amy,10,0,10,0
1653301245582,VIS 80,A06,088873,Adler; Amy,7,0,10,3
1653301246120,VIS 100,A00,088874,Cruz; Edwin Teddy,65,0,75,10
1653301246642,VIS 105A,A00,088875,Tonies; Joshua Vanjaymes,26,0,30,4
1653301247176,VIS 105B,A00,088876,Staff,25,0,30,5
1653301247721,VIS 106A,A00,088877,Tobe; Geoffroy,21,0,25,4
1653301248276,VIS 106B,A00,088878,Staff,21,0,25,4
1653301248801,VIS 106C,A00,088879,Staff,9,0,15,6
1653301249324,VIS 107B,A00,088880,Gallaccio; Anya,24,0,25,1
1653301249873,VIS 108,A00,093894,Gallaccio; Anya,5,0,15,10
1653301250408,VIS 110A,A00,093895,Dean; Danielle Adobi,15,0,15,0
1653301250934,VIS 110B,A00,088881,Adler; Amy,14,0,15,1
1653301251469,VIS 125E,A00,093896,Welchman; John C.,75,0,75,0
1653301251999,VIS 126HN,A00,088882,Newsome; Elizabeth Ann,74,0,75,1
1653301252550,VIS 126P,A00,088883,Wardwell; Mariana Razo,72,0,75,3
1653301253073,VIS 128E,A00,088884,Staff,68,0,75,7
1653301253624,VIS 132,A00,088885,Miller; Nicole L,15,0,15,0
1653301254178,VIS 133,A01,094348,D'Elena-Tweed; Jessica Erin,34,0,34,0
1653301254178,VIS 133,A02,094492,D'Elena-Tweed; Jessica Erin,33,0,34,1
1653301254713,VIS 142,A01,088887,Stalbaum; Brett,14,0,15,1
1653301254713,VIS 142,A02,088888,Stalbaum; Brett,10,0,15,5
1653301254713,VIS 142,A03,088889,Stalbaum; Brett,15,0,15,0
1653301254713,VIS 142,A04,088890,Stalbaum; Brett,8,0,15,7
1653301254713,VIS 142,A05,088891,Stalbaum; Brett,14,0,15,1
1653301254713,VIS 142,A06,094828,Stalbaum; Brett,15,0,15,0
1653301255241,VIS 143,A00,088892,Akten; Mehmet,11,0,22,11
1653301255778,VIS 147A,A01,088894,Stalbaum; Brett,20,0,22,2
1653301255778,VIS 147A,A02,088895,Stalbaum; Brett,17,0,22,5
1653301256325,VIS 149,A00,088896,Akten; Mehmet,11,0,15,4
1653301256853,VIS 150,A00,093893,Tufenkian; Armand Yervant,24,0,30,6
1653301257393,VIS 151A,A00,088897,Williams; Alena J,13,0,15,2
1653301257925,VIS 163,A00,088901,Bratton; Benjamin H.,75,0,75,0
1653301258464,VIS 164,A00,088902,Nakayama; Yue,22,0,22,0
1653301258998,VIS 165A,A00,093892,Cross; Brian R,19,0,22,3
1653301259525,VIS 167,A00,088903,Ortiz-Torres; Ruben,19,0,22,3
1653301260067,VIS 174,A00,088905,Staff,21,0,22,1
1653301260067,VIS 174,B00,088906,Kauffmann; Casey,22,0,22,0
1653301260615,VIS 175,A00,093891,Staff,18,0,22,4
1653301261144,VIS 177,A00,088907,Segade; Alexandro Abraham,20,0,22,2
1653301261680,VIS 178,A00,093890,Staff,17,0,22,5
1653301262212,VIS 179,A00,093889,Kauffmann; Casey,21,0,22,1
1653301262754,VIS 180A,A00,093888,Nakayama; Yue,16,0,22,6
1653301263292,VIS 180B,A00,088908,Miller; Nicole L,21,0,22,1
1653301263831,VIS 183A,A00,088909,Sepuya; Paul Mpagi,20,0,22,2
1653301264369,WCWP 10A,001,086588,Gagnon; Jeffrey C,15,0,15,0
1653301264369,WCWP 10A,002,086589,Gagnon; Jeffrey C,14,0,15,1
1653301264369,WCWP 10A,003,086590,Gagnon; Jeffrey C,15,0,15,0
1653301264369,WCWP 10A,004,086591,Gagnon; Jeffrey C,15,0,15,0
1653301264369,WCWP 10A,005,086592,Gagnon; Jeffrey C,15,0,15,0
1653301264369,WCWP 10A,006,086593,Gagnon; Jeffrey C,15,0,15,0
1653301264369,WCWP 10A,007,086594,Gagnon; Jeffrey C,15,0,15,0
1653301264369,WCWP 10A,008,086595,Gagnon; Jeffrey C,15,0,15,0
1653301264369,WCWP 10A,009,086596,Gagnon; Jeffrey C,15,0,15,0
1653301264369,WCWP 10A,010,086597,Gagnon; Jeffrey C,15,0,15,0
1653301264369,WCWP 10A,011,086598,Gagnon; Jeffrey C,20,0,20,0
1653301264369,WCWP 10A,012,086599,Gagnon; Jeffrey C,20,0,20,0
1653301264369,WCWP 10A,013,086600,Gagnon; Jeffrey C,20,0,20,0
1653301264369,WCWP 10A,014,086601,Gagnon; Jeffrey C,20,0,20,0
1653301264369,WCWP 10A,015,086602,Gagnon; Jeffrey C,20,0,20,0
1653301264369,WCWP 10A,016,086603,Gagnon; Jeffrey C,20,0,20,0
1653301264369,WCWP 10A,017,086604,Gagnon; Jeffrey C,20,0,20,0
1653301264369,WCWP 10A,018,086605,Gagnon; Jeffrey C,19,0,20,1
1653301264369,WCWP 10A,019,086606,Gagnon; Jeffrey C,19,0,20,1
1653301264369,WCWP 10A,020,086607,Gagnon; Jeffrey C,20,0,20,0
1653301264369,WCWP 10A,021,086608,Gagnon; Jeffrey C,20,0,20,0
1653301264369,WCWP 10A,022,086609,Gagnon; Jeffrey C,20,0,20,0
1653301264369,WCWP 10A,023,086610,Gagnon; Jeffrey C,19,0,20,1
1653301264369,WCWP 10A,024,086611,Gagnon; Jeffrey C,20,0,20,0
1653301264369,WCWP 10A,025,086612,Gagnon; Jeffrey C,0,0,0,0
1653301264369,WCWP 10A,026,086613,Gagnon; Jeffrey C,0,0,0,0
1653301264369,WCWP 10A,027,086614,Gagnon; Jeffrey C,0,0,0,0
1653301264369,WCWP 10A,028,086615,Gagnon; Jeffrey C,0,0,0,0
1653301264369,WCWP 10A,029,086616,Gagnon; Jeffrey C,0,0,0,0
1653301264369,WCWP 10A,030,086617,Gagnon; Jeffrey C,15,0,15,0
1653301264369,WCWP 10A,031,086618,Gagnon; Jeffrey C,15,0,15,0
1653301264369,WCWP 10A,032,093687,Gagnon; Jeffrey C,15,0,15,0
1653301264369,WCWP 10A,033,093688,Gagnon; Jeffrey C,15,0,15,0
1653301264369,WCWP 10A,034,093689,Gagnon; Jeffrey C,0,0,0,0
1653301264369,WCWP 10A,035,093690,Gagnon; Jeffrey C,0,0,0,0
1653301264919,WCWP 10B,003,086621,Gagnon; Jeffrey C,0,0,0,0
1653301264919,WCWP 10B,004,086622,Gagnon; Jeffrey C,16,0,20,4
1653301264919,WCWP 10B,005,086623,Gagnon; Jeffrey C,18,0,20,2
1653301264919,WCWP 10B,006,086624,Gagnon; Jeffrey C,20,0,20,0
1653301264919,WCWP 10B,007,086625,Gagnon; Jeffrey C,0,0,0,0
1653301265470,WCWP 100,A00,086626,McCleary; Keith Long,20,0,20,0
1653301265470,WCWP 100,B00,086627,McCleary; Keith Long,20,0,20,0
1653301265470,WCWP 100,C00,086628,McCleary; Keith Long,18,0,20,2
1653301265470,WCWP 100,D00,086629,Twohig; Niall Ivan,17,0,20,3
1653301265470,WCWP 100,E00,086630,Twohig; Niall Ivan,17,0,20,3
1653301265470,WCWP 100,F00,086631,Twohig; Niall Ivan,18,0,20,2
1653301265470,WCWP 100,G00,086632,Young; Mark T,20,0,20,0
1653301265470,WCWP 100,H00,086633,Young; Mark T,20,0,20,0
1653301324288,AAS 10,A01,085689,Butler; Elizabeth Annette,28,0,34,6
1653301324288,AAS 10,A02,085690,Butler; Elizabeth Annette,34,0,34,0
1653301324814,AAS 170,A00,085691,Butler; Elizabeth Annette,30,0,32,2
1653301325341,AIP 197,001,085683,Staff,100,0,100,0
1653301325341,AIP 197,002,085684,Rao; Ramesh R,50,0,50,0
1653301325865,AIP 197DC,001,085696,Anderson; Patrick W.,27,0,27,0
1653301326387,AIP 197T,A00,085685,Anderson; Patrick W.,15,0,15,0
1653301326913,ANAR 100,A00,094326,Fortier; Jana,22,0,25,3
1653301327447,ANAR 104,A01,085846,Staff,13,0,15,2
1653301327991,ANAR 120,A00,085847,Staff,15,0,15,0
1653301328541,ANAR 143,A00,094288,Staff,31,0,32,1
1653301329082,ANBI 100,A00,085849,Marchetto; Maria Carolina,31,0,34,3
1653301329607,ANBI 112,A00,085850,Marchetto; Maria Carolina,21,0,28,7
1653301330158,ANBI 118,A00,085851,Fox; Patrick Keolu Ozer,32,0,32,0
1653301330717,ANBI 136,A00,085852,Semendeferi; Ekaterini,20,0,22,2
1653301331253,ANBI 141,A00,085854,Gagneux; Pascal,186,0,192,6
1653301331779,ANBI 145,A00,085855,Staff,30,0,32,2
1653301332312,ANBI 175,A00,085857,Staff,30,0,32,2
1653301332855,ANSC 104,A00,094290,Yeh; Rihan Wen Xin,40,0,46,6
1653301333379,ANSC 105,A00,085859,Olivas Hernandez; Olga Lid,36,0,37,1
1653301333904,ANSC 120,A00,085860,Jassal; Aftab,51,0,56,5
1653301334436,ANSC 121,A00,085861,Staff,29,0,32,3
1653301335522,ANSC 148,A00,085866,Staff,71,0,73,2
1653301336056,ANSC 169,A00,085869,Fortier; Jana,23,0,25,2
1653301336586,ANSC 175,A00,085871,Pedersen; David,28,0,32,4
1653301337127,ANTH 1,A00,085803,Varma; Saiba,146,0,146,0
1653301337664,ANTH 2,A01,085805,Staff,43,0,44,1
1653301337664,ANTH 2,A02,085806,Staff,42,0,44,2
1653301337664,ANTH 2,A03,085807,Staff,44,0,44,0
1653301337664,ANTH 2,A04,085808,Staff,44,0,44,0
1653301337664,ANTH 2,A05,085809,Staff,40,0,40,0
1653301338214,ANTH 4,A01,085811,Yeh; Rihan Wen Xin,32,0,32,0
1653301338214,ANTH 4,A02,095113,Yeh; Rihan Wen Xin,32,0,32,0
1653301338214,ANTH 4,A03,095114,Yeh; Rihan Wen Xin,32,0,32,0
1653301338214,ANTH 4,A04,095115,Yeh; Rihan Wen Xin,34,0,34,0
1653301338770,ANTH 10,A00,085814,Stewart; Alexander B,215,0,216,1
1653301339305,ANTH 21,A01,085816,Kang; Byung Chu,35,0,35,0
1653301339305,ANTH 21,A02,085817,Kang; Byung Chu,35,0,35,0
1653301339305,ANTH 21,A03,085818,Kang; Byung Chu,35,0,35,0
1653301339305,ANTH 21,A04,085819,Kang; Byung Chu,35,0,35,0
1653301339305,ANTH 21,A05,085820,Kang; Byung Chu,33,0,35,2
1653301339305,ANTH 21,A06,085821,Kang; Byung Chu,33,0,35,2
1653301339305,ANTH 21,A07,085822,Kang; Byung Chu,35,0,35,0
1653301339305,ANTH 21,A08,085823,Kang; Byung Chu,35,0,35,0
1653301339305,ANTH 21,A09,085824,Kang; Byung Chu,0,0,0,0
1653301339305,ANTH 21,A10,085825,Kang; Byung Chu,0,0,0,0
1653301339305,ANTH 21,A11,095111,Kang; Byung Chu,30,0,30,0
1653301339305,ANTH 21,A12,095112,Kang; Byung Chu,30,0,30,0
1653301339305,ANTH 21,B01,085827,Staff,36,0,36,0
1653301339305,ANTH 21,B02,085828,Staff,36,0,36,0
1653301339305,ANTH 21,B03,085829,Staff,36,0,36,0
1653301339305,ANTH 21,B04,085830,Staff,38,0,38,0
1653301339830,ANTH 23,A01,085832,Stewart; Alexander B,31,0,31,0
1653301339830,ANTH 23,A02,085833,Stewart; Alexander B,31,0,31,0
1653301339830,ANTH 23,A03,085834,Stewart; Alexander B,31,0,31,0
1653301339830,ANTH 23,A04,085835,Stewart; Alexander B,31,0,31,0
1653301339830,ANTH 23,A05,085836,Stewart; Alexander B,31,0,31,0
1653301339830,ANTH 23,A06,085837,Stewart; Alexander B,0,0,0,0
1653301339830,ANTH 23,A07,085838,Stewart; Alexander B,0,0,0,0
1653301340359,ANTH 87,A00,085842,Staff,20,0,20,0
1653301340359,ANTH 87,B00,085843,Staff,20,0,20,0
1653301340900,ANTH 101,A01,085873,Goldstein; Paul S,33,0,36,3
1653301340900,ANTH 101,A02,085874,Goldstein; Paul S,33,0,36,3
1653301340900,ANTH 101,A03,085875,Goldstein; Paul S,36,0,36,0
1653301340900,ANTH 101,A04,085876,Goldstein; Paul S,36,0,38,2
1653301341428,ANTH 105,A00,085877,Staff,39,0,40,1
1653301341967,ANTH 108,A00,085878,Staff,31,0,32,1
1653301342498,ANTH 192,A00,094234,Kaiser; Bronwyn Nicole & Non; Amy L,20,0,20,0
1653301343024,ANTH 196A,A00,085879,Varma; Saiba,20,0,20,0
1653301343575,AWP 3,001,085697,Staff,13,0,13,0
1653301343575,AWP 3,002,085698,Staff,13,0,13,0
1653301343575,AWP 3,003,085699,Staff,13,0,13,0
1653301343575,AWP 3,004,085700,Staff,0,0,0,0
1653301343575,AWP 3,005,085701,Staff,0,0,0,0
1653301343575,AWP 3,006,085703,Staff,0,0,0,0
1653301343575,AWP 3,007,085704,Staff,13,0,13,0
1653301343575,AWP 3,008,085707,Staff,0,0,0,0
1653301343575,AWP 3,009,085709,Staff,13,0,13,0
1653301343575,AWP 3,010,085710,Staff,13,0,13,0
1653301343575,AWP 3,011,085711,Staff,0,0,0,0
1653301343575,AWP 3,012,085712,Staff,0,0,0,0
1653301343575,AWP 3,013,085713,Staff,13,0,13,0
1653301343575,AWP 3,014,085715,Staff,13,0,13,0
1653301343575,AWP 3,015,085717,Staff,13,0,13,0
1653301343575,AWP 3,016,085719,Staff,13,0,13,0
1653301343575,AWP 3,017,085720,Staff,13,0,13,0
1653301343575,AWP 3,018,085721,Staff,13,0,13,0
1653301343575,AWP 3,019,085722,Staff,13,0,13,0
1653301343575,AWP 3,020,085723,Staff,13,0,13,0
1653301343575,AWP 3,021,085724,Staff,13,0,13,0
1653301343575,AWP 3,022,085725,Staff,13,0,13,0
1653301343575,AWP 3,023,085726,Staff,13,0,13,0
1653301343575,AWP 3,024,085727,Staff,13,0,13,0
1653301343575,AWP 3,025,085728,Staff,13,0,13,0
1653301343575,AWP 3,026,085729,Staff,13,0,13,0
1653301343575,AWP 3,027,085730,Staff,13,0,13,0
1653301343575,AWP 3,028,085731,Staff,13,0,13,0
1653301343575,AWP 3,029,085732,Staff,13,0,13,0
1653301343575,AWP 3,030,085733,Staff,13,0,13,0
1653301343575,AWP 3,031,085734,Staff,13,0,13,0
1653301343575,AWP 3,032,085735,Staff,13,0,13,0
1653301343575,AWP 3,033,085736,Staff,13,0,13,0
1653301343575,AWP 3,034,085737,Staff,13,0,13,0
1653301343575,AWP 3,035,085738,Staff,13,0,13,0
1653301343575,AWP 3,036,085739,Staff,13,0,13,0
1653301343575,AWP 3,037,085740,Staff,13,0,13,0
1653301343575,AWP 3,038,085741,Staff,13,0,13,0
1653301343575,AWP 3,039,085742,Staff,13,0,13,0
1653301343575,AWP 3,040,085743,Staff,13,0,13,0
1653301343575,AWP 3,041,085744,Staff,13,0,13,0
1653301343575,AWP 3,042,085745,Staff,13,0,13,0
1653301343575,AWP 3,043,085746,Staff,13,0,13,0
1653301343575,AWP 3,044,085747,Staff,13,0,13,0
1653301343575,AWP 3,045,085748,Staff,13,0,13,0
1653301343575,AWP 3,046,085749,Staff,13,0,13,0
1653301343575,AWP 3,047,085750,Staff,13,0,13,0
1653301343575,AWP 3,048,085751,Staff,13,0,13,0
1653301343575,AWP 3,049,085752,Staff,13,0,13,0
1653301343575,AWP 3,050,085753,Staff,13,0,13,0
1653301343575,AWP 3,051,085754,Staff,13,0,13,0
1653301343575,AWP 3,052,085755,Staff,0,0,0,0
1653301343575,AWP 3,053,085756,Staff,13,0,13,0
1653301343575,AWP 3,054,085757,Staff,0,0,0,0
1653301343575,AWP 3,055,085758,Staff,13,0,13,0
1653301343575,AWP 3,056,085759,Staff,13,0,13,0
1653301343575,AWP 3,057,085760,Staff,13,0,13,0
1653301343575,AWP 3,058,085761,Staff,13,0,13,0
1653301343575,AWP 3,059,085762,Staff,13,0,13,0
1653301343575,AWP 3,060,085763,Staff,13,0,13,0
1653301343575,AWP 3,061,085764,Staff,13,0,13,0
1653301343575,AWP 3,062,085765,Staff,13,0,13,0
1653301343575,AWP 3,063,085766,Staff,13,0,13,0
1653301343575,AWP 3,064,085767,Staff,13,0,13,0
1653301343575,AWP 3,065,085768,Staff,13,0,13,0
1653301343575,AWP 3,066,085769,Staff,0,0,0,0
1653301344106,AWP 4A,001,085770,Staff,0,0,0,0
1653301344106,AWP 4A,002,085771,Staff,13,0,13,0
1653301344106,AWP 4A,003,085772,Staff,13,0,13,0
1653301344106,AWP 4A,004,085773,Staff,13,0,13,0
1653301344106,AWP 4A,005,085774,Staff,0,0,0,0
1653301344106,AWP 4A,006,085775,Staff,13,0,13,0
1653301344106,AWP 4A,007,085776,Staff,0,0,0,0
1653301344106,AWP 4A,008,085777,Staff,0,0,0,0
1653301344106,AWP 4A,009,085778,Staff,0,0,0,0
1653301344106,AWP 4A,010,085779,Staff,13,0,13,0
1653301344106,AWP 4A,011,085780,Staff,13,0,13,0
1653301344106,AWP 4A,012,085781,Staff,0,0,0,0
1653301344106,AWP 4A,013,085782,Staff,13,0,13,0
1653301344106,AWP 4A,014,085783,Staff,13,0,13,0
1653301344106,AWP 4A,015,085784,Staff,13,0,13,0
1653301344106,AWP 4A,016,085785,Staff,13,0,13,0
1653301344106,AWP 4A,017,085786,Staff,13,0,13,0
1653301344106,AWP 4A,018,085787,Staff,0,0,0,0
1653301344106,AWP 4A,019,085788,Staff,13,0,13,0
1653301344106,AWP 4A,020,085789,Staff,13,0,13,0
1653301344106,AWP 4A,021,085790,Staff,0,0,0,0
1653301344106,AWP 4A,022,085791,Staff,13,0,13,0
1653301344106,AWP 4A,023,085792,Staff,0,0,0,0
1653301344106,AWP 4A,024,085793,Staff,0,0,0,0
1653301344106,AWP 4A,025,085794,Staff,13,0,13,0
1653301344106,AWP 4A,026,085795,Staff,13,0,13,0
1653301344106,AWP 4A,027,085796,Staff,13,0,13,0
1653301344106,AWP 4A,028,085797,Staff,13,0,13,0
1653301344106,AWP 4A,029,085798,Staff,0,0,0,0
1653301344106,AWP 4A,030,085799,Staff,0,0,0,0
1653301344106,AWP 4A,031,093835,Staff,0,0,0,0
1653301344649,AWP 4B,001,085800,Staff,0,0,0,0
1653301344649,AWP 4B,002,085801,Staff,0,0,0,0
1653301345172,BENG 2,A00,085936,Wheeler; Bruce Christopher,28,0,30,2
1653301345711,BENG 110,A01,085939,Mc Culloch; Andrew Douglas,20,0,30,10
1653301345711,BENG 110,A02,085940,Mc Culloch; Andrew Douglas,18,0,30,12
1653301345711,BENG 110,A03,085941,Mc Culloch; Andrew Douglas,27,0,30,3
1653301346257,BENG 119A,A01,085943,Wheeler; Bruce Christopher,29,0,30,1
1653301346907,BENG 122A,A01,085945,Cauwenberghs; Gert,18,0,25,7
1653301346907,BENG 122A,A02,085946,Cauwenberghs; Gert,22,0,25,3
1653301346907,BENG 122A,A03,085947,Cauwenberghs; Gert,22,0,25,3
1653301347441,BENG 126A,A01,085949,Wheeler; Bruce Christopher,30,0,30,0
1653301347980,BENG 127A,A01,085951,Wheeler; Bruce Christopher,28,0,30,2
1653301348518,BENG 128A,A01,085953,Wheeler; Bruce Christopher,29,0,30,1
1653301349046,BENG 134,A01,085955,Smarr; Benjamin,0,0,0,0
1653301349591,BENG 135,A00,085956,Wheeler; Bruce Christopher,23,0,30,7
1653301350139,BENG 141,A00,085958,Lal; Ratnesh,20,0,30,10
1653301350680,BENG 147A,A01,085963,Wheeler; Bruce Christopher,30,0,30,0
1653301351230,BENG 148A,A01,085967,Wheeler; Bruce Christopher,30,0,30,0
1653301351766,BENG 149A,A01,085969,Wheeler; Bruce Christopher,30,0,30,0
1653301352304,BENG 161A,A01,085971,Fraley; Stephanie I.,20,0,25,5
1653301352304,BENG 161A,A02,085972,Fraley; Stephanie I.,13,0,25,12
1653301352304,BENG 161A,A03,085973,Fraley; Stephanie I.,9,0,25,16
1653301352857,BENG 162,A01,085975,Mali; Prashant Gulab Ram,0,0,35,35
1653301352857,BENG 162,A02,085976,Mali; Prashant Gulab Ram,26,0,35,9
1653301353381,BENG 166A,A00,085977,Sah; Robert Lie-Yuan,0,0,0,0
1653301353929,BENG 169A,A01,085982,Wheeler; Bruce Christopher,28,0,30,2
1653301354469,BENG 179A,A01,085984,Wheeler; Bruce Christopher,30,0,30,0
1653301354997,BENG 183,A01,085986,Zhong; Sheng,13,0,30,17
1653301354997,BENG 183,A02,085987,Zhong; Sheng,15,0,30,15
1653301354997,BENG 183,A03,085988,Zhong; Sheng,20,0,30,10
1653301355542,BENG 187B,A00,085989,Wheeler; Bruce Christopher,105,0,170,65
1653301356078,BENG 196,001,094047,Engler; Adam J.,9999,0,9999,0
1653301356601,BIBC 100,A01,092918,Huffaker; Alisa,0,0,19,19
1653301356601,BIBC 100,A02,092919,Huffaker; Alisa,19,0,19,0
1653301356601,BIBC 100,A03,092920,Huffaker; Alisa,18,0,19,1
1653301356601,BIBC 100,A04,092921,Huffaker; Alisa,18,0,19,1
1653301356601,BIBC 100,A05,092922,Huffaker; Alisa,19,0,19,0
1653301356601,BIBC 100,A06,092923,Huffaker; Alisa,18,0,19,1
1653301356601,BIBC 100,A07,092924,Huffaker; Alisa,10,0,19,9
1653301356601,BIBC 100,A08,092925,Huffaker; Alisa,17,0,19,2
1653301356601,BIBC 100,A09,092926,Huffaker; Alisa,19,0,19,0
1653301356601,BIBC 100,A10,092927,Huffaker; Alisa,11,0,19,8
1653301357129,BIBC 102,A01,092997,Schmelz; Eric Alexander,16,0,19,3
1653301357129,BIBC 102,A02,092998,Schmelz; Eric Alexander,5,0,19,14
1653301357129,BIBC 102,A03,092999,Schmelz; Eric Alexander,1,0,19,18
1653301357129,BIBC 102,A04,093000,Schmelz; Eric Alexander,17,0,19,2
1653301357129,BIBC 102,A05,093001,Schmelz; Eric Alexander,9,0,19,10
1653301357129,BIBC 102,A06,093002,Schmelz; Eric Alexander,16,0,19,3
1653301357129,BIBC 102,A07,093003,Schmelz; Eric Alexander,19,0,19,0
1653301357129,BIBC 102,A08,093004,Schmelz; Eric Alexander,19,0,19,0
1653301357129,BIBC 102,A09,093005,Schmelz; Eric Alexander,14,0,19,5
1653301357129,BIBC 102,B01,093064,Coleman; Aaron B.,19,0,19,0
1653301357129,BIBC 102,B02,093065,Coleman; Aaron B.,17,0,19,2
1653301357129,BIBC 102,B03,093066,Coleman; Aaron B.,16,0,19,3
1653301357129,BIBC 102,B04,093067,Coleman; Aaron B.,11,0,19,8
1653301357129,BIBC 102,B05,093068,Coleman; Aaron B.,18,0,19,1
1653301357129,BIBC 102,B06,093069,Coleman; Aaron B.,16,0,19,3
1653301357129,BIBC 102,B07,093070,Coleman; Aaron B.,19,0,19,0
1653301357129,BIBC 102,B08,093071,Coleman; Aaron B.,15,0,19,4
1653301357129,BIBC 102,B09,093072,Coleman; Aaron B.,17,0,19,2
1653301357676,BIBC 103,A01,089887,Bozinovic; Goran,19,0,24,5
1653301357676,BIBC 103,A02,089888,Bozinovic; Goran,23,0,24,1
1653301357676,BIBC 103,B01,089890,Burg; Michael,1,0,24,23
1653301357676,BIBC 103,B02,089891,Burg; Michael,20,0,24,4
1653301357676,BIBC 103,C01,089893,Beyhan; Sinem,14,0,24,10
1653301357676,BIBC 103,C02,089894,Beyhan; Sinem,22,0,24,2
1653301357676,BIBC 103,D01,089896,Coleman; Aaron B.,10,0,24,14
1653301357676,BIBC 103,D02,089897,Coleman; Aaron B.,22,0,24,2
1653301358223,BIBC 194,A00,089898,Hui; Enfu,16,0,27,11
1653301358790,BICD 100,A01,092396,Smith; Laurie,21,0,22,1
1653301358790,BICD 100,A02,092397,Smith; Laurie,22,0,22,0
1653301358790,BICD 100,A03,092398,Smith; Laurie,21,0,22,1
1653301358790,BICD 100,A04,092399,Smith; Laurie,22,0,22,0
1653301358790,BICD 100,A05,092400,Smith; Laurie,21,0,22,1
1653301358790,BICD 100,A06,092401,Smith; Laurie,22,0,22,0
1653301358790,BICD 100,A07,092402,Smith; Laurie,22,0,22,0
1653301358790,BICD 100,A08,092403,Smith; Laurie,22,0,22,0
1653301358790,BICD 100,B01,093073,Mueller; Liam O'Connor,21,0,22,1
1653301358790,BICD 100,B02,093074,Mueller; Liam O'Connor,22,0,22,0
1653301358790,BICD 100,B03,093075,Mueller; Liam O'Connor,22,0,22,0
1653301358790,BICD 100,B04,093076,Mueller; Liam O'Connor,22,0,22,0
1653301358790,BICD 100,B05,093077,Mueller; Liam O'Connor,22,0,22,0
1653301358790,BICD 100,B06,093078,Mueller; Liam O'Connor,22,0,22,0
1653301358790,BICD 100,B07,093079,Mueller; Liam O'Connor,21,0,22,1
1653301358790,BICD 100,B08,093080,Mueller; Liam O'Connor,22,0,22,0
1653301358790,BICD 100,C01,093021,McDonnell; Lisa Marie,21,0,22,1
1653301358790,BICD 100,C02,093022,McDonnell; Lisa Marie,20,0,22,2
1653301358790,BICD 100,C03,093023,McDonnell; Lisa Marie,22,0,22,0
1653301358790,BICD 100,C04,093024,McDonnell; Lisa Marie,22,0,22,0
1653301358790,BICD 100,C05,093025,McDonnell; Lisa Marie,22,0,22,0
1653301358790,BICD 100,C06,093026,McDonnell; Lisa Marie,22,0,22,0
1653301358790,BICD 100,C07,093027,McDonnell; Lisa Marie,20,0,22,2
1653301358790,BICD 100,C08,093028,McDonnell; Lisa Marie,22,0,22,0
1653301358790,BICD 100,D01,093081,Day; Christopher D,22,0,22,0
1653301358790,BICD 100,D02,093082,Day; Christopher D,17,0,22,5
1653301358790,BICD 100,D03,093083,Day; Christopher D,21,0,22,1
1653301358790,BICD 100,D04,093084,Day; Christopher D,19,0,22,3
1653301358790,BICD 100,D05,093085,Day; Christopher D,22,0,22,0
1653301358790,BICD 100,D06,093086,Day; Christopher D,20,0,22,2
1653301358790,BICD 100,D07,093087,Day; Christopher D,19,0,22,3
1653301358790,BICD 100,D08,093088,Day; Christopher D,20,0,22,2
1653301359339,BICD 110,A01,093089,Kiger; Amy,29,0,32,3
1653301359339,BICD 110,A02,093091,Kiger; Amy,32,0,32,0
1653301359339,BICD 110,A03,093092,Kiger; Amy,31,0,32,1
1653301359339,BICD 110,A04,093093,Kiger; Amy,31,0,32,1
1653301359339,BICD 110,A05,093094,Kiger; Amy,26,0,32,6
1653301359339,BICD 110,A06,093095,Kiger; Amy,31,0,32,1
1653301359339,BICD 110,A07,093096,Kiger; Amy,31,0,32,1
1653301359339,BICD 110,B01,093029,Grossman; Emily N,21,0,32,11
1653301359339,BICD 110,B02,093030,Grossman; Emily N,28,0,32,4
1653301359339,BICD 110,B03,093031,Grossman; Emily N,32,0,32,0
1653301359339,BICD 110,B04,093032,Grossman; Emily N,28,0,32,4
1653301359339,BICD 110,B05,093033,Grossman; Emily N,26,0,32,6
1653301359339,BICD 110,B06,093034,Grossman; Emily N,19,0,32,13
1653301359339,BICD 110,B07,093035,Grossman; Emily N,20,0,32,12
1653301359887,BICD 140,A01,093097,Zuniga; Elina I,19,0,32,13
1653301359887,BICD 140,A02,093098,Zuniga; Elina I,17,0,32,15
1653301359887,BICD 140,A03,093099,Zuniga; Elina I,30,0,32,2
1653301359887,BICD 140,A04,093100,Zuniga; Elina I,32,0,32,0
1653301359887,BICD 140,A05,093101,Zuniga; Elina I,29,0,32,3
1653301359887,BICD 140,A06,093102,Zuniga; Elina I,27,0,32,5
1653301360418,BIEB 102,A01,092528,Butler; Shannon Rhey,22,0,27,5
1653301360418,BIEB 102,A02,092529,Butler; Shannon Rhey,17,0,27,10
1653301360418,BIEB 102,A03,092530,Butler; Shannon Rhey,24,0,27,3
1653301360418,BIEB 102,A04,092531,Butler; Shannon Rhey,26,0,27,1
1653301360418,BIEB 102,A05,092532,Butler; Shannon Rhey,25,0,27,2
1653301360418,BIEB 102,A06,092533,Butler; Shannon Rhey,24,0,27,3
1653301360418,BIEB 102,A07,092534,Butler; Shannon Rhey,23,0,27,4
1653301360968,BIEB 121,A00,089907,Holway; David A.,0,0,32,32
1653301361499,BIEB 126,A01,092974,Kohn; Joshua R,24,0,27,3
1653301361499,BIEB 126,A02,092975,Kohn; Joshua R,26,0,27,1
1653301361499,BIEB 126,A03,092976,Kohn; Joshua R,23,0,27,4
1653301361499,BIEB 126,A04,092977,Kohn; Joshua R,25,0,27,2
1653301361499,BIEB 126,A05,092978,Kohn; Joshua R,27,0,27,0
1653301362040,BIEB 146,A01,093054,Petrie; Katherine Lynn,1,0,27,26
1653301362040,BIEB 146,A02,093055,Petrie; Katherine Lynn,4,0,27,23
1653301362040,BIEB 146,A03,093056,Petrie; Katherine Lynn,0,0,27,27
1653301362040,BIEB 146,A04,093057,Petrie; Katherine Lynn,0,0,27,27
1653301362040,BIEB 146,A05,093058,Petrie; Katherine Lynn,20,0,27,7
1653301362040,BIEB 146,A06,093059,Petrie; Katherine Lynn,26,0,27,1
1653301362040,BIEB 146,A07,093060,Petrie; Katherine Lynn,16,0,27,11
1653301362040,BIEB 146,A08,093061,Petrie; Katherine Lynn,25,0,27,2
1653301362040,BIEB 146,A09,093062,Petrie; Katherine Lynn,17,0,27,10
1653301362580,BIEB 150,A01,093103,Rennison; Diana,16,0,27,11
1653301362580,BIEB 150,A02,093104,Rennison; Diana,21,0,27,6
1653301362580,BIEB 150,A03,093105,Rennison; Diana,26,0,27,1
1653301362580,BIEB 150,A04,093106,Rennison; Diana,24,0,27,3
1653301362580,BIEB 150,A05,093107,Rennison; Diana,25,0,27,2
1653301362580,BIEB 150,A06,093108,Rennison; Diana,27,0,27,0
1653301363108,BIEB 158,A01,094057,Reese; Aspen Taylor & Jackrel; Sara,31,0,32,1
1653301363108,BIEB 158,A02,094058,Reese; Aspen Taylor & Jackrel; Sara,28,0,32,4
1653301363108,BIEB 158,A03,094059,Reese; Aspen Taylor & Jackrel; Sara,31,0,32,1
1653301363108,BIEB 158,A04,094060,Reese; Aspen Taylor & Jackrel; Sara,32,0,32,0
1653301363636,BIEB 174,A01,092465,Cleland; Elsa Eleanor & Barton; Andrew David,27,0,27,0
1653301363636,BIEB 174,A02,092466,Cleland; Elsa Eleanor & Barton; Andrew David,27,0,27,0
1653301363636,BIEB 174,A03,092467,Cleland; Elsa Eleanor & Barton; Andrew David,23,0,27,4
1653301363636,BIEB 174,A04,092468,Cleland; Elsa Eleanor & Barton; Andrew David,20,0,27,7
1653301363636,BIEB 174,A05,092469,Cleland; Elsa Eleanor & Barton; Andrew David,25,0,27,2
1653301363636,BIEB 174,A06,092470,Cleland; Elsa Eleanor & Barton; Andrew David,27,0,27,0
1653301363636,BIEB 174,A07,092471,Cleland; Elsa Eleanor & Barton; Andrew David,25,0,27,2
1653301364162,BILD 1,A01,092884,Pickett; Brooke Elizabeth,16,0,19,3
1653301364162,BILD 1,A02,092885,Pickett; Brooke Elizabeth,19,0,19,0
1653301364162,BILD 1,A03,092886,Pickett; Brooke Elizabeth,19,0,19,0
1653301364162,BILD 1,A04,092887,Pickett; Brooke Elizabeth,18,0,19,1
1653301364162,BILD 1,A05,092888,Pickett; Brooke Elizabeth,19,0,19,0
1653301364162,BILD 1,A06,092889,Pickett; Brooke Elizabeth,19,0,19,0
1653301364162,BILD 1,A07,092890,Pickett; Brooke Elizabeth,17,0,19,2
1653301364162,BILD 1,B01,092891,Pekkurnaz Banghart; Gulcin,19,0,19,0
1653301364162,BILD 1,B02,092892,Pekkurnaz Banghart; Gulcin,16,0,19,3
1653301364162,BILD 1,B03,092893,Pekkurnaz Banghart; Gulcin,19,0,19,0
1653301364162,BILD 1,B04,092894,Pekkurnaz Banghart; Gulcin,19,0,19,0
1653301364162,BILD 1,B05,092895,Pekkurnaz Banghart; Gulcin,17,0,19,2
1653301364162,BILD 1,B06,092896,Pekkurnaz Banghart; Gulcin,19,0,19,0
1653301364162,BILD 1,B07,092897,Pekkurnaz Banghart; Gulcin,19,0,19,0
1653301364162,BILD 1,C01,092421,Meaders; Clara Leigh,18,0,19,1
1653301364162,BILD 1,C02,092422,Meaders; Clara Leigh,18,0,19,1
1653301364162,BILD 1,C03,092423,Meaders; Clara Leigh,17,0,19,2
1653301364162,BILD 1,C04,092424,Meaders; Clara Leigh,16,0,19,3
1653301364162,BILD 1,C05,092425,Meaders; Clara Leigh,19,0,19,0
1653301364162,BILD 1,C06,092426,Meaders; Clara Leigh,19,0,19,0
1653301364162,BILD 1,C07,092427,Meaders; Clara Leigh,19,0,19,0
1653301364162,BILD 1,D01,092428,Meaders; Clara Leigh,14,0,19,5
1653301364162,BILD 1,D02,092429,Meaders; Clara Leigh,19,0,19,0
1653301364162,BILD 1,D03,092430,Meaders; Clara Leigh,19,0,19,0
1653301364162,BILD 1,D04,092431,Meaders; Clara Leigh,19,0,19,0
1653301364162,BILD 1,D05,092432,Meaders; Clara Leigh,19,0,19,0
1653301364162,BILD 1,D06,092433,Meaders; Clara Leigh,19,0,19,0
1653301364162,BILD 1,D07,092434,Meaders; Clara Leigh,19,0,19,0
1653301364162,BILD 1,E01,092445,Cooper; Andrew Michael,19,0,19,0
1653301364162,BILD 1,E02,092446,Cooper; Andrew Michael,19,0,19,0
1653301364162,BILD 1,E03,092447,Cooper; Andrew Michael,19,0,19,0
1653301364162,BILD 1,E04,092448,Cooper; Andrew Michael,19,0,19,0
1653301364162,BILD 1,E05,092449,Cooper; Andrew Michael,17,0,19,2
1653301364162,BILD 1,E06,092450,Cooper; Andrew Michael,19,0,19,0
1653301364162,BILD 1,E07,092451,Cooper; Andrew Michael,19,0,19,0
1653301364690,BILD 2,A01,092822,Glasgow; Stacey Marie,25,0,25,0
1653301364690,BILD 2,A02,092823,Glasgow; Stacey Marie,24,0,25,1
1653301364690,BILD 2,A03,092824,Glasgow; Stacey Marie,24,0,25,1
1653301364690,BILD 2,A04,092825,Glasgow; Stacey Marie,25,0,25,0
1653301364690,BILD 2,A05,092826,Glasgow; Stacey Marie,25,0,25,0
1653301364690,BILD 2,A06,092827,Glasgow; Stacey Marie,25,0,25,0
1653301364690,BILD 2,A07,092828,Glasgow; Stacey Marie,25,0,25,0
1653301364690,BILD 2,B01,092830,Owens; Melinda Tsao-Ying,25,0,25,0
1653301364690,BILD 2,B02,092831,Owens; Melinda Tsao-Ying,21,0,25,4
1653301364690,BILD 2,B03,092832,Owens; Melinda Tsao-Ying,23,0,25,2
1653301364690,BILD 2,B04,092833,Owens; Melinda Tsao-Ying,25,0,25,0
1653301364690,BILD 2,B05,092834,Owens; Melinda Tsao-Ying,24,0,25,1
1653301364690,BILD 2,B06,092835,Owens; Melinda Tsao-Ying,21,0,25,4
1653301364690,BILD 2,B07,092836,Owens; Melinda Tsao-Ying,25,0,25,0
1653301364690,BILD 2,C01,092668,Owens; Melinda Tsao-Ying,24,0,25,1
1653301364690,BILD 2,C02,092669,Owens; Melinda Tsao-Ying,23,0,25,2
1653301364690,BILD 2,C03,092670,Owens; Melinda Tsao-Ying,22,0,25,3
1653301364690,BILD 2,C04,092671,Owens; Melinda Tsao-Ying,25,0,25,0
1653301364690,BILD 2,C05,092672,Owens; Melinda Tsao-Ying,25,0,25,0
1653301364690,BILD 2,C06,092673,Owens; Melinda Tsao-Ying,24,0,25,1
1653301364690,BILD 2,C07,092674,Owens; Melinda Tsao-Ying,25,0,25,0
1653301365224,BILD 3,A01,092454,Stockwell; Sarah R,17,0,19,2
1653301365224,BILD 3,A02,092455,Stockwell; Sarah R,17,0,19,2
1653301365224,BILD 3,A03,092456,Stockwell; Sarah R,18,0,19,1
1653301365224,BILD 3,A04,092457,Stockwell; Sarah R,19,0,19,0
1653301365224,BILD 3,A05,092458,Stockwell; Sarah R,19,0,19,0
1653301365224,BILD 3,A06,092459,Stockwell; Sarah R,18,0,19,1
1653301365224,BILD 3,A07,092460,Stockwell; Sarah R,18,0,19,1
1653301365224,BILD 3,A08,092461,Stockwell; Sarah R,19,0,19,0
1653301365224,BILD 3,A09,092462,Stockwell; Sarah R,19,0,19,0
1653301365224,BILD 3,B01,092479,Stockwell; Sarah R,19,0,19,0
1653301365224,BILD 3,B02,092480,Stockwell; Sarah R,18,0,19,1
1653301365224,BILD 3,B03,092481,Stockwell; Sarah R,18,0,19,1
1653301365224,BILD 3,B04,092482,Stockwell; Sarah R,19,0,19,0
1653301365224,BILD 3,B05,092483,Stockwell; Sarah R,19,0,19,0
1653301365224,BILD 3,B06,092484,Stockwell; Sarah R,19,0,19,0
1653301365224,BILD 3,B07,092485,Stockwell; Sarah R,19,0,19,0
1653301365224,BILD 3,B08,092486,Stockwell; Sarah R,18,0,19,1
1653301365224,BILD 3,B09,092487,Stockwell; Sarah R,18,0,19,1
1653301365224,BILD 3,C01,092412,Butler; Shannon Rhey,18,0,19,1
1653301365224,BILD 3,C02,092413,Butler; Shannon Rhey,15,0,19,4
1653301365224,BILD 3,C03,092414,Butler; Shannon Rhey,19,0,19,0
1653301365224,BILD 3,C04,092415,Butler; Shannon Rhey,19,0,19,0
1653301365224,BILD 3,C05,092416,Butler; Shannon Rhey,19,0,19,0
1653301365224,BILD 3,C06,092417,Butler; Shannon Rhey,19,0,19,0
1653301365224,BILD 3,C07,092418,Butler; Shannon Rhey,19,0,19,0
1653301365224,BILD 3,C08,092419,Butler; Shannon Rhey,19,0,19,0
1653301365224,BILD 3,C09,092420,Butler; Shannon Rhey,19,0,19,0
1653301365224,BILD 3,D01,092898,Reuther; Keefe,18,0,19,1
1653301365224,BILD 3,D02,092899,Reuther; Keefe,19,0,19,0
1653301365224,BILD 3,D03,092900,Reuther; Keefe,19,0,19,0
1653301365224,BILD 3,D04,092901,Reuther; Keefe,19,0,19,0
1653301365224,BILD 3,D05,092902,Reuther; Keefe,19,0,19,0
1653301365224,BILD 3,D06,092903,Reuther; Keefe,19,0,19,0
1653301365224,BILD 3,D07,092904,Reuther; Keefe,18,0,19,1
1653301365224,BILD 3,D08,092905,Reuther; Keefe,19,0,19,0
1653301365224,BILD 3,D09,092906,Reuther; Keefe,19,0,19,0
1653301365748,BILD 4,A01,089840,Mel; Stephanie,0,0,0,0
1653301365748,BILD 4,A02,089841,Mel; Stephanie,0,0,0,0
1653301365748,BILD 4,A03,089842,Mel; Stephanie,0,0,0,0
1653301365748,BILD 4,A04,089843,Mel; Stephanie,0,0,0,0
1653301365748,BILD 4,A05,089844,Mel; Stephanie,0,0,0,0
1653301365748,BILD 4,A06,089845,Mel; Stephanie,0,0,0,0
1653301365748,BILD 4,A07,089846,Mel; Stephanie,0,0,0,0
1653301365748,BILD 4,A08,089847,Mel; Stephanie,0,0,0,0
1653301365748,BILD 4,A09,089848,Mel; Stephanie,0,0,0,0
1653301365748,BILD 4,A10,089849,Mel; Stephanie,0,0,0,0
1653301365748,BILD 4,A11,089850,Mel; Stephanie,0,0,0,0
1653301365748,BILD 4,A12,089851,Mel; Stephanie,0,0,0,0
1653301365748,BILD 4,A13,089852,Mel; Stephanie,0,0,0,0
1653301365748,BILD 4,A14,089853,Mel; Stephanie,0,0,0,0
1653301365748,BILD 4,A15,089854,Mel; Stephanie,0,0,0,0
1653301365748,BILD 4,A16,089855,Mel; Stephanie,0,0,0,0
1653301365748,BILD 4,B01,089857,Lo; Stanley M.,0,0,0,0
1653301365748,BILD 4,B02,089858,Lo; Stanley M.,0,0,0,0
1653301365748,BILD 4,B03,089859,Lo; Stanley M.,0,0,0,0
1653301365748,BILD 4,B04,089860,Lo; Stanley M.,0,0,0,0
1653301365748,BILD 4,B05,089861,Lo; Stanley M.,0,0,0,0
1653301365748,BILD 4,B06,089862,Lo; Stanley M.,0,0,0,0
1653301365748,BILD 4,B07,089863,Lo; Stanley M.,0,0,0,0
1653301365748,BILD 4,B08,089864,Lo; Stanley M.,0,0,0,0
1653301365748,BILD 4,B09,089865,Lo; Stanley M.,0,0,0,0
1653301365748,BILD 4,B10,089866,Lo; Stanley M.,0,0,0,0
1653301365748,BILD 4,B11,089867,Lo; Stanley M.,0,0,0,0
1653301365748,BILD 4,B12,089868,Lo; Stanley M.,0,0,0,0
1653301365748,BILD 4,B13,089869,Lo; Stanley M.,0,0,0,0
1653301365748,BILD 4,B14,089870,Lo; Stanley M.,0,0,0,0
1653301365748,BILD 4,B15,089871,Lo; Stanley M.,0,0,0,0
1653301365748,BILD 4,B16,089872,Lo; Stanley M.,0,0,0,0
1653301366270,BILD 5,A01,092907,Reuther; Keefe,31,0,32,1
1653301366270,BILD 5,A02,092908,Reuther; Keefe,30,0,32,2
1653301366795,BILD 10,A01,092909,Gustafson-Brown; Cindy,27,0,27,0
1653301366795,BILD 10,A02,092910,Gustafson-Brown; Cindy,27,0,27,0
1653301366795,BILD 10,A03,092911,Gustafson-Brown; Cindy,27,0,27,0
1653301366795,BILD 10,A04,092912,Gustafson-Brown; Cindy,27,0,27,0
1653301366795,BILD 10,A05,092913,Gustafson-Brown; Cindy,25,0,27,2
1653301366795,BILD 10,A06,092914,Gustafson-Brown; Cindy,26,0,27,1
1653301366795,BILD 10,A07,092915,Gustafson-Brown; Cindy,27,0,27,0
1653301366795,BILD 10,A08,092916,Gustafson-Brown; Cindy,27,0,27,0
1653301366795,BILD 10,A09,092917,Gustafson-Brown; Cindy,27,0,27,0
1653301367322,BILD 20,A01,092956,Rana; Brinda Kanti,24,0,27,3
1653301367322,BILD 20,A02,092957,Rana; Brinda Kanti,24,0,27,3
1653301367322,BILD 20,A03,092958,Rana; Brinda Kanti,27,0,27,0
1653301367322,BILD 20,A04,092959,Rana; Brinda Kanti,27,0,27,0
1653301367844,BILD 32,A01,092990,Burg; Michael,27,0,27,0
1653301367844,BILD 32,A02,092991,Burg; Michael,26,0,27,1
1653301367844,BILD 32,A03,092992,Burg; Michael,27,0,27,0
1653301367844,BILD 32,A04,092993,Burg; Michael,26,0,27,1
1653301367844,BILD 32,A05,092994,Burg; Michael,27,0,27,0
1653301367844,BILD 32,A06,092995,Burg; Michael,27,0,27,0
1653301367844,BILD 32,A07,092996,Burg; Michael,27,0,27,0
1653301368366,BILD 60,A01,092392,Hammond; LaTisha Marie,24,0,24,0
1653301368366,BILD 60,A02,092393,Hammond; LaTisha Marie,24,0,24,0
1653301368366,BILD 60,B01,092394,Macagno; Eduardo R.,23,0,24,1
1653301368366,BILD 60,B02,092395,Macagno; Eduardo R.,24,0,24,0
1653301368895,BILD 62,A01,092949,Aljadeff; Johnatan,31,0,32,1
1653301368895,BILD 62,A02,092950,Aljadeff; Johnatan,32,0,32,0
1653301368895,BILD 62,A03,092951,Aljadeff; Johnatan,32,0,32,0
1653301369426,BILD 80,A00,089880,Pogliano; Joseph,27,0,30,3
1653301369959,BIMM 100,A01,092435,Pasquinelli; Amy,32,0,32,0
1653301369959,BIMM 100,A02,092436,Pasquinelli; Amy,30,0,32,2
1653301369959,BIMM 100,A03,092437,Pasquinelli; Amy,32,0,32,0
1653301369959,BIMM 100,A04,092438,Pasquinelli; Amy,31,0,32,1
1653301369959,BIMM 100,A05,092439,Pasquinelli; Amy,32,0,32,0
1653301369959,BIMM 100,A06,092440,Pasquinelli; Amy,32,0,32,0
1653301369959,BIMM 100,A07,092441,Pasquinelli; Amy,32,0,32,0
1653301369959,BIMM 100,A08,092442,Pasquinelli; Amy,32,0,32,0
1653301369959,BIMM 100,A09,092443,Pasquinelli; Amy,32,0,32,0
1653301369959,BIMM 100,A10,092444,Pasquinelli; Amy,32,0,32,0
1653301369959,BIMM 100,B01,092518,Pruneda-Paz; Jose L.,26,0,32,6
1653301369959,BIMM 100,B02,092519,Pruneda-Paz; Jose L.,19,0,32,13
1653301369959,BIMM 100,B03,092520,Pruneda-Paz; Jose L.,20,0,32,12
1653301369959,BIMM 100,B04,092521,Pruneda-Paz; Jose L.,24,0,32,8
1653301369959,BIMM 100,B05,092522,Pruneda-Paz; Jose L.,23,0,32,9
1653301369959,BIMM 100,B06,092523,Pruneda-Paz; Jose L.,24,0,32,8
1653301369959,BIMM 100,B07,092524,Pruneda-Paz; Jose L.,28,0,32,4
1653301369959,BIMM 100,B08,092525,Pruneda-Paz; Jose L.,25,0,32,7
1653301369959,BIMM 100,B09,092526,Pruneda-Paz; Jose L.,26,0,32,6
1653301369959,BIMM 100,B10,092527,Pruneda-Paz; Jose L.,24,0,32,8
1653301370500,BIMM 101,A01,089915,Rusert; Jessica Marie,22,0,24,2
1653301370500,BIMM 101,A02,089916,Rusert; Jessica Marie,21,0,24,3
1653301370500,BIMM 101,A03,089917,Rusert; Jessica Marie,21,0,24,3
1653301370500,BIMM 101,A04,089918,Rusert; Jessica Marie,20,0,24,4
1653301370500,BIMM 101,B01,089920,Grossman; Emily N,0,0,24,24
1653301370500,BIMM 101,B02,089921,Grossman; Emily N,1,0,24,23
1653301370500,BIMM 101,C01,089923,Day; Christopher D,0,0,24,24
1653301370500,BIMM 101,C02,089924,Day; Christopher D,0,0,24,24
1653301370500,BIMM 101,D01,089926,Cooper; Andrew Michael,18,0,24,6
1653301370500,BIMM 101,D02,089927,Cooper; Andrew Michael,24,0,24,0
1653301370500,BIMM 101,E01,089929,McDonnell; Lisa Marie,1,0,24,23
1653301370500,BIMM 101,E02,089930,McDonnell; Lisa Marie,12,0,24,12
1653301371023,BIMM 110,A01,092472,Tour; Ella,26,0,32,6
1653301371023,BIMM 110,A02,092473,Tour; Ella,23,0,32,9
1653301371023,BIMM 110,A03,092474,Tour; Ella,29,0,32,3
1653301371023,BIMM 110,A04,092475,Tour; Ella,27,0,32,5
1653301371023,BIMM 110,A05,092476,Tour; Ella,32,0,32,0
1653301371023,BIMM 110,A06,092477,Tour; Ella,30,0,32,2
1653301371023,BIMM 110,A07,092478,Tour; Ella,29,0,32,3
1653301371548,BIMM 120,A01,092979,Allen; Eric,28,0,32,4
1653301371548,BIMM 120,A02,092980,Allen; Eric,1,0,32,31
1653301371548,BIMM 120,A03,092981,Allen; Eric,14,0,32,18
1653301371548,BIMM 120,A04,092982,Allen; Eric,27,0,32,5
1653301371548,BIMM 120,A05,092983,Allen; Eric,30,0,32,2
1653301371548,BIMM 120,A06,092984,Allen; Eric,29,0,32,3
1653301371548,BIMM 120,A07,092985,Allen; Eric,20,0,32,12
1653301371548,BIMM 120,A08,092986,Allen; Eric,30,0,32,2
1653301371548,BIMM 120,A09,092987,Allen; Eric,30,0,32,2
1653301371548,BIMM 120,A10,092988,Allen; Eric,30,0,32,2
1653301371548,BIMM 120,A11,092989,Allen; Eric,32,0,32,0
1653301372093,BIMM 121,A01,089934,Petrie; Katherine Lynn,0,0,24,24
1653301372093,BIMM 121,A02,089935,Petrie; Katherine Lynn,0,0,24,24
1653301372093,BIMM 121,B01,089937,Pickett; Brooke Elizabeth,0,0,24,24
1653301372093,BIMM 121,B02,089938,Pickett; Brooke Elizabeth,0,0,24,24
1653301372093,BIMM 121,C01,089940,Pirino; Giorgia,0,0,24,24
1653301372093,BIMM 121,C02,089941,Pirino; Giorgia,0,0,24,24
1653301372093,BIMM 121,C03,089942,Pirino; Giorgia,0,0,24,24
1653301372093,BIMM 121,C04,089943,Pirino; Giorgia,0,0,24,24
1653301372651,BIMM 122,A01,093006,Russell; Alistair B,18,0,32,14
1653301372651,BIMM 122,A02,093007,Russell; Alistair B,16,0,32,16
1653301372651,BIMM 122,A03,093008,Russell; Alistair B,26,0,32,6
1653301372651,BIMM 122,A04,093009,Russell; Alistair B,32,0,32,0
1653301372651,BIMM 122,A05,093010,Russell; Alistair B,30,0,32,2
1653301373174,BIMM 124,A01,092404,Gustafson-Brown; Cindy,26,0,32,6
1653301373174,BIMM 124,A02,092405,Gustafson-Brown; Cindy,29,0,32,3
1653301373174,BIMM 124,A03,092406,Gustafson-Brown; Cindy,30,0,32,2
1653301373174,BIMM 124,A04,092407,Gustafson-Brown; Cindy,32,0,32,0
1653301373174,BIMM 124,A05,092408,Gustafson-Brown; Cindy,28,0,32,4
1653301373174,BIMM 124,A06,092409,Gustafson-Brown; Cindy,31,0,32,1
1653301373174,BIMM 124,A07,092410,Gustafson-Brown; Cindy,32,0,32,0
1653301373710,BIMM 140,A01,089947,Suel; Gurol Mehmet & Hao; Nan,16,0,27,11
1653301373710,BIMM 140,A02,089948,Suel; Gurol Mehmet & Hao; Nan,24,0,27,3
1653301373710,BIMM 140,A03,089949,Suel; Gurol Mehmet & Hao; Nan,21,0,27,6
1653301373710,BIMM 140,A04,089950,Suel; Gurol Mehmet & Hao; Nan,25,0,27,2
1653301373710,BIMM 140,A05,089951,Suel; Gurol Mehmet & Hao; Nan,24,0,27,3
1653301374254,BIMM 143,A01,089953,Grant; Barry J,0,0,40,40
1653301374254,BIMM 143,B01,089955,Fan; Chun Chieh,39,0,40,1
1653301374254,BIMM 143,C01,089957,Bozinovic; Goran,29,0,40,11
1653301374791,BIMM 194,A00,089958,Hasty; Jeff M,15,0,27,12
1653301374791,BIMM 194,B00,089959,Golden; James W,19,0,27,8
1653301374791,BIMM 194,C00,089960,Lykke-Andersen; Jens,2,0,27,25
1653301374791,BIMM 194,D00,094317,Golden; Susan S.,25,0,27,2
1653301375330,BIPN 100,A01,093011,Cooke; James Edward,7,0,19,12
1653301375330,BIPN 100,A02,093012,Cooke; James Edward,10,0,19,9
1653301375330,BIPN 100,A03,093013,Cooke; James Edward,8,0,19,11
1653301375330,BIPN 100,A04,093014,Cooke; James Edward,12,0,19,7
1653301375330,BIPN 100,A05,093015,Cooke; James Edward,17,0,19,2
1653301375330,BIPN 100,A06,093016,Cooke; James Edward,12,0,19,7
1653301375330,BIPN 100,A07,093017,Cooke; James Edward,12,0,19,7
1653301375330,BIPN 100,A08,093018,Cooke; James Edward,18,0,19,1
1653301375330,BIPN 100,A09,093019,Cooke; James Edward,17,0,19,2
1653301375330,BIPN 100,A10,093020,Cooke; James Edward,18,0,19,1
1653301375330,BIPN 100,B01,093036,Reyes Gonzalez; Catalina,17,0,19,2
1653301375330,BIPN 100,B02,093037,Reyes Gonzalez; Catalina,14,0,19,5
1653301375330,BIPN 100,B03,093038,Reyes Gonzalez; Catalina,16,0,19,3
1653301375330,BIPN 100,B04,093039,Reyes Gonzalez; Catalina,19,0,19,0
1653301375330,BIPN 100,B05,093040,Reyes Gonzalez; Catalina,19,0,19,0
1653301375330,BIPN 100,B06,093041,Reyes Gonzalez; Catalina,19,0,19,0
1653301375330,BIPN 100,B07,093042,Reyes Gonzalez; Catalina,14,0,19,5
1653301375330,BIPN 100,B08,093043,Reyes Gonzalez; Catalina,16,0,19,3
1653301375330,BIPN 100,B09,093044,Reyes Gonzalez; Catalina,19,0,19,0
1653301375330,BIPN 100,B10,093045,Reyes Gonzalez; Catalina,19,0,19,0
1653301375874,BIPN 102,A01,093046,Reyes Gonzalez; Catalina,28,0,32,4
1653301375874,BIPN 102,A02,093047,Reyes Gonzalez; Catalina,17,0,32,15
1653301375874,BIPN 102,A05,093050,Reyes Gonzalez; Catalina,29,0,32,3
1653301375874,BIPN 102,A06,093051,Reyes Gonzalez; Catalina,15,0,32,17
1653301375874,BIPN 102,A07,093052,Reyes Gonzalez; Catalina,29,0,32,3
1653301375874,BIPN 102,A08,093053,Reyes Gonzalez; Catalina,31,0,32,1
1653301376424,BIPN 105,A01,089966,Armour; Jon Christopher,0,0,21,21
1653301376424,BIPN 105,A02,089967,Armour; Jon Christopher,0,0,21,21
1653301376424,BIPN 105,A03,089968,Armour; Jon Christopher,3,0,21,18
1653301376424,BIPN 105,A04,089969,Armour; Jon Christopher,10,0,21,11
1653301376950,BIPN 140,A01,092514,Spitzer; Nicholas & Su; Chih-Ying,9,0,19,10
1653301376950,BIPN 140,A02,092515,Spitzer; Nicholas & Su; Chih-Ying,12,0,19,7
1653301376950,BIPN 140,A03,092516,Spitzer; Nicholas & Su; Chih-Ying,11,0,19,8
1653301376950,BIPN 140,A04,092517,Spitzer; Nicholas & Su; Chih-Ying,15,0,19,4
1653301376950,BIPN 140,B01,092952,Banghart; Matthew Ryan,12,0,19,7
1653301376950,BIPN 140,B02,092953,Banghart; Matthew Ryan,19,0,19,0
1653301376950,BIPN 140,B03,092954,Banghart; Matthew Ryan,19,0,19,0
1653301376950,BIPN 140,B04,092955,Banghart; Matthew Ryan,19,0,19,0
1653301377499,BIPN 145,A01,089973,Marino; Marc J,35,0,42,7
1653301377499,BIPN 145,A02,089974,Marino; Marc J,36,0,42,6
1653301377499,BIPN 145,B01,089976,Juavinett; Ashley Lauren,0,0,42,42
1653301378026,BIPN 148,A01,092960,Leutgeb; Jill K.,31,0,32,1
1653301378026,BIPN 148,A02,092961,Leutgeb; Jill K.,25,0,32,7
1653301378026,BIPN 148,A03,092962,Leutgeb; Jill K.,29,0,31,2
1653301378026,BIPN 148,A04,092963,Leutgeb; Jill K.,31,0,31,0
1653301378026,BIPN 148,A05,092964,Leutgeb; Jill K.,31,0,31,0
1653301378026,BIPN 148,A06,094351,Leutgeb; Jill K.,26,0,31,5
1653301378026,BIPN 148,A07,092966,Leutgeb; Jill K.,26,0,31,5
1653301378026,BIPN 148,A08,092967,Leutgeb; Jill K.,26,0,31,5
1653301378573,BIPN 189,A00,090665,Gentner; Tim,0,0,25,25
1653301379097,BIPN 194,A00,089978,Pekkurnaz Banghart; Gulcin,17,0,27,10
1653301379097,BIPN 194,B00,089979,Leutgeb; Stefan,24,0,27,3
1653301379631,BISP 194,A00,089980,Wertheim; Joel Okrent,8,0,27,19
1653301380160,CAT 1,A01,086671,Bronstein; Phoebe Malan,17,0,17,0
1653301380160,CAT 1,A02,086672,Bronstein; Phoebe Malan,13,0,17,4
1653301380160,CAT 1,A03,086673,Bronstein; Phoebe Malan,17,0,17,0
1653301380160,CAT 1,A04,086674,Bronstein; Phoebe Malan,15,0,17,2
1653301380160,CAT 1,A05,086675,Bronstein; Phoebe Malan,17,0,17,0
1653301380160,CAT 1,A06,086676,Bronstein; Phoebe Malan,17,0,17,0
1653301380160,CAT 1,A07,086677,Bronstein; Phoebe Malan,16,0,17,1
1653301380160,CAT 1,A08,086678,Bronstein; Phoebe Malan,17,0,17,0
1653301380160,CAT 1,A09,086679,Bronstein; Phoebe Malan,16,0,17,1
1653301380160,CAT 1,A10,086680,Bronstein; Phoebe Malan,17,0,17,0
1653301380160,CAT 1,A11,086681,Bronstein; Phoebe Malan,16,0,17,1
1653301380160,CAT 1,A12,086682,Bronstein; Phoebe Malan,17,0,17,0
1653301380160,CAT 1,A13,086683,Bronstein; Phoebe Malan,17,0,17,0
1653301380160,CAT 1,A14,086684,Bronstein; Phoebe Malan,17,0,17,0
1653301380160,CAT 1,A15,086685,Bronstein; Phoebe Malan,17,0,17,0
1653301380160,CAT 1,A16,086686,Bronstein; Phoebe Malan,17,0,17,0
1653301380160,CAT 1,B01,086688,Bigham; David Joseph,17,0,17,0
1653301380160,CAT 1,B02,086689,Bigham; David Joseph,16,0,17,1
1653301380160,CAT 1,B03,086690,Bigham; David Joseph,17,0,17,0
1653301380160,CAT 1,B04,086691,Bigham; David Joseph,17,0,17,0
1653301380160,CAT 1,B05,086692,Bigham; David Joseph,16,0,17,1
1653301380160,CAT 1,B06,086693,Bigham; David Joseph,17,0,17,0
1653301380160,CAT 1,B07,086694,Bigham; David Joseph,17,0,17,0
1653301380160,CAT 1,B08,086695,Bigham; David Joseph,17,0,17,0
1653301380160,CAT 1,B09,086696,Bigham; David Joseph,17,0,17,0
1653301380160,CAT 1,B10,086697,Bigham; David Joseph,17,0,17,0
1653301380160,CAT 1,B11,086698,Bigham; David Joseph,17,0,17,0
1653301380160,CAT 1,B12,086699,Bigham; David Joseph,17,0,17,0
1653301380160,CAT 1,B13,086700,Bigham; David Joseph,15,0,17,2
1653301380160,CAT 1,B14,086701,Bigham; David Joseph,17,0,17,0
1653301380160,CAT 1,C01,086703,Algaze; Guillermo,17,0,17,0
1653301380160,CAT 1,C02,086704,Algaze; Guillermo,17,0,17,0
1653301380160,CAT 1,C03,086705,Algaze; Guillermo,17,0,17,0
1653301380160,CAT 1,C04,086706,Algaze; Guillermo,17,0,17,0
1653301380160,CAT 1,C05,086707,Algaze; Guillermo,17,0,17,0
1653301380160,CAT 1,C06,086708,Algaze; Guillermo,17,0,17,0
1653301380160,CAT 1,C07,086709,Algaze; Guillermo,17,0,17,0
1653301380160,CAT 1,C08,086710,Algaze; Guillermo,17,0,17,0
1653301380160,CAT 1,C09,086711,Algaze; Guillermo,17,0,17,0
1653301380160,CAT 1,C10,086712,Algaze; Guillermo,17,0,17,0
1653301380160,CAT 1,C11,086713,Algaze; Guillermo,17,0,17,0
1653301380160,CAT 1,C12,086714,Algaze; Guillermo,17,0,17,0
1653301380160,CAT 1,C13,086715,Algaze; Guillermo,17,0,17,0
1653301380160,CAT 1,C14,086716,Algaze; Guillermo,16,0,17,1
1653301380160,CAT 1,C15,086717,Algaze; Guillermo,17,0,17,0
1653301380160,CAT 1,C16,086718,Algaze; Guillermo,16,0,17,1
1653301380160,CAT 1,D01,086720,Staff,17,0,17,0
1653301380160,CAT 1,D02,086721,Staff,17,0,17,0
1653301380160,CAT 1,D03,086722,Staff,17,0,17,0
1653301380160,CAT 1,D04,086723,Staff,17,0,17,0
1653301380160,CAT 1,D05,086724,Staff,16,0,17,1
1653301380160,CAT 1,D06,086725,Staff,16,0,17,1
1653301380160,CAT 1,D07,086726,Staff,17,0,17,0
1653301380160,CAT 1,D08,086727,Staff,17,0,17,0
1653301380160,CAT 1,D09,086728,Staff,16,0,17,1
1653301380160,CAT 1,D10,086729,Staff,17,0,17,0
1653301380160,CAT 1,D11,086730,Staff,17,0,17,0
1653301380160,CAT 1,D12,086731,Staff,17,0,17,0
1653301380160,CAT 1,D13,086732,Staff,17,0,17,0
1653301380160,CAT 1,D14,086733,Staff,17,0,17,0
1653301380692,CAT 3,A01,086735,Gumm; Elizabeth Ashley,14,0,15,1
1653301380692,CAT 3,A02,086736,Gumm; Elizabeth Ashley,14,0,15,1
1653301380692,CAT 3,A03,086737,Gumm; Elizabeth Ashley,15,0,15,0
1653301380692,CAT 3,A04,086738,Gumm; Elizabeth Ashley,15,0,15,0
1653301380692,CAT 3,A05,086739,Gumm; Elizabeth Ashley,15,0,15,0
1653301380692,CAT 3,A06,086740,Gumm; Elizabeth Ashley,15,0,15,0
1653301381227,CAT 124,A01,086742,Staff,15,0,15,0
1653301381758,CAT 125R,A01,094882,Staff,14,0,16,2
1653301381758,CAT 125R,A02,086745,Staff,16,0,16,0
1653301381758,CAT 125R,A03,086746,Staff,14,0,16,2
1653301381758,CAT 125R,A04,086747,Staff,13,0,16,3
1653301381758,CAT 125R,A05,086748,Staff,15,0,16,1
1653301381758,CAT 125R,A06,086749,Staff,12,0,16,4
1653301381758,CAT 125R,A07,086750,Staff,14,0,16,2
1653301381758,CAT 125R,A08,094883,Staff,14,0,16,2
1653301381758,CAT 125R,A09,094884,Staff,16,0,16,0
1653301381758,CAT 125R,A10,094885,Staff,15,0,16,1
1653301381758,CAT 125R,A14,086761,Staff,15,0,16,1
1653301381758,CAT 125R,A15,086762,Staff,16,0,16,0
1653301381758,CAT 125R,A16,086763,Staff,13,0,16,3
1653301381758,CAT 125R,A17,086764,Staff,14,0,16,2
1653301381758,CAT 125R,A18,086765,Staff,14,0,16,2
1653301381758,CAT 125R,A19,086766,Staff,14,0,16,2
1653301382287,CCS 101,A00,088353,Staff,29,0,35,6
1653301382839,CENG 4,A01,086204,Bae; Jinhye,30,0,30,0
1653301382839,CENG 4,A02,086205,Bae; Jinhye,30,0,30,0
1653301382839,CENG 4,B01,086207,Drews; Aaron,30,0,30,0
1653301382839,CENG 4,B02,086208,Drews; Aaron,30,0,30,0
1653301383394,CENG 15,A01,086210,Lubarda; Vlado,63,0,65,2
1653301383394,CENG 15,B01,086212,Lubarda; Vlado,65,0,65,0
1653301383943,CENG 100,A00,086213,Chen; Zheng,147,0,150,3
1653301384471,CENG 101A,A00,086214,Bae; Jinhye,142,0,150,8
1653301385012,CENG 120,A00,086215,Opatkiewicz; Justin Paul,125,0,150,25
1653301385572,CENG 122,A00,086216,Opatkiewicz; Justin Paul,137,0,150,13
1653301386097,CGS 2A,A01,086271,Shelby; Karen Lee,12,0,15,3
1653301386097,CGS 2A,A02,086272,Shelby; Karen Lee,13,0,15,2
1653301386097,CGS 2A,A03,086273,Shelby; Karen Lee,14,0,15,1
1653301386097,CGS 2A,A04,086274,Shelby; Karen Lee,15,0,15,0
1653301386632,CGS 100A,A00,086275,Perez; Roy,26,0,32,6
1653301387177,CGS 101,A00,086276,Shelby; Karen Lee,30,0,30,0
1653301387711,CGS 106,A00,086277,Shelby; Karen Lee,24,0,30,6
1653301388268,CGS 119,A00,086279,Nguyen; Hoang Tan,27,0,30,3
1653301388804,CGS 121,A00,086280,Martin Sandino; Amanda Maria Yoland,19,0,20,1
1653301389351,CGS 122,A00,086281,Whitley; Leila Marie,20,0,20,0
1653301389905,CGS 123,A00,086282,Staff,0,0,0,0
1653301390429,CGS 127,A00,086283,Whitley; Leila Marie,15,0,15,0
1653301390975,CGS 130,A00,086284,Martin Sandino; Amanda Maria Yoland,15,0,15,0
1653301391513,CGS 187,A00,086285,Perez; Roy,15,0,16,1
1653301392045,CGS 190,A00,086286,Staff,5,0,5,0
1653301392571,CHEM 4,A01,089669,Bussey; Thomas J,40,0,40,0
1653301392571,CHEM 4,A02,089670,Bussey; Thomas J,42,0,42,0
1653301392571,CHEM 4,A03,089671,Bussey; Thomas J,40,0,42,2
1653301392571,CHEM 4,A04,089672,Bussey; Thomas J,42,0,42,0
1653301392571,CHEM 4,A05,089673,Bussey; Thomas J,40,0,42,2
1653301392571,CHEM 4,A06,089674,Bussey; Thomas J,40,0,42,2
1653301392571,CHEM 4,A07,089675,Bussey; Thomas J,42,0,42,0
1653301392571,CHEM 4,A08,089676,Bussey; Thomas J,42,0,42,0
1653301392571,CHEM 4,A09,089677,Bussey; Thomas J,41,0,41,0
1653301392571,CHEM 4,A10,089678,Bussey; Thomas J,40,0,40,0
1653301393121,CHEM 6A,A01,092734,Pomeroy; Robert S.,4,0,4,0
1653301393121,CHEM 6A,A02,092735,Pomeroy; Robert S.,4,0,4,0
1653301393121,CHEM 6A,A03,092736,Pomeroy; Robert S.,4,0,4,0
1653301393121,CHEM 6A,A04,092737,Pomeroy; Robert S.,4,0,4,0
1653301393121,CHEM 6A,A05,092738,Pomeroy; Robert S.,4,0,4,0
1653301393121,CHEM 6A,A06,092739,Pomeroy; Robert S.,4,0,4,0
1653301393121,CHEM 6A,A07,092740,Pomeroy; Robert S.,4,0,4,0
1653301393121,CHEM 6A,A08,092741,Pomeroy; Robert S.,4,0,4,0
1653301393121,CHEM 6A,A09,092742,Pomeroy; Robert S.,0,0,0,0
1653301393121,CHEM 6A,B01,092744,Schurmeier; Kimberly,4,0,4,0
1653301393121,CHEM 6A,B02,092746,Schurmeier; Kimberly,4,0,4,0
1653301393121,CHEM 6A,B03,092749,Schurmeier; Kimberly,4,0,4,0
1653301393121,CHEM 6A,B04,092751,Schurmeier; Kimberly,4,0,4,0
1653301393121,CHEM 6A,B05,092753,Schurmeier; Kimberly,4,0,4,0
1653301393121,CHEM 6A,B06,092755,Schurmeier; Kimberly,3,0,4,1
1653301393121,CHEM 6A,B07,092756,Schurmeier; Kimberly,4,0,4,0
1653301393121,CHEM 6A,B08,092757,Schurmeier; Kimberly,4,0,4,0
1653301393121,CHEM 6A,B09,092758,Schurmeier; Kimberly,0,0,0,0
1653301393121,CHEM 6A,C01,092805,Schurmeier; Kimberly,4,0,4,0
1653301393121,CHEM 6A,C02,092806,Schurmeier; Kimberly,4,0,4,0
1653301393121,CHEM 6A,C03,092807,Schurmeier; Kimberly,4,0,4,0
1653301393121,CHEM 6A,C04,092808,Schurmeier; Kimberly,4,0,4,0
1653301393121,CHEM 6A,C05,092809,Schurmeier; Kimberly,4,0,4,0
1653301393121,CHEM 6A,C06,092810,Schurmeier; Kimberly,4,0,4,0
1653301393121,CHEM 6A,C07,092811,Schurmeier; Kimberly,4,0,4,0
1653301393121,CHEM 6A,C08,092812,Schurmeier; Kimberly,4,0,4,0
1653301393121,CHEM 6A,C09,092813,Schurmeier; Kimberly,0,0,0,0
1653301393121,CHEM 6A,D01,092837,Stallings; Dontarie M,4,0,4,0
1653301393121,CHEM 6A,D02,092838,Stallings; Dontarie M,4,0,4,0
1653301393121,CHEM 6A,D03,092839,Stallings; Dontarie M,4,0,4,0
1653301393121,CHEM 6A,D04,092840,Stallings; Dontarie M,4,0,4,0
1653301393121,CHEM 6A,D05,092841,Stallings; Dontarie M,4,0,4,0
1653301393121,CHEM 6A,D06,092842,Stallings; Dontarie M,4,0,4,0
1653301393121,CHEM 6A,D07,092843,Stallings; Dontarie M,4,0,4,0
1653301393121,CHEM 6A,D08,092844,Stallings; Dontarie M,4,0,4,0
1653301393121,CHEM 6A,D09,092845,Stallings; Dontarie M,0,0,0,0
1653301393121,CHEM 6A,E01,092796,Brydges; Stacey,4,0,4,0
1653301393121,CHEM 6A,E02,092797,Brydges; Stacey,3,0,4,1
1653301393121,CHEM 6A,E03,092798,Brydges; Stacey,4,0,4,0
1653301393121,CHEM 6A,E04,092799,Brydges; Stacey,3,0,4,1
1653301393121,CHEM 6A,E05,092800,Brydges; Stacey,4,0,4,0
1653301393121,CHEM 6A,E06,092801,Brydges; Stacey,4,0,4,0
1653301393121,CHEM 6A,E07,092802,Brydges; Stacey,4,0,4,0
1653301393121,CHEM 6A,E08,092803,Brydges; Stacey,4,0,4,0
1653301393121,CHEM 6A,E09,092804,Brydges; Stacey,0,0,0,0
1653301393121,CHEM 6A,F01,092759,Brydges; Stacey,4,0,4,0
1653301393121,CHEM 6A,F02,092760,Brydges; Stacey,4,0,4,0
1653301393121,CHEM 6A,F03,092761,Brydges; Stacey,3,0,4,1
1653301393121,CHEM 6A,F04,092762,Brydges; Stacey,4,0,4,0
1653301393121,CHEM 6A,F05,092763,Brydges; Stacey,4,0,4,0
1653301393121,CHEM 6A,F06,092764,Brydges; Stacey,4,0,4,0
1653301393121,CHEM 6A,F07,092765,Brydges; Stacey,4,0,4,0
1653301393121,CHEM 6A,F08,092766,Brydges; Stacey,4,0,4,0
1653301393121,CHEM 6A,F09,092767,Brydges; Stacey,0,0,0,0
1653301393121,CHEM 6A,G01,092774,Zid; Brian M,0,0,4,4
1653301393121,CHEM 6A,G02,092775,Zid; Brian M,2,0,4,2
1653301393121,CHEM 6A,G03,092776,Zid; Brian M,2,0,4,2
1653301393121,CHEM 6A,G04,092777,Zid; Brian M,2,0,4,2
1653301393121,CHEM 6A,G05,092778,Zid; Brian M,4,0,4,0
1653301393121,CHEM 6A,G06,092779,Zid; Brian M,4,0,4,0
1653301393121,CHEM 6A,G07,092780,Zid; Brian M,3,0,4,1
1653301393121,CHEM 6A,G08,092781,Zid; Brian M,3,0,4,1
1653301393121,CHEM 6A,G09,092782,Zid; Brian M,0,0,0,0
1653301393121,CHEM 6A,H01,092846,Stallings; Dontarie M,4,0,4,0
1653301393121,CHEM 6A,H02,092847,Stallings; Dontarie M,3,0,4,1
1653301393121,CHEM 6A,H03,092848,Stallings; Dontarie M,4,0,4,0
1653301393121,CHEM 6A,H04,092849,Stallings; Dontarie M,4,0,4,0
1653301393121,CHEM 6A,H05,092850,Stallings; Dontarie M,4,0,4,0
1653301393121,CHEM 6A,H06,092851,Stallings; Dontarie M,3,0,4,1
1653301393121,CHEM 6A,H07,092852,Stallings; Dontarie M,4,0,4,0
1653301393121,CHEM 6A,H08,092853,Stallings; Dontarie M,3,0,4,1
1653301393121,CHEM 6A,H09,092854,Stallings; Dontarie M,0,0,0,0
1653301393121,CHEM 6A,I01,092814,Staff,0,0,0,0
1653301393121,CHEM 6A,I02,092815,Staff,0,0,0,0
1653301393121,CHEM 6A,I04,092816,Staff,0,0,0,0
1653301393121,CHEM 6A,I05,092817,Staff,0,0,0,0
1653301393121,CHEM 6A,I06,092818,Staff,0,0,0,0
1653301393121,CHEM 6A,I07,092819,Staff,0,0,0,0
1653301393121,CHEM 6A,I08,092820,Staff,0,0,0,0
1653301393121,CHEM 6A,I09,092821,Staff,0,0,0,0
1653301393653,CHEM 6AH,A01,092793,Paesani; Francesco,15,0,16,1
1653301393653,CHEM 6AH,A02,092794,Paesani; Francesco,16,0,16,0
1653301393653,CHEM 6AH,A03,092795,Paesani; Francesco,16,0,16,0
1653301394198,CHEM 6B,A01,092691,Hopkins; Patrycja Anna,21,0,25,4
1653301394198,CHEM 6B,A02,092692,Hopkins; Patrycja Anna,23,0,25,2
1653301394198,CHEM 6B,A03,092693,Hopkins; Patrycja Anna,25,0,25,0
1653301394198,CHEM 6B,A04,092694,Hopkins; Patrycja Anna,0,0,0,0
1653301394198,CHEM 6B,A05,092695,Hopkins; Patrycja Anna,24,0,25,1
1653301394198,CHEM 6B,A06,092696,Hopkins; Patrycja Anna,22,0,25,3
1653301394198,CHEM 6B,A07,092697,Hopkins; Patrycja Anna,24,0,25,1
1653301394721,CHEM 6C,A01,092708,Albizati; Kim F.,31,0,38,7
1653301394721,CHEM 6C,A02,092709,Albizati; Kim F.,32,0,38,6
1653301394721,CHEM 6C,A03,092710,Albizati; Kim F.,37,0,38,1
1653301394721,CHEM 6C,A04,092711,Albizati; Kim F.,36,0,38,2
1653301394721,CHEM 6C,A05,092712,Albizati; Kim F.,0,0,0,0
1653301394721,CHEM 6C,A06,092714,Albizati; Kim F.,33,0,38,5
1653301394721,CHEM 6C,A07,092715,Albizati; Kim F.,32,0,38,6
1653301394721,CHEM 6C,A08,092716,Albizati; Kim F.,37,0,38,1
1653301394721,CHEM 6C,A09,092717,Albizati; Kim F.,38,0,38,0
1653301395297,CHEM 7L,A01,089692,Leigh; Brian,11,0,19,8
1653301395297,CHEM 7L,A02,089693,Leigh; Brian,23,0,24,1
1653301395297,CHEM 7L,A03,089694,Leigh; Brian,24,0,24,0
1653301395297,CHEM 7L,A04,089695,Leigh; Brian,24,0,24,0
1653301395297,CHEM 7L,A05,089696,Leigh; Brian,23,0,24,1
1653301395297,CHEM 7L,A06,089697,Leigh; Brian,22,0,24,2
1653301395297,CHEM 7L,A07,089698,Leigh; Brian,21,0,21,0
1653301395297,CHEM 7L,A08,089699,Leigh; Brian,17,0,24,7
1653301395297,CHEM 7L,A09,089700,Leigh; Brian,23,0,24,1
1653301395297,CHEM 7L,A10,089701,Leigh; Brian,0,0,0,0
1653301395297,CHEM 7L,B01,089703,Leigh; Brian,18,0,24,6
1653301395297,CHEM 7L,B02,089704,Leigh; Brian,18,0,24,6
1653301395297,CHEM 7L,B03,089705,Leigh; Brian,23,0,24,1
1653301395297,CHEM 7L,B04,089706,Leigh; Brian,20,0,21,1
1653301395297,CHEM 7L,B05,089707,Leigh; Brian,17,0,24,7
1653301395297,CHEM 7L,B06,089708,Leigh; Brian,17,0,24,7
1653301395297,CHEM 7L,B07,089709,Leigh; Brian,17,0,24,7
1653301395297,CHEM 7L,B08,089710,Leigh; Brian,21,0,24,3
1653301395297,CHEM 7L,B09,089711,Leigh; Brian,21,0,24,3
1653301395297,CHEM 7L,B10,089712,Leigh; Brian,0,0,0,0
1653301395297,CHEM 7L,C01,089714,Staff,23,0,24,1
1653301395297,CHEM 7L,C02,089715,Staff,22,0,24,2
1653301395297,CHEM 7L,C03,089716,Staff,23,0,24,1
1653301395297,CHEM 7L,C04,089717,Staff,24,0,24,0
1653301395297,CHEM 7L,C05,089718,Staff,21,0,24,3
1653301395297,CHEM 7L,C06,089719,Staff,22,0,24,2
1653301395297,CHEM 7L,C07,089720,Staff,23,0,24,1
1653301395297,CHEM 7L,C08,089721,Staff,24,0,24,0
1653301395297,CHEM 7L,C09,089722,Staff,24,0,24,0
1653301395297,CHEM 7L,C10,089723,Staff,0,0,0,0
1653301395867,CHEM 40A,A01,092871,Schmidt; Valerie A,31,0,31,0
1653301395867,CHEM 40A,A02,092872,Schmidt; Valerie A,31,0,31,0
1653301395867,CHEM 40A,A03,092873,Schmidt; Valerie A,31,0,31,0
1653301395867,CHEM 40A,A04,092874,Schmidt; Valerie A,0,0,0,0
1653301395867,CHEM 40A,A05,092875,Schmidt; Valerie A,31,0,31,0
1653301395867,CHEM 40A,A06,092876,Schmidt; Valerie A,29,0,31,2
1653301395867,CHEM 40A,A07,092877,Schmidt; Valerie A,31,0,31,0
1653301395867,CHEM 40A,A08,092878,Schmidt; Valerie A,28,0,28,0
1653301395867,CHEM 40A,B01,089726,Lam; Tin Yiu,31,0,31,0
1653301395867,CHEM 40A,B02,089727,Lam; Tin Yiu,31,0,31,0
1653301395867,CHEM 40A,B03,089728,Lam; Tin Yiu,31,0,31,0
1653301395867,CHEM 40A,B04,089729,Lam; Tin Yiu,30,0,31,1
1653301395867,CHEM 40A,B05,089730,Lam; Tin Yiu,31,0,31,0
1653301395867,CHEM 40A,B06,089731,Lam; Tin Yiu,30,0,31,1
1653301395867,CHEM 40A,B07,089732,Lam; Tin Yiu,29,0,31,2
1653301395867,CHEM 40A,B08,089733,Lam; Tin Yiu,0,0,0,0
1653301395867,CHEM 40A,C01,092718,Albizati; Kim F.,17,0,31,14
1653301395867,CHEM 40A,C02,092719,Albizati; Kim F.,24,0,31,7
1653301395867,CHEM 40A,C03,092720,Albizati; Kim F.,12,0,31,19
1653301395867,CHEM 40A,C04,092721,Albizati; Kim F.,24,0,31,7
1653301395867,CHEM 40A,C05,092722,Albizati; Kim F.,21,0,31,10
1653301395867,CHEM 40A,C06,092723,Albizati; Kim F.,24,0,31,7
1653301395867,CHEM 40A,C07,092724,Albizati; Kim F.,30,0,31,1
1653301395867,CHEM 40A,C08,092725,Albizati; Kim F.,0,0,0,0
1653301395867,CHEM 40A,D01,092863,Yang; Jerry,28,0,31,3
1653301395867,CHEM 40A,D02,092864,Yang; Jerry,28,0,31,3
1653301395867,CHEM 40A,D03,092865,Yang; Jerry,31,0,31,0
1653301395867,CHEM 40A,D04,092866,Yang; Jerry,31,0,31,0
1653301395867,CHEM 40A,D05,092867,Yang; Jerry,0,0,0,0
1653301395867,CHEM 40A,D06,092868,Yang; Jerry,31,0,31,0
1653301395867,CHEM 40A,D07,092869,Yang; Jerry,31,0,31,0
1653301395867,CHEM 40A,D08,092870,Yang; Jerry,31,0,31,0
1653301396392,CHEM 40B,A01,092698,Oconnor; Joseph M.,24,0,34,10
1653301396392,CHEM 40B,A02,092699,Oconnor; Joseph M.,34,0,34,0
1653301396392,CHEM 40B,A03,092700,Oconnor; Joseph M.,0,0,0,0
1653301396392,CHEM 40B,A04,092701,Oconnor; Joseph M.,30,0,34,4
1653301396392,CHEM 40B,A05,092702,Oconnor; Joseph M.,33,0,34,1
1653301396392,CHEM 40B,A06,092703,Oconnor; Joseph M.,34,0,34,0
1653301396392,CHEM 40B,A07,092704,Oconnor; Joseph M.,32,0,34,2
1653301396392,CHEM 40B,A08,092705,Oconnor; Joseph M.,33,0,34,1
1653301396392,CHEM 40B,A09,092706,Oconnor; Joseph M.,34,0,34,0
1653301396918,CHEM 40C,A01,089739,Lam; Tin Yiu,0,0,0,0
1653301396918,CHEM 40C,A02,089740,Lam; Tin Yiu,0,0,0,0
1653301396918,CHEM 40C,A03,089741,Lam; Tin Yiu,0,0,0,0
1653301396918,CHEM 40C,A04,089742,Lam; Tin Yiu,13,0,34,21
1653301396918,CHEM 40C,A05,089743,Lam; Tin Yiu,32,0,34,2
1653301396918,CHEM 40C,A06,089744,Lam; Tin Yiu,31,0,34,3
1653301397456,CHEM 41A,A01,093840,Ternansky; Robert J.,29,0,33,4
1653301397456,CHEM 41A,A02,093841,Ternansky; Robert J.,32,0,33,1
1653301397456,CHEM 41A,A03,093842,Ternansky; Robert J.,33,0,33,0
1653301397456,CHEM 41A,A04,093843,Ternansky; Robert J.,30,0,33,3
1653301397456,CHEM 41A,A05,093844,Ternansky; Robert J.,31,0,33,2
1653301397456,CHEM 41A,A06,093845,Ternansky; Robert J.,27,0,27,0
1653301397456,CHEM 41A,A07,093846,Ternansky; Robert J.,32,0,33,1
1653301397456,CHEM 41A,A08,093847,Ternansky; Robert J.,33,0,33,0
1653301397992,CHEM 43A,A01,089746,Klosterman; Jeremy K,11,0,24,13
1653301397992,CHEM 43A,A02,089747,Klosterman; Jeremy K,16,0,24,8
1653301397992,CHEM 43A,A03,089748,Klosterman; Jeremy K,21,0,24,3
1653301397992,CHEM 43A,A04,089749,Klosterman; Jeremy K,22,0,24,2
1653301397992,CHEM 43A,A05,089750,Klosterman; Jeremy K,23,0,24,1
1653301397992,CHEM 43A,A06,089751,Klosterman; Jeremy K,8,0,24,16
1653301397992,CHEM 43A,A07,089752,Klosterman; Jeremy K,17,0,24,7
1653301397992,CHEM 43A,A08,089753,Klosterman; Jeremy K,16,0,24,8
1653301397992,CHEM 43A,A09,089754,Klosterman; Jeremy K,21,0,24,3
1653301397992,CHEM 43A,A10,089755,Klosterman; Jeremy K,21,0,24,3
1653301397992,CHEM 43A,A11,089756,Klosterman; Jeremy K,0,0,0,0
1653301397992,CHEM 43A,A12,089757,Klosterman; Jeremy K,0,0,0,0
1653301397992,CHEM 43A,A13,089758,Klosterman; Jeremy K,0,0,0,0
1653301397992,CHEM 43A,B01,089760,Klosterman; Jeremy K,0,0,0,0
1653301397992,CHEM 43A,B02,089761,Klosterman; Jeremy K,0,0,0,0
1653301397992,CHEM 43A,B03,089762,Klosterman; Jeremy K,16,0,24,8
1653301397992,CHEM 43A,B04,089763,Klosterman; Jeremy K,22,0,24,2
1653301397992,CHEM 43A,B05,089764,Klosterman; Jeremy K,23,0,24,1
1653301397992,CHEM 43A,B06,089765,Klosterman; Jeremy K,23,0,24,1
1653301397992,CHEM 43A,B07,089766,Klosterman; Jeremy K,17,0,24,7
1653301397992,CHEM 43A,B08,089767,Klosterman; Jeremy K,23,0,24,1
1653301397992,CHEM 43A,B09,089768,Klosterman; Jeremy K,24,0,24,0
1653301397992,CHEM 43A,B10,089769,Klosterman; Jeremy K,23,0,24,1
1653301397992,CHEM 43A,B11,089770,Klosterman; Jeremy K,22,0,24,2
1653301397992,CHEM 43A,B12,089771,Klosterman; Jeremy K,21,0,24,3
1653301398523,CHEM 87,A00,089772,Bussey; Thomas J,20,0,20,0
1653301399062,CHEM 96,A00,089773,Bussey; Thomas J,20,0,25,5
1653301399591,CHEM 100A,A01,089775,Pomeroy; Robert S.,22,0,24,2
1653301399591,CHEM 100A,A02,089776,Pomeroy; Robert S.,19,0,24,5
1653301399591,CHEM 100A,A03,089777,Pomeroy; Robert S.,13,0,24,11
1653301399591,CHEM 100A,A04,089778,Pomeroy; Robert S.,18,0,24,6
1653301399591,CHEM 100A,A05,089779,Pomeroy; Robert S.,19,0,24,5
1653301399591,CHEM 100A,A06,089780,Pomeroy; Robert S.,24,0,24,0
1653301399591,CHEM 100A,A07,089781,Pomeroy; Robert S.,0,0,0,0
1653301400126,CHEM 105A,A01,089783,Young; Mark,0,0,39,39
1653301400126,CHEM 105A,B01,089785,Young; Mark,26,0,39,13
1653301400664,CHEM 108,A01,089787,Ghosh; Gourisankar,1,0,22,21
1653301400664,CHEM 108,A02,089788,Ghosh; Gourisankar,6,0,22,16
1653301400664,CHEM 108,B01,089790,Ghosh; Gourisankar,13,0,22,9
1653301400664,CHEM 108,B02,089791,Ghosh; Gourisankar,20,0,22,2
1653301401288,CHEM 109,A01,089793,Hamaoka; Brent Y,4,0,22,18
1653301401288,CHEM 109,A02,089794,Hamaoka; Brent Y,10,0,22,12
1653301401288,CHEM 109,B01,089796,Hamaoka; Brent Y,6,0,22,16
1653301401288,CHEM 109,B02,089797,Hamaoka; Brent Y,18,0,22,4
1653301401812,CHEM 114A,A01,092855,Toor; Navtej,21,0,25,4
1653301401812,CHEM 114A,A02,092856,Toor; Navtej,25,0,25,0
1653301401812,CHEM 114A,A03,092857,Toor; Navtej,19,0,25,6
1653301401812,CHEM 114A,A04,092858,Toor; Navtej,24,0,25,1
1653301401812,CHEM 114A,A05,092859,Toor; Navtej,0,0,0,0
1653301401812,CHEM 114A,A06,092860,Toor; Navtej,14,0,25,11
1653301401812,CHEM 114A,A07,092861,Toor; Navtej,24,0,25,1
1653301401812,CHEM 114A,A08,092862,Toor; Navtej,24,0,25,1
1653301402336,CHEM 116,A01,092707,Ferguson; Fleur,6,0,35,29
1653301402336,CHEM 116,A02,094887,Ferguson; Fleur,31,0,35,4
1653301402872,CHEM 120A,A01,092785,Schimpf; Alina M,16,0,28,12
1653301402872,CHEM 120A,A02,092786,Schimpf; Alina M,26,0,28,2
1653301402872,CHEM 120A,A03,092787,Schimpf; Alina M,20,0,28,8
1653301402872,CHEM 120A,A04,092788,Schimpf; Alina M,27,0,28,1
1653301402872,CHEM 120A,A05,092789,Schimpf; Alina M,27,0,28,1
1653301402872,CHEM 120A,A06,092790,Schimpf; Alina M,0,0,0,0
1653301402872,CHEM 120A,A07,092791,Schimpf; Alina M,15,0,28,13
1653301402872,CHEM 120A,A08,092792,Schimpf; Alina M,0,0,0,0
1653301403418,CHEM 126A,A01,092768,Schoeneberg; Johannes,16,0,35,19
1653301403418,CHEM 126A,A02,092769,Schoeneberg; Johannes,35,0,35,0
1653301403418,CHEM 126A,A03,092770,Schoeneberg; Johannes,29,0,35,6
1653301403418,CHEM 126A,A04,092771,Schoeneberg; Johannes,0,0,0,0
1653301403418,CHEM 126A,A05,092772,Schoeneberg; Johannes,30,0,35,5
1653301403418,CHEM 126A,A06,092773,Schoeneberg; Johannes,33,0,35,2
1653301403962,CHEM 130,A01,092685,Sinha; Amitabha,28,0,38,10
1653301403962,CHEM 130,A02,092686,Sinha; Amitabha,31,0,38,7
1653301403962,CHEM 130,A03,092687,Sinha; Amitabha,34,0,38,4
1653301404495,CHEM 142,A00,089803,Esko; Jeffrey D. & Godula; Kamil,9,0,46,37
1653301405020,CHEM 143C,A01,089805,Ternansky; Robert J.,17,0,22,5
1653301405020,CHEM 143C,A02,089806,Ternansky; Robert J.,18,0,22,4
1653301405020,CHEM 143C,A03,089807,Ternansky; Robert J.,19,0,22,3
1653301405020,CHEM 143C,A04,089808,Ternansky; Robert J.,20,0,22,2
1653301405553,CHEM 152,A00,089809,Romero; Nathan A & Schmidt; Valerie A,35,0,40,5
1653301406082,CHEM 171,A01,092688,Slade; Jonathan,35,0,45,10
1653301406082,CHEM 171,A02,092689,Slade; Jonathan,44,0,45,1
1653301406082,CHEM 171,A03,092690,Slade; Jonathan,45,0,45,0
1653301406617,CHEM 186,A00,089811,Paesani; Francesco,9,0,15,6
1653301407161,CHIN 10AD,A01,086223,Staff,13,0,13,0
1653301407161,CHIN 10AD,A02,086224,Staff,12,0,13,1
1653301407161,CHIN 10AD,B01,086227,Staff,14,0,15,1
1653301407703,CHIN 10AM,A01,086230,Chen; Pei-Chia,16,0,16,0
1653301407703,CHIN 10AM,A02,086231,Chen; Pei-Chia,16,0,16,0
1653301408258,CHIN 10AN,A01,086234,Xu; Li,14,0,14,0
1653301408258,CHIN 10AN,A02,086235,Xu; Li,14,0,14,0
1653301408258,CHIN 10AN,B01,086240,Xu; Li,14,0,14,0
1653301408258,CHIN 10AN,B02,086242,Xu; Li,0,0,0,0
1653301408258,CHIN 10AN,C01,086245,Xu; Li,14,0,14,0
1653301408258,CHIN 10AN,C02,086246,Xu; Li,14,0,14,0
1653301408809,CHIN 20AD,A01,086248,Wang; Xiao,14,0,14,0
1653301408809,CHIN 20AD,A02,086249,Wang; Xiao,14,0,14,0
1653301408809,CHIN 20AD,B01,086251,Wang; Xiao,13,0,14,1
1653301408809,CHIN 20AD,B02,086252,Wang; Xiao,14,0,14,0
1653301409359,CHIN 20AM,A01,086254,Wang; Xiao,11,0,14,3
1653301409359,CHIN 20AM,A02,086255,Wang; Xiao,13,0,14,1
1653301409359,CHIN 20AM,B01,086257,Staff,15,0,15,0
1653301409884,CHIN 20AN,A01,086259,Anderson; Qin-Hong,11,0,12,1
1653301409884,CHIN 20AN,A02,086260,Anderson; Qin-Hong,12,0,12,0
1653301409884,CHIN 20AN,A03,086261,Anderson; Qin-Hong,0,0,0,0
1653301409884,CHIN 20AN,B01,086263,Anderson; Qin-Hong,12,0,13,1
1653301409884,CHIN 20AN,B02,086264,Anderson; Qin-Hong,13,0,13,0
1653301410422,CHIN 100AM,A00,086265,Anderson; Qin-Hong,20,0,20,0
1653301410944,CHIN 100AN,A00,086266,Chen; Pei-Chia,17,0,20,3
1653301411477,CHIN 185A,A00,086268,Staff,20,0,20,0
1653301412010,COGS 1,A01,087834,Barrera; Steven James,57,0,60,3
1653301412010,COGS 1,A02,087835,Barrera; Steven James,52,0,60,8
1653301412010,COGS 1,A03,087836,Barrera; Steven James,57,0,60,3
1653301412010,COGS 1,A04,087837,Barrera; Steven James,59,0,60,1
1653301412010,COGS 1,A05,087838,Barrera; Steven James,60,0,60,0
1653301412010,COGS 1,A06,087839,Barrera; Steven James,59,0,60,1
1653301412010,COGS 1,A07,087840,Barrera; Steven James,54,0,57,3
1653301412542,COGS 2,A01,087842,Boyle; Mary E. T.,64,0,64,0
1653301412542,COGS 2,A02,087843,Boyle; Mary E. T.,61,0,64,3
1653301412542,COGS 2,A03,087844,Boyle; Mary E. T.,64,0,64,0
1653301413070,COGS 3,A01,094312,Boyle; Mary E. T.,30,0,35,5
1653301413070,COGS 3,A02,094313,Boyle; Mary E. T.,33,0,35,2
1653301413070,COGS 3,A03,094314,Boyle; Mary E. T.,35,0,35,0
1653301413070,COGS 3,A04,094315,Boyle; Mary E. T.,35,0,35,0
1653301413070,COGS 3,A05,094316,Boyle; Mary E. T.,35,0,35,0
1653301413595,COGS 8,A01,087846,Staff,35,0,35,0
1653301414132,COGS 10,A01,094357,Hollan; James D.,53,0,60,7
1653301414132,COGS 10,A02,094358,Hollan; James D.,58,0,60,2
1653301414132,COGS 10,A03,094359,Hollan; James D.,59,0,60,1
1653301414132,COGS 10,A04,094360,Hollan; James D.,60,0,60,0
1653301414132,COGS 10,A05,094361,Hollan; James D.,60,0,60,0
1653301414686,COGS 11,A01,087848,Boyle; Mary E. T.,46,0,47,1
1653301414686,COGS 11,A02,087849,Boyle; Mary E. T.,44,0,47,3
1653301414686,COGS 11,A03,087850,Boyle; Mary E. T.,46,0,46,0
1653301415223,COGS 13,A01,087852,Davis; Joshua Daniel,56,0,60,4
1653301415223,COGS 13,A02,087853,Davis; Joshua Daniel,55,0,60,5
1653301415223,COGS 13,A03,087854,Davis; Joshua Daniel,57,0,60,3
1653301415223,COGS 13,A04,087855,Davis; Joshua Daniel,58,0,60,2
1653301415756,COGS 14A,A01,087857,Creel; Sarah,58,0,65,7
1653301415756,COGS 14A,A02,087858,Creel; Sarah,62,0,65,3
1653301415756,COGS 14A,A03,087859,Creel; Sarah,63,0,65,2
1653301415756,COGS 14A,A04,087860,Creel; Sarah,63,0,65,2
1653301416287,COGS 14B,A01,087862,Hoffman; Drew Ellen,56,0,60,4
1653301416287,COGS 14B,A02,087863,Hoffman; Drew Ellen,53,0,60,7
1653301416287,COGS 14B,A03,087864,Hoffman; Drew Ellen,60,0,60,0
1653301416826,COGS 15,A01,087866,Bergen; Benjamin,60,0,60,0
1653301416826,COGS 15,A02,087867,Bergen; Benjamin,59,0,60,1
1653301417374,COGS 17,A01,087869,Johnson; Christine M.,55,0,60,5
1653301417374,COGS 17,A02,087870,Johnson; Christine M.,58,0,60,2
1653301417374,COGS 17,A03,087871,Johnson; Christine M.,55,0,60,5
1653301417374,COGS 17,A04,087872,Johnson; Christine M.,60,0,60,0
1653301417374,COGS 17,A05,087873,Johnson; Christine M.,59,0,60,1
1653301417374,COGS 17,A06,087874,Johnson; Christine M.,60,0,60,0
1653301417898,COGS 18,A01,087876,Fleischer; Jason G,22,0,35,13
1653301417898,COGS 18,A02,087877,Fleischer; Jason G,31,0,35,4
1653301417898,COGS 18,A03,087878,Fleischer; Jason G,33,0,35,2
1653301417898,COGS 18,A04,087879,Fleischer; Jason G,33,0,35,2
1653301417898,COGS 18,A05,087880,Fleischer; Jason G,28,0,35,7
1653301417898,COGS 18,A06,087881,Fleischer; Jason G,34,0,35,1
1653301417898,COGS 18,A07,087882,Fleischer; Jason G,33,0,35,2
1653301417898,COGS 18,A08,087883,Fleischer; Jason G,31,0,35,4
1653301417898,COGS 18,A09,087884,Fleischer; Jason G,33,0,35,2
1653301418445,COGS 20,A01,090761,Borgo; David Garcia,5,0,5,0
1653301418445,COGS 20,A02,090762,Borgo; David Garcia,5,0,5,0
1653301418445,COGS 20,A03,090763,Borgo; David Garcia,5,0,5,0
1653301418993,COGS 87,A00,087885,Deak; Gedeon O.,20,0,20,0
1653301418993,COGS 87,B00,087886,Fleischer; Jason G,20,0,20,0
1653301419524,COGS 100,A01,087892,Kirsh; David Joel,56,0,60,4
1653301419524,COGS 100,A02,087893,Kirsh; David Joel,54,0,60,6
1653301419524,COGS 100,A03,087894,Kirsh; David Joel,54,0,60,6
1653301419524,COGS 100,A04,087895,Kirsh; David Joel,51,0,60,9
1653301419524,COGS 100,A05,087896,Kirsh; David Joel,48,0,60,12
1653301420058,COGS 101A,A01,087898,Hoffman; Drew Ellen,48,0,60,12
1653301420058,COGS 101A,A02,087899,Hoffman; Drew Ellen,58,0,60,2
1653301420058,COGS 101A,A03,087900,Hoffman; Drew Ellen,55,0,60,5
1653301420058,COGS 101A,A04,087901,Hoffman; Drew Ellen,58,0,60,2
1653301420058,COGS 101A,A05,087902,Hoffman; Drew Ellen,59,0,60,1
1653301420058,COGS 101A,A06,087903,Hoffman; Drew Ellen,56,0,60,4
1653301420582,COGS 101B,A01,087905,Barrera; Steven James,30,0,60,30
1653301420582,COGS 101B,A02,087906,Barrera; Steven James,52,0,60,8
1653301420582,COGS 101B,A03,087907,Barrera; Steven James,54,0,60,6
1653301421115,COGS 101C,A01,094240,Cooperrider; Kensy A,70,0,75,5
1653301421115,COGS 101C,A02,094241,Cooperrider; Kensy A,73,0,75,2
1653301421646,COGS 102A,A01,087909,Scott; Taylor Jackson,58,0,60,2
1653301421646,COGS 102A,A02,087910,Scott; Taylor Jackson,51,0,60,9
1653301422168,COGS 107A,A01,087912,Rangel; Lara M,51,0,60,9
1653301422168,COGS 107A,A02,087913,Rangel; Lara M,54,0,60,6
1653301422168,COGS 107A,A03,087914,Rangel; Lara M,47,0,60,13
1653301422168,COGS 107A,A04,087915,Rangel; Lara M,53,0,60,7
1653301422168,COGS 107A,A05,087916,Rangel; Lara M,55,0,60,5
1653301422168,COGS 107A,A06,087917,Rangel; Lara M,50,0,60,10
1653301422697,COGS 108,A01,087919,Fleischer; Jason G,14,0,60,46
1653301422697,COGS 108,A02,087920,Fleischer; Jason G,25,0,60,35
1653301422697,COGS 108,A03,087921,Fleischer; Jason G,40,0,60,20
1653301422697,COGS 108,A04,087922,Fleischer; Jason G,40,0,60,20
1653301422697,COGS 108,A05,087923,Fleischer; Jason G,48,0,60,12
1653301422697,COGS 108,A06,087924,Fleischer; Jason G,55,0,60,5
1653301422697,COGS 108,A07,087925,Fleischer; Jason G,42,0,57,15
1653301423224,COGS 110,A01,087927,Deak; Gedeon O.,30,0,35,5
1653301423224,COGS 110,A02,087928,Deak; Gedeon O.,33,0,35,2
1653301423753,COGS 116,A01,094228,Greene; Deanna Jacquelyn,51,0,52,1
1653301423753,COGS 116,A02,094229,Greene; Deanna Jacquelyn,52,0,52,0
1653301423753,COGS 116,A03,094230,Greene; Deanna Jacquelyn,50,0,52,2
1653301424290,COGS 118B,A01,087930,De Sa; Virginia,24,0,35,11
1653301424290,COGS 118B,A02,087931,De Sa; Virginia,28,0,35,7
1653301424290,COGS 118B,A03,087932,De Sa; Virginia,18,0,35,17
1653301424290,COGS 118B,A04,087933,De Sa; Virginia,29,0,35,6
1653301424290,COGS 118B,A05,087934,De Sa; Virginia,27,0,35,8
1653301424290,COGS 118B,A06,087935,De Sa; Virginia,27,0,35,8
1653301424831,COGS 120,A01,087937,Xia; Haijun,38,0,50,12
1653301424831,COGS 120,A02,087938,Xia; Haijun,32,0,50,18
1653301424831,COGS 120,A03,087939,Xia; Haijun,26,0,50,24
1653301424831,COGS 120,A04,087940,Xia; Haijun,1,0,50,49
1653301425358,COGS 128,A01,087944,Scott; Taylor Jackson,11,0,56,45
1653301425885,COGS 143,A01,087947,Johnson; Christine M.,23,0,40,17
1653301426409,COGS 153,A00,087949,Davis; Joshua Daniel,46,0,75,29
1653301426932,COGS 160,A00,087950,Deak; Gedeon O.,20,0,20,0
1653301426932,COGS 160,B00,094232,Saygin; Ayse P,40,0,40,0
1653301427461,COGS 175,A01,094238,Staff,27,0,40,13
1653301427985,COGS 187A,A01,087958,Kirsh; David Joel,22,0,50,28
1653301427985,COGS 187A,A02,087959,Kirsh; David Joel,30,0,50,20
1653301427985,COGS 187A,A03,087960,Kirsh; David Joel,34,0,45,11
1653301428512,COGS 190A,A00,087961,Staff,9999,0,9999,0
1653301429038,COGS 194,A00,087962,Hill; Seth J,9999,0,9999,0
1653301429578,COMM 10,A02,090628,Schmidt; Thomas Rainer,1,0,5,4
1653301429578,COMM 10,A03,090629,Schmidt; Thomas Rainer,3,0,5,2
1653301429578,COMM 10,A04,090630,Schmidt; Thomas Rainer,4,0,5,1
1653301429578,COMM 10,A05,090631,Schmidt; Thomas Rainer,4,0,5,1
1653301429578,COMM 10,A06,090632,Schmidt; Thomas Rainer,5,0,5,0
1653301429578,COMM 10,A07,090633,Schmidt; Thomas Rainer,5,0,5,0
1653301429578,COMM 10,A08,090634,Schmidt; Thomas Rainer,5,0,5,0
1653301429578,COMM 10,A09,090635,Schmidt; Thomas Rainer,5,0,5,0
1653301429578,COMM 10,A10,090636,Schmidt; Thomas Rainer,2,0,5,3
1653301429578,COMM 10,A11,090637,Schmidt; Thomas Rainer,4,0,5,1
1653301429578,COMM 10,A12,094013,Schmidt; Thomas Rainer,2,0,5,3
1653301429578,COMM 10,A13,094014,Schmidt; Thomas Rainer,5,0,5,0
1653301429578,COMM 10,A14,094015,Schmidt; Thomas Rainer,4,0,5,1
1653301429578,COMM 10,A15,094016,Schmidt; Thomas Rainer,5,0,5,0
1653301430108,COMM 100A,A01,090639,Irani; Lilly C,5,0,5,0
1653301430108,COMM 100A,A02,090640,Irani; Lilly C,4,0,5,1
1653301430108,COMM 100A,A03,090641,Irani; Lilly C,5,0,5,0
1653301430108,COMM 100A,A04,090642,Irani; Lilly C,3,0,5,2
1653301430108,COMM 100A,A05,090643,Irani; Lilly C,3,0,5,2
1653301430108,COMM 100A,A06,090644,Irani; Lilly C,4,0,5,1
1653301430108,COMM 100A,A07,090645,Irani; Lilly C,5,0,5,0
1653301430108,COMM 100A,A08,090646,Irani; Lilly C,5,0,5,0
1653301430108,COMM 100A,A09,090647,Irani; Lilly C,5,0,5,0
1653301430108,COMM 100A,A10,090648,Irani; Lilly C,5,0,5,0
1653301430108,COMM 100A,A11,090649,Irani; Lilly C,3,0,5,2
1653301430108,COMM 100A,A12,090650,Irani; Lilly C,5,0,5,0
1653301430631,COMM 101,A01,090652,Halm; Gavin Patrick,14,0,15,1
1653301430631,COMM 101,A02,090653,Halm; Gavin Patrick,14,0,15,1
1653301430631,COMM 101,A03,090654,Halm; Gavin Patrick,12,0,15,3
1653301430631,COMM 101,A04,090655,Halm; Gavin Patrick,13,0,15,2
1653301431155,COMM 101D,A00,090656,Halm; Gavin Patrick,14,0,15,1
1653301431679,COMM 101K,A00,090657,Ahn; Patricia Jeehyun,16,0,20,4
1653301432203,COMM 101T,A00,093701,Staff,20,0,20,0
1653301432748,COMM 102C,A01,090660,Staff,4,0,6,2
1653301432748,COMM 102C,A02,090661,Staff,6,0,6,0
1653301432748,COMM 102C,A03,090662,Staff,4,0,6,2
1653301433282,COMM 103D,A00,090663,Davis; Zeinabu I.,38,0,40,2
1653301433822,COMM 106E,A00,090667,Geiger; Richard Stuart,26,0,30,4
1653301434345,COMM 106G,A00,090668,Cordoba Azcarate; Matilde,25,0,30,5
1653301434881,COMM 108G,A00,090670,Walkover; Lillian B,30,0,30,0
1653301435431,COMM 109I,A00,090671,Tanaka; Stefan A.,30,0,30,0
1653301435954,COMM 109N,A00,094205,Hallin; Daniel C,25,0,30,5
1653301436493,COMM 110G,A00,090672,Whitworth-Smith; Andrew C,45,0,50,5
1653301437027,COMM 111P,A00,090673,Conner; Thomas Hartnell,27,0,30,3
1653301437560,COMM 111T,A00,090674,Iatarola; Briana Marie,27,0,30,3
1653301438105,COMM 124A,A00,090677,Sims; Christopher O,79,0,80,1
1653301438644,COMM 131,A00,090678,Fields; Gary,22,0,25,3
1653301439179,COMM 134,A00,090679,Kidman; Shawna F,16,0,25,9
1653301439727,COMM 146,A00,090680,Staff,22,0,25,3
1653301440265,COMM 166,A00,094493,Staff,24,0,25,1
1653301440813,COMM 172,A00,094066,Staff,23,0,25,2
1653301441336,COMM 182,A00,094063,Staff,25,0,25,0
1653301441881,COMM 190,A00,090686,Kidman; Shawna F,17,0,23,6
1653301441881,COMM 190,B00,090687,Irani; Lilly C,0,0,0,0
1653301441881,COMM 190,C00,090688,Keith; Kerry,21,0,23,2
1653301441881,COMM 190,D00,090689,Zilberg; Elana,23,0,23,0
1653301442414,COMM 194,A00,091600,Hill; Seth J,9999,0,9999,0
1653301442959,COMM 196A,A00,090690,Schmidt; Thomas Rainer,0,0,0,0
1653301443492,COMM 198,001,091397,Ahn; Patricia Jeehyun,9999,0,9999,0
1653301443492,COMM 198,002,091398,Alac; Morana,9999,0,9999,0
1653301443492,COMM 198,003,091399,Anderson; Patrick W.,9999,0,9999,0
1653301443492,COMM 198,004,091400,Boateng; Boatema,9999,0,9999,0
1653301443492,COMM 198,005,091401,Booker; Angela N,9999,0,9999,0
1653301443492,COMM 198,008,091402,Cordoba Azcarate; Matilde,9999,0,9999,0
1653301443492,COMM 198,009,091403,Davis; Zeinabu I.,9999,0,9999,0
1653301443492,COMM 198,010,091404,Dewaard; Andrew Michael,9999,0,9999,0
1653301443492,COMM 198,011,091405,Dominguez Rubio; Fernando,9999,0,9999,0
1653301443492,COMM 198,012,091406,Fattal; Alexander Leor,9999,0,9999,0
1653301443492,COMM 198,013,091407,Fields; Gary,9999,0,9999,0
1653301443492,COMM 198,014,091408,Gates; Kelly,9999,0,9999,0
1653301443492,COMM 198,015,091409,Goldfarb; Brian,9999,0,9999,0
1653301443492,COMM 198,018,091410,Hill; Erin Truesdell,9999,0,9999,0
1653301443492,COMM 198,019,091411,Horwitz; Robert B,9999,0,9999,0
1653301443492,COMM 198,021,091412,Irani; Lilly C,9999,0,9999,0
1653301443492,COMM 198,022,091413,Jack; Caroline Sarah,9999,0,9999,0
1653301443492,COMM 198,023,091414,Kidman; Shawna F,9999,0,9999,0
1653301443492,COMM 198,024,091415,Martinico; Daniel J,9999,0,9999,0
1653301443492,COMM 198,026,091416,Schmidt; Thomas Rainer,9999,0,9999,0
1653301443492,COMM 198,027,091417,Serlin; David,9999,0,9999,0
1653301443492,COMM 198,028,091418,Sims; Christopher O,9999,0,9999,0
1653301443492,COMM 198,029,091419,Tanaka; Stefan A.,9999,0,9999,0
1653301443492,COMM 198,030,091420,Zilberg; Elana,9999,0,9999,0
1653301443492,COMM 198,031,091421,Walkover; Lillian B,9999,0,9999,0
1653301443492,COMM 198,032,091422,Geiger; Richard Stuart,9999,0,9999,0
1653301444047,CSE 8A,A50,089985,Soosai Raj; Adalbert Geral,7,0,10,3
1653301444047,CSE 8A,A51,089986,Soosai Raj; Adalbert Geral,1,0,10,9
1653301444047,CSE 8A,A52,089987,Soosai Raj; Adalbert Geral,5,0,10,5
1653301444047,CSE 8A,A53,089988,Soosai Raj; Adalbert Geral,9,0,10,1
1653301444047,CSE 8A,B50,089990,Soosai Raj; Adalbert Geral,0,0,10,10
1653301444047,CSE 8A,B51,089991,Soosai Raj; Adalbert Geral,5,0,10,5
1653301444047,CSE 8A,B52,089992,Soosai Raj; Adalbert Geral,5,0,10,5
1653301444047,CSE 8A,B53,089993,Soosai Raj; Adalbert Geral,9,0,10,1
1653301444047,CSE 8A,C50,089995,Lerner; Sorin,0,0,10,10
1653301444047,CSE 8A,C51,089996,Lerner; Sorin,6,0,10,4
1653301444047,CSE 8A,C52,089997,Lerner; Sorin,9,0,10,1
1653301444047,CSE 8A,C53,089998,Lerner; Sorin,8,0,10,2
1653301444582,CSE 8B,A01,090000,Ochoa; Benjamin Lawrence,94,0,100,6
1653301445118,CSE 11,A01,090002,Cao; Yingjun,39,0,49,10
1653301445118,CSE 11,B01,090004,Cao; Yingjun,45,0,49,4
1653301445118,CSE 11,C01,090006,Cao; Yingjun,35,0,49,14
1653301445649,CSE 12,A01,090008,Staff,73,0,73,0
1653301445649,CSE 12,B01,090010,Staff,67,0,73,6
1653301445649,CSE 12,C01,090012,Staff,60,0,73,13
1653301446183,CSE 15L,A01,090014,Politz; Joseph Gibbs,4,0,10,6
1653301446183,CSE 15L,A02,090015,Politz; Joseph Gibbs,7,0,10,3
1653301446183,CSE 15L,A03,090016,Politz; Joseph Gibbs,9,0,10,1
1653301446183,CSE 15L,A04,090017,Politz; Joseph Gibbs,9,0,10,1
1653301446183,CSE 15L,A05,090018,Politz; Joseph Gibbs,9,0,10,1
1653301446183,CSE 15L,B01,090020,Politz; Joseph Gibbs,8,0,10,2
1653301446183,CSE 15L,B02,090021,Politz; Joseph Gibbs,6,0,10,4
1653301446183,CSE 15L,B03,090022,Politz; Joseph Gibbs,7,0,10,3
1653301446183,CSE 15L,B04,090023,Politz; Joseph Gibbs,7,0,10,3
1653301446183,CSE 15L,B05,090024,Politz; Joseph Gibbs,7,0,10,3
1653301446720,CSE 20,A01,090026,Staff,204,0,210,6
1653301447257,CSE 21,A01,090028,Impagliazzo; Russell,0,0,0,0
1653301447257,CSE 21,A02,094488,Impagliazzo; Russell,0,0,0,0
1653301447257,CSE 21,A03,094489,Impagliazzo; Russell,0,0,0,0
1653301447799,CSE 30,A01,092463,Muller; P Keith,73,0,100,27
1653301447799,CSE 30,A02,092464,Staff,97,0,100,3
1653301448331,CSE 87,A00,094193,Moshiri; Alexander Niema,20,0,20,0
1653301448854,CSE 95,A00,090030,Minnes Kemp; Mor Mia,35,0,35,0
1653301448854,CSE 95,B00,093883,Minnes Kemp; Mor Mia,35,0,35,0
1653301448854,CSE 95,C00,093885,Minnes Kemp; Mor Mia,35,0,35,0
1653301449383,CSE 100,A01,090033,Moshiri; Alexander Niema,68,0,114,46
1653301449910,CSE 100R,A01,093837,Moshiri; Alexander Niema,334,0,350,16
1653301450435,CSE 101,A01,090035,Saha; Barna,152,0,237,85
1653301450971,CSE 103,A01,090037,Freund; Yoav,60,0,75,15
1653301451498,CSE 105,A01,090039,Lovett; Shachar,201,0,225,24
1653301452022,CSE 106,A50,090042,Paturi; Ramamohan,11,0,30,19
1653301452561,CSE 107,A01,090044,Bellare; Mihir,94,0,120,26
1653301453099,CSE 110,A50,090047,Powell; Thomas Allan,39,0,50,11
1653301453099,CSE 110,A51,090048,Powell; Thomas Allan,39,0,50,11
1653301453099,CSE 110,A52,090049,Powell; Thomas Allan,48,0,50,2
1653301453099,CSE 110,A53,090050,Powell; Thomas Allan,49,0,50,1
1653301453099,CSE 110,A54,090051,Powell; Thomas Allan,45,0,50,5
1653301453099,CSE 110,A55,090052,Powell; Thomas Allan,50,0,50,0
1653301453099,CSE 110,A56,090053,Powell; Thomas Allan,49,0,50,1
1653301453099,CSE 110,A57,090054,Powell; Thomas Allan,41,0,45,4
1653301453628,CSE 118,A00,094897,Weibel; Nadir,0,0,0,0
1653301454157,CSE 120,A01,090056,Voelker; Geoffrey M.,226,0,300,74
1653301454683,CSE 124,A01,090058,Porter; George M,123,0,189,66
1653301455307,CSE 127,A01,090060,Savage; Stefan,46,0,189,143
1653301455833,CSE 130,A01,090062,Polikarpova; Nadezhda,171,0,189,18
1653301456358,CSE 132A,A01,090064,Deutsch; Alin Bernard,46,0,189,143
1653301456893,CSE 140,A01,090068,Eldon; John,169,0,196,27
1653301456893,CSE 140,B01,090070,Orailoglu; Alex,48,0,49,1
1653301457425,CSE 140L,A01,090072,Eldon; John,161,0,192,31
1653301457425,CSE 140L,B01,090075,Orailoglu; Alex,44,0,49,5
1653301457948,CSE 142,A01,090078,Porter; Leonard Emerson,86,0,146,60
1653301457948,CSE 142,B01,090080,Porter; Leonard Emerson,107,0,146,39
1653301458495,CSE 142L,A01,090082,Swanson; Steven James,48,0,146,98
1653301458495,CSE 142L,B01,090084,Swanson; Steven James,120,0,146,26
1653301459035,CSE 151B,A01,090088,Cottrell; Garrison W,258,0,328,70
1653301459559,CSE 152A,A01,090090,Chandraker; Manmohan Krishna,153,0,189,36
1653301460089,CSE 158,A01,090092,McAuley; Julian John,84,0,197,113
1653301460614,CSE 158R,A01,090094,McAuley; Julian John,306,0,353,47
1653301461150,CSE 167,A01,090096,Chern; Albert Ren-Haur,165,0,189,24
1653301461674,CSE 170,A01,090098,Vaccaro; Kristen Marie,20,0,20,0
1653301461674,CSE 170,A02,090099,Vaccaro; Kristen Marie,14,0,20,6
1653301461674,CSE 170,A03,090100,Vaccaro; Kristen Marie,14,0,20,6
1653301461674,CSE 170,A04,090101,Vaccaro; Kristen Marie,14,0,20,6
1653301461674,CSE 170,A05,090102,Vaccaro; Kristen Marie,18,0,20,2
1653301462199,CSE 190,A00,090103,Shalev; Aaron D,40,0,40,0
1653301462199,CSE 190,B00,090104,Vaccaro; Kristen Marie,100,0,100,0
1653301462199,CSE 190,C00,090105,Pannuto; Patrick William,25,0,25,0
1653301462725,CSE 191,A00,093848,Minnes Kemp; Mor Mia,9999,0,9999,0
1653301463248,CSE 193,A01,090107,Elsherif; May Elhussein,49,0,49,0
1653301463776,CSE 194,A01,090109,Munyaka; Imani N. S.,20,0,49,29
1653301464299,CSS 1,A01,086486,Staff,22,0,24,2
1653301464299,CSS 1,A02,086487,Staff,21,0,24,3
1653301464299,CSS 1,A03,086488,Staff,20,0,24,4
1653301464299,CSS 1,A04,086489,Staff,23,0,24,1
1653301464857,DOC 1,A01,086773,Solomon; Amanda Lee Albaniel,0,0,0,0
1653301464857,DOC 1,A02,086774,Solomon; Amanda Lee Albaniel,0,0,0,0
1653301464857,DOC 1,A03,086775,Solomon; Amanda Lee Albaniel,5,0,6,1
1653301464857,DOC 1,A04,086776,Solomon; Amanda Lee Albaniel,6,0,6,0
1653301464857,DOC 1,A05,086777,Solomon; Amanda Lee Albaniel,6,0,6,0
1653301464857,DOC 1,A06,086778,Solomon; Amanda Lee Albaniel,6,0,6,0
1653301464857,DOC 1,A07,086779,Solomon; Amanda Lee Albaniel,5,0,6,1
1653301464857,DOC 1,A08,086849,Solomon; Amanda Lee Albaniel,6,0,6,0
1653301464857,DOC 1,A09,086780,Solomon; Amanda Lee Albaniel,6,0,6,0
1653301464857,DOC 1,A10,086781,Solomon; Amanda Lee Albaniel,6,0,6,0
1653301464857,DOC 1,A11,086782,Solomon; Amanda Lee Albaniel,5,0,6,1
1653301464857,DOC 1,A12,086783,Solomon; Amanda Lee Albaniel,6,0,6,0
1653301464857,DOC 1,A13,086784,Solomon; Amanda Lee Albaniel,6,0,6,0
1653301464857,DOC 1,A14,086785,Solomon; Amanda Lee Albaniel,6,0,6,0
1653301464857,DOC 1,A15,086786,Solomon; Amanda Lee Albaniel,6,0,6,0
1653301464857,DOC 1,A16,086787,Solomon; Amanda Lee Albaniel,6,0,6,0
1653301464857,DOC 1,A17,086788,Solomon; Amanda Lee Albaniel,0,0,0,0
1653301464857,DOC 1,A18,086789,Solomon; Amanda Lee Albaniel,0,0,0,0
1653301464857,DOC 1,B01,086791,Solomon; Amanda Lee Albaniel,6,0,6,0
1653301464857,DOC 1,B02,086792,Solomon; Amanda Lee Albaniel,6,0,6,0
1653301464857,DOC 1,B03,086793,Solomon; Amanda Lee Albaniel,6,0,6,0
1653301464857,DOC 1,B04,086794,Solomon; Amanda Lee Albaniel,6,0,6,0
1653301464857,DOC 1,B05,086795,Solomon; Amanda Lee Albaniel,3,0,6,3
1653301464857,DOC 1,B06,086796,Solomon; Amanda Lee Albaniel,6,0,6,0
1653301464857,DOC 1,B07,086797,Solomon; Amanda Lee Albaniel,6,0,6,0
1653301464857,DOC 1,B08,086798,Solomon; Amanda Lee Albaniel,6,0,6,0
1653301464857,DOC 1,B09,086799,Solomon; Amanda Lee Albaniel,6,0,6,0
1653301464857,DOC 1,B10,086800,Solomon; Amanda Lee Albaniel,6,0,6,0
1653301464857,DOC 1,B11,086801,Solomon; Amanda Lee Albaniel,5,0,6,1
1653301464857,DOC 1,B12,086802,Solomon; Amanda Lee Albaniel,6,0,6,0
1653301464857,DOC 1,B13,086803,Solomon; Amanda Lee Albaniel,6,0,6,0
1653301464857,DOC 1,B14,086804,Solomon; Amanda Lee Albaniel,6,0,6,0
1653301464857,DOC 1,B15,086805,Solomon; Amanda Lee Albaniel,5,0,6,1
1653301464857,DOC 1,B16,086806,Solomon; Amanda Lee Albaniel,6,0,6,0
1653301464857,DOC 1,B17,086807,Solomon; Amanda Lee Albaniel,0,0,0,0
1653301464857,DOC 1,B18,086808,Solomon; Amanda Lee Albaniel,0,0,0,0
1653301464857,DOC 1,C01,086810,Strom; Megan C.,6,0,6,0
1653301464857,DOC 1,C02,086811,Strom; Megan C.,5,0,6,1
1653301464857,DOC 1,C03,086812,Strom; Megan C.,6,0,6,0
1653301464857,DOC 1,C04,086813,Strom; Megan C.,5,0,6,1
1653301464857,DOC 1,C05,086814,Strom; Megan C.,5,0,6,1
1653301464857,DOC 1,C06,086815,Strom; Megan C.,6,0,6,0
1653301464857,DOC 1,C07,086816,Strom; Megan C.,6,0,6,0
1653301464857,DOC 1,C08,086817,Strom; Megan C.,6,0,6,0
1653301464857,DOC 1,C09,086818,Strom; Megan C.,6,0,6,0
1653301464857,DOC 1,C10,086819,Strom; Megan C.,6,0,6,0
1653301464857,DOC 1,C11,086820,Strom; Megan C.,6,0,6,0
1653301464857,DOC 1,C12,086821,Strom; Megan C.,6,0,6,0
1653301464857,DOC 1,C13,086822,Strom; Megan C.,6,0,6,0
1653301464857,DOC 1,C14,086823,Strom; Megan C.,6,0,6,0
1653301464857,DOC 1,C15,086824,Strom; Megan C.,6,0,6,0
1653301464857,DOC 1,C16,086825,Strom; Megan C.,6,0,6,0
1653301464857,DOC 1,C17,086826,Strom; Megan C.,0,0,0,0
1653301464857,DOC 1,C18,086827,Strom; Megan C.,0,0,0,0
1653301464857,DOC 1,D01,086829,Strom; Megan C.,6,0,6,0
1653301464857,DOC 1,D02,086830,Strom; Megan C.,6,0,6,0
1653301464857,DOC 1,D03,086831,Strom; Megan C.,5,0,6,1
1653301464857,DOC 1,D04,086832,Strom; Megan C.,6,0,6,0
1653301464857,DOC 1,D05,086833,Strom; Megan C.,6,0,6,0
1653301464857,DOC 1,D06,086834,Strom; Megan C.,6,0,6,0
1653301464857,DOC 1,D07,086835,Strom; Megan C.,6,0,6,0
1653301464857,DOC 1,D08,086836,Strom; Megan C.,6,0,6,0
1653301464857,DOC 1,D09,086837,Strom; Megan C.,0,0,0,0
1653301464857,DOC 1,D10,086838,Strom; Megan C.,0,0,0,0
1653301464857,DOC 1,D11,086839,Strom; Megan C.,6,0,6,0
1653301464857,DOC 1,D12,086840,Strom; Megan C.,6,0,6,0
1653301464857,DOC 1,D13,086841,Strom; Megan C.,6,0,6,0
1653301464857,DOC 1,D14,086842,Strom; Megan C.,5,0,6,1
1653301464857,DOC 1,D15,086843,Strom; Megan C.,6,0,6,0
1653301464857,DOC 1,D16,086844,Strom; Megan C.,5,0,6,1
1653301465381,DOC 100D,A00,086845,Pass; Natalye Joann,0,0,0,0
1653301465381,DOC 100D,B00,086846,Pass; Natalye Joann,21,0,25,4
1653301465381,DOC 100D,C00,086847,Pass; Natalye Joann,23,0,25,2
1653301465906,DSC 10,A01,088092,Tiefenbruck; Janine LoBue,13,0,15,2
1653301465906,DSC 10,B01,088095,Tiefenbruck; Janine LoBue,9,0,15,6
1653301465906,DSC 10,C01,088098,Rampure; Suraj,0,0,15,15
1653301466435,DSC 20,A01,088101,Langlois; Marina,148,0,150,2
1653301466958,DSC 30,A01,088105,Langlois; Marina,74,0,75,1
1653301467483,DSC 40A,A01,088107,Rampure; Suraj,97,0,100,3
1653301467483,DSC 40A,B01,088109,Rampure; Suraj,99,0,100,1
1653301468007,DSC 40B,A01,088111,Eldridge; Justin Matthew,73,0,75,2
1653301468007,DSC 40B,B01,088113,Wang; Yusu,75,0,75,0
1653301468533,DSC 80,A01,088115,Eldridge; Justin Matthew,95,0,100,5
1653301469061,DSC 95,A01,088117,Langlois; Marina,20,0,20,0
1653301469595,DSC 96,A00,088118,Liao; Soohyun Nam,50,0,50,0
1653301470122,DSC 100,A01,088120,Salimi; Babak,164,0,175,11
1653301470646,DSC 102,A01,094320,Kumar; Arun Kumar,77,0,125,48
1653301471201,DSC 180A,A01,088124,Fraenkel; Aaron Mcmillan,0,0,0,0
1653301471201,DSC 180A,A02,088125,Fraenkel; Aaron Mcmillan,0,0,0,0
1653301471201,DSC 180A,A03,088126,Fraenkel; Aaron Mcmillan,0,0,0,0
1653301471201,DSC 180A,A04,088127,Fraenkel; Aaron Mcmillan,0,0,0,0
1653301471201,DSC 180A,A05,088128,Fraenkel; Aaron Mcmillan,0,0,0,0
1653301471201,DSC 180A,A06,088129,Fraenkel; Aaron Mcmillan,0,0,0,0
1653301471201,DSC 180A,A07,088130,Fraenkel; Aaron Mcmillan,0,0,0,0
1653301471201,DSC 180A,A08,088131,Fraenkel; Aaron Mcmillan,0,0,0,0
1653301471201,DSC 180A,A09,088132,Fraenkel; Aaron Mcmillan,0,0,0,0
1653301471201,DSC 180A,A10,088133,Fraenkel; Aaron Mcmillan,0,0,0,0
1653301471201,DSC 180A,A11,088134,Fraenkel; Aaron Mcmillan,0,0,0,0
1653301471201,DSC 180A,A12,088135,Fraenkel; Aaron Mcmillan,0,0,0,0
1653301471201,DSC 180A,A13,088136,Fraenkel; Aaron Mcmillan,0,0,0,0
1653301471201,DSC 180A,A14,088137,Fraenkel; Aaron Mcmillan,0,0,0,0
1653301471201,DSC 180A,A15,088138,Fraenkel; Aaron Mcmillan,0,0,0,0
1653301471201,DSC 180A,B01,088141,Fraenkel; Aaron Mcmillan,0,0,0,0
1653301471201,DSC 180A,B02,088142,Fraenkel; Aaron Mcmillan,0,0,0,0
1653301471201,DSC 180A,B03,088143,Fraenkel; Aaron Mcmillan,0,0,0,0
1653301471201,DSC 180A,B04,088144,Fraenkel; Aaron Mcmillan,0,0,0,0
1653301471201,DSC 180A,B05,088145,Fraenkel; Aaron Mcmillan,0,0,0,0
1653301471201,DSC 180A,B06,088146,Fraenkel; Aaron Mcmillan,0,0,0,0
1653301471201,DSC 180A,B07,088147,Fraenkel; Aaron Mcmillan,0,0,0,0
1653301471201,DSC 180A,B08,088148,Fraenkel; Aaron Mcmillan,0,0,0,0
1653301471201,DSC 180A,B09,088149,Fraenkel; Aaron Mcmillan,0,0,0,0
1653301471201,DSC 180A,B10,088150,Fraenkel; Aaron Mcmillan,0,0,0,0
1653301471201,DSC 180A,B11,088151,Fraenkel; Aaron Mcmillan,0,0,0,0
1653301471201,DSC 180A,B12,088152,Fraenkel; Aaron Mcmillan,0,0,0,0
1653301471201,DSC 180A,B13,088153,Fraenkel; Aaron Mcmillan,0,0,0,0
1653301471201,DSC 180A,B14,088154,Fraenkel; Aaron Mcmillan,0,0,0,0
1653301471201,DSC 180A,B15,088155,Fraenkel; Aaron Mcmillan,0,0,0,0
1653301471724,DSC 190,A01,088158,Mishne; Gal,48,0,50,2
1653301471724,DSC 190,B01,088160,Silberman; Jack,16,0,21,5
1653301472247,DSC 197,001,088161,Eldridge; Justin Matthew,9999,0,9999,0
1653301472771,DSGN 1,A01,087888,Meyer; Michael Wayne,49,0,53,4
1653301472771,DSGN 1,A02,087889,Meyer; Michael Wayne,47,0,53,6
1653301472771,DSGN 1,A03,087890,Meyer; Michael Wayne,43,0,53,10
1653301473293,DSGN 100,A01,087983,Dow; Steven P,39,0,40,1
1653301473293,DSGN 100,A02,087984,Dow; Steven P,40,0,40,0
1653301473293,DSGN 100,A03,087985,Dow; Steven P,34,0,40,6
1653301473816,DSGN 118,A01,087987,Xia; Haijun,55,0,60,5
1653301473816,DSGN 118,A02,087988,Xia; Haijun,56,0,60,4
1653301474344,DSGN 119,A00,087989,Staff,51,0,70,19
1653301474881,ECE 5,A01,090699,Morris; Karcher William,0,0,0,0
1653301474881,ECE 5,A02,090700,Morris; Karcher William,0,0,0,0
1653301474881,ECE 5,A03,090701,Morris; Karcher William,0,0,0,0
1653301474881,ECE 5,A04,090702,Morris; Karcher William,0,0,0,0
1653301474881,ECE 5,A05,090703,Morris; Karcher William,0,0,0,0
1653301474881,ECE 5,A06,090704,Morris; Karcher William,0,0,0,0
1653301475409,ECE 15,A01,090706,Schurgers; Curt,0,0,0,0
1653301475409,ECE 15,A02,090707,Schurgers; Curt,0,0,0,0
1653301475958,ECE 16,A01,090709,Khoshabeh; Ramsin,24,0,30,6
1653301476513,ECE 17,A01,090711,Gilja; Vikash,55,0,60,5
1653301477043,ECE 25,A50,090714,Liu; Zhaowei,0,0,0,0
1653301477043,ECE 25,A51,090715,Liu; Zhaowei,0,0,0,0
1653301477043,ECE 25,A52,090716,Liu; Zhaowei,0,0,0,0
1653301477568,ECE 30,A50,094300,Mir Arabbaygi; Siavash,25,0,30,5
1653301477568,ECE 30,A51,094301,Mir Arabbaygi; Siavash,29,0,30,1
1653301477568,ECE 30,A52,094302,Mir Arabbaygi; Siavash,27,0,30,3
1653301477568,ECE 30,A53,094303,Mir Arabbaygi; Siavash,29,0,30,1
1653301477568,ECE 30,A54,094304,Mir Arabbaygi; Siavash,25,0,25,0
1653301478114,ECE 35,A50,090720,Schurgers; Curt,0,0,0,0
1653301478114,ECE 35,A51,090721,Schurgers; Curt,0,0,0,0
1653301478114,ECE 35,A52,090722,Schurgers; Curt,0,0,0,0
1653301478114,ECE 35,A53,090723,Schurgers; Curt,0,0,0,0
1653301478114,ECE 35,A54,090724,Schurgers; Curt,0,0,0,0
1653301478114,ECE 35,A55,090725,Schurgers; Curt,0,0,0,0
1653301478114,ECE 35,B50,090729,Schurgers; Curt,0,0,0,0
1653301478114,ECE 35,B51,090730,Schurgers; Curt,0,0,0,0
1653301478114,ECE 35,B52,090731,Schurgers; Curt,0,0,0,0
1653301478114,ECE 35,B53,090732,Schurgers; Curt,0,0,0,0
1653301478114,ECE 35,B54,090733,Schurgers; Curt,0,0,0,0
1653301478114,ECE 35,B55,090734,Schurgers; Curt,0,0,0,0
1653301478644,ECE 45,A01,090736,Franceschetti; Massimo,56,0,57,1
1653301478644,ECE 45,A02,090737,Franceschetti; Massimo,50,0,58,8
1653301479186,ECE 65,A50,090741,Baghdadchi; Saharnaz,13,0,15,2
1653301479186,ECE 65,A51,090742,Baghdadchi; Saharnaz,5,0,10,5
1653301479186,ECE 65,A52,090743,Baghdadchi; Saharnaz,14,0,15,1
1653301479186,ECE 65,A53,090744,Baghdadchi; Saharnaz,8,0,10,2
1653301479186,ECE 65,A54,094865,Baghdadchi; Saharnaz,14,0,15,1
1653301479186,ECE 65,A55,094866,Baghdadchi; Saharnaz,9,0,10,1
1653301479186,ECE 65,A56,094867,Baghdadchi; Saharnaz,14,0,15,1
1653301479186,ECE 65,A57,094868,Baghdadchi; Saharnaz,15,0,15,0
1653301479186,ECE 65,A58,094869,Baghdadchi; Saharnaz,10,0,10,0
1653301479720,ECE 100,A01,090746,Baghdadchi; Saharnaz,16,0,20,4
1653301479720,ECE 100,A02,090747,Baghdadchi; Saharnaz,20,0,20,0
1653301479720,ECE 100,A03,090748,Baghdadchi; Saharnaz,18,0,20,2
1653301479720,ECE 100,A04,090749,Baghdadchi; Saharnaz,20,0,20,0
1653301479720,ECE 100,A05,090750,Baghdadchi; Saharnaz,18,0,20,2
1653301479720,ECE 100,A06,090751,Baghdadchi; Saharnaz,18,0,20,2
1653301479720,ECE 100,A07,090752,Baghdadchi; Saharnaz,20,0,20,0
1653301480267,ECE 101,A01,090754,Siegel; Paul H.,62,0,75,13
1653301480267,ECE 101,A02,090755,Siegel; Paul H.,71,0,75,4
1653301480792,ECE 102,A00,090756,Hsueh; Tzu-Chien,57,0,75,18
1653301481340,ECE 103,A01,090767,Lo; Yu-Hwa,45,0,50,5
1653301481888,ECE 107,A01,090769,Lomakin; Vitaliy,72,0,75,3
1653301482439,ECE 109,A01,090771,Zeger; Kenneth A.,176,0,180,4
1653301482971,ECE 111,A01,090774,Koushanfar; Farinaz,100,0,120,20
1653301483508,ECE 121A,A50,090777,Esmaili; Gholamreza,17,0,24,7
1653301483508,ECE 121A,A51,090778,Esmaili; Gholamreza,9,0,24,15
1653301483508,ECE 121A,A52,090779,Esmaili; Gholamreza,22,0,24,2
1653301484033,ECE 128A,A00,090780,Staff,40,0,70,30
1653301484579,ECE 135A,A00,090781,Kuzum; Duygu,30,0,30,0
1653301485130,ECE 143,A00,090782,Unpingco; Jose H.,0,0,0,2
1653301485679,ECE 148,A01,090784,Staff,32,0,32,0
1653301486240,ECE 155,A01,090786,Milstein; Laurence B.,16,0,20,4
1653301486773,ECE 158A,A01,090788,Franceschetti; Massimo,56,0,65,9
1653301487296,ECE 161A,A01,090790,Rao; Bhaskar D.,103,0,115,12
1653301487820,ECE 164,A00,090791,Hall; Drew A.,87,0,115,28
1653301488350,ECE 166,A50,090796,Rebeiz; Gabriel,6,0,12,6
1653301488350,ECE 166,A51,090797,Rebeiz; Gabriel,9,0,12,3
1653301488350,ECE 166,A52,090799,Rebeiz; Gabriel,1,0,12,11
1653301488350,ECE 166,A53,090800,Rebeiz; Gabriel,6,0,12,6
1653301488350,ECE 166,A54,094335,Rebeiz; Gabriel,11,0,12,1
1653301488350,ECE 166,A55,094336,Rebeiz; Gabriel,12,0,12,0
1653301488350,ECE 166,A56,094349,Rebeiz; Gabriel,13,0,15,2
1653301488350,ECE 166,A57,094350,Rebeiz; Gabriel,14,0,15,1
1653301488887,ECE 171A,A01,090802,Atanasov; Nikolay A.,45,0,60,15
1653301489428,ECE 171B,A01,090804,Shi; Yuanyuan,44,0,50,6
1653301489955,ECE 174,A01,090806,Pal; Piya,125,0,146,21
1653301490502,ECE 182,A01,090808,Lomakin; Vitaliy,23,0,23,0
1653301491043,ECE 187,A00,090809,Liu; Zhaowei,19,0,20,1
1653301491571,ECE 196,A00,090812,Morris; Karcher William,19,0,24,5
1653301491571,ECE 196,B00,094833,Morris; Karcher William,24,0,24,0
1653301492098,ECE 197,001,090813,Sievenpiper; Daniel F.,9999,0,9999,0
1653301492636,ECON 1,A01,092535,Staff,0,0,0,0
1653301492636,ECON 1,A02,092536,Staff,0,0,0,0
1653301492636,ECON 1,A03,092537,Staff,0,0,0,0
1653301492636,ECON 1,A04,092538,Staff,0,0,0,0
1653301492636,ECON 1,A05,092539,Staff,0,0,0,0
1653301492636,ECON 1,B01,092540,Ma; Alyson Chan,42,0,45,3
1653301492636,ECON 1,B02,092541,Ma; Alyson Chan,45,0,45,0
1653301492636,ECON 1,B03,092542,Ma; Alyson Chan,45,0,45,0
1653301492636,ECON 1,B04,092543,Ma; Alyson Chan,40,0,40,0
1653301492636,ECON 1,B05,092544,Ma; Alyson Chan,40,0,40,0
1653301492636,ECON 1,C01,092545,Tocoian; Oana,0,0,0,0
1653301492636,ECON 1,C02,092546,Tocoian; Oana,0,0,0,0
1653301492636,ECON 1,C03,092547,Tocoian; Oana,0,0,0,0
1653301492636,ECON 1,C04,092548,Tocoian; Oana,0,0,0,0
1653301492636,ECON 1,D01,094253,Levkoff; Steven B.,41,0,45,4
1653301492636,ECON 1,D02,094254,Levkoff; Steven B.,44,0,45,1
1653301492636,ECON 1,D03,094255,Levkoff; Steven B.,45,0,45,0
1653301492636,ECON 1,D04,094256,Levkoff; Steven B.,36,0,40,4
1653301492636,ECON 1,D05,094257,Levkoff; Steven B.,40,0,40,0
1653301493179,ECON 2,A01,092549,Staff,0,0,0,0
1653301493179,ECON 2,A02,092550,Staff,0,0,0,0
1653301493179,ECON 2,A03,092551,Staff,0,0,0,0
1653301493705,ECON 4,A01,092554,Levkoff; Steven B.,29,0,30,1
1653301493705,ECON 4,A02,092555,Levkoff; Steven B.,27,0,30,3
1653301493705,ECON 4,A03,092556,Levkoff; Steven B.,30,0,30,0
1653301494244,ECON 100A,A01,092557,Newhouse; Herbert S,23,0,30,7
1653301494244,ECON 100A,A02,092558,Newhouse; Herbert S,28,0,30,2
1653301494244,ECON 100A,A03,092559,Newhouse; Herbert S,29,0,30,1
1653301494244,ECON 100A,A04,092560,Newhouse; Herbert S,35,0,35,0
1653301494244,ECON 100A,B01,092561,Newhouse; Herbert S,20,0,30,10
1653301494244,ECON 100A,B02,092562,Newhouse; Herbert S,28,0,30,2
1653301494244,ECON 100A,B03,092563,Newhouse; Herbert S,15,0,30,15
1653301494244,ECON 100A,B04,092564,Newhouse; Herbert S,35,0,35,0
1653301494799,ECON 100B,A01,092565,Galperti; Simone,27,0,30,3
1653301494799,ECON 100B,A02,092566,Galperti; Simone,18,0,20,2
1653301494799,ECON 100B,A03,094496,Staff,27,0,30,3
1653301494799,ECON 100B,A04,094497,Staff,16,0,20,4
1653301494799,ECON 100B,B01,092567,Galperti; Simone,16,0,25,9
1653301495325,ECON 100C,A01,092569,Du; Songzi,62,0,75,13
1653301495325,ECON 100C,B01,092570,Du; Songzi,70,0,75,5
1653301495325,ECON 100C,B02,094258,Du; Songzi,75,0,75,0
1653301495868,ECON 100CH,A00,088284,Andreoni; James,20,0,20,0
1653301496410,ECON 109,A01,092572,Watson; Joel Christopher,68,0,75,7
1653301496410,ECON 109,B01,092573,Watson; Joel Christopher,68,0,75,7
1653301496956,ECON 110A,A01,092574,Alon; Titan Michael,12,0,25,13
1653301496956,ECON 110A,A02,092575,Alon; Titan Michael,24,0,25,1
1653301496956,ECON 110A,B01,092576,Alon; Titan Michael,24,0,25,1
1653301496956,ECON 110A,B02,092577,Alon; Titan Michael,25,0,25,0
1653301497479,ECON 110B,A01,092578,Trottner; Fabian Gunter We,16,0,25,9
1653301497479,ECON 110B,A02,094054,Trottner; Fabian Gunter We,23,0,25,2
1653301497479,ECON 110B,B01,092579,Trottner; Fabian Gunter We,7,0,25,18
1653301497479,ECON 110B,B02,094055,Trottner; Fabian Gunter We,24,0,25,1
1653301498003,ECON 116,A00,088291,Lowes; Sara Rachel,58,0,70,12
1653301498527,ECON 120A,A01,092580,Elliott; Graham,18,0,25,7
1653301498527,ECON 120A,A02,092581,Elliott; Graham,22,0,25,3
1653301498527,ECON 120A,B01,092582,Elliott; Graham,18,0,25,7
1653301498527,ECON 120A,B02,092583,Elliott; Graham,20,0,25,5
1653301498527,ECON 120A,C01,092584,Tocoian; Oana,27,0,30,3
1653301498527,ECON 120A,C02,092585,Tocoian; Oana,28,0,30,2
1653301498527,ECON 120A,C03,092586,Tocoian; Oana,40,0,40,0
1653301499051,ECON 120B,A01,092587,Candido; Maria Teresa,58,0,70,12
1653301499051,ECON 120B,A02,092588,Candido; Maria Teresa,51,0,60,9
1653301499051,ECON 120B,A03,092589,Candido; Maria Teresa,56,0,60,4
1653301499592,ECON 120C,A01,092590,Candido; Maria Teresa,48,0,60,12
1653301499592,ECON 120C,A02,092591,Candido; Maria Teresa,59,0,60,1
1653301499592,ECON 120C,A03,094310,Candido; Maria Teresa,73,0,75,2
1653301500118,ECON 121,A00,088298,Vogl; Tom Saul,36,0,50,14
1653301500644,ECON 130,A00,088299,Staff,59,0,75,16
1653301501172,ECON 131,A00,088300,Jacobsen; Mark,129,0,150,21
1653301501172,ECON 131,B00,088301,Jacobsen; Mark,15,0,30,15
1653301501700,ECON 152,A00,088302,Fadlon; Yizhak,34,0,50,16
1653301501700,ECON 152,B00,088303,Fadlon; Yizhak,49,0,50,1
1653301502226,ECON 168,A00,088304,Staff,54,0,60,6
1653301502751,ECON 191B,A00,088312,Galperti; Simone,20,0,20,0
1653301503275,EDS 25,A01,087581,Staff,9,0,10,1
1653301503275,EDS 25,A02,087582,Staff,10,0,10,0
1653301503275,EDS 25,A03,087583,Staff,7,0,10,3
1653301503275,EDS 25,A04,087584,Staff,10,0,10,0
1653301503802,EDS 31,A00,087585,Bussey; Thomas J,9,0,10,1
1653301504330,EDS 110R,A01,087597,Cohen; Shana R,43,0,50,7
1653301504330,EDS 110R,B01,093579,Cohen; Shana R,10,0,10,0
1653301504855,EDS 113,A00,087598,Staff,45,0,50,5
1653301505381,EDS 114,A01,088091,Eguchi; Emi,17,0,20,3
1653301505381,EDS 114,A02,087600,Eguchi; Emi,19,0,20,1
1653301505904,EDS 117,A01,087603,Chung; Luz Marina,25,0,35,10
1653301505904,EDS 117,A02,087604,Chung; Luz Marina,34,0,35,1
1653301506437,EDS 124AR,A01,087606,Simon; Elizabeth A,0,0,19,19
1653301506437,EDS 124AR,A02,087607,Simon; Elizabeth A,13,0,19,6
1653301506437,EDS 124AR,A03,087608,Simon; Elizabeth A,15,0,19,4
1653301506437,EDS 124AR,A04,087609,Simon; Elizabeth A,4,0,19,15
1653301506437,EDS 124AR,B01,087611,Simon; Elizabeth A,14,0,19,5
1653301506437,EDS 124AR,B02,087612,Simon; Elizabeth A,18,0,19,1
1653301506437,EDS 124AR,B03,087613,Simon; Elizabeth A,18,0,19,1
1653301506437,EDS 124AR,B04,087614,Simon; Elizabeth A,19,0,19,0
1653301506437,EDS 124AR,C01,094210,Simon; Elizabeth A,6,0,6,0
1653301506437,EDS 124AR,C02,094211,Simon; Elizabeth A,6,0,6,0
1653301506437,EDS 124AR,C03,094212,Simon; Elizabeth A,6,0,6,0
1653301506437,EDS 124AR,C04,094213,Simon; Elizabeth A,6,0,6,0
1653301506437,EDS 124AR,D01,094215,Simon; Elizabeth A,6,0,6,0
1653301506437,EDS 124AR,D02,094216,Simon; Elizabeth A,6,0,6,0
1653301506437,EDS 124AR,D03,094217,Simon; Elizabeth A,6,0,6,0
1653301506437,EDS 124AR,D04,094218,Simon; Elizabeth A,6,0,6,0
1653301506960,EDS 124BR,A00,087615,Eguchi; Emi,65,0,75,10
1653301506960,EDS 124BR,B00,093580,Eguchi; Emi,25,0,25,0
1653301507485,EDS 125,A00,087616,Jones; Gabrielle Anastasia,51,0,60,9
1653301508009,EDS 129A,A01,087618,Heinzman; Erica M.,43,0,50,7
1653301508539,EDS 130,A01,087620,Holtzman; Caren Lynn,17,0,20,3
1653301508539,EDS 130,A02,087621,Holtzman; Caren Lynn,20,0,20,0
1653301508539,EDS 130,A03,087622,Holtzman; Caren Lynn,20,0,20,0
1653301509136,EDS 131,A01,087624,Wishard Guerra; Alison G.,37,0,40,3
1653301509671,EDS 133,A01,087627,Bintliff; Amy S.V.,17,0,20,3
1653301509671,EDS 133,A02,087628,Bintliff; Amy S.V.,19,0,20,1
1653301510195,EDS 139,A00,087629,Holtzman; Caren Lynn,55,0,60,5
1653301510195,EDS 139,B00,087630,Heinzman; Erica M.,51,0,60,9
1653301510195,EDS 139,C00,087631,Bintliff; Amy S.V.,57,0,60,3
1653301510195,EDS 139,D00,087632,Wishard Guerra; Alison G.,58,0,60,2
1653301510195,EDS 139,E00,087633,Holtzman; Caren Lynn,30,0,30,0
1653301510195,EDS 139,F00,094886,Staff,25,0,25,0
1653301510722,EDS 146,A01,094220,Staff,25,0,25,0
1653301511252,EDS 164R,A01,087644,Wishard Guerra; Alison G.,37,0,40,3
1653301511252,EDS 164R,B01,093582,Wishard Guerra; Alison G.,20,0,20,0
1653301511781,EDS 190,A00,087645,Bresser; Bernard George,20,0,20,0
1653301511781,EDS 190,B00,087646,Pappas; Elizabeth,20,0,20,0
1653301511781,EDS 190,C00,087647,Scharton; Susan Michelle,20,0,20,0
1653301511781,EDS 190,E00,087648,Staff,20,0,20,0
1653301512304,ENG 10,A00,086288,Staff,30,0,30,0
1653301512304,ENG 10,B00,086289,Staff,30,0,30,0
1653301512840,ENG 15,A01,086291,Staff,35,0,35,0
1653301513365,ENG 20,A00,086292,Evdokimenko; Ekaterina,33,0,35,2
1653301513912,ENG 100D,A00,086293,Ngo; Anh-Thu T.,45,0,50,5
1653301513912,ENG 100D,B00,094309,Staff,46,0,50,4
1653301514455,ENG 100L,A00,086295,Kleissl; Jan,6,0,6,0
1653301514455,ENG 100L,B00,086296,Bratton; Maryann,8,0,8,0
1653301514455,ENG 100L,C00,086297,Nguyen; Truong Quang,10,0,10,0
1653301514455,ENG 100L,E00,086299,de Oliveira; Mauricio,8,0,8,0
1653301514455,ENG 100L,F00,086300,Goldberg; Charles G.,6,0,6,0
1653301514455,ENG 100L,G00,086301,Bratton; Maryann,6,0,6,0
1653301514455,ENG 100L,H00,086302,Staff,6,0,6,0
1653301514981,ENVR 30,A01,093565,Staff,29,0,30,1
1653301514981,ENVR 30,A02,093567,Staff,28,0,30,2
1653301514981,ENVR 30,A03,093568,Staff,25,0,30,5
1653301514981,ENVR 30,A04,093569,Staff,30,0,30,0
1653301514981,ENVR 30,A05,093570,Staff,29,0,30,1
1653301514981,ENVR 30,A06,093566,Staff,29,0,30,1
1653301515508,ENVR 102,A00,093571,Daly; Heather Marie,25,0,30,5
1653301516574,ERC 1,A01,092328,Herbst; Matthew,20,0,20,0
1653301516574,ERC 1,A02,092330,Herbst; Matthew,20,0,20,0
1653301516574,ERC 1,A03,092331,Herbst; Matthew,20,0,20,0
1653301516574,ERC 1,A04,092332,Herbst; Matthew,20,0,20,0
1653301516574,ERC 1,A05,092333,Herbst; Matthew,20,0,20,0
1653301516574,ERC 1,A06,092334,Herbst; Matthew,20,0,20,0
1653301517103,ERC 2,A01,092336,Rahimi; Babak,20,0,20,0
1653301517103,ERC 2,A02,092337,Rahimi; Babak,20,0,20,0
1653301517103,ERC 2,A03,092338,Rahimi; Babak,20,0,20,0
1653301517103,ERC 2,A04,092339,Rahimi; Babak,20,0,20,0
1653301517629,ERC 20,A00,092340,Evans; Ivan T,30,0,30,0
1653301517629,ERC 20,B00,092341,Evans; Ivan T,30,0,30,0
1653301518176,ERC 87,A00,093850,Herbst; Matthew,20,0,20,0
1653301518719,ERC 92,A00,092342,Staff,1,0,1,0
1653301518719,ERC 92,B00,092343,Staff,1,0,1,0
1653301518719,ERC 92,C00,092344,Staff,1,0,1,0
1653301518719,ERC 92,D00,092345,Staff,1,0,1,0
1653301518719,ERC 92,E00,092346,Staff,1,0,1,0
1653301518719,ERC 92,F00,092347,Staff,1,0,1,0
1653301519272,ESYS 90,A00,086303,Teranes; Jane,12,0,12,0
1653301519797,ESYS 101,A01,086305,Taylor; Jennifer Rebecca & Diaz; Julia Michelle,25,0,27,2
1653301519797,ESYS 101,A02,086306,Taylor; Jennifer Rebecca & Diaz; Julia Michelle,15,0,27,12
1653301519797,ESYS 101,A03,086307,Taylor; Jennifer Rebecca & Diaz; Julia Michelle,21,0,27,6
1653301519797,ESYS 101,A04,086308,Taylor; Jennifer Rebecca & Diaz; Julia Michelle,27,0,27,0
1653301520322,ESYS 187A,A01,086310,Teranes; Jane,38,0,40,2
1653301520322,ESYS 187A,B01,086312,Teranes; Jane,30,0,40,10
1653301520848,ETHN 1,A01,086314,Frank; Ross H.,15,0,15,0
1653301520848,ETHN 1,A02,086315,Frank; Ross H.,15,0,15,0
1653301520848,ETHN 1,A03,086316,Frank; Ross H.,14,0,15,1
1653301520848,ETHN 1,A04,086317,Frank; Ross H.,15,0,15,0
1653301520848,ETHN 1,A05,086318,Frank; Ross H.,15,0,15,0
1653301520848,ETHN 1,A06,086319,Frank; Ross H.,13,0,15,2
1653301520848,ETHN 1,A07,086320,Frank; Ross H.,15,0,15,0
1653301520848,ETHN 1,A08,086321,Frank; Ross H.,14,0,15,1
1653301520848,ETHN 1,A09,086322,Frank; Ross H.,15,0,15,0
1653301520848,ETHN 1,A10,086323,Frank; Ross H.,15,0,15,0
1653301520848,ETHN 1,A11,086324,Frank; Ross H.,15,0,15,0
1653301520848,ETHN 1,A12,086325,Frank; Ross H.,15,0,15,0
1653301520848,ETHN 1,A13,086326,Frank; Ross H.,15,0,15,0
1653301520848,ETHN 1,A14,086327,Frank; Ross H.,15,0,15,0
1653301520848,ETHN 1,A15,086328,Frank; Ross H.,15,0,15,0
1653301520848,ETHN 1,A16,086329,Frank; Ross H.,15,0,15,0
1653301521396,ETHN 100A,A00,086330,Patel; Shaista,41,0,48,7
1653301521920,ETHN 103,A00,086331,Perreira; Christopher Michael,63,0,70,7
1653301522466,ETHN 104,A00,086332,Staff,0,0,0,0
1653301523019,ETHN 106,A00,086333,Staff,0,0,0,0
1653301523558,ETHN 121,A00,086341,Sasaki; Christen T,20,0,28,8
1653301524101,ETHN 139,A00,086342,Ruiz; Ariana,16,0,20,4
1653301524637,ETHN 144M,A00,086343,Jolivette; Andrew J,66,0,70,4
1653301525188,ETHN 159,A00,088427,Graham; Jessica Lynn,0,0,0,0
1653301525738,ETHN 163E,A00,086344,Patel; Shaista,37,0,40,3
1653301526265,ETHN 178R,A00,090798,Borgo; David Garcia,15,0,20,5
1653301526789,ETHN 187,A00,086345,Perez; Roy,14,0,16,2
1653301527315,EXPR 100,A00,085686,Staff,9999,0,9999,0
1653301527872,FMPH 40,A00,086370,Emory; Kristen,70,0,75,5
1653301527872,FMPH 40,B00,086371,Romero; Sally Ann Dominick,71,0,75,4
1653301528399,FMPH 101,A00,086372,Brouwer; Kimberly,43,0,55,12
1653301528936,FMPH 102,A50,094498,Rana; Brinda Kanti,42,0,55,13
1653301529473,FMPH 110,A00,086374,Zoumas-Morse; Christine E.,61,0,65,4
1653301530024,FMPH 120,A00,086375,Nguyen-Grozavu; France T.,45,0,65,20
1653301530024,FMPH 120,B00,086376,Nguyen-Grozavu; France T.,60,0,65,5
1653301530550,FMPH 130,A00,086377,Staff,48,0,65,17
1653301531620,FMPH 161,A00,086379,Zoumas-Morse; Christine E.,58,0,65,7
1653301532161,FMPH 191,A00,086380,Harrell; Maralee Mae,58,0,60,2
1653301532706,FMPH 196A,A00,086381,Binkin; Nancy Jeanne,0,0,0,0
1653301533253,GLBH 20,A00,086407,Walkover; Lillian B,85,0,90,5
1653301533789,GLBH 100,A00,086408,Staff,55,0,56,1
1653301533789,GLBH 100,B00,086409,Wu; Hua,52,0,56,4
1653301533789,GLBH 100,D00,086411,Staff,38,0,40,2
1653301534333,GLBH 103,A00,086412,Hannah; Seth Donal,48,0,50,2
1653301534862,GLBH 105,A00,086413,Olivas Hernandez; Olga Lid,36,0,38,2
1653301535408,GLBH 106,A00,086414,Kayser; Georgia Lyn,40,0,40,0
1653301535933,GLBH 111,A01,094330,Burgos; Jose L.,0,0,0,0
1653301535933,GLBH 111,B01,094332,Burgos; Jose L.,0,0,0,0
1653301536465,GLBH 148,A00,086415,Staff,69,0,73,4
1653301536989,GLBH 181,A00,086417,Burgos; Jose L.,144,0,146,2
1653301537520,GSS 20,A00,094269,Staff,73,0,75,2
1653301538049,HDS 1,A01,086423,Staff,24,0,25,1
1653301538049,HDS 1,A02,086424,Staff,24,0,25,1
1653301538049,HDS 1,A03,086425,Staff,23,0,25,2
1653301538049,HDS 1,A04,086426,Staff,25,0,25,0
1653301538049,HDS 1,A05,086427,Staff,24,0,25,1
1653301538049,HDS 1,A06,086428,Staff,25,0,25,0
1653301538049,HDS 1,A07,086429,Staff,30,0,30,0
1653301538581,HDS 60,A01,086431,Staff,23,0,25,2
1653301539105,HDS 111,A00,086432,Staff,73,0,80,7
1653301539631,HDS 121,A01,086434,Deak; Gedeon O.,11,0,15,4
1653301539631,HDS 121,A02,086435,Deak; Gedeon O.,13,0,15,2
1653301540156,HDS 150,A00,086436,Staff,25,0,25,0
1653301540156,HDS 150,B00,086437,Staff,25,0,25,0
1653301540689,HDS 173,A00,086439,Staff,27,0,30,3
1653301541214,HDS 181,A01,086441,Staff,30,0,30,0
1653301541737,HDS 191,A01,086443,Staff,25,0,25,0
1653301542275,HIEA 129,A00,088057,Schneewind; Sarah,0,0,0,0
1653301542813,HIEA 137,A00,088058,Lu; Weijing,53,0,55,2
1653301543338,HIEA 144,A00,088059,Henry; Todd A.,43,0,45,2
1653301543874,HIEA 171,A00,088060,Lu; Weijing,15,0,15,0
1653301544401,HIEU 102,A00,088061,Watts; Edward J.,0,0,0,0
1653301544930,HIEU 107,A00,088062,Caciola; Nancy A,0,0,0,0
1653301545453,HIEU 108,A00,088063,Balberg; Mira,53,0,60,7
1653301545976,HIEU 128,A00,088064,Neuheiser; Joerg,0,0,0,0
1653301546500,HIEU 144,A00,094327,Staff,48,0,50,2
1653301547023,HIEU 149,A00,088065,Devereux; Andrew W,38,0,45,7
1653301547548,HIEU 154,A00,088066,Biess; Frank Peter,58,0,65,7
1653301548095,HIGL 114,A00,088067,Edington; Claire Ellen,53,0,55,2
1653301548622,HILA 119,A00,088068,Vitz; Matthew,49,0,51,2
1653301549163,HILA 122,A00,088069,Widener; Daniel,61,0,65,4
1653301549693,HILD 2A,A01,088024,Hanna; Mark G.,28,0,28,0
1653301549693,HILD 2A,A02,088025,Hanna; Mark G.,25,0,25,0
1653301549693,HILD 2A,A03,088026,Hanna; Mark G.,27,0,28,1
1653301549693,HILD 2A,A04,088027,Hanna; Mark G.,28,0,28,0
1653301549693,HILD 2A,A05,088028,Hanna; Mark G.,28,0,28,0
1653301549693,HILD 2A,A06,088029,Hanna; Mark G.,28,0,28,0
1653301550237,HILD 7A,A01,088031,Graham; Jessica Lynn,28,0,28,0
1653301550237,HILD 7A,A02,088032,Graham; Jessica Lynn,27,0,28,1
1653301550237,HILD 7A,A03,088033,Graham; Jessica Lynn,27,0,28,1
1653301550237,HILD 7A,A04,088034,Graham; Jessica Lynn,26,0,28,2
1653301550237,HILD 7A,A05,088035,Graham; Jessica Lynn,26,0,28,2
1653301550237,HILD 7A,A06,088037,Graham; Jessica Lynn,22,0,28,6
1653301550237,HILD 7A,A07,088038,Graham; Jessica Lynn,28,0,28,0
1653301550237,HILD 7A,A08,088039,Graham; Jessica Lynn,28,0,28,0
1653301550237,HILD 7A,A09,088040,Graham; Jessica Lynn,27,0,28,1
1653301550237,HILD 7A,A10,088041,Graham; Jessica Lynn,28,0,28,0
1653301550237,HILD 7A,A11,088042,Graham; Jessica Lynn,28,0,28,0
1653301550237,HILD 7A,A12,088043,Graham; Jessica Lynn,28,0,28,0
1653301550785,HILD 10,A01,088045,Muscolino; Micah S,27,0,28,1
1653301550785,HILD 10,A02,088046,Muscolino; Micah S,27,0,28,1
1653301550785,HILD 10,A03,088047,Muscolino; Micah S,28,0,28,0
1653301550785,HILD 10,A04,088048,Muscolino; Micah S,27,0,28,1
1653301550785,HILD 10,A05,088049,Muscolino; Micah S,28,0,28,0
1653301550785,HILD 10,A06,088050,Muscolino; Micah S,27,0,28,1
1653301551312,HILD 30,A01,088052,Edington; Claire Ellen,24,0,28,4
1653301551312,HILD 30,A02,088053,Edington; Claire Ellen,28,0,28,0
1653301551836,HILD 41,A01,088055,Devereux; Andrew W,28,0,28,0
1653301551836,HILD 41,A02,088056,Devereux; Andrew W,28,0,28,0
1653301552372,HINE 116,A00,088070,Kayali; Hasan,47,0,50,3
1653301552921,HINE 144,A00,088071,Provence; Michael,40,0,45,5
1653301553474,HISC 106,A00,088072,Pineda De Avila; Nydia,47,0,50,3
1653301554006,HISC 115,A00,088073,Gere; Catherina M.,103,0,110,7
1653301554543,HITO 87,A00,094352,Patterson; Patrick H.,20,0,20,0
1653301554543,HITO 87,C00,094354,Patterson; Patrick H.,20,0,20,0
1653301554543,HITO 87,B00,094353,Hanna; Mark G.,20,0,20,0
1653301555096,HITO 100,A00,088074,Hanna; Mark G.,8,0,12,4
1653301555624,HITO 193,A00,091603,Hill; Seth J,9999,0,9999,0
1653301556147,HITO 196,A00,088075,Hendrickson; Gerald M.,20,0,20,0
1653301556672,HIUS 108B,A00,088076,Klann; Mary Cameron,48,0,51,3
1653301557196,HIUS 112,A00,088077,Plant; Rebecca Jo,144,0,148,4
1653301557732,HIUS 152A,A00,088078,Vandevelde; Kenneth Joseph,40,0,45,5
1653301558269,HIUS 155,A00,088079,Alvarez; Luis A,37,0,45,8
1653301558794,HIUS 183,A00,088080,Graham; Jessica Lynn,19,0,20,1
1653301559384,HUM 3,A01,087224,West; Geoffrey Scott,27,0,28,1
1653301559384,HUM 3,A02,087225,West; Geoffrey Scott,28,0,28,0
1653301559384,HUM 3,A03,087226,West; Geoffrey Scott,26,0,28,2
1653301559384,HUM 3,A04,087227,West; Geoffrey Scott,27,0,28,1
1653301559384,HUM 3,A05,087228,West; Geoffrey Scott,27,0,28,1
1653301559384,HUM 3,A06,087229,West; Geoffrey Scott,24,0,28,4
1653301559384,HUM 3,A07,087230,West; Geoffrey Scott,27,0,28,1
1653301559384,HUM 3,A08,087231,West; Geoffrey Scott,28,0,28,0
1653301559384,HUM 3,B01,087233,Staff,28,0,28,0
1653301559384,HUM 3,B02,087234,Staff,28,0,28,0
1653301559384,HUM 3,B03,087235,Staff,28,0,28,0
1653301559384,HUM 3,B04,087236,Staff,28,0,28,0
1653301559384,HUM 3,B05,087237,Staff,28,0,28,0
1653301559384,HUM 3,B06,087238,Staff,28,0,28,0
1653301559384,HUM 3,B07,087239,Staff,0,0,0,0
1653301559384,HUM 3,B08,087240,Staff,0,0,0,0
1653301559384,HUM 3,B09,087241,Staff,30,0,30,0
1653301559384,HUM 3,B10,087242,Staff,28,0,30,2
1653301559384,HUM 3,C01,087244,Patterson; Patrick H.,0,0,0,0
1653301559384,HUM 3,C02,087245,Patterson; Patrick H.,0,0,0,0
1653301559384,HUM 3,C03,087246,Patterson; Patrick H.,23,0,28,5
1653301559384,HUM 3,C04,087247,Patterson; Patrick H.,28,0,28,0
1653301559384,HUM 3,C05,087248,Patterson; Patrick H.,27,0,28,1
1653301559384,HUM 3,C06,087249,Patterson; Patrick H.,25,0,28,3
1653301559384,HUM 3,C07,087250,Patterson; Patrick H.,27,0,28,1
1653301559384,HUM 3,C08,087251,Patterson; Patrick H.,28,0,28,0
1653301559384,HUM 3,C09,087252,Patterson; Patrick H.,28,0,28,0
1653301559384,HUM 3,C10,087253,Patterson; Patrick H.,27,0,28,1
1653301559384,HUM 3,D01,087255,Lyon; Antony J.,24,0,28,4
1653301559384,HUM 3,D02,087256,Lyon; Antony J.,28,0,28,0
1653301559384,HUM 3,D03,087257,Lyon; Antony J.,0,0,0,0
1653301559384,HUM 3,D04,087258,Lyon; Antony J.,0,0,0,0
1653301559384,HUM 3,D05,087259,Lyon; Antony J.,27,0,28,1
1653301559384,HUM 3,D06,087260,Lyon; Antony J.,28,0,28,0
1653301559384,HUM 3,D07,087261,Lyon; Antony J.,21,0,28,7
1653301559384,HUM 3,D08,087262,Lyon; Antony J.,20,0,28,8
1653301559384,HUM 3,D09,087263,Lyon; Antony J.,28,0,28,0
1653301559384,HUM 3,D10,087264,Lyon; Antony J.,27,0,28,1
1653301559384,HUM 3,D11,087265,Lyon; Antony J.,30,0,30,0
1653301559384,HUM 3,D12,087266,Lyon; Antony J.,30,0,30,0
1653301559384,HUM 3,D13,087267,Lyon; Antony J.,26,0,28,2
1653301559384,HUM 3,D14,087268,Lyon; Antony J.,25,0,28,3
1653301559921,INTL 101,A01,088176,Day; Joel Keith,19,0,20,1
1653301559921,INTL 101,A02,088177,Day; Joel Keith,20,0,20,0
1653301559921,INTL 101,A03,088178,Day; Joel Keith,17,0,20,3
1653301559921,INTL 101,A04,088179,Day; Joel Keith,19,0,20,1
1653301559921,INTL 101,A05,088180,Day; Joel Keith,19,0,20,1
1653301559921,INTL 101,A06,088181,Day; Joel Keith,18,0,20,2
1653301560465,INTL 102,A01,088183,Walter; Barbara Florence,19,0,20,1
1653301560465,INTL 102,A02,088184,Walter; Barbara Florence,19,0,20,1
1653301560465,INTL 102,A03,088185,Walter; Barbara Florence,18,0,20,2
1653301560465,INTL 102,A04,088186,Walter; Barbara Florence,16,0,20,4
1653301560465,INTL 102,A05,088187,Walter; Barbara Florence,19,0,20,1
1653301560465,INTL 102,A06,088188,Walter; Barbara Florence,19,0,20,1
1653301561023,INTL 190,A00,088189,Auerbach; Bradford C,0,0,0,0
1653301561023,INTL 190,B00,088190,Auerbach; Bradford C,0,0,0,0
1653301561023,INTL 190,C00,088191,Fortier; Jana,0,0,0,0
1653301561023,INTL 190,D00,088192,Kshatriya; Krista C,0,0,0,0
1653301561023,INTL 190,E00,088193,Nadkarni; Vidya,0,0,0,0
1653301561023,INTL 190,F00,088194,Scott; Jeffrey F,0,0,0,0
1653301561023,INTL 190,G00,088195,Segui; Alan S,0,0,0,0
1653301561023,INTL 190,H00,088196,Segui; Alan S,0,0,0,0
1653301561549,INTL 190H,A00,088197,Gibson; Clark C,0,0,0,0
1653301562117,JAPN 10A,A01,086851,Maruyama; Rie,15,0,15,0
1653301562117,JAPN 10A,A02,086852,Maruyama; Rie,15,0,15,0
1653301562117,JAPN 10A,B01,086854,Staff,13,0,13,0
1653301562117,JAPN 10A,B02,086855,Staff,13,0,13,0
1653301562117,JAPN 10A,C01,086857,McKee; Mayumi Mochizuki,13,0,13,0
1653301562117,JAPN 10A,C02,086858,McKee; Mayumi Mochizuki,11,0,13,2
1653301562117,JAPN 10A,D01,086860,Sato; Kyoko,13,0,13,0
1653301562117,JAPN 10A,D02,086861,Sato; Kyoko,13,0,13,0
1653301562117,JAPN 10A,E01,086863,Kamioka; Sachiko,12,0,13,1
1653301562117,JAPN 10A,E02,086864,Kamioka; Sachiko,12,0,13,1
1653301562117,JAPN 10A,F01,086866,Sato; Kyoko,13,0,13,0
1653301562117,JAPN 10A,F02,086867,Sato; Kyoko,13,0,13,0
1653301562117,JAPN 10A,G01,086869,Maruyama; Rie,8,0,13,5
1653301562117,JAPN 10A,G02,086870,Maruyama; Rie,13,0,13,0
1653301562117,JAPN 10A,H01,086872,Kamioka; Sachiko,12,0,13,1
1653301562117,JAPN 10A,H02,086873,Kamioka; Sachiko,11,0,13,2
1653301562117,JAPN 10A,I01,086875,Staff,12,0,13,1
1653301562117,JAPN 10A,I02,086876,Staff,13,0,13,0
1653301562117,JAPN 10A,J01,086878,McKee; Mayumi Mochizuki,12,0,13,1
1653301562117,JAPN 10A,J02,086879,McKee; Mayumi Mochizuki,13,0,13,0
1653301562117,JAPN 10A,K01,086881,Inada; Minori,13,0,13,0
1653301562117,JAPN 10A,K02,086882,Inada; Minori,12,0,13,1
1653301562117,JAPN 10A,L01,086884,Tipton; Yuko,13,0,13,0
1653301562117,JAPN 10A,L02,086885,Tipton; Yuko,13,0,13,0
1653301562117,JAPN 10A,M01,086887,Inada; Minori,12,0,13,1
1653301562117,JAPN 10A,M02,086888,Inada; Minori,13,0,13,0
1653301562117,JAPN 10A,N01,086890,McKee; Mayumi Mochizuki,13,0,13,0
1653301562117,JAPN 10A,N02,086891,McKee; Mayumi Mochizuki,11,0,13,2
1653301562117,JAPN 10A,O01,086893,Staff,13,0,13,0
1653301562117,JAPN 10A,O02,086894,Staff,12,0,13,1
1653301562117,JAPN 10A,P01,086896,Tipton; Yuko,15,0,15,0
1653301562117,JAPN 10A,P02,086897,Tipton; Yuko,15,0,15,0
1653301562672,JAPN 20A,A01,086899,Simpson; Junko Tokuda,11,0,13,2
1653301562672,JAPN 20A,A02,086900,Simpson; Junko Tokuda,12,0,13,1
1653301562672,JAPN 20A,B01,086902,Takeda; Izumi,11,0,13,2
1653301562672,JAPN 20A,B02,086903,Takeda; Izumi,12,0,13,1
1653301562672,JAPN 20A,C01,086905,Ross; Kayoko F,12,0,13,1
1653301562672,JAPN 20A,C02,086906,Ross; Kayoko F,12,0,13,1
1653301562672,JAPN 20A,D01,086908,Takeda; Izumi,10,0,13,3
1653301562672,JAPN 20A,D02,086909,Takeda; Izumi,13,0,13,0
1653301562672,JAPN 20A,E01,086911,Maruyama; Rie,11,0,13,2
1653301562672,JAPN 20A,E02,086912,Maruyama; Rie,11,0,13,2
1653301562672,JAPN 20A,F01,086914,Kamioka; Sachiko,7,0,13,6
1653301562672,JAPN 20A,F02,086915,Kamioka; Sachiko,9,0,13,4
1653301562672,JAPN 20A,G01,086917,Ross; Kayoko F,13,0,13,0
1653301562672,JAPN 20A,G02,086918,Ross; Kayoko F,12,0,13,1
1653301563292,JAPN 130A,A01,086920,Simpson; Junko Tokuda,6,0,10,4
1653301563292,JAPN 130A,A02,086921,Simpson; Junko Tokuda,5,0,10,5
1653301563292,JAPN 130A,B01,086923,Ross; Kayoko F,9,0,10,1
1653301563292,JAPN 130A,B02,086924,Ross; Kayoko F,9,0,10,1
1653301563817,JAPN 135A,A00,086925,Inada; Minori,14,0,15,1
1653301563817,JAPN 135A,B00,086926,Takeda; Izumi,15,0,15,0
1653301564344,JAPN 140A,A00,086927,Sato; Kyoko,19,0,20,1
1653301564897,JWSP 1,A01,086445,Shuster; Alana,15,0,15,0
1653301564897,JWSP 1,A02,086446,Shuster; Alana,15,0,15,0
1653301565422,JWSP 104,A01,086448,Shuster; Alana,15,0,15,0
1653301565958,LATI 10,A01,093588,Kennemore; Amy Michelle,31,0,32,1
1653301565958,LATI 10,A02,093589,Kennemore; Amy Michelle,32,0,32,0
1653301565958,LATI 10,A03,093590,Kennemore; Amy Michelle,32,0,32,0
1653301566483,LATI 50,A01,093592,Kokinis; Troy Andreas,32,0,32,0
1653301566483,LATI 50,A02,093593,Kokinis; Troy Andreas,31,0,32,1
1653301566483,LATI 50,A03,093595,Kokinis; Troy Andreas,32,0,32,0
1653301567018,LATI 122A,A00,093649,Andrews; Abigail Leslie,0,0,0,0
1653301567541,LATI 180,A00,093597,Staff,36,0,40,4
1653301568087,LIAB 1A,A00,087085,Saab; Dima,13,0,14,1
1653301568087,LIAB 1A,B00,087086,Saab; Dima,13,0,14,1
1653301568087,LIAB 1A,C00,087087,Saab; Dima,14,0,14,0
1653301568087,LIAB 1A,D00,087088,El Cheddadi; Youniss,14,0,14,0
1653301568622,LIAB 1AX,A00,087089,Akjeje; Abdelhak,28,0,28,0
1653301568622,LIAB 1AX,B00,087091,Akjeje; Abdelhak,28,0,28,0
1653301569171,LIAB 1D,A00,087093,El Cheddadi; Youniss,13,0,14,1
1653301569171,LIAB 1D,B00,087094,El Cheddadi; Youniss,12,0,14,2
1653301569706,LIAB 1DX,A00,087095,Akjeje; Abdelhak,27,0,28,1
1653301570250,LIDS 19,001,095098,Goodall; Grant Todd,9999,0,9999,0
1653301570250,LIDS 19,002,095099,Goodall; Grant Todd,9999,0,9999,0
1653301570250,LIDS 19,003,095100,Goodall; Grant Todd,9999,0,9999,0
1653301570250,LIDS 19,004,095101,Goodall; Grant Todd,9999,0,9999,0
1653301570250,LIDS 19,005,095102,Goodall; Grant Todd,9999,0,9999,0
1653301570250,LIDS 19,006,095103,Goodall; Grant Todd,9999,0,9999,0
1653301570250,LIDS 19,007,095104,Goodall; Grant Todd,9999,0,9999,0
1653301570250,LIDS 19,008,095105,Goodall; Grant Todd,9999,0,9999,0
1653301570250,LIDS 19,009,095106,Goodall; Grant Todd,9999,0,9999,0
1653301570250,LIDS 19,010,095107,Goodall; Grant Todd,9999,0,9999,0
1653301570250,LIDS 19,011,095108,Goodall; Grant Todd,9999,0,9999,0
1653301570250,LIDS 19,012,095109,Goodall; Grant Todd,9999,0,9999,0
1653301570796,LIFR 1A,A00,087097,Goodall; Grant Todd,13,0,14,1
1653301570796,LIFR 1A,B00,087098,Goodall; Grant Todd,13,0,14,1
1653301570796,LIFR 1A,C00,087099,Goodall; Grant Todd,12,0,14,2
1653301570796,LIFR 1A,D00,087100,Goodall; Grant Todd,12,0,14,2
1653301570796,LIFR 1A,E00,087101,Goodall; Grant Todd,14,0,14,0
1653301570796,LIFR 1A,F00,087102,Goodall; Grant Todd,13,0,14,1
1653301571323,LIFR 1AX,A00,087103,Goodall; Grant Todd,27,0,28,1
1653301571323,LIFR 1AX,B00,087104,Goodall; Grant Todd,27,0,28,1
1653301571323,LIFR 1AX,C00,087105,Goodall; Grant Todd,25,0,28,3
1653301571873,LIFR 1B,A00,087106,Goodall; Grant Todd,14,0,14,0
1653301571873,LIFR 1B,B00,087107,Goodall; Grant Todd,13,0,14,1
1653301571873,LIFR 1B,C00,087108,Goodall; Grant Todd,13,0,14,1
1653301571873,LIFR 1B,D00,087109,Goodall; Grant Todd,13,0,14,1
1653301572399,LIFR 1BX,A00,087110,Goodall; Grant Todd,26,0,28,2
1653301572399,LIFR 1BX,B00,087111,Goodall; Grant Todd,26,0,28,2
1653301572940,LIFR 1D,A00,087112,Goodall; Grant Todd,14,0,14,0
1653301572940,LIFR 1D,B00,087113,Goodall; Grant Todd,12,0,14,2
1653301572940,LIFR 1D,C00,087114,Goodall; Grant Todd,11,0,14,3
1653301572940,LIFR 1D,D00,087115,Goodall; Grant Todd,10,0,14,4
1653301573463,LIFR 1DX,A00,087116,Goodall; Grant Todd,26,0,28,2
1653301573463,LIFR 1DX,B00,087117,Goodall; Grant Todd,23,0,28,5
1653301573989,LIFR 11,A00,087118,Goodall; Grant Todd,10,0,10,0
1653301574522,LIGM 1A,A00,087119,Riebeling; Elke,14,0,14,0
1653301574522,LIGM 1A,B00,087120,Riebeling; Elke,14,0,14,0
1653301574522,LIGM 1A,C00,087121,Riebeling; Elke,12,0,14,2
1653301574522,LIGM 1A,D00,087122,Riebeling; Elke,14,0,14,0
1653301574522,LIGM 1A,E00,087123,Riebeling; Elke,14,0,14,0
1653301575065,LIGM 1AX,A00,087124,Riebeling; Elke,28,0,28,0
1653301575065,LIGM 1AX,B00,087125,Riebeling; Elke,28,0,28,0
1653301575065,LIGM 1AX,C00,087126,Riebeling; Elke,27,0,28,1
1653301575609,LIGM 1D,A00,087127,Riebeling; Elke,14,0,14,0
1653301575609,LIGM 1D,B00,087128,Riebeling; Elke,12,0,14,2
1653301576163,LIGM 1DX,A00,087129,Riebeling; Elke,26,0,28,2
1653301576697,LIGM 11,A00,087130,Goodall; Grant Todd,10,0,10,0
1653301577231,LIGN 5,A00,087005,Goodall; Grant Todd,74,0,75,1
1653301577763,LIGN 7,A00,087006,Mayberry; Rachel,139,0,146,7
1653301578303,LIGN 8,A00,087007,McIntosh; Justin Daniel,244,0,250,6
1653301578853,LIGN 17,A00,087008,Kehler; Andrew Scott,218,0,220,2
1653301579378,LIGN 101,A01,087010,Styler; William Francis,29,0,30,1
1653301579378,LIGN 101,A02,087011,Styler; William Francis,29,0,30,1
1653301579378,LIGN 101,A03,087012,Styler; William Francis,29,0,30,1
1653301579378,LIGN 101,A04,087013,Styler; William Francis,29,0,30,1
1653301579908,LIGN 110,A01,087015,Garellek; Marc,29,0,30,1
1653301579908,LIGN 110,A02,087016,Garellek; Marc,26,0,30,4
1653301579908,LIGN 110,A03,087017,Garellek; Marc,26,0,30,4
1653301579908,LIGN 110,A04,087018,Garellek; Marc,28,0,30,2
1653301580433,LIGN 121,A01,087020,Drake; Emily C,23,0,25,2
1653301580433,LIGN 121,A02,087021,Drake; Emily C,24,0,25,1
1653301580976,LIGN 150,A00,093702,Staff,71,0,75,4
1653301581504,LIGN 152,A00,087023,Caballero; Gabriela Hernandez,16,0,20,4
1653301582042,LIGN 154,A00,087024,Kluender; Robert,70,0,70,0
1653301582568,LIGN 167,A00,087025,Bergen; Leon,70,0,100,30
1653301583116,LIGN 187,A00,087026,McIntosh; Justin Daniel,20,0,20,0
1653301583661,LIHL 112F,A00,086505,Alicio; Atilio,25,0,28,3
1653301584212,LIHL 114F,A00,086506,Staff,21,0,28,7
1653301584766,LIHL 117F,A00,086508,Sadegholvad; Elham,20,0,20,0
1653301585305,LIHL 118,A00,086509,Staff,25,0,28,3
1653301585830,LIHL 119F,A00,086510,Staff,26,0,28,2
1653301586384,LIHL 124F,A00,086511,Staff,27,0,28,1
1653301586922,LIHL 132F,A00,086512,Alicio; Atilio,28,0,28,0
1653301587468,LIIT 1A,A00,087131,Riebeling; Elke,14,0,14,0
1653301587468,LIIT 1A,B00,087132,Riebeling; Elke,14,0,14,0
1653301587468,LIIT 1A,C00,087133,Riebeling; Elke,12,0,14,2
1653301587468,LIIT 1A,D00,087134,Riebeling; Elke,14,0,14,0
1653301588017,LIIT 1AX,A00,087135,Riebeling; Elke,28,0,28,0
1653301588017,LIIT 1AX,B00,087136,Riebeling; Elke,26,0,28,2
1653301588551,LIPO 1A,A00,087137,Paladini; Denise,14,0,14,0
1653301588551,LIPO 1A,B00,087138,Paladini; Denise,10,0,14,4
1653301589075,LIPO 1AX,A00,087139,De Abreu; Cassia,18,0,22,4
1653301589075,LIPO 1AX,B00,087140,De Abreu; Cassia,22,0,22,0
1653301589602,LIPO 1D,A00,087141,Paladini; Denise,10,0,14,4
1653301590126,LIPO 1DX,A00,087143,De Abreu; Cassia,10,0,14,4
1653301590655,LISL 1A,A00,087145,Lott; Margaret S.,10,0,14,4
1653301590655,LISL 1A,B00,087146,Lott; Margaret S.,14,0,14,0
1653301590655,LISL 1A,C00,087147,Lott; Margaret S.,10,0,14,4
1653301590655,LISL 1A,D00,087148,Lott; Margaret S.,11,0,14,3
1653301590655,LISL 1A,E00,087149,Lott; Margaret S.,13,0,14,1
1653301590655,LISL 1A,F00,087150,Lott; Margaret S.,12,0,14,2
1653301590655,LISL 1A,G00,087151,Lott; Margaret S.,13,0,14,1
1653301590655,LISL 1A,H00,087152,Lott; Margaret S.,13,0,14,1
1653301591207,LISL 1AX,A00,087153,Lott; Margaret S.,28,0,28,0
1653301591207,LISL 1AX,B00,087154,Lott; Margaret S.,25,0,28,3
1653301591207,LISL 1AX,C00,087155,Lott; Margaret S.,25,0,28,3
1653301591207,LISL 1AX,D00,087156,Lott; Margaret S.,24,0,28,4
1653301591741,LISL 1B,A00,087157,Lott; Margaret S.,13,0,14,1
1653301591741,LISL 1B,B00,087158,Lott; Margaret S.,12,0,14,2
1653301591741,LISL 1B,C00,087159,Lott; Margaret S.,11,0,14,3
1653301591741,LISL 1B,D00,087160,Lott; Margaret S.,13,0,14,1
1653301591741,LISL 1B,E00,087161,Lott; Margaret S.,13,0,14,1
1653301591741,LISL 1B,F00,087162,Lott; Margaret S.,13,0,14,1
1653301592265,LISL 1BX,A00,087163,Lott; Margaret S.,23,0,28,5
1653301592265,LISL 1BX,B00,087164,Lott; Margaret S.,26,0,28,2
1653301592265,LISL 1BX,C00,087165,Lott; Margaret S.,28,0,28,0
1653301592814,LISL 1D,A00,087166,Lott; Margaret S.,14,0,14,0
1653301592814,LISL 1D,B00,087167,Lott; Margaret S.,14,0,14,0
1653301592814,LISL 1D,C00,087168,Lott; Margaret S.,8,0,14,6
1653301592814,LISL 1D,D00,087169,Lott; Margaret S.,13,0,14,1
1653301593338,LISL 1DX,A00,087170,Lott; Margaret S.,23,0,28,5
1653301593338,LISL 1DX,B00,087171,Lott; Margaret S.,26,0,28,2
1653301593862,LISP 1A,001,087172,Munoz Sanchez; Alicia,13,0,14,1
1653301593862,LISP 1A,002,087173,Munoz Sanchez; Alicia,12,0,14,2
1653301593862,LISP 1A,003,087174,Munoz Sanchez; Alicia,13,0,14,1
1653301593862,LISP 1A,004,087175,Munoz Sanchez; Alicia,12,0,14,2
1653301593862,LISP 1A,005,087176,Munoz Sanchez; Alicia,10,0,14,4
1653301593862,LISP 1A,006,087177,Munoz Sanchez; Alicia,12,0,14,2
1653301593862,LISP 1A,007,087178,Munoz Sanchez; Alicia,12,0,14,2
1653301593862,LISP 1A,008,087179,Munoz Sanchez; Alicia,14,0,14,0
1653301594388,LISP 1AX,A00,087180,Munoz Sanchez; Alicia,27,0,28,1
1653301594388,LISP 1AX,B00,087181,Munoz Sanchez; Alicia,24,0,28,4
1653301594388,LISP 1AX,C00,087182,Munoz Sanchez; Alicia,25,0,28,3
1653301594388,LISP 1AX,D00,087183,Munoz Sanchez; Alicia,25,0,28,3
1653301594914,LISP 1B,001,087184,Munoz Sanchez; Alicia,14,0,14,0
1653301594914,LISP 1B,002,087185,Munoz Sanchez; Alicia,14,0,14,0
1653301594914,LISP 1B,003,087186,Munoz Sanchez; Alicia,11,0,14,3
1653301594914,LISP 1B,004,087187,Munoz Sanchez; Alicia,12,0,14,2
1653301594914,LISP 1B,005,087188,Munoz Sanchez; Alicia,13,0,14,1
1653301594914,LISP 1B,006,087189,Munoz Sanchez; Alicia,13,0,14,1
1653301594914,LISP 1B,007,087190,Munoz Sanchez; Alicia,14,0,14,0
1653301594914,LISP 1B,008,087191,Munoz Sanchez; Alicia,13,0,14,1
1653301594914,LISP 1B,009,087192,Munoz Sanchez; Alicia,14,0,14,0
1653301594914,LISP 1B,010,087193,Munoz Sanchez; Alicia,13,0,14,1
1653301594914,LISP 1B,011,087194,Munoz Sanchez; Alicia,14,0,14,0
1653301595437,LISP 1BX,A00,087195,Munoz Sanchez; Alicia,28,0,28,0
1653301595437,LISP 1BX,B00,087196,Munoz Sanchez; Alicia,26,0,28,2
1653301595437,LISP 1BX,C00,087197,Munoz Sanchez; Alicia,26,0,28,2
1653301595437,LISP 1BX,D00,087198,Munoz Sanchez; Alicia,26,0,28,2
1653301595437,LISP 1BX,E00,087199,Munoz Sanchez; Alicia,28,0,28,0
1653301595972,LISP 1D,001,087200,Munoz Sanchez; Alicia,13,0,14,1
1653301595972,LISP 1D,002,087201,Munoz Sanchez; Alicia,14,0,14,0
1653301595972,LISP 1D,003,087202,Munoz Sanchez; Alicia,8,0,14,6
1653301595972,LISP 1D,004,087203,Munoz Sanchez; Alicia,5,0,14,9
1653301595972,LISP 1D,005,087204,Munoz Sanchez; Alicia,11,0,14,3
1653301595972,LISP 1D,006,087205,Munoz Sanchez; Alicia,13,0,14,1
1653301595972,LISP 1D,007,087206,Munoz Sanchez; Alicia,13,0,14,1
1653301595972,LISP 1D,008,087207,Munoz Sanchez; Alicia,13,0,14,1
1653301595972,LISP 1D,009,087208,Munoz Sanchez; Alicia,14,0,14,0
1653301595972,LISP 1D,010,087209,Munoz Sanchez; Alicia,12,0,14,2
1653301595972,LISP 1D,011,087210,Munoz Sanchez; Alicia,13,0,14,1
1653301595972,LISP 1D,012,087211,Munoz Sanchez; Alicia,14,0,14,0
1653301595972,LISP 1D,013,087212,Munoz Sanchez; Alicia,14,0,14,0
1653301595972,LISP 1D,014,087213,Munoz Sanchez; Alicia,14,0,14,0
1653301596507,LISP 1DX,A00,087214,Munoz Sanchez; Alicia,27,0,28,1
1653301596507,LISP 1DX,B00,087215,Munoz Sanchez; Alicia,23,0,28,5
1653301596507,LISP 1DX,C00,087216,Munoz Sanchez; Alicia,23,0,28,5
1653301596507,LISP 1DX,D00,087217,Munoz Sanchez; Alicia,25,0,28,3
1653301596507,LISP 1DX,E00,087218,Munoz Sanchez; Alicia,27,0,28,1
1653301596507,LISP 1DX,F00,087219,Munoz Sanchez; Alicia,25,0,28,3
1653301596507,LISP 1DX,G00,087220,Munoz Sanchez; Alicia,28,0,28,0
1653301597048,LISP 15,A00,087221,Munoz Sanchez; Alicia,19,0,20,1
1653301597581,LISP 18,A00,087222,Munoz Sanchez; Alicia,15,0,20,5
1653301598105,LTAM 110,A00,087352,Chacon; Gloria Elizabeth,35,0,40,5
1653301598631,LTCS 87,A00,094011,Nguyen; Hoang Tan,19,0,20,1
1653301599153,LTCS 111,A00,087353,Vitkus; Daniel J.,40,0,40,0
1653301599679,LTCS 119,A00,087354,Nguyen; Hoang Tan,29,0,30,1
1653301600208,LTCS 130,A00,087355,Kim; Joo Ok,37,0,40,3
1653301600741,LTCS 165,A00,087356,Kim; Joo Ok,38,0,40,2
1653301601267,LTEA 120A,A00,087357,Fiss; Geraldine Anna,291,0,300,9
1653301601793,LTEA 140,A00,094009,Lee; Jin-Kyung,28,0,32,4
1653301602319,LTEA 142,A00,087358,Lee; Jin-Kyung,102,0,120,18
1653301602842,LTEN 21,A01,087275,Lampert-Weissig; Lisa,25,0,25,0
1653301602842,LTEN 21,A02,087276,Lampert-Weissig; Lisa,25,0,25,0
1653301602842,LTEN 21,A03,087277,Lampert-Weissig; Lisa,25,0,25,0
1653301602842,LTEN 21,A04,087278,Lampert-Weissig; Lisa,25,0,25,0
1653301603365,LTEN 25,A01,087280,Johnson; Sara E.,25,0,25,0
1653301603365,LTEN 25,A02,087281,Johnson; Sara E.,25,0,25,0
1653301603365,LTEN 25,A03,087282,Johnson; Sara E.,23,0,25,2
1653301603365,LTEN 25,A04,087283,Johnson; Sara E.,25,0,25,0
1653301603887,LTEN 29,A01,087285,Ruiz; Ariana,24,0,25,1
1653301603887,LTEN 29,A02,087286,Ruiz; Ariana,25,0,25,0
1653301603887,LTEN 29,A03,087287,Ruiz; Ariana,24,0,25,1
1653301603887,LTEN 29,A04,087288,Ruiz; Ariana,24,0,25,1
1653301604415,LTEN 107,A00,087359,Lampert-Weissig; Lisa,39,0,40,1
1653301604943,LTEN 117,A00,087360,Vitkus; Daniel J.,40,0,40,0
1653301605468,LTEN 127,A00,087361,Loose; Margaret,38,0,40,2
1653301605995,LTEN 142,A00,094010,Loose; Margaret,38,0,40,2
1653301606517,LTEN 148,A00,087363,Walkiewicz; Kathryn A,40,0,40,0
1653301607041,LTEN 152,A00,087364,Walkiewicz; Kathryn A,37,0,40,3
1653301607564,LTEN 180,A00,087365,Ruiz; Ariana,18,0,20,2
1653301608087,LTFR 2A,A01,087290,Ploye; Catherine,23,0,25,2
1653301608609,LTFR 2B,A01,087292,Ploye; Catherine,25,0,25,0
1653301609136,LTFR 104,A00,087366,Ploye; Catherine,25,0,25,0
1653301609673,LTFR 116,A00,087367,Zhiri; Oumelbanine,13,0,15,2
1653301610219,LTGK 1,A00,087293,Myerston Santana; Jacobo,27,0,30,3
1653301610763,LTGK 103,A00,087368,duBois; Page Ann,14,0,15,1
1653301611298,LTGM 2A,A01,087295,Fischer-Grunski; Eva K,24,0,25,1
1653301611843,LTIT 2A,A01,087297,De Marchi Gherini; Adriana,24,0,25,1
1653301612387,LTKO 1A,A01,087299,Staff,24,0,25,1
1653301612387,LTKO 1A,B01,087301,Staff,25,0,25,0
1653301612387,LTKO 1A,C01,087303,Staff,25,0,25,0
1653301612387,LTKO 1A,D01,087305,Staff,25,0,25,0
1653301612387,LTKO 1A,E01,087307,Staff,24,0,25,1
1653301612387,LTKO 1A,F01,087309,Staff,25,0,25,0
1653301612387,LTKO 1A,G01,087311,Staff,25,0,25,0
1653301612387,LTKO 1A,H01,087313,Staff,24,0,25,1
1653301612387,LTKO 1A,I01,087315,Staff,25,0,25,0
1653301612937,LTKO 2A,A01,087317,Staff,24,0,25,1
1653301612937,LTKO 2A,B01,087319,Staff,22,0,25,3
1653301612937,LTKO 2A,C01,087321,Lee; Jeyseon,24,0,25,1
1653301613487,LTKO 130,A00,087369,Lee; Jeyseon,25,0,25,0
1653301614012,LTLA 1,A00,087322,Murray; Kourtney Kristine,38,0,40,2
1653301614547,LTLA 100,A00,087371,Kelting; Edward William,23,0,25,2
1653301615075,LTRU 1A,A01,087324,Wells; Patricia Rebecca,23,0,25,2
1653301615623,LTRU 2A,A01,087326,Wells; Patricia Rebecca,20,0,20,0
1653301616152,LTRU 104B,A01,087373,Wells; Patricia Rebecca,14,0,15,1
1653301616688,LTSP 2A,A01,087328,Staff,25,0,25,0
1653301616688,LTSP 2A,B01,087330,Staff,22,0,25,3
1653301616688,LTSP 2A,C01,087332,Staff,22,0,25,3
1653301617306,LTSP 2B,A01,087334,Staff,22,0,25,3
1653301617306,LTSP 2B,B01,087336,Staff,19,0,25,6
1653301617835,LTSP 2D,A00,087337,Staff,25,0,25,0
1653301617835,LTSP 2D,B00,087338,Staff,25,0,25,0
1653301617835,LTSP 2D,C00,087339,Staff,25,0,25,0
1653301618361,LTSP 100A,A00,087374,Arcos Herrera; Carol,23,0,25,2
1653301618887,LTSP 116,A00,087375,Blanco; John D,29,0,30,1
1653301619414,LTSP 140,A00,087376,Chacon; Gloria Elizabeth,30,0,30,0
1653301619938,LTSP 175,A00,087377,Arcos Herrera; Carol,30,0,30,0
1653301620469,LTTH 150,A00,087379,Cohen; Alain J. J.,40,0,40,0
1653301620993,LTWL 19A,A00,087340,Myerston Santana; Jacobo,39,0,40,1
1653301621528,LTWL 87,A00,094012,Lampert-Weissig; Lisa,20,0,20,0
1653301622064,LTWL 116,A00,087380,Nguyen; Hoang Tan,60,0,60,0
1653301622599,LTWL 120,A00,087381,Fiss; Geraldine Anna,37,0,40,3
1653301623124,LTWL 172,A00,087382,De Marchi Gherini; Adriana,40,0,40,0
1653301623657,LTWL 180,A00,087383,Kontje; Todd Curtis,39,0,40,1
1653301624204,LTWL 194,A00,087384,Suzuki; Erin M.,31,0,32,1
1653301624733,LTWR 8A,A01,087342,Jemc; Jaclyn,24,0,25,1
1653301624733,LTWR 8A,A02,087343,Jemc; Jaclyn,25,0,25,0
1653301624733,LTWR 8A,A03,087344,Jemc; Jaclyn,24,0,25,1
1653301624733,LTWR 8A,A04,087345,Jemc; Jaclyn,24,0,25,1
1653301625262,LTWR 8C,A01,087348,Forbes; Camille,25,0,25,0
1653301625262,LTWR 8C,A02,087349,Forbes; Camille,25,0,25,0
1653301625262,LTWR 8C,A03,087350,Forbes; Camille,25,0,25,0
1653301625262,LTWR 8C,A04,087351,Forbes; Camille,23,0,25,2
1653301625789,LTWR 100,A00,087385,Staff,12,0,15,3
1653301626316,LTWR 102,A00,087386,Staff,14,0,15,1
1653301626850,LTWR 115,A00,087387,Carroll; Amy Sara,24,0,30,6
1653301627375,LTWR 119,A00,087388,Staff,22,0,30,8
1653301627902,LTWR 140,A00,087389,Carroll; Amy Sara,37,0,40,3
1653301628425,LTWR 194,A00,087390,Som; Brandon D,35,0,40,5
1653301628951,MAE 2,A01,090334,Anderson; Mark Ronald,8,0,8,0
1653301628951,MAE 2,A02,090335,Anderson; Mark Ronald,8,0,8,0
1653301628951,MAE 2,A03,090336,Anderson; Mark Ronald,8,0,8,0
1653301628951,MAE 2,A04,090337,Anderson; Mark Ronald,8,0,8,0
1653301628951,MAE 2,A05,090338,Anderson; Mark Ronald,8,0,8,0
1653301628951,MAE 2,A06,090339,Anderson; Mark Ronald,8,0,8,0
1653301628951,MAE 2,A07,090340,Anderson; Mark Ronald,8,0,8,0
1653301628951,MAE 2,A08,090341,Anderson; Mark Ronald,7,0,8,1
1653301628951,MAE 2,A09,090342,Anderson; Mark Ronald,8,0,8,0
1653301629477,MAE 3,A01,090344,Delson; Nathan Joseph,21,0,22,1
1653301629477,MAE 3,A02,090345,Delson; Nathan Joseph,20,0,22,2
1653301629477,MAE 3,A03,090346,Delson; Nathan Joseph,21,0,22,1
1653301629477,MAE 3,A04,090347,Delson; Nathan Joseph,22,0,22,0
1653301629477,MAE 3,B01,090349,Qi; Huihui,18,0,22,4
1653301629477,MAE 3,B02,090350,Qi; Huihui,17,0,22,5
1653301629477,MAE 3,B03,090351,Qi; Huihui,20,0,22,2
1653301629477,MAE 3,B04,090352,Qi; Huihui,19,0,22,3
1653301630001,MAE 8,A01,090354,Pham; Hieu Tan,182,0,185,3
1653301630524,MAE 11,A00,090355,Nomura; Keiko K.,155,0,165,10
1653301631056,MAE 20,A00,090356,Bandaru; Prabhakar,160,0,160,0
1653301631056,MAE 20,B00,090357,Evdokimenko; Ekaterina,145,0,160,15
1653301631602,MAE 21,A01,090359,Cai; Shengqiang,8,0,9,1
1653301631602,MAE 21,A02,090360,Cai; Shengqiang,9,0,9,0
1653301631602,MAE 21,A03,090361,Cai; Shengqiang,6,0,9,3
1653301631602,MAE 21,A04,090362,Cai; Shengqiang,7,0,9,2
1653301631602,MAE 21,A05,090363,Cai; Shengqiang,0,0,0,0
1653301631602,MAE 21,A06,090364,Cai; Shengqiang,9,0,9,0
1653301631602,MAE 21,A07,090365,Cai; Shengqiang,9,0,9,0
1653301631602,MAE 21,A08,090366,Cai; Shengqiang,8,0,9,1
1653301631602,MAE 21,A09,090367,Cai; Shengqiang,8,0,9,1
1653301631602,MAE 21,A10,090368,Cai; Shengqiang,0,0,0,0
1653301631602,MAE 21,A11,090369,Cai; Shengqiang,9,0,9,0
1653301631602,MAE 21,A12,090370,Cai; Shengqiang,8,0,9,1
1653301632126,MAE 30A,A00,090371,Lal; Ratnesh,72,0,75,3
1653301632651,MAE 40,A00,090372,Bitmead; Robert R.,167,0,175,8
1653301633183,MAE 101A,A00,090373,Bahadori; Mohammad Yousef,105,0,115,10
1653301633709,MAE 101C,A00,090374,Poulikakos; Lisa Voula,41,0,110,69
1653301633709,MAE 101C,B00,090375,Chen; Renkun,96,0,110,14
1653301634234,MAE 104,A00,090376,Sanchez; Antonio Luis,78,0,120,42
1653301634772,MAE 105,A00,090377,Saintillan; David,154,0,170,16
1653301635307,MAE 107,A00,090378,Lindsey; Stephanie,104,0,110,6
1653301635307,MAE 107,B00,090379,Tolley; Michael Thomas,85,0,110,25
1653301635834,MAE 118,A00,090380,Krasheninnikov; Sergei,27,0,45,18
1653301636357,MAE 131A,A00,090381,Ghazinejad; Maziar,70,0,75,5
1653301636880,MAE 133,A00,090382,Frazier; Michael,26,0,33,7
1653301637404,MAE 143A,A00,090383,de Oliveira; Mauricio,74,0,100,26
1653301637932,MAE 144,A00,090384,Bewley; Thomas R,50,0,70,20
1653301638469,MAE 148,A01,091597,Staff,32,0,32,0
1653301638993,MAE 150,A00,090385,Friend; James Robert,69,0,90,21
1653301638993,MAE 150,B00,090386,Ghazinejad; Maziar,4,0,90,86
1653301639520,MAE 152,A00,090387,Tynan; George Robert,0,0,16,16
1653301639520,MAE 152,B00,090388,Tynan; George Robert,0,0,16,16
1653301639520,MAE 152,C00,090389,Tynan; George Robert,0,0,16,16
1653301639520,MAE 152,D00,090390,Tynan; George Robert,0,0,16,16
1653301640062,MAE 156A,A01,090392,Delson; Nathan Joseph,2,0,12,10
1653301640062,MAE 156A,A02,090393,Delson; Nathan Joseph,1,0,12,11
1653301640062,MAE 156A,A03,090394,Delson; Nathan Joseph,4,0,12,8
1653301640588,MAE 170,A01,090396,Lubarda; Marko,14,0,30,16
1653301640588,MAE 170,A02,090397,Lubarda; Marko,19,0,30,11
1653301640588,MAE 170,A03,090398,Lubarda; Marko,28,0,30,2
1653301640588,MAE 170,A04,090399,Lubarda; Marko,20,0,30,10
1653301640588,MAE 170,B01,090401,Diagne; Mamadou Lamine,30,0,30,0
1653301640588,MAE 170,B02,090402,Diagne; Mamadou Lamine,27,0,30,3
1653301640588,MAE 170,B03,090403,Diagne; Mamadou Lamine,28,0,30,2
1653301640588,MAE 170,B04,090404,Diagne; Mamadou Lamine,28,0,30,2
1653301641114,MAE 180A,A00,090405,McEneaney; William Michael,110,0,125,15
1653301641641,MAE 181,A00,090406,Bahadori; Mohammad Yousef,46,0,60,14
1653301642165,MAE 190,A00,090407,Anderson; Mark Ronald,27,0,45,18
1653301642718,MAE 191,A01,090409,Qi; Huihui,25,0,32,7
1653301643243,MATH 2,A01,089123,Hammock; Frances H,0,0,0,0
1653301643243,MATH 2,B01,089126,Hammock; Frances H,0,0,0,0
1653301643243,MATH 2,C01,089129,Hammock; Frances H,0,0,0,0
1653301643243,MATH 2,D01,094201,Harel; Guershon,0,0,0,0
1653301643770,MATH 3C,A01,089132,Bowers; Adam R.,0,0,0,0
1653301643770,MATH 3C,A02,089133,Bowers; Adam R.,0,0,0,0
1653301643770,MATH 3C,A03,089134,Bowers; Adam R.,0,0,0,0
1653301643770,MATH 3C,A04,089135,Bowers; Adam R.,0,0,0,0
1653301643770,MATH 3C,A05,089136,Bowers; Adam R.,0,0,0,0
1653301643770,MATH 3C,A06,089137,Bowers; Adam R.,0,0,0,0
1653301643770,MATH 3C,A07,089138,Bowers; Adam R.,0,0,0,0
1653301643770,MATH 3C,A08,089139,Bowers; Adam R.,0,0,0,0
1653301643770,MATH 3C,A09,089140,Bowers; Adam R.,0,0,0,0
1653301643770,MATH 3C,A10,089141,Bowers; Adam R.,0,0,0,0
1653301643770,MATH 3C,A11,089142,Bowers; Adam R.,0,0,0,0
1653301643770,MATH 3C,A12,089143,Bowers; Adam R.,0,0,0,0
1653301643770,MATH 3C,A13,089144,Bowers; Adam R.,0,0,0,0
1653301643770,MATH 3C,A14,089145,Bowers; Adam R.,0,0,0,0
1653301643770,MATH 3C,A15,089146,Bowers; Adam R.,0,0,0,0
1653301643770,MATH 3C,A16,089147,Bowers; Adam R.,0,0,0,0
1653301643770,MATH 3C,A17,089148,Bowers; Adam R.,0,0,0,0
1653301643770,MATH 3C,A18,089149,Bowers; Adam R.,0,0,0,0
1653301643770,MATH 3C,A19,089150,Bowers; Adam R.,0,0,0,0
1653301643770,MATH 3C,A20,089151,Bowers; Adam R.,0,0,0,0
1653301643770,MATH 3C,A21,089152,Bowers; Adam R.,0,0,0,0
1653301643770,MATH 3C,A22,089153,Bowers; Adam R.,0,0,0,0
1653301643770,MATH 3C,A23,089154,Bowers; Adam R.,0,0,0,0
1653301643770,MATH 3C,A24,089155,Bowers; Adam R.,0,0,0,0
1653301643770,MATH 3C,B01,089158,Staff,0,0,0,0
1653301643770,MATH 3C,B02,089159,Staff,0,0,0,0
1653301643770,MATH 3C,B03,089160,Staff,0,0,0,0
1653301643770,MATH 3C,B04,089161,Staff,0,0,0,0
1653301643770,MATH 3C,C01,094244,Staff,0,0,0,0
1653301643770,MATH 3C,C02,094245,Staff,0,0,0,0
1653301643770,MATH 3C,C03,094246,Staff,0,0,0,0
1653301643770,MATH 3C,C04,094247,Staff,0,0,0,0
1653301644303,MATH 4C,A01,089164,Staff,0,0,0,0
1653301644303,MATH 4C,A02,089165,Staff,0,0,0,0
1653301644303,MATH 4C,A03,089166,Staff,0,0,0,0
1653301644303,MATH 4C,B01,089169,Ganzberger; Geoffrey Michael,0,0,0,0
1653301644303,MATH 4C,B02,089170,Ganzberger; Geoffrey Michael,0,0,0,0
1653301644303,MATH 4C,B03,089171,Ganzberger; Geoffrey Michael,0,0,0,0
1653301644303,MATH 4C,C01,089174,Ganzberger; Geoffrey Michael,0,0,0,0
1653301644303,MATH 4C,C02,089175,Ganzberger; Geoffrey Michael,0,0,0,0
1653301644303,MATH 4C,C03,089176,Ganzberger; Geoffrey Michael,0,0,0,0
1653301644303,MATH 4C,D01,094249,Ganzberger; Geoffrey Michael,0,0,0,0
1653301644303,MATH 4C,D02,094250,Ganzberger; Geoffrey Michael,0,0,0,0
1653301644303,MATH 4C,D03,094251,Ganzberger; Geoffrey Michael,0,0,0,0
1653301644831,MATH 10A,A01,089179,Jin; Muzhi,5,0,5,0
1653301644831,MATH 10A,A02,089180,Jin; Muzhi,5,0,5,0
1653301644831,MATH 10A,A03,089181,Jin; Muzhi,4,0,5,1
1653301644831,MATH 10A,A04,089182,Jin; Muzhi,4,0,5,1
1653301644831,MATH 10A,A05,089183,Jin; Muzhi,5,0,5,0
1653301644831,MATH 10A,A06,089184,Jin; Muzhi,5,0,5,0
1653301644831,MATH 10A,A07,089185,Jin; Muzhi,5,0,5,0
1653301644831,MATH 10A,A08,089186,Jin; Muzhi,5,0,5,0
1653301644831,MATH 10A,B01,089188,Stevens; Laura Jeanne,1,0,5,4
1653301644831,MATH 10A,B02,089189,Stevens; Laura Jeanne,4,0,5,1
1653301644831,MATH 10A,B03,089190,Stevens; Laura Jeanne,4,0,5,1
1653301644831,MATH 10A,B04,089191,Stevens; Laura Jeanne,5,0,5,0
1653301644831,MATH 10A,B05,089192,Stevens; Laura Jeanne,4,0,5,1
1653301644831,MATH 10A,B06,089193,Stevens; Laura Jeanne,5,0,5,0
1653301644831,MATH 10A,B07,089194,Stevens; Laura Jeanne,5,0,5,0
1653301644831,MATH 10A,B08,089195,Stevens; Laura Jeanne,4,0,5,1
1653301644831,MATH 10A,C01,089197,Jin; Muzhi,1,0,5,4
1653301644831,MATH 10A,C02,089198,Jin; Muzhi,5,0,5,0
1653301644831,MATH 10A,C03,089199,Jin; Muzhi,5,0,5,0
1653301644831,MATH 10A,C04,089200,Jin; Muzhi,5,0,5,0
1653301644831,MATH 10A,C05,089201,Jin; Muzhi,5,0,5,0
1653301644831,MATH 10A,C06,089202,Jin; Muzhi,5,0,5,0
1653301644831,MATH 10A,D01,089204,Upton; James Thomas,4,0,5,1
1653301644831,MATH 10A,D02,089205,Upton; James Thomas,5,0,5,0
1653301644831,MATH 10A,D03,089206,Upton; James Thomas,5,0,5,0
1653301644831,MATH 10A,D04,089207,Upton; James Thomas,5,0,5,0
1653301644831,MATH 10A,E01,089211,Greenfeld; Be'Eri,5,0,5,0
1653301644831,MATH 10A,E02,089212,Greenfeld; Be'Eri,3,0,5,2
1653301644831,MATH 10A,E03,089213,Greenfeld; Be'Eri,4,0,5,1
1653301644831,MATH 10A,E04,089214,Greenfeld; Be'Eri,5,0,5,0
1653301644831,MATH 10A,E05,089215,Greenfeld; Be'Eri,5,0,5,0
1653301644831,MATH 10A,E06,089216,Greenfeld; Be'Eri,5,0,5,0
1653301645355,MATH 10B,A01,089218,Stevens; Laura Jeanne,7,0,8,1
1653301645355,MATH 10B,A02,089219,Stevens; Laura Jeanne,7,0,8,1
1653301645355,MATH 10B,A03,089220,Stevens; Laura Jeanne,8,0,8,0
1653301645355,MATH 10B,A04,089221,Stevens; Laura Jeanne,6,0,8,2
1653301645355,MATH 10B,A05,089222,Stevens; Laura Jeanne,2,0,8,6
1653301645355,MATH 10B,A06,089223,Stevens; Laura Jeanne,0,0,8,8
1653301645355,MATH 10B,A07,089224,Stevens; Laura Jeanne,6,0,8,2
1653301645355,MATH 10B,A08,089225,Stevens; Laura Jeanne,4,0,8,4
1653301645355,MATH 10B,B01,089227,Staff,8,0,8,0
1653301645355,MATH 10B,B02,089228,Staff,8,0,8,0
1653301645355,MATH 10B,B03,089229,Staff,7,0,8,1
1653301645355,MATH 10B,B04,089230,Staff,8,0,8,0
1653301645355,MATH 10B,B05,089231,Staff,8,0,8,0
1653301645355,MATH 10B,B06,089232,Staff,8,0,8,0
1653301645355,MATH 10B,B07,089233,Staff,8,0,8,0
1653301645355,MATH 10B,B08,089234,Staff,8,0,8,0
1653301645355,MATH 10B,C01,089236,McKinley; Gweneth Anne,4,0,8,4
1653301645355,MATH 10B,C02,089237,McKinley; Gweneth Anne,8,0,8,0
1653301645355,MATH 10B,C03,089238,McKinley; Gweneth Anne,8,0,8,0
1653301645355,MATH 10B,C04,089239,McKinley; Gweneth Anne,8,0,8,0
1653301645355,MATH 10B,C05,089240,McKinley; Gweneth Anne,8,0,8,0
1653301645355,MATH 10B,C06,089241,McKinley; Gweneth Anne,8,0,8,0
1653301645889,MATH 10C,A01,089243,Staff,13,0,20,7
1653301645889,MATH 10C,A02,089244,Staff,20,0,20,0
1653301645889,MATH 10C,A03,089245,Staff,18,0,20,2
1653301645889,MATH 10C,A04,089246,Staff,20,0,20,0
1653301645889,MATH 10C,A05,089247,Staff,19,0,20,1
1653301645889,MATH 10C,A06,089248,Staff,20,0,20,0
1653301645889,MATH 10C,A07,094505,Staff,20,0,20,0
1653301645889,MATH 10C,A08,094506,Staff,20,0,20,0
1653301645889,MATH 10C,B01,089250,Staff,19,0,20,1
1653301645889,MATH 10C,B02,089251,Staff,19,0,20,1
1653301645889,MATH 10C,B03,089252,Staff,14,0,20,6
1653301645889,MATH 10C,B04,089253,Staff,20,0,20,0
1653301645889,MATH 10C,B05,089254,Staff,20,0,20,0
1653301645889,MATH 10C,B06,089255,Staff,18,0,20,2
1653301646427,MATH 11,A01,089258,Rava; Denise,1,0,15,14
1653301646427,MATH 11,A02,089260,Rava; Denise,9,0,15,6
1653301646427,MATH 11,A03,089263,Rava; Denise,10,0,15,5
1653301646427,MATH 11,A04,089265,Rava; Denise,13,0,15,2
1653301646427,MATH 11,A05,089267,Rava; Denise,10,0,15,5
1653301646427,MATH 11,A06,089269,Rava; Denise,14,0,15,1
1653301646427,MATH 11,A07,089271,Rava; Denise,14,0,15,1
1653301646427,MATH 11,A08,089273,Rava; Denise,13,0,15,2
1653301646427,MATH 11,B01,089279,Staff,4,0,15,11
1653301646427,MATH 11,B02,089281,Staff,14,0,15,1
1653301646427,MATH 11,B03,089283,Staff,14,0,15,1
1653301646427,MATH 11,B04,089284,Staff,15,0,15,0
1653301646427,MATH 11,B05,089286,Staff,14,0,15,1
1653301646427,MATH 11,B06,089288,Staff,15,0,15,0
1653301646427,MATH 11,B07,089289,Staff,14,0,15,1
1653301646427,MATH 11,B08,089290,Staff,14,0,15,1
1653301646955,MATH 18,A01,089303,Anzaldo; Leesa B,5,0,10,5
1653301646955,MATH 18,A02,089304,Anzaldo; Leesa B,6,0,10,4
1653301646955,MATH 18,A03,089305,Anzaldo; Leesa B,10,0,10,0
1653301646955,MATH 18,A04,089306,Anzaldo; Leesa B,8,0,10,2
1653301646955,MATH 18,A05,089307,Anzaldo; Leesa B,10,0,10,0
1653301646955,MATH 18,A06,089308,Anzaldo; Leesa B,9,0,10,1
1653301646955,MATH 18,A07,089309,Anzaldo; Leesa B,10,0,10,0
1653301646955,MATH 18,A08,089310,Anzaldo; Leesa B,10,0,10,0
1653301646955,MATH 18,A09,089311,Anzaldo; Leesa B,10,0,10,0
1653301646955,MATH 18,A10,089312,Anzaldo; Leesa B,10,0,10,0
1653301646955,MATH 18,A11,089313,Anzaldo; Leesa B,9,0,10,1
1653301646955,MATH 18,A12,089314,Anzaldo; Leesa B,10,0,10,0
1653301646955,MATH 18,A13,089315,Anzaldo; Leesa B,9,0,10,1
1653301646955,MATH 18,A14,089316,Anzaldo; Leesa B,10,0,10,0
1653301646955,MATH 18,A15,089317,Anzaldo; Leesa B,9,0,10,1
1653301646955,MATH 18,A16,089318,Anzaldo; Leesa B,10,0,10,0
1653301646955,MATH 18,A17,089319,Anzaldo; Leesa B,9,0,10,1
1653301646955,MATH 18,A18,089320,Anzaldo; Leesa B,10,0,10,0
1653301646955,MATH 18,A19,089321,Anzaldo; Leesa B,0,0,0,0
1653301646955,MATH 18,A20,089322,Anzaldo; Leesa B,0,0,0,0
1653301646955,MATH 18,A21,089323,Anzaldo; Leesa B,9,0,10,1
1653301646955,MATH 18,A22,089324,Anzaldo; Leesa B,7,0,10,3
1653301646955,MATH 18,A23,089325,Anzaldo; Leesa B,10,0,10,0
1653301646955,MATH 18,A24,089326,Anzaldo; Leesa B,9,0,10,1
1653301646955,MATH 18,B01,089329,Staff,13,0,13,0
1653301646955,MATH 18,B02,089330,Staff,12,0,13,1
1653301646955,MATH 18,B03,089331,Staff,12,0,13,1
1653301646955,MATH 18,B04,089332,Staff,13,0,13,0
1653301646955,MATH 18,B05,089333,Staff,12,0,13,1
1653301646955,MATH 18,C01,089336,Staff,13,0,13,0
1653301646955,MATH 18,C02,089337,Staff,11,0,13,2
1653301646955,MATH 18,C03,089338,Staff,0,0,0,0
1653301646955,MATH 18,C04,089339,Staff,0,0,0,0
1653301646955,MATH 18,C05,089340,Staff,0,0,0,1
1653301646955,MATH 18,D01,094194,Staff,0,0,0,0
1653301646955,MATH 18,D02,094195,Staff,0,0,0,0
1653301646955,MATH 18,D03,094196,Staff,0,0,0,0
1653301646955,MATH 18,D04,094197,Staff,0,0,0,0
1653301646955,MATH 18,D05,094198,Staff,0,0,0,0
1653301647493,MATH 20A,A01,089343,Staff,5,0,5,0
1653301647493,MATH 20A,A02,089344,Staff,5,0,5,0
1653301647493,MATH 20A,A03,089345,Staff,5,0,5,0
1653301647493,MATH 20A,B01,089347,Suk; Andrew Hoon,2,0,3,1
1653301647493,MATH 20A,B02,089348,Suk; Andrew Hoon,3,0,3,0
1653301647493,MATH 20A,B03,089349,Suk; Andrew Hoon,3,0,3,0
1653301647493,MATH 20A,B04,089350,Suk; Andrew Hoon,3,0,3,0
1653301647493,MATH 20A,B05,089351,Suk; Andrew Hoon,3,0,3,0
1653301647493,MATH 20A,B06,089352,Suk; Andrew Hoon,2,0,3,1
1653301647493,MATH 20A,B07,089353,Suk; Andrew Hoon,3,0,3,0
1653301647493,MATH 20A,B08,089354,Suk; Andrew Hoon,3,0,3,0
1653301647493,MATH 20A,B09,089355,Suk; Andrew Hoon,3,0,3,0
1653301647493,MATH 20A,B10,089356,Suk; Andrew Hoon,3,0,3,0
1653301647493,MATH 20A,B11,089357,Suk; Andrew Hoon,3,0,3,0
1653301647493,MATH 20A,B12,089358,Suk; Andrew Hoon,3,0,3,0
1653301647493,MATH 20A,B13,089359,Suk; Andrew Hoon,2,0,3,1
1653301647493,MATH 20A,B14,089360,Suk; Andrew Hoon,3,0,3,0
1653301647493,MATH 20A,B15,089361,Suk; Andrew Hoon,3,0,3,0
1653301647493,MATH 20A,B16,089362,Suk; Andrew Hoon,3,0,3,0
1653301647493,MATH 20A,B17,089363,Suk; Andrew Hoon,3,0,3,0
1653301647493,MATH 20A,B18,089364,Suk; Andrew Hoon,0,0,0,0
1653301647493,MATH 20A,B19,089365,Suk; Andrew Hoon,3,0,3,0
1653301647493,MATH 20A,B20,089366,Suk; Andrew Hoon,3,0,3,0
1653301647493,MATH 20A,B21,089367,Suk; Andrew Hoon,3,0,3,0
1653301647493,MATH 20A,B22,089368,Suk; Andrew Hoon,3,0,3,0
1653301647493,MATH 20A,B23,089369,Suk; Andrew Hoon,3,0,3,0
1653301647493,MATH 20A,B24,089370,Suk; Andrew Hoon,3,0,3,0
1653301648027,MATH 20B,A01,089372,Quarfoot; David James,8,0,8,0
1653301648027,MATH 20B,A02,089373,Quarfoot; David James,8,0,8,0
1653301648027,MATH 20B,A03,089374,Quarfoot; David James,7,0,8,1
1653301648027,MATH 20B,A04,089375,Quarfoot; David James,7,0,8,1
1653301648027,MATH 20B,A05,089376,Quarfoot; David James,0,0,0,0
1653301648027,MATH 20B,A06,089377,Quarfoot; David James,0,0,0,0
1653301648027,MATH 20B,A07,089378,Quarfoot; David James,0,0,0,0
1653301648027,MATH 20B,A08,089379,Quarfoot; David James,0,0,0,0
1653301648027,MATH 20B,A09,089380,Quarfoot; David James,0,0,0,0
1653301648027,MATH 20B,A10,089381,Quarfoot; David James,0,0,0,0
1653301648027,MATH 20B,A11,089382,Quarfoot; David James,0,0,0,0
1653301648027,MATH 20B,A12,089383,Quarfoot; David James,0,0,0,0
1653301648027,MATH 20B,A13,089384,Quarfoot; David James,0,0,0,0
1653301648027,MATH 20B,A14,089385,Quarfoot; David James,0,0,0,0
1653301648027,MATH 20B,A15,089386,Quarfoot; David James,0,0,0,0
1653301648027,MATH 20B,A16,089387,Quarfoot; David James,0,0,0,0
1653301648027,MATH 20B,A17,089388,Quarfoot; David James,8,0,8,0
1653301648027,MATH 20B,A18,089389,Quarfoot; David James,8,0,8,0
1653301648027,MATH 20B,A19,089390,Quarfoot; David James,8,0,8,0
1653301648027,MATH 20B,A20,089391,Quarfoot; David James,8,0,8,0
1653301648027,MATH 20B,A21,089392,Quarfoot; David James,8,0,8,0
1653301648027,MATH 20B,A22,089393,Quarfoot; David James,7,0,8,1
1653301648027,MATH 20B,A23,089394,Quarfoot; David James,7,0,8,1
1653301648027,MATH 20B,A24,089395,Quarfoot; David James,8,0,8,0
1653301648027,MATH 20B,B01,089397,Lahiri; Aranya,7,0,10,3
1653301648027,MATH 20B,B02,089398,Lahiri; Aranya,10,0,10,0
1653301648027,MATH 20B,B03,089399,Lahiri; Aranya,10,0,10,0
1653301648027,MATH 20B,B04,089400,Lahiri; Aranya,10,0,10,0
1653301648027,MATH 20B,B05,089401,Lahiri; Aranya,10,0,10,0
1653301648027,MATH 20B,C01,089403,Lahiri; Aranya,0,0,0,0
1653301648027,MATH 20B,C02,089404,Lahiri; Aranya,8,0,10,2
1653301648027,MATH 20B,C03,089405,Lahiri; Aranya,10,0,10,0
1653301648027,MATH 20B,C04,089406,Lahiri; Aranya,9,0,10,1
1653301648027,MATH 20B,C05,089407,Lahiri; Aranya,9,0,10,1
1653301648602,MATH 20C,A01,089409,Um; Ko Woon,10,0,10,0
1653301648602,MATH 20C,A02,089410,Um; Ko Woon,10,0,10,0
1653301648602,MATH 20C,A03,089411,Um; Ko Woon,9,0,10,1
1653301648602,MATH 20C,A04,089412,Um; Ko Woon,9,0,10,1
1653301648602,MATH 20C,A05,089413,Um; Ko Woon,10,0,10,0
1653301648602,MATH 20C,A06,089414,Um; Ko Woon,9,0,10,1
1653301648602,MATH 20C,A07,094270,Um; Ko Woon,10,0,10,0
1653301648602,MATH 20C,A08,094271,Um; Ko Woon,10,0,10,0
1653301648602,MATH 20C,A09,094272,Um; Ko Woon,7,0,10,3
1653301648602,MATH 20C,A10,094273,Um; Ko Woon,10,0,10,0
1653301648602,MATH 20C,A11,094274,Um; Ko Woon,10,0,10,0
1653301648602,MATH 20C,A12,094275,Um; Ko Woon,8,0,10,2
1653301648602,MATH 20C,A13,094276,Um; Ko Woon,10,0,10,0
1653301648602,MATH 20C,A14,094277,Um; Ko Woon,10,0,10,0
1653301648602,MATH 20C,A15,094278,Um; Ko Woon,10,0,10,0
1653301648602,MATH 20C,A16,094279,Um; Ko Woon,10,0,10,0
1653301648602,MATH 20C,B03,089418,Zhang; Ming,7,0,15,8
1653301648602,MATH 20C,B04,089419,Zhang; Ming,13,0,15,2
1653301648602,MATH 20C,B05,089420,Zhang; Ming,13,0,15,2
1653301648602,MATH 20C,C01,089423,Staff,15,0,15,0
1653301648602,MATH 20C,C02,089424,Staff,15,0,15,0
1653301648602,MATH 20C,C03,089425,Staff,15,0,15,0
1653301648602,MATH 20C,C04,089426,Staff,15,0,15,0
1653301648602,MATH 20C,C05,089427,Staff,15,0,15,0
1653301648602,MATH 20C,D04,089433,Zhang; Ming,13,0,15,2
1653301648602,MATH 20C,D05,089434,Zhang; Ming,15,0,15,0
1653301648602,MATH 20C,E01,089439,Staff,15,0,15,0
1653301648602,MATH 20C,E02,089440,Staff,15,0,15,0
1653301648602,MATH 20C,E03,089441,Staff,15,0,15,0
1653301648602,MATH 20C,E04,089442,Staff,15,0,15,0
1653301648602,MATH 20C,E05,089443,Staff,15,0,15,0
1653301648602,MATH 20C,E06,089444,Staff,15,0,15,0
1653301648602,MATH 20C,A17,094280,Um; Ko Woon,0,0,0,0
1653301648602,MATH 20C,A18,094281,Um; Ko Woon,0,0,0,0
1653301648602,MATH 20C,A19,094282,Um; Ko Woon,0,0,0,0
1653301648602,MATH 20C,A20,094283,Um; Ko Woon,0,0,0,0
1653301648602,MATH 20C,A21,094284,Um; Ko Woon,0,0,0,0
1653301648602,MATH 20C,A22,094285,Um; Ko Woon,0,0,0,0
1653301648602,MATH 20C,A23,094286,Um; Ko Woon,0,0,0,0
1653301648602,MATH 20C,A24,094287,Um; Ko Woon,0,0,0,0
1653301648602,MATH 20C,B01,089416,Zhang; Ming,0,0,0,0
1653301648602,MATH 20C,B02,089417,Zhang; Ming,0,0,0,0
1653301648602,MATH 20C,D01,089430,Zhang; Ming,0,0,0,0
1653301648602,MATH 20C,D02,089431,Zhang; Ming,0,0,0,0
1653301648602,MATH 20C,D03,089432,Zhang; Ming,0,0,0,0
1653301649128,MATH 20D,A01,089455,Lee; Kisun,11,0,25,14
1653301649128,MATH 20D,A02,089456,Lee; Kisun,24,0,25,1
1653301649128,MATH 20D,A03,089457,Lee; Kisun,24,0,25,1
1653301649128,MATH 20D,A04,089458,Lee; Kisun,25,0,25,0
1653301649128,MATH 20D,A05,089459,Lee; Kisun,25,0,25,0
1653301649128,MATH 20D,A06,089460,Lee; Kisun,25,0,25,0
1653301649128,MATH 20D,B01,089463,Lee; Kisun,20,0,25,5
1653301649128,MATH 20D,B02,089464,Lee; Kisun,25,0,25,0
1653301649128,MATH 20D,B03,089465,Lee; Kisun,24,0,25,1
1653301649128,MATH 20D,B04,089466,Lee; Kisun,25,0,25,0
1653301649128,MATH 20D,B05,089467,Lee; Kisun,23,0,25,2
1653301649128,MATH 20D,B06,089468,Lee; Kisun,24,0,25,1
1653301649128,MATH 20D,C01,089471,Staff,23,0,25,2
1653301649128,MATH 20D,C02,089472,Staff,25,0,25,0
1653301649128,MATH 20D,C03,089473,Staff,25,0,25,0
1653301649128,MATH 20D,C04,089474,Staff,25,0,25,0
1653301649128,MATH 20D,C05,089475,Staff,25,0,25,0
1653301649128,MATH 20D,C06,089476,Staff,25,0,25,0
1653301649653,MATH 20E,A01,089479,Eggers; John Dietrich,17,0,24,7
1653301649653,MATH 20E,A02,089480,Eggers; John Dietrich,24,0,25,1
1653301649653,MATH 20E,A03,089481,Eggers; John Dietrich,25,0,25,0
1653301649653,MATH 20E,A04,089482,Eggers; John Dietrich,25,0,25,0
1653301649653,MATH 20E,A05,089483,Eggers; John Dietrich,19,0,25,6
1653301649653,MATH 20E,A06,089484,Eggers; John Dietrich,25,0,25,0
1653301649653,MATH 20E,A07,089485,Eggers; John Dietrich,24,0,25,1
1653301649653,MATH 20E,A08,089486,Eggers; John Dietrich,24,0,25,1
1653301649653,MATH 20E,B01,089488,Staff,15,0,25,10
1653301649653,MATH 20E,B02,089489,Staff,21,0,25,4
1653301649653,MATH 20E,B03,089490,Staff,25,0,25,0
1653301649653,MATH 20E,B04,089491,Staff,25,0,25,0
1653301649653,MATH 20E,B05,089492,Staff,24,0,25,1
1653301649653,MATH 20E,B06,089493,Staff,24,0,25,1
1653301649653,MATH 20E,B07,089494,Staff,25,0,25,0
1653301649653,MATH 20E,B08,089495,Staff,25,0,25,0
1653301649653,MATH 20E,C01,089497,Staff,23,0,25,2
1653301649653,MATH 20E,C02,089498,Staff,25,0,25,0
1653301649653,MATH 20E,C03,089499,Staff,25,0,25,0
1653301649653,MATH 20E,C04,089500,Staff,25,0,25,0
1653301649653,MATH 20E,C05,089501,Staff,25,0,25,0
1653301649653,MATH 20E,C06,089502,Staff,25,0,25,0
1653301649653,MATH 20E,C07,089503,Staff,25,0,25,0
1653301649653,MATH 20E,C08,089504,Staff,25,0,25,0
1653301650190,MATH 31AH,A01,089506,Rabin; Jeffrey Mark,35,0,35,0
1653301650190,MATH 31AH,A02,089507,Rabin; Jeffrey Mark,35,0,35,0
1653301650716,MATH 87,A00,094827,Meyer; David A.,20,0,20,0
1653301651242,MATH 96,A00,094836,Kane; Daniel Mertz,11,0,30,19
1653301651778,MATH 100A,A01,089509,Kedlaya; Kiran S.,23,0,30,7
1653301651778,MATH 100A,A02,089510,Kedlaya; Kiran S.,28,0,30,2
1653301651778,MATH 100A,B01,089512,Greenfeld; Be'Eri,24,0,30,6
1653301651778,MATH 100A,B02,089513,Greenfeld; Be'Eri,30,0,30,0
1653301652313,MATH 102,A01,089515,Hodges; Reuven Moses,25,0,30,5
1653301652313,MATH 102,A02,089516,Hodges; Reuven Moses,30,0,30,0
1653301652313,MATH 102,A03,089517,Hodges; Reuven Moses,30,0,30,0
1653301652313,MATH 102,A04,089518,Hodges; Reuven Moses,29,0,30,1
1653301652313,MATH 102,B01,089520,Hodges; Reuven Moses,29,0,30,1
1653301652313,MATH 102,B02,089521,Hodges; Reuven Moses,29,0,30,1
1653301652313,MATH 102,B03,089522,Hodges; Reuven Moses,29,0,30,1
1653301652313,MATH 102,B04,089523,Hodges; Reuven Moses,30,0,30,0
1653301652837,MATH 103A,A01,089525,Staff,27,0,30,3
1653301652837,MATH 103A,A02,089526,Staff,30,0,30,0
1653301652837,MATH 103A,B01,089528,Seward; Brandon M.,9,0,30,21
1653301652837,MATH 103A,B02,089529,Seward; Brandon M.,22,0,30,8
1653301652837,MATH 103A,C01,089531,Staff,27,0,30,3
1653301652837,MATH 103A,C02,089532,Staff,28,0,30,2
1653301652837,MATH 103A,D01,089534,Staff,28,0,30,2
1653301652837,MATH 103A,D02,089535,Staff,28,0,30,2
1653301653371,MATH 109,A01,089537,Chung; Kwun,9,0,10,1
1653301653371,MATH 109,A02,089538,Chung; Kwun,10,0,10,0
1653301653371,MATH 109,B01,089540,Belmont; Eva Kinoshita,9,0,10,1
1653301653371,MATH 109,B02,089541,Belmont; Eva Kinoshita,6,0,10,4
1653301653371,MATH 109,C01,089543,Chow; Bennett,8,0,10,2
1653301653371,MATH 109,C02,089544,Chow; Bennett,10,0,10,0
1653301653371,MATH 109,D01,089546,Chung; Kwun,9,0,10,1
1653301653371,MATH 109,D02,089547,Chung; Kwun,9,0,10,1
1653301653371,MATH 109,E01,089549,Schweinsberg; Jason,6,0,10,4
1653301653371,MATH 109,E02,089550,Schweinsberg; Jason,10,0,10,0
1653301653893,MATH 110,A01,089552,Wenzl; Hans G,27,0,35,8
1653301653893,MATH 110,A02,089553,Wenzl; Hans G,33,0,35,2
1653301654444,MATH 111A,A01,089555,Meyer; David A.,0,0,0,1
1653301654980,MATH 120A,A01,089557,Manners; Frederick,30,0,35,5
1653301654980,MATH 120A,A02,089558,Manners; Frederick,33,0,35,2
1653301655509,MATH 140A,A01,089560,Seward; Brandon M.,25,0,30,5
1653301655509,MATH 140A,A02,089561,Seward; Brandon M.,29,0,30,1
1653301655509,MATH 140A,B01,089563,Chan; Pak Yeung,30,0,30,0
1653301655509,MATH 140A,B02,089564,Chan; Pak Yeung,22,0,30,8
1653301656034,MATH 142A,A01,089566,Staff,29,0,30,1
1653301656034,MATH 142A,A02,089567,Staff,29,0,30,1
1653301656034,MATH 142A,B01,089569,Staff,30,0,30,0
1653301656034,MATH 142A,B02,089570,Staff,29,0,30,1
1653301656034,MATH 142A,C01,089572,Staff,26,0,30,4
1653301656034,MATH 142A,C02,089573,Staff,29,0,30,1
1653301656034,MATH 142A,D01,089575,Eggers; John Dietrich,15,0,30,15
1653301656034,MATH 142A,D02,089576,Eggers; John Dietrich,27,0,30,3
1653301656556,MATH 144,A01,089578,Bejenaru; Ioan,29,0,30,1
1653301657109,MATH 150A,A01,089580,Chow; Bennett,29,0,35,6
1653301657109,MATH 150A,A02,089581,Chow; Bennett,34,0,35,1
1653301658204,MATH 153,A01,094204,Harel; Guershon,33,0,35,2
1653301658731,MATH 154,A01,089590,Verstraete; Jacques Allan,3,0,30,27
1653301658731,MATH 154,A02,089591,Verstraete; Jacques Allan,23,0,30,7
1653301658731,MATH 154,A03,089592,Verstraete; Jacques Allan,28,0,30,2
1653301658731,MATH 154,A04,089593,Verstraete; Jacques Allan,26,0,30,4
1653301659255,MATH 155A,A01,089595,Buss; Samuel R,22,0,35,13
1653301659255,MATH 155A,A02,089596,Buss; Samuel R,32,0,35,3
1653301659790,MATH 160A,A01,089598,Manners; Frederick,28,0,35,7
1653301659790,MATH 160A,A02,094207,Manners; Frederick,34,0,35,1
1653301660331,MATH 170A,A01,089600,Liu; Shuang,24,0,25,1
1653301660331,MATH 170A,A02,089601,Liu; Shuang,24,0,25,1
1653301660331,MATH 170A,A03,089602,Liu; Shuang,24,0,25,1
1653301660331,MATH 170A,A04,089603,Liu; Shuang,23,0,25,2
1653301660331,MATH 170A,B01,089605,Dumitriu; Ioana,8,0,25,17
1653301660331,MATH 170A,B02,089606,Dumitriu; Ioana,20,0,25,5
1653301660331,MATH 170A,B03,089607,Dumitriu; Ioana,21,0,25,4
1653301660331,MATH 170A,B04,089608,Dumitriu; Ioana,25,0,25,0
1653301660876,MATH 173A,A01,089610,Cloninger; Alexander,0,0,35,35
1653301660876,MATH 173A,A02,089611,Cloninger; Alexander,2,0,35,33
1653301660876,MATH 173A,A03,089612,Cloninger; Alexander,20,0,35,15
1653301661416,MATH 174,A01,089614,Cheng; Li-Tien,23,0,25,2
1653301661416,MATH 174,A02,089615,Cheng; Li-Tien,25,0,25,0
1653301661955,MATH 180A,A01,089617,Jekel; David Andrew,0,0,25,25
1653301661955,MATH 180A,A02,089618,Jekel; David Andrew,23,0,25,2
1653301661955,MATH 180A,A03,089619,Jekel; David Andrew,22,0,25,3
1653301661955,MATH 180A,A04,089620,Jekel; David Andrew,22,0,25,3
1653301661955,MATH 180A,A05,089621,Jekel; David Andrew,24,0,25,1
1653301661955,MATH 180A,A06,089622,Jekel; David Andrew,23,0,25,2
1653301661955,MATH 180A,B01,089624,Agarwal; Pooja,23,0,25,2
1653301661955,MATH 180A,B02,089625,Agarwal; Pooja,24,0,25,1
1653301661955,MATH 180A,B03,089626,Agarwal; Pooja,22,0,25,3
1653301661955,MATH 180A,B04,089627,Agarwal; Pooja,25,0,25,0
1653301661955,MATH 180A,B05,089628,Agarwal; Pooja,24,0,25,1
1653301661955,MATH 180A,B06,089629,Agarwal; Pooja,25,0,25,0
1653301661955,MATH 180A,C01,089631,Staff,22,0,25,3
1653301661955,MATH 180A,C02,089632,Staff,25,0,25,0
1653301661955,MATH 180A,C03,089633,Staff,25,0,25,0
1653301661955,MATH 180A,C04,089634,Staff,25,0,25,0
1653301662503,MATH 180C,A01,089636,Fitzsimmons; Patrick J,4,0,25,21
1653301662503,MATH 180C,A02,089637,Fitzsimmons; Patrick J,21,0,25,4
1653301663027,MATH 181B,A01,089639,Rava; Denise,31,0,35,4
1653301663027,MATH 181B,A02,089640,Rava; Denise,34,0,35,1
1653301663027,MATH 181B,A03,089641,Rava; Denise,31,0,35,4
1653301663027,MATH 181B,A04,089642,Rava; Denise,35,0,35,0
1653301663565,MATH 183,A01,089644,Staff,10,0,25,15
1653301663565,MATH 183,A02,089645,Staff,23,0,25,2
1653301663565,MATH 183,A03,089646,Staff,23,0,25,2
1653301663565,MATH 183,A04,089647,Staff,25,0,25,0
1653301663565,MATH 183,A05,089648,Staff,19,0,25,6
1653301663565,MATH 183,A06,089649,Staff,22,0,25,3
1653301663565,MATH 183,A07,089650,Staff,25,0,25,0
1653301663565,MATH 183,A08,089651,Staff,25,0,25,0
1653301664102,MATH 184,A01,089653,Kane; Daniel Mertz,24,0,30,6
1653301664102,MATH 184,A02,089654,Kane; Daniel Mertz,30,0,30,0
1653301664102,MATH 184,A03,089655,Kane; Daniel Mertz,30,0,30,0
1653301664102,MATH 184,A04,089656,Kane; Daniel Mertz,30,0,30,0
1653301664633,MATH 187A,A01,089658,Bucur; Alina Ioana,0,0,25,25
1653301664633,MATH 187A,A02,089659,Bucur; Alina Ioana,12,0,25,13
1653301664633,MATH 187A,A03,089660,Bucur; Alina Ioana,0,0,25,25
1653301664633,MATH 187A,A04,089661,Bucur; Alina Ioana,17,0,25,8
1653301665167,MATH 187B,A01,089663,Bucur; Alina Ioana,28,0,35,7
1653301665167,MATH 187B,A02,089664,Bucur; Alina Ioana,34,0,35,1
1653301665690,MATH 188,A01,094817,Sam; Steven V,33,0,35,2
1653301666213,MATH 190A,A01,089666,Sam; Steven V,21,0,35,14
1653301666745,MATH 196,A00,089667,Spolaor; Luca,33,0,45,12
1653301667295,MCWP 40,004,093486,Wastal; Carrie King,0,0,3,3
1653301667295,MCWP 40,005,093487,Wastal; Carrie King,0,0,3,3
1653301667295,MCWP 40,006,093488,Wastal; Carrie King,3,0,3,0
1653301667295,MCWP 40,007,093489,Wastal; Carrie King,3,0,3,0
1653301667295,MCWP 40,008,093490,Wastal; Carrie King,2,0,3,1
1653301667295,MCWP 40,009,093491,Wastal; Carrie King,2,0,3,1
1653301667295,MCWP 40,013,093495,Wastal; Carrie King,3,0,3,0
1653301667295,MCWP 40,014,093496,Wastal; Carrie King,0,0,3,3
1653301667295,MCWP 40,015,093497,Wastal; Carrie King,3,0,3,0
1653301667295,MCWP 40,016,093498,Wastal; Carrie King,3,0,3,0
1653301667295,MCWP 40,017,093499,Wastal; Carrie King,3,0,3,0
1653301667295,MCWP 40,018,093500,Wastal; Carrie King,1,0,3,2
1653301667295,MCWP 40,020,093502,Wastal; Carrie King,0,0,0,0
1653301667295,MCWP 40,021,093503,Wastal; Carrie King,3,0,3,0
1653301667295,MCWP 40,022,093504,Wastal; Carrie King,2,0,3,1
1653301667295,MCWP 40,023,093505,Wastal; Carrie King,2,0,3,1
1653301667295,MCWP 40,024,093506,Wastal; Carrie King,2,0,3,1
1653301667295,MCWP 40,026,093508,Wastal; Carrie King,3,0,3,0
1653301667295,MCWP 40,027,093509,Wastal; Carrie King,3,0,3,0
1653301667295,MCWP 40,028,093510,Wastal; Carrie King,3,0,3,0
1653301667295,MCWP 40,029,093511,Wastal; Carrie King,3,0,3,0
1653301667295,MCWP 40,030,093512,Wastal; Carrie King,2,0,3,1
1653301667295,MCWP 40,032,093514,Wastal; Carrie King,2,0,3,1
1653301667295,MCWP 40,033,093515,Wastal; Carrie King,3,0,3,0
1653301667295,MCWP 40,034,093516,Wastal; Carrie King,3,0,3,0
1653301667295,MCWP 40,035,093517,Wastal; Carrie King,3,0,3,0
1653301667295,MCWP 40,038,093520,Wastal; Carrie King,2,0,3,1
1653301667295,MCWP 40,039,093521,Wastal; Carrie King,3,0,3,0
1653301667295,MCWP 40,041,093523,Wastal; Carrie King,2,0,3,1
1653301667295,MCWP 40,042,093524,Wastal; Carrie King,3,0,3,0
1653301667295,MCWP 40,043,093525,Wastal; Carrie King,0,0,0,0
1653301667295,MCWP 40,049,093531,Wastal; Carrie King,2,0,3,1
1653301667295,MCWP 40,050,093532,Wastal; Carrie King,3,0,3,0
1653301667295,MCWP 40,051,093533,Wastal; Carrie King,3,0,3,0
1653301667821,MCWP 50,001,093534,Wastal; Carrie King,0,0,0,0
1653301667821,MCWP 50,002,093535,Wastal; Carrie King,0,0,3,3
1653301667821,MCWP 50,003,093536,Wastal; Carrie King,0,0,3,3
1653301667821,MCWP 50,004,093537,Wastal; Carrie King,0,0,3,3
1653301667821,MCWP 50,005,093538,Wastal; Carrie King,0,0,3,3
1653301667821,MCWP 50,006,093539,Wastal; Carrie King,2,0,3,1
1653301667821,MCWP 50,007,093540,Wastal; Carrie King,0,0,3,3
1653301667821,MCWP 50,008,093541,Wastal; Carrie King,0,0,3,3
1653301667821,MCWP 50,009,093542,Wastal; Carrie King,0,0,3,3
1653301667821,MCWP 50,010,093543,Wastal; Carrie King,0,0,3,3
1653301667821,MCWP 50,013,093546,Wastal; Carrie King,1,0,3,2
1653301667821,MCWP 50,014,093547,Wastal; Carrie King,0,0,3,3
1653301667821,MCWP 50,015,093548,Wastal; Carrie King,0,0,3,3
1653301667821,MCWP 50,016,093549,Wastal; Carrie King,0,0,0,0
1653301668353,MCWP 125,A00,093550,Wilson; Marion E.,3,0,3,0
1653301668353,MCWP 125,B00,093551,Guillen; Melinda,3,0,3,0
1653301668353,MCWP 125,C00,093552,Guillen; Melinda,3,0,3,0
1653301668353,MCWP 125,D00,093553,Guillen; Melinda,3,0,3,0
1653301668353,MCWP 125,E00,093554,Miller; Elizabeth Deen,3,0,3,0
1653301668353,MCWP 125,F00,093555,Miller; Elizabeth Deen,3,0,3,0
1653301668353,MCWP 125,G00,093556,Miller; Elizabeth Deen,3,0,3,0
1653301668878,MGT 3,A00,087704,Wagner; Timothy Ryan,90,0,90,0
1653301669425,MGT 4,A01,087706,Levkoff; Steven B.,2,0,3,1
1653301669425,MGT 4,A02,087707,Levkoff; Steven B.,3,0,3,0
1653301669425,MGT 4,A03,092659,Levkoff; Steven B.,1,0,4,3
1653301669970,MGT 5,A00,087708,Houskeeper; Robert,194,0,196,2
1653301670503,MGT 12,A00,087709,Pecore; Joseph P.,91,0,100,9
1653301670503,MGT 12,B00,087710,Lindenberger; Wade Douglas,91,0,100,9
1653301671132,MGT 16,A00,087711,Campbell; Robert Harold,108,0,110,2
1653301671132,MGT 16,B00,087712,Campbell; Robert Harold,110,0,110,0
1653301671132,MGT 16,C00,087713,Lindenberger; Wade Douglas,100,0,110,10
1653301671132,MGT 16,D00,087714,Lindenberger; Wade Douglas,107,0,110,3
1653301671132,MGT 16,E00,094819,Buchanan; Harold G,99,0,100,1
1653301671668,MGT 18,A00,087715,McKay; Michael J,88,0,90,2
1653301671668,MGT 18,B00,087716,McKay; Michael J,90,0,90,0
1653301671668,MGT 18,C00,087717,McKay; Michael J,88,0,90,2
1653301671668,MGT 18,D00,087718,McKay; Mary A,90,0,90,0
1653301671668,MGT 18,E00,087719,McKay; Mary A,87,0,90,3
1653301672192,MGT 45,A00,087720,Pecore; Joseph P.,136,0,150,14
1653301672192,MGT 45,B00,087721,Pecore; Joseph P.,140,0,150,10
1653301672716,MGT 52,A00,087722,Deal; Jennifer Jean,83,0,90,7
1653301673238,MGT 71,A00,087723,August; Terrence,60,0,90,30
1653301674315,MGT 103,A00,087726,Ehrich; Kristine R,86,0,90,4
1653301674315,MGT 103,B00,087727,Ehrich; Kristine R,89,0,90,1
1653301674315,MGT 103,C00,087728,Eberhard; Craig A,89,0,90,1
1653301674315,MGT 103,D00,087729,Eberhard; Craig A,88,0,90,2
1653301674315,MGT 103,E00,087730,Demill; Burritt,75,0,90,15
1653301674315,MGT 103,F00,087731,Bates; Kenneth Walter,81,0,90,9
1653301674315,MGT 103,G00,087732,Bates; Kenneth Walter,88,0,90,2
1653301674848,MGT 105,A00,087733,Campbell; Robert Harold,102,0,120,18
1653301675384,MGT 106,A00,087734,Eberhard; Craig A,81,0,90,9
1653301675921,MGT 108R,A00,087735,Amir; On,84,0,90,6
1653301676444,MGT 109,A00,087736,Staff,77,0,90,13
1653301676977,MGT 112,A00,087737,Somasundaram; Tyagarajan,89,0,90,1
1653301676977,MGT 112,B00,087738,Somasundaram; Tyagarajan,86,0,90,4
1653301676977,MGT 112,C00,087739,Ehrich; Kristine R,86,0,90,4
1653301676977,MGT 112,D00,087740,Zimmermann; Carsten,65,0,90,25
1653301677506,MGT 121A,A00,087741,Wang; Helen Shan,65,0,70,5
1653301677506,MGT 121A,B00,087742,Wang; Helen Shan,64,0,70,6
1653301678028,MGT 131A,A00,087743,Houskeeper; Robert,146,0,150,4
1653301678552,MGT 132,A00,087744,Blakley; Bruce,88,0,90,2
1653301679082,MGT 134,A00,087745,Houskeeper; Robert,84,0,90,6
1653301679621,MGT 135,A00,087746,Anderson; John Charles,83,0,90,7
1653301680150,MGT 139,A00,087747,Perols; Johan Lars,88,0,90,2
1653301680674,MGT 153,A00,087748,Perols; Johan Lars,82,0,90,8
1653301680674,MGT 153,B00,087749,Phiroz; Zal Navroze,75,0,90,15
1653301680674,MGT 153,C00,087750,Phiroz; Zal Navroze,87,0,90,3
1653301681197,MGT 162R,A00,087751,Gneezy; Uri,64,0,90,26
1653301681726,MGT 164,A00,087752,McKay; Mary A,90,0,90,0
1653301681726,MGT 164,B00,087753,Meyer; Alison Bloomfield,0,0,0,0
1653301681726,MGT 164,C00,087754,Smith; Pamela Karen,82,0,90,8
1653301682252,MGT 166,A00,087755,Moran; Cathleen L.,89,0,90,1
1653301682252,MGT 166,B00,087756,Moran; Cathleen L.,90,0,90,0
1653301682252,MGT 166,C00,087757,Moran; Cathleen L.,90,0,90,0
1653301682252,MGT 166,D00,087758,Demill; Burritt,56,0,90,34
1653301682780,MGT 167,A00,087759,Klaas; Jeffrey David,88,0,90,2
1653301682780,MGT 167,B00,087760,Jacob; Jo Dee C,83,0,90,7
1653301683303,MGT 171,A00,087761,Phiroz; Zal Navroze,85,0,90,5
1653301683846,MGT 172,A00,087762,Hedges; Kathleen & Royal; Rebecca,96,0,100,4
1653301683846,MGT 172,B00,087763,Hedges; Kathleen,79,0,90,11
1653301683846,MGT 172,C00,087764,Zimmermann; Carsten,90,0,90,0
1653301684387,MGT 172R,A00,094888,Erat; Sanjiv,90,0,90,0
1653301684929,MGT 173,A00,087765,Hayes; Sherry Lorine,80,0,100,20
1653301685453,MGT 175,A00,087766,Gopal; Christopher S.,84,0,90,6
1653301685981,MGT 181,A00,087767,Buchanan; Harold G,114,0,120,6
1653301685981,MGT 181,B00,087768,Buchanan; Harold G,110,0,120,10
1653301685981,MGT 181,C00,087769,Bliss; Barbara Ann,109,0,120,11
1653301687030,MGT 185,A00,087771,Dunn; Louis Jean,83,0,90,7
1653301687564,MGT 187,A00,087772,Dunn; Louis Jean,138,0,146,8
1653301688090,MMW 11,A01,086931,duBois; Page Ann,4,0,4,0
1653301688090,MMW 11,A02,086932,duBois; Page Ann,4,0,4,0
1653301688090,MMW 11,A03,086933,duBois; Page Ann,3,0,4,1
1653301688090,MMW 11,A04,086934,duBois; Page Ann,3,0,4,1
1653301688090,MMW 11,A05,086935,duBois; Page Ann,4,0,4,0
1653301688090,MMW 11,A06,086936,duBois; Page Ann,3,0,4,1
1653301688090,MMW 11,A07,086937,duBois; Page Ann,4,0,4,0
1653301688090,MMW 11,A08,086938,duBois; Page Ann,4,0,4,0
1653301688090,MMW 11,A09,086939,duBois; Page Ann,4,0,4,0
1653301688090,MMW 11,A10,086940,duBois; Page Ann,4,0,4,0
1653301688090,MMW 11,A11,086941,duBois; Page Ann,4,0,4,0
1653301688090,MMW 11,A12,093877,duBois; Page Ann,3,0,4,1
1653301688614,MMW 11R,A01,093852,Herbst; Matthew,4,0,4,0
1653301688614,MMW 11R,A02,093853,Herbst; Matthew,4,0,4,0
1653301688614,MMW 11R,A03,093854,Herbst; Matthew,4,0,4,0
1653301688614,MMW 11R,A04,093855,Herbst; Matthew,4,0,4,0
1653301688614,MMW 11R,A05,093856,Herbst; Matthew,4,0,4,0
1653301688614,MMW 11R,A06,093857,Herbst; Matthew,4,0,4,0
1653301688614,MMW 11R,A07,093858,Herbst; Matthew,4,0,4,0
1653301688614,MMW 11R,A08,093859,Herbst; Matthew,4,0,4,0
1653301688614,MMW 11R,A09,093860,Herbst; Matthew,4,0,4,0
1653301688614,MMW 11R,A10,093861,Herbst; Matthew,4,0,4,0
1653301688614,MMW 11R,A11,093862,Herbst; Matthew,4,0,4,0
1653301688614,MMW 11R,A12,093863,Herbst; Matthew,4,0,4,0
1653301688614,MMW 11R,B01,093865,Herbst; Matthew,4,0,4,0
1653301688614,MMW 11R,B02,093866,Herbst; Matthew,4,0,4,0
1653301688614,MMW 11R,B03,093867,Herbst; Matthew,4,0,4,0
1653301688614,MMW 11R,B04,093868,Herbst; Matthew,4,0,4,0
1653301688614,MMW 11R,B05,093869,Herbst; Matthew,4,0,4,0
1653301688614,MMW 11R,B06,093870,Herbst; Matthew,4,0,4,0
1653301688614,MMW 11R,B07,093871,Herbst; Matthew,4,0,4,0
1653301688614,MMW 11R,B08,093872,Herbst; Matthew,4,0,4,0
1653301688614,MMW 11R,B09,093873,Herbst; Matthew,4,0,4,0
1653301688614,MMW 11R,B10,093874,Herbst; Matthew,4,0,4,0
1653301688614,MMW 11R,B11,093875,Herbst; Matthew,4,0,4,0
1653301688614,MMW 11R,B12,093876,Herbst; Matthew,4,0,4,0
1653301689139,MMW 14,A01,086968,Chang; Edmond Yi-Teh,28,0,28,0
1653301689139,MMW 14,A02,086969,Chang; Edmond Yi-Teh,27,0,28,1
1653301689139,MMW 14,A03,086970,Chang; Edmond Yi-Teh,21,0,28,7
1653301689139,MMW 14,A04,086971,Chang; Edmond Yi-Teh,27,0,28,1
1653301689139,MMW 14,A05,086972,Chang; Edmond Yi-Teh,26,0,28,2
1653301689139,MMW 14,A06,086973,Chang; Edmond Yi-Teh,28,0,28,0
1653301689139,MMW 14,A07,086974,Chang; Edmond Yi-Teh,27,0,28,1
1653301689139,MMW 14,A08,086975,Chang; Edmond Yi-Teh,25,0,28,3
1653301689139,MMW 14,A09,086976,Chang; Edmond Yi-Teh,0,0,0,0
1653301689139,MMW 14,A10,086977,Chang; Edmond Yi-Teh,27,0,28,1
1653301689139,MMW 14,A11,086978,Chang; Edmond Yi-Teh,26,0,28,2
1653301689139,MMW 14,A12,086979,Chang; Edmond Yi-Teh,27,0,28,1
1653301689139,MMW 14,A13,086980,Chang; Edmond Yi-Teh,28,0,28,0
1653301689664,MMW 121,A01,086982,Chang; Edmond Yi-Teh,0,0,0,0
1653301689664,MMW 121,A02,086983,Chang; Edmond Yi-Teh,0,0,0,0
1653301689664,MMW 121,A03,086984,Chang; Edmond Yi-Teh,2,0,4,2
1653301689664,MMW 121,A04,086985,Chang; Edmond Yi-Teh,4,0,4,0
1653301689664,MMW 121,A05,086986,Chang; Edmond Yi-Teh,4,0,4,0
1653301689664,MMW 121,A06,086987,Chang; Edmond Yi-Teh,4,0,4,0
1653301689664,MMW 121,A07,086988,Chang; Edmond Yi-Teh,4,0,4,0
1653301689664,MMW 121,A08,086989,Chang; Edmond Yi-Teh,4,0,4,0
1653301689664,MMW 121,B01,086991,Patterson; Patrick H.,4,0,4,0
1653301689664,MMW 121,B02,086992,Patterson; Patrick H.,4,0,4,0
1653301689664,MMW 121,B03,086993,Patterson; Patrick H.,4,0,4,0
1653301689664,MMW 121,B04,086994,Patterson; Patrick H.,3,0,4,1
1653301689664,MMW 121,B05,086995,Patterson; Patrick H.,4,0,4,0
1653301689664,MMW 121,B06,086996,Patterson; Patrick H.,4,0,4,0
1653301689664,MMW 121,B07,086997,Patterson; Patrick H.,4,0,4,0
1653301689664,MMW 121,B08,086998,Patterson; Patrick H.,4,0,4,0
1653301689664,MMW 121,B09,086999,Patterson; Patrick H.,4,0,4,0
1653301689664,MMW 121,B10,087000,Patterson; Patrick H.,4,0,4,0
1653301689664,MMW 121,B11,087001,Patterson; Patrick H.,0,0,0,0
1653301689664,MMW 121,B12,087002,Patterson; Patrick H.,0,0,0,0
1653301690188,MUS 1A,A01,090497,Staff,19,0,20,1
1653301690188,MUS 1A,A02,090498,Staff,13,0,20,7
1653301690188,MUS 1A,A03,090499,Staff,18,0,20,2
1653301690188,MUS 1A,A04,090500,Staff,19,0,20,1
1653301690188,MUS 1A,A05,090501,Staff,20,0,20,0
1653301690188,MUS 1A,A06,090502,Staff,20,0,20,0
1653301690188,MUS 1A,B01,090504,Staff,18,0,20,2
1653301690188,MUS 1A,B02,090505,Staff,20,0,20,0
1653301690188,MUS 1A,B03,090506,Staff,18,0,20,2
1653301690188,MUS 1A,B04,090507,Staff,18,0,20,2
1653301690188,MUS 1A,B05,090508,Staff,16,0,20,4
1653301690188,MUS 1A,B06,090509,Staff,20,0,20,0
1653301690717,MUS 2A,A01,090511,Carlson; Erik Norman,19,0,20,1
1653301691243,MUS 2AK,A00,090512,Ohnishi; Takae,24,0,25,1
1653301691243,MUS 2AK,B00,090513,Ohnishi; Takae,15,0,15,0
1653301691767,MUS 4,A01,090515,Staff,24,0,25,1
1653301691767,MUS 4,A02,090516,Staff,24,0,25,1
1653301691767,MUS 4,A03,090517,Staff,22,0,25,3
1653301691767,MUS 4,A04,090518,Staff,24,0,25,1
1653301691767,MUS 4,A05,090519,Staff,25,0,25,0
1653301691767,MUS 4,A06,090520,Staff,25,0,25,0
1653301691767,MUS 4,A07,090521,Staff,24,0,25,1
1653301691767,MUS 4,A08,090522,Staff,24,0,25,1
1653301692290,MUS 5,A01,090524,Staff,20,0,20,0
1653301692290,MUS 5,A02,090525,Staff,18,0,20,2
1653301692290,MUS 5,A03,090526,Staff,20,0,20,0
1653301692290,MUS 5,A04,090527,Staff,20,0,20,0
1653301692290,MUS 5,A05,090528,Staff,19,0,20,1
1653301692817,MUS 6,A01,090530,Staff,22,0,25,3
1653301692817,MUS 6,A02,090531,Staff,25,0,25,0
1653301692817,MUS 6,A03,090532,Staff,25,0,25,0
1653301692817,MUS 6,A04,090533,Staff,23,0,25,2
1653301693340,MUS 8,A01,090535,Kenyatta; Kamau,17,0,25,8
1653301693340,MUS 8,A02,090536,Kenyatta; Kamau,19,0,25,6
1653301693340,MUS 8,A03,090537,Kenyatta; Kamau,17,0,25,8
1653301693340,MUS 8,A04,090538,Kenyatta; Kamau,21,0,25,4
1653301693869,MUS 12,A01,090540,Narucki; Susan M,20,0,20,0
1653301693869,MUS 12,A02,090541,Narucki; Susan M,20,0,20,0
1653301693869,MUS 12,A03,090542,Narucki; Susan M,17,0,20,3
1653301694392,MUS 15,A01,090544,Staff,21,0,25,4
1653301694392,MUS 15,A02,090545,Staff,23,0,25,2
1653301694392,MUS 15,A03,090546,Staff,24,0,25,1
1653301694392,MUS 15,A04,090547,Staff,22,0,25,3
1653301694392,MUS 15,A05,090548,Staff,25,0,25,0
1653301694392,MUS 15,A06,090549,Staff,24,0,25,1
1653301694917,MUS 19R,A01,090551,Britt; King James,17,0,20,3
1653301694917,MUS 19R,A02,090552,Britt; King James,19,0,20,1
1653301694917,MUS 19R,A03,090553,Britt; King James,20,0,20,0
1653301694917,MUS 19R,A04,090554,Britt; King James,19,0,20,1
1653301694917,MUS 19R,A05,090555,Britt; King James,20,0,20,0
1653301694917,MUS 19R,A06,090556,Britt; King James,18,0,20,2
1653301694917,MUS 19R,A07,090557,Britt; King James,19,0,20,1
1653301694917,MUS 19R,A08,090558,Britt; King James,19,0,20,1
1653301694917,MUS 19R,A09,090559,Britt; King James,20,0,20,0
1653301694917,MUS 19R,A10,090560,Britt; King James,20,0,20,0
1653301694917,MUS 19R,B01,090562,Britt; King James,10,0,10,0
1653301694917,MUS 19R,B02,090563,Britt; King James,10,0,10,0
1653301694917,MUS 19R,B03,090564,Britt; King James,10,0,10,0
1653301694917,MUS 19R,B04,090565,Britt; King James,10,0,10,0
1653301694917,MUS 19R,B05,090566,Britt; King James,10,0,10,0
1653301694917,MUS 19R,B06,090567,Britt; King James,10,0,10,0
1653301694917,MUS 19R,B07,090568,Britt; King James,10,0,10,0
1653301694917,MUS 19R,B08,090569,Britt; King James,10,0,10,0
1653301694917,MUS 19R,B09,090570,Britt; King James,10,0,10,0
1653301694917,MUS 19R,B10,090571,Britt; King James,10,0,10,0
1653301695450,MUS 20,A01,090573,Borgo; David Garcia,12,0,15,3
1653301695450,MUS 20,A02,090574,Borgo; David Garcia,14,0,15,1
1653301695450,MUS 20,A03,090575,Borgo; David Garcia,13,0,15,2
1653301695985,MUS 32,001,094074,Staff,10,0,10,0
1653301695985,MUS 32,002,094075,Kenyatta; Kamau,10,0,10,0
1653301695985,MUS 32,003,094076,Curtis; Charles Rector,10,0,10,0
1653301695985,MUS 32,005,094078,Terrazas Perez; Wilfrido D,10,0,10,0
1653301695985,MUS 32,006,094079,Ohnishi; Takae,10,0,10,0
1653301695985,MUS 32,007,094080,Burr; Anthony I,10,0,10,0
1653301695985,MUS 32,008,094081,Carlson; Erik Norman,10,0,10,0
1653301695985,MUS 32,009,094082,Dresser; Mark Stuart,10,0,10,0
1653301695985,MUS 32,011,094084,Richards; Stephanie F,10,0,10,0
1653301695985,MUS 32,012,094085,Borgo; David Garcia,10,0,10,0
1653301695985,MUS 32,013,094086,Paganos Koukakis; Dimitrios,10,0,10,0
1653301695985,MUS 32,014,094087,Jones; Michael David,10,0,10,0
1653301696510,MUS 32V,A00,094355,Zazueta Cervera; Miguel Angel,10,0,10,0
1653301696510,MUS 32V,B00,094089,Flores; Mariana,10,0,10,0
1653301697037,MUS 32VM,A00,094090,Zazueta Cervera; Miguel Angel,15,0,15,0
1653301697564,MUS 33A,A00,090576,Liang; Lei,24,0,25,1
1653301698087,MUS 43,A00,090577,Burr; Anthony I,92,0,100,8
1653301698613,MUS 95C,B00,094829,Staff,28,0,30,2
1653301699140,MUS 95D,A00,090579,Staff,30,0,30,0
1653301699665,MUS 95E,A00,090580,Staff,30,0,30,0
1653301700189,MUS 95G,A00,090581,Anderson; Kenneth,384,0,395,11
1653301700189,MUS 95G,B00,090582,Anderson; Kenneth,393,0,395,2
1653301700712,MUS 95JC,A00,090583,Kenyatta; Kamau,35,0,35,0
1653301701234,MUS 95L,A00,090584,Staff,30,0,30,0
1653301701759,MUS 95W,A00,090585,Seshadri; Kartik,60,0,60,0
1653301701759,MUS 95W,B00,090586,Seshadri; Kartik,30,0,30,0
1653301702282,MUS 101A,A01,090588,Staff,29,0,30,1
1653301702818,MUS 103A,A00,090589,Ung; Chinary,15,0,15,0
1653301703343,MUS 107,A00,090590,Terrazas Perez; Wilfrido D,30,0,30,0
1653301703871,MUS 111,A00,090591,Yadegari; Shahrokh D,124,0,130,6
1653301704416,MUS 114,A00,090592,Curtis; Charles Rector,117,0,125,8
1653301704943,MUS 120A,A01,090594,Cimini; Amy Marie,29,0,30,1
1653301705470,MUS 126R,A00,090595,Borgo; David Garcia,106,0,115,9
1653301706013,MUS 130,A00,090596,Ohnishi; Takae,30,0,30,0
1653301706542,MUS 132,001,094091,Nourai; Keyarash,10,0,10,0
1653301706542,MUS 132,002,094093,Kenyatta; Kamau,10,0,10,0
1653301706542,MUS 132,003,094094,Curtis; Charles Rector,10,0,10,0
1653301706542,MUS 132,005,094096,Terrazas Perez; Wilfrido D,10,0,10,0
1653301706542,MUS 132,006,094097,Ohnishi; Takae,10,0,10,0
1653301706542,MUS 132,007,094098,Burr; Anthony I,10,0,10,0
1653301706542,MUS 132,008,094099,Carlson; Erik Norman,10,0,10,0
1653301706542,MUS 132,009,094100,Dresser; Mark Stuart,10,0,10,0
1653301706542,MUS 132,011,094102,Richards; Stephanie F,10,0,10,0
1653301706542,MUS 132,012,094103,Borgo; David Garcia,10,0,10,0
1653301706542,MUS 132,013,094104,Jones; Michael David,10,0,10,0
1653301706542,MUS 132,014,094105,Staff,10,0,10,0
1653301707067,MUS 132V,A00,094106,Narucki; Susan M,15,0,15,0
1653301707597,MUS 134,A00,090597,Staff,30,0,30,0
1653301708125,MUS 137A,A00,090598,Kenyatta; Kamau,30,0,30,0
1653301708662,MUS 143,A00,090599,Staff,26,0,30,4
1653301709729,MUS 173,A00,090600,Britt; King James,19,0,30,11
1653301710255,MUS 174A,A00,090601,Staff,8,0,15,7
1653301711323,NANO 4,A01,088199,Vazquez Mena; Oscar,20,0,20,0
1653301711323,NANO 4,B01,088201,Vazquez Mena; Oscar,20,0,20,0
1653301711323,NANO 4,C01,088203,Vazquez Mena; Oscar,20,0,20,0
1653301711876,NANO 15,A01,088205,Lubarda; Vlado,50,0,50,0
1653301711876,NANO 15,B01,088207,Lubarda; Vlado,50,0,50,0
1653301712400,NANO 20L,A00,088208,Sirbuly; Donald,27,0,30,3
1653301712400,NANO 20L,B00,088209,Sirbuly; Donald,29,0,30,1
1653301712954,NANO 100L,A00,088210,Vecchio; Kenneth S,24,0,30,6
1653301713485,NANO 102,A00,088211,Tao; Andrea Rae,94,0,100,6
1653301714013,NANO 110,A00,088212,Pascal; Tod A,99,0,100,1
1653301714540,NANO 111,A00,088213,Fenning; David,45,0,50,5
1653301715067,NANO 117,A00,088214,Cubukcu; Ertugrul,71,0,75,4
1653301715591,NANO 119,A00,088215,Vazquez Mena; Oscar,50,0,50,0
1653301716120,NANO 159,A00,088216,Wang; Joseph,33,0,40,7
1653301716646,NANO 181,A01,088218,Ong; Shyue Ping,22,0,25,3
1653301717187,PHIL 1,A00,090815,Sher; Gila,57,0,60,3
1653301717721,PHIL 10,A01,090817,Grush; Rick Scott,37,0,40,3
1653301717721,PHIL 10,A02,090818,Grush; Rick Scott,37,0,40,3
1653301717721,PHIL 10,A03,090819,Grush; Rick Scott,38,0,40,2
1653301717721,PHIL 10,A04,090820,Grush; Rick Scott,40,0,40,0
1653301717721,PHIL 10,A05,090821,Grush; Rick Scott,38,0,40,2
1653301717721,PHIL 10,A06,090822,Grush; Rick Scott,39,0,40,1
1653301718250,PHIL 12,A01,090824,Bechtel; William,20,0,25,5
1653301718250,PHIL 12,A02,090825,Bechtel; William,24,0,25,1
1653301718250,PHIL 12,A03,090826,Bechtel; William,25,0,25,0
1653301718250,PHIL 12,A04,090827,Bechtel; William,25,0,25,0
1653301718785,PHIL 13,A01,090829,Wonderly; Monique L.,25,0,25,0
1653301718785,PHIL 13,A02,090830,Wonderly; Monique L.,24,0,25,1
1653301718785,PHIL 13,A03,090831,Wonderly; Monique L.,24,0,25,1
1653301718785,PHIL 13,A04,090832,Wonderly; Monique L.,25,0,25,0
1653301719317,PHIL 27,A01,090834,Harrell; Maralee Mae,23,0,35,12
1653301719317,PHIL 27,A02,090835,Harrell; Maralee Mae,35,0,35,0
1653301719317,PHIL 27,A03,090836,Harrell; Maralee Mae,33,0,35,2
1653301719317,PHIL 27,A04,090837,Harrell; Maralee Mae,33,0,35,2
1653301719317,PHIL 27,A05,090838,Harrell; Maralee Mae,35,0,35,0
1653301719317,PHIL 27,A06,090839,Harrell; Maralee Mae,35,0,35,0
1653301719862,PHIL 28,A01,090841,Bazargan-Forward; Saba,31,0,35,4
1653301719862,PHIL 28,A02,090842,Bazargan-Forward; Saba,31,0,35,4
1653301719862,PHIL 28,A03,090843,Bazargan-Forward; Saba,35,0,35,0
1653301719862,PHIL 28,A04,090844,Bazargan-Forward; Saba,30,0,35,5
1653301719862,PHIL 28,A05,090845,Bazargan-Forward; Saba,33,0,35,2
1653301719862,PHIL 28,A06,090846,Bazargan-Forward; Saba,34,0,35,1
1653301719862,PHIL 28,A07,090847,Bazargan-Forward; Saba,32,0,35,3
1653301719862,PHIL 28,A08,090848,Bazargan-Forward; Saba,33,0,35,2
1653301720409,PHIL 31,A00,090849,Johnson; Monte,59,0,60,1
1653301720936,PHIL 100,A00,090852,Nelkin; Dana Kay,28,0,35,7
1653301721461,PHIL 110,A00,090853,Johnson; Monte,29,0,30,1
1653301721989,PHIL 120,A00,090854,Rickless; Samuel Charles,23,0,35,12
1653301722513,PHIL 123,A00,090855,Sher; Gila,38,0,40,2
1653301723050,PHIL 131,A00,090856,Cohen; Jonathan David,34,0,35,1
1653301723574,PHIL 132,A00,090857,Carr; Jennifer Rose,33,0,35,2
1653301724102,PHIL 138,A00,090858,Brink; David O.,34,0,40,6
1653301724698,PHIL 147,A00,090860,Fulkerson; Matthew Todd,33,0,35,2
1653301725220,PHIL 150,A00,090861,Bechtel; William,36,0,40,4
1653301725743,PHIL 155,A00,090862,Vargas; Manuel Rogelio,38,0,40,2
1653301726271,PHIL 165,A00,090863,Rickless; Samuel Charles,59,0,70,11
1653301726797,PHIL 172,A00,090864,Bazargan-Forward; Saba,37,0,40,3
1653301727321,PHIL 173,A00,090865,Wonderly; Monique L.,33,0,40,7
1653301727848,PHYS 1A,A00,088555,Koslover; Elena F,354,0,362,8
1653301727848,PHYS 1A,B00,088556,Koslover; Elena F,343,0,362,19
1653301727848,PHYS 1A,C00,088557,Shpyrko; Oleg,326,0,362,36
1653301728374,PHYS 1AL,001,088558,Tsai; Philbert S,30,0,30,0
1653301728374,PHYS 1AL,002,088559,Tsai; Philbert S,30,0,30,0
1653301728374,PHYS 1AL,003,088560,Tsai; Philbert S,23,0,30,7
1653301728374,PHYS 1AL,004,088561,Tsai; Philbert S,26,0,30,4
1653301728374,PHYS 1AL,005,088562,Tsai; Philbert S,24,0,30,6
1653301728374,PHYS 1AL,006,088563,Tsai; Philbert S,30,0,30,0
1653301728374,PHYS 1AL,007,088564,Tsai; Philbert S,26,0,30,4
1653301728374,PHYS 1AL,008,088565,Tsai; Philbert S,29,0,30,1
1653301728374,PHYS 1AL,009,088566,Tsai; Philbert S,28,0,30,2
1653301728374,PHYS 1AL,010,088567,Tsai; Philbert S,30,0,30,0
1653301728374,PHYS 1AL,011,088568,Tsai; Philbert S,29,0,30,1
1653301728374,PHYS 1AL,012,088569,Tsai; Philbert S,29,0,30,1
1653301728374,PHYS 1AL,013,088570,Tsai; Philbert S,30,0,30,0
1653301728374,PHYS 1AL,014,088571,Tsai; Philbert S,29,0,30,1
1653301728374,PHYS 1AL,015,088572,Tsai; Philbert S,23,0,30,7
1653301728374,PHYS 1AL,016,088573,Tsai; Philbert S,28,0,30,2
1653301728374,PHYS 1AL,017,088574,Tsai; Philbert S,29,0,30,1
1653301728374,PHYS 1AL,018,088575,Tsai; Philbert S,28,0,30,2
1653301728374,PHYS 1AL,019,088576,Tsai; Philbert S,26,0,30,4
1653301728374,PHYS 1AL,020,088577,Tsai; Philbert S,29,0,30,1
1653301728374,PHYS 1AL,021,088578,Tsai; Philbert S,30,0,30,0
1653301728374,PHYS 1AL,022,088579,Tsai; Philbert S,30,0,30,0
1653301728374,PHYS 1AL,023,088580,Tsai; Philbert S,30,0,30,0
1653301728374,PHYS 1AL,024,088581,Tsai; Philbert S,30,0,30,0
1653301728374,PHYS 1AL,025,088582,Tsai; Philbert S,26,0,30,4
1653301728374,PHYS 1AL,026,088583,Tsai; Philbert S,29,0,30,1
1653301728374,PHYS 1AL,027,088584,Tsai; Philbert S,28,0,30,2
1653301728374,PHYS 1AL,028,088585,Tsai; Philbert S,30,0,30,0
1653301728374,PHYS 1AL,029,088586,Tsai; Philbert S,27,0,30,3
1653301728374,PHYS 1AL,030,088587,Tsai; Philbert S,29,0,30,1
1653301728374,PHYS 1AL,031,088588,Tsai; Philbert S,30,0,30,0
1653301728374,PHYS 1AL,032,088589,Tsai; Philbert S,30,0,30,0
1653301728374,PHYS 1AL,033,088590,Tsai; Philbert S,30,0,30,0
1653301728374,PHYS 1AL,034,088591,Tsai; Philbert S,30,0,30,0
1653301728374,PHYS 1AL,035,088592,Tsai; Philbert S,29,0,30,1
1653301728374,PHYS 1AL,036,088593,Tsai; Philbert S,30,0,30,0
1653301728902,PHYS 1B,A00,088594,Groisman; Alexander,351,0,360,9
1653301729428,PHYS 1BL,001,088595,Tsai; Philbert S,30,0,30,0
1653301729428,PHYS 1BL,002,088596,Tsai; Philbert S,25,0,30,5
1653301729428,PHYS 1BL,003,088597,Tsai; Philbert S,27,0,30,3
1653301729428,PHYS 1BL,004,088598,Tsai; Philbert S,30,0,30,0
1653301729428,PHYS 1BL,005,088599,Tsai; Philbert S,29,0,30,1
1653301729428,PHYS 1BL,006,088600,Tsai; Philbert S,25,0,30,5
1653301729428,PHYS 1BL,007,088601,Tsai; Philbert S,30,0,30,0
1653301729428,PHYS 1BL,008,088602,Tsai; Philbert S,29,0,30,1
1653301729428,PHYS 1BL,009,088603,Tsai; Philbert S,30,0,30,0
1653301729428,PHYS 1BL,010,088604,Tsai; Philbert S,30,0,30,0
1653301729428,PHYS 1BL,011,088605,Tsai; Philbert S,28,0,30,2
1653301729428,PHYS 1BL,012,088606,Tsai; Philbert S,26,0,30,4
1653301729955,PHYS 1C,A00,088607,Tsai; Philbert S,334,0,360,26
1653301730483,PHYS 1CL,001,088608,Tsai; Philbert S,30,0,30,0
1653301730483,PHYS 1CL,002,088609,Tsai; Philbert S,24,0,30,6
1653301730483,PHYS 1CL,003,088610,Tsai; Philbert S,24,0,30,6
1653301730483,PHYS 1CL,004,088611,Tsai; Philbert S,29,0,30,1
1653301730483,PHYS 1CL,005,088612,Tsai; Philbert S,17,0,30,13
1653301730483,PHYS 1CL,006,088613,Tsai; Philbert S,19,0,30,11
1653301730483,PHYS 1CL,007,088614,Tsai; Philbert S,30,0,30,0
1653301730483,PHYS 1CL,008,088615,Tsai; Philbert S,26,0,30,4
1653301730483,PHYS 1CL,009,088616,Tsai; Philbert S,27,0,30,3
1653301730483,PHYS 1CL,010,088617,Tsai; Philbert S,29,0,30,1
1653301730483,PHYS 1CL,011,088618,Tsai; Philbert S,27,0,30,3
1653301730483,PHYS 1CL,012,088619,Tsai; Philbert S,24,0,30,6
1653301731013,PHYS 2A,A01,092602,Meyertholen; Andrew D.,26,0,30,4
1653301731013,PHYS 2A,A02,092603,Meyertholen; Andrew D.,28,0,30,2
1653301731013,PHYS 2A,A03,092604,Meyertholen; Andrew D.,29,0,30,1
1653301731013,PHYS 2A,A04,092605,Meyertholen; Andrew D.,30,0,30,0
1653301731013,PHYS 2A,A05,092606,Meyertholen; Andrew D.,29,0,30,1
1653301731013,PHYS 2A,A06,092607,Meyertholen; Andrew D.,29,0,30,1
1653301731013,PHYS 2A,A07,092608,Meyertholen; Andrew D.,30,0,30,0
1653301731013,PHYS 2A,A08,092609,Meyertholen; Andrew D.,30,0,30,0
1653301731013,PHYS 2A,A09,092610,Meyertholen; Andrew D.,27,0,30,3
1653301731013,PHYS 2A,A10,092611,Meyertholen; Andrew D.,30,0,30,0
1653301731013,PHYS 2A,A11,092612,Meyertholen; Andrew D.,30,0,30,0
1653301731013,PHYS 2A,A12,094499,Meyertholen; Andrew D.,27,0,30,3
1653301731538,PHYS 2B,A01,092613,Branson; James G,28,0,30,2
1653301731538,PHYS 2B,A02,092614,Branson; James G,29,0,30,1
1653301731538,PHYS 2B,A03,092615,Branson; James G,30,0,30,0
1653301731538,PHYS 2B,A04,092616,Branson; James G,30,0,30,0
1653301731538,PHYS 2B,A05,092617,Branson; James G,29,0,30,1
1653301731538,PHYS 2B,A06,092618,Branson; James G,29,0,30,1
1653301731538,PHYS 2B,A07,092619,Branson; James G,29,0,30,1
1653301731538,PHYS 2B,A08,092620,Branson; James G,0,0,0,0
1653301731538,PHYS 2B,A09,092621,Branson; James G,0,0,0,0
1653301731538,PHYS 2B,A10,092622,Branson; James G,0,0,0,0
1653301731538,PHYS 2B,A11,092623,Branson; James G,0,0,0,0
1653301731538,PHYS 2B,A12,092624,Branson; James G,30,0,30,0
1653301732087,PHYS 2C,A01,092625,Barreiro Guerrero; Julio,27,0,30,3
1653301732087,PHYS 2C,A02,092626,Barreiro Guerrero; Julio,28,0,30,2
1653301732087,PHYS 2C,A03,092627,Barreiro Guerrero; Julio,29,0,30,1
1653301732087,PHYS 2C,A04,092628,Barreiro Guerrero; Julio,29,0,30,1
1653301732087,PHYS 2C,A05,092629,Barreiro Guerrero; Julio,30,0,30,0
1653301732087,PHYS 2C,A06,092630,Barreiro Guerrero; Julio,30,0,30,0
1653301732087,PHYS 2C,A07,092631,Barreiro Guerrero; Julio,30,0,30,0
1653301732087,PHYS 2C,A08,092632,Barreiro Guerrero; Julio,30,0,30,0
1653301732087,PHYS 2C,A09,092633,Barreiro Guerrero; Julio,29,0,30,1
1653301732087,PHYS 2C,A10,092634,Barreiro Guerrero; Julio,29,0,30,1
1653301732087,PHYS 2C,A11,092635,Barreiro Guerrero; Julio,27,0,30,3
1653301732087,PHYS 2C,A12,092636,Barreiro Guerrero; Julio,29,0,30,1
1653301732087,PHYS 2C,B01,092637,Barreiro Guerrero; Julio,29,0,30,1
1653301732087,PHYS 2C,B02,092638,Barreiro Guerrero; Julio,30,0,30,0
1653301732087,PHYS 2C,B03,092639,Barreiro Guerrero; Julio,28,0,30,2
1653301732087,PHYS 2C,B04,092640,Barreiro Guerrero; Julio,29,0,30,1
1653301732087,PHYS 2C,B05,092641,Barreiro Guerrero; Julio,26,0,30,4
1653301732087,PHYS 2C,B06,092642,Barreiro Guerrero; Julio,28,0,30,2
1653301732087,PHYS 2C,B07,092643,Barreiro Guerrero; Julio,29,0,30,1
1653301732087,PHYS 2C,B08,092644,Barreiro Guerrero; Julio,30,0,30,0
1653301732087,PHYS 2C,B09,092645,Barreiro Guerrero; Julio,29,0,30,1
1653301732087,PHYS 2C,B10,092646,Barreiro Guerrero; Julio,29,0,30,1
1653301732087,PHYS 2C,B11,092647,Barreiro Guerrero; Julio,30,0,30,0
1653301732087,PHYS 2C,B12,092648,Barreiro Guerrero; Julio,30,0,30,0
1653301732610,PHYS 2CL,A01,088625,Du; Chunhui,26,0,30,4
1653301732610,PHYS 2CL,A02,088626,Du; Chunhui,29,0,30,1
1653301732610,PHYS 2CL,A03,088627,Du; Chunhui,21,0,30,9
1653301732610,PHYS 2CL,A04,088628,Du; Chunhui,30,0,30,0
1653301732610,PHYS 2CL,A05,088629,Du; Chunhui,29,0,30,1
1653301732610,PHYS 2CL,A06,088630,Du; Chunhui,24,0,30,6
1653301732610,PHYS 2CL,A07,088631,Du; Chunhui,28,0,30,2
1653301732610,PHYS 2CL,A08,088632,Du; Chunhui,28,0,30,2
1653301732610,PHYS 2CL,A09,088633,Du; Chunhui,24,0,30,6
1653301732610,PHYS 2CL,A10,088634,Du; Chunhui,29,0,30,1
1653301732610,PHYS 2CL,A11,088635,Du; Chunhui,27,0,30,3
1653301732610,PHYS 2CL,A12,088636,Du; Chunhui,30,0,30,0
1653301733135,PHYS 2D,A01,092649,Hirsch; Jorge Eduardo,30,0,30,0
1653301733135,PHYS 2D,A02,092650,Hirsch; Jorge Eduardo,28,0,30,2
1653301733135,PHYS 2D,A03,092651,Hirsch; Jorge Eduardo,30,0,30,0
1653301733135,PHYS 2D,A04,092652,Hirsch; Jorge Eduardo,30,0,30,0
1653301733135,PHYS 2D,A05,092653,Hirsch; Jorge Eduardo,30,0,30,0
1653301733135,PHYS 2D,A06,092654,Hirsch; Jorge Eduardo,30,0,30,0
1653301733660,PHYS 2DL,A01,088639,Butov; Leonid,7,0,16,9
1653301733660,PHYS 2DL,A02,088640,Butov; Leonid,13,0,16,3
1653301733660,PHYS 2DL,A03,094501,Butov; Leonid,13,0,16,3
1653301733660,PHYS 2DL,A04,094502,Butov; Leonid,16,0,16,0
1653301734184,PHYS 4C,A01,092655,Averitt; Richard Douglas,28,0,30,2
1653301734184,PHYS 4C,A02,092656,Averitt; Richard Douglas,30,0,30,0
1653301734184,PHYS 4C,A03,092657,Averitt; Richard Douglas,30,0,30,0
1653301734184,PHYS 4C,A04,092658,Staff,30,0,30,0
1653301734707,PHYS 5,A01,092662,Konopacky; Quinn Morgan,197,0,200,3
1653301735232,PHYS 10,A01,092663,Tytler; David Robert,191,0,192,1
1653301735755,PHYS 100A,A01,092660,Shpyrko; Oleg,114,0,120,6
1653301736279,PHYS 110A,A01,092664,Arovas; Daniel P,116,0,120,4
1653301736812,PHYS 122,A01,088647,Yang; Liang,30,0,40,10
1653301737343,PHYS 130B,A01,092661,Grover; Tarun,106,0,120,14
1653301737867,PHYS 139,A00,088649,Kuti; Julius,19,0,20,1
1653301738395,PHYS 140A,A01,092665,Shotwell; Brian,105,0,120,15
1653301738919,PHYS 161,A01,092666,Fuller; George Michael,46,0,65,19
1653301739443,PHYS 163,A01,092667,Keres; Dusan,48,0,50,2
1653301739981,PHYS 175,A00,088653,Dudko; Olga,18,0,20,2
1653301740506,PHYS 191,A00,088654,Shpyrko; Oleg,26,0,30,4
1653301741033,POLI 11D,A01,090896,Ferree; Karen E,29,0,30,1
1653301741033,POLI 11D,A02,090897,Ferree; Karen E,28,0,30,2
1653301741033,POLI 11D,A03,090899,Ferree; Karen E,28,0,30,2
1653301741033,POLI 11D,A04,090900,Ferree; Karen E,29,0,30,1
1653301741558,POLI 12D,A01,090902,Roeder; Philip G,26,0,30,4
1653301741558,POLI 12D,A02,090903,Roeder; Philip G,27,0,30,3
1653301741558,POLI 12D,A05,090906,Roeder; Philip G,28,0,30,2
1653301741558,POLI 12D,A06,090907,Roeder; Philip G,30,0,30,0
1653301742108,POLI 13DR,A01,090909,Forman; Fonna,26,0,30,4
1653301742108,POLI 13DR,A02,090910,Forman; Fonna,30,0,30,0
1653301742108,POLI 13DR,A03,090911,Forman; Fonna,28,0,30,2
1653301742108,POLI 13DR,A04,090912,Forman; Fonna,30,0,30,0
1653301742108,POLI 13DR,A05,090913,Forman; Fonna,28,0,30,2
1653301742108,POLI 13DR,A06,090914,Forman; Fonna,34,0,34,0
1653301742649,POLI 27,A01,090916,Elgin; Samuel Zincke,23,0,30,7
1653301742649,POLI 27,A02,090917,Elgin; Samuel Zincke,26,0,30,4
1653301742649,POLI 27,A03,090918,Elgin; Samuel Zincke,30,0,30,0
1653301742649,POLI 27,A04,090919,Elgin; Samuel Zincke,28,0,30,2
1653301742649,POLI 27,A05,090920,Elgin; Samuel Zincke,24,0,30,6
1653301742649,POLI 27,A06,090921,Elgin; Samuel Zincke,29,0,30,1
1653301743180,POLI 28,A01,090923,Elgin; Samuel Zincke,23,0,30,7
1653301743180,POLI 28,A02,090924,Elgin; Samuel Zincke,26,0,30,4
1653301743180,POLI 28,A05,090927,Elgin; Samuel Zincke,23,0,30,7
1653301743180,POLI 28,A06,090928,Elgin; Samuel Zincke,23,0,30,7
1653301743709,POLI 30D,A01,090930,Desposato; Scott,22,0,24,2
1653301743709,POLI 30D,A02,090931,Desposato; Scott,22,0,24,2
1653301743709,POLI 30D,A03,090932,Desposato; Scott,23,0,24,1
1653301743709,POLI 30D,A04,090933,Desposato; Scott,24,0,24,0
1653301743709,POLI 30D,A05,090934,Desposato; Scott,23,0,24,1
1653301743709,POLI 30D,A06,090935,Desposato; Scott,24,0,24,0
1653301744234,POLI 100G,A00,090936,Fletcher; Nathan,199,0,208,9
1653301744767,POLI 100V,A00,090937,Gause; LaGina,111,0,115,4
1653301745291,POLI 100W,A00,090938,Paglayan; Agustina,161,0,165,4
1653301745840,POLI 104A,A00,090940,Smith; Glenn Chatmas,186,0,195,9
1653301746377,POLI 104F,A00,090941,Smith; Glenn Chatmas,11,0,19,8
1653301746929,POLI 104M,A00,090942,Stephens; Mattheus E,156,0,165,9
1653301747465,POLI 110A,A00,090943,Wiens; David,39,0,44,5
1653301747989,POLI 110F,A00,090944,Elgin; Samuel Zincke,50,0,50,0
1653301748513,POLI 113A,A00,090945,Magagna; Victor Valentine,469,0,475,6
1653301748513,POLI 113A,B00,090946,Magagna; Victor Valentine,467,0,475,8
1653301749037,POLI 117R,A00,090947,Forman; Fonna,16,0,40,24
1653301749564,POLI 120E,A00,090948,Strom; Kaare,47,0,50,3
1653301750088,POLI 120G,A00,090949,Fisk; David Lee,110,0,115,5
1653301750624,POLI 120H,A00,090950,Fisk; David Lee,111,0,115,4
1653301751147,POLI 133A,A00,090951,Naoi; Megumi,156,0,165,9
1653301751670,POLI 135,A00,090952,Fisk; David Lee,111,0,115,4
1653301752196,POLI 142J,A00,090953,Slantchev; Branislav,45,0,50,5
1653301752727,POLI 143,A00,090954,Gartzke; Erik,111,0,115,4
1653301753259,POLI 149,A00,090955,Joseph; Michael F,152,0,165,13
1653301753785,POLI 151,A00,090956,Schneider; Christina,92,0,100,8
1653301754310,POLI 165,A00,090957,Warren; Scott,45,0,50,5
1653301754835,POLI 178,A00,090958,Joseph; Michael F,34,0,50,16
1653301755358,POLI 191A,A00,090959,Forman; Fonna & Hoston; Germaine,25,0,25,0
1653301755883,POLI 194,A00,090960,Hill; Seth J,9999,0,9999,0
1653301756422,POLI 194SD,A00,090961,Nichter; Maysa,9999,0,9999,0
1653301756945,POLI 197SD,001,090962,Nichter; Maysa,9999,0,9999,0
1653301757470,PSYC 1,A00,088391,Ferreira; Victor,194,0,200,6
1653301757995,PSYC 2,A00,093916,Moranton; Nirelia Melbina-,192,0,195,3
1653301758523,PSYC 3,A00,088392,Pilegard; Celeste Cristine,221,0,225,4
1653301759047,PSYC 6,A00,088393,McCullough; Michael E,198,0,200,2
1653301759570,PSYC 7,A00,088394,Powell; Lindsey Jane,196,0,200,4
1653301760095,PSYC 60,A01,088397,Lowe; Angela Beth,12,0,25,13
1653301760095,PSYC 60,A02,088398,Lowe; Angela Beth,25,0,25,0
1653301760095,PSYC 60,A03,088399,Lowe; Angela Beth,24,0,25,1
1653301760095,PSYC 60,A04,088400,Lowe; Angela Beth,23,0,25,2
1653301760095,PSYC 60,A05,088401,Lowe; Angela Beth,24,0,25,1
1653301760095,PSYC 60,A06,088402,Lowe; Angela Beth,25,0,25,0
1653301760095,PSYC 60,A07,088403,Lowe; Angela Beth,24,0,25,1
1653301760095,PSYC 60,B01,088405,Rickard; Timothy C.,25,0,25,0
1653301760095,PSYC 60,B02,088406,Rickard; Timothy C.,25,0,25,0
1653301760095,PSYC 60,B03,088407,Rickard; Timothy C.,25,0,25,0
1653301760095,PSYC 60,B04,088408,Rickard; Timothy C.,23,0,25,2
1653301760095,PSYC 60,B05,088410,Rickard; Timothy C.,24,0,25,1
1653301760095,PSYC 60,B06,088411,Rickard; Timothy C.,24,0,25,1
1653301760095,PSYC 60,B07,088412,Rickard; Timothy C.,24,0,25,1
1653301760628,PSYC 70,A01,088414,Pilegard; Celeste Cristine,17,0,25,8
1653301760628,PSYC 70,A02,088415,Pilegard; Celeste Cristine,24,0,25,1
1653301760628,PSYC 70,A03,088416,Pilegard; Celeste Cristine,25,0,25,0
1653301760628,PSYC 70,A04,088417,Pilegard; Celeste Cristine,25,0,25,0
1653301760628,PSYC 70,A05,088418,Pilegard; Celeste Cristine,22,0,25,3
1653301760628,PSYC 70,A06,088419,Pilegard; Celeste Cristine,19,0,25,6
1653301761151,PSYC 71,A01,088421,Lowe; Angela Beth,15,0,25,10
1653301761151,PSYC 71,A02,088422,Lowe; Angela Beth,21,0,25,4
1653301761151,PSYC 71,B01,088424,Steiner; Eric Tomas,20,0,25,5
1653301761151,PSYC 71,B02,088425,Steiner; Eric Tomas,23,0,25,2
1653301761677,PSYC 87,A00,093915,Gorman; Michael R.,20,0,20,0
1653301762203,PSYC 88,A00,088426,Dobkins; Karen R.,61,0,65,4
1653301762731,PSYC 100,A00,088428,Chapman; Eddie Nathaniel,125,0,170,45
1653301763256,PSYC 101,A00,088429,Heyman; Gail D.,148,0,170,22
1653301763783,PSYC 102,A00,093917,Moranton; Nirelia Melbina-,162,0,170,8
1653301764310,PSYC 104,A00,088430,Fine; Rachel,163,0,175,12
1653301764838,PSYC 116A,A01,088433,Lang; Ariel,25,0,25,0
1653301765365,PSYC 122,A00,088434,Miller; Cory T.,103,0,115,12
1653301765889,PSYC 125,A00,088436,Rose; Fred E.,90,0,120,30
1653301766417,PSYC 134,A00,088437,Kaye; Walter H.,235,0,250,15
1653301766942,PSYC 137,A00,088438,Fine; Rachel,210,0,216,6
1653301767470,PSYC 145,A00,093918,Staff,73,0,90,17
1653301767993,PSYC 147,A00,088441,Wong; Lauren Hitomi,120,0,146,26
1653301768516,PSYC 154,A00,093919,Lacefield; Katharine I,270,0,295,25
1653301769040,PSYC 158,A00,088443,Willis; Jarryd Thomas,250,0,295,45
1653301769564,PSYC 162,A00,088444,Wixted; John T,210,0,225,15
1653301770088,PSYC 167,A00,088445,Walker; Caren Michelle,0,0,30,30
1653301770610,PSYC 168,A00,088446,Chapman; Eddie Nathaniel,222,0,250,28
1653301771138,PSYC 171,A00,088447,Mukku; Dhananjaya,66,0,75,9
1653301771661,PSYC 178,A00,088448,Glaser; Dale,105,0,120,15
1653301772186,PSYC 179,A00,088449,Lacefield; Katharine I,193,0,250,57
1653301772713,PSYC 181,A00,088450,Anagnostaras; Stephan,284,0,300,16
1653301773239,PSYC 189,A00,088451,Gentner; Tim,19,0,31,12
1653301773763,PSYC 193,A00,088452,Gremel; Christina M,19,0,20,1
1653301773763,PSYC 193,B00,088453,Staff,19,0,20,1
1653301774285,PSYC 193L,A01,088455,Staff,33,0,35,2
1653301774812,PSYC 194A,A01,088461,Heyman; Gail D.,35,0,35,0
1653301775342,RELI 1,A01,086478,Kalleres; Dayna,20,0,20,0
1653301775342,RELI 1,A02,086479,Kalleres; Dayna,19,0,20,1
1653301775865,RELI 147,A00,088409,Caciola; Nancy A,0,0,0,0
1653301776391,REV 1,A01,092308,Leigh; Brian,24,0,24,0
1653301776391,REV 1,A02,092310,Leigh; Brian,24,0,24,0
1653301776391,REV 1,A03,092312,Leigh; Brian,24,0,24,0
1653301776391,REV 1,A04,092314,Leigh; Brian,24,0,24,0
1653301776391,REV 1,A05,092316,Leigh; Brian,24,0,24,0
1653301776918,REV 2,A01,092318,Staff,28,0,28,0
1653301776918,REV 2,A02,092319,Staff,28,0,28,0
1653301777442,REV 20,A00,092320,Staff,40,0,40,0
1653301778041,REV 87,A00,092321,Lyon; Antony J.,20,0,20,0
1653301778568,SE 1,A01,088674,Van Den Einde; Yael Dahlia,48,0,48,0
1653301778568,SE 1,A02,088675,Van Den Einde; Yael Dahlia,47,0,48,1
1653301778568,SE 1,A03,088676,Van Den Einde; Yael Dahlia,46,0,48,2
1653301779089,SE 101A,A00,088677,Morrison; Machel Leigh,191,0,200,9
1653301779619,SE 101C,A00,088678,Zhu; Qiang,137,0,145,8
1653301780144,SE 125,A00,088679,Conte; Joel P,143,0,145,2
1653301780675,SE 130A,A00,088680,Loh; Kenneth J. H.,110,0,115,5
1653301781200,SE 131B,A00,088681,Krysl; Petr,84,0,115,31
1653301781723,SE 142,A01,088683,Staff,11,0,18,7
1653301781723,SE 142,A02,088684,Staff,13,0,18,5
1653301782247,SE 164,A01,088686,Loh; Kenneth J. H.,14,0,16,2
1653301782775,SE 180,A00,088687,Elgamal; Ahmed,66,0,75,9
1653301783299,SE 181,A01,088689,McCartney; John Scott,25,0,30,5
1653301783299,SE 181,A02,088690,McCartney; John Scott,14,0,30,16
1653301783299,SE 181,A03,088691,McCartney; John Scott,25,0,25,0
1653301783299,SE 181,A04,088692,McCartney; John Scott,25,0,25,0
1653301783822,SIO 12,A00,088342,Staff,141,0,146,5
1653301784346,SIO 15,A00,088343,Laske; Gabi,333,0,340,7
1653301784884,SIO 30,A01,092382,Castillo; Paterno R.,28,0,35,7
1653301784884,SIO 30,A02,092383,Castillo; Paterno R.,32,0,35,3
1653301784884,SIO 30,A03,092384,Castillo; Paterno R.,35,0,35,0
1653301784884,SIO 30,A04,092385,Castillo; Paterno R.,35,0,35,0
1653301785416,SIO 40,A00,088345,Barbeau; Katherine,144,0,146,2
1653301785945,SIO 50,A01,088347,Cook; Geoffrey W,11,0,14,3
1653301785945,SIO 50,A02,088348,Cook; Geoffrey W,11,0,14,3
1653301786468,SIO 87,A00,088350,Cook; Geoffrey W,20,0,20,0
1653301786468,SIO 87,B00,088351,Cook; Geoffrey W,20,0,20,0
1653301786468,SIO 87,C00,094017,Gilbert; Jack Anthony,20,0,20,0
1653301786468,SIO 87,D00,094018,Gerwick; William Henry,20,0,20,0
1653301786993,SIO 90,A00,088352,Staff,56,0,60,4
1653301787520,SIO 100,A00,088354,Norris; Richard D. & Gee; Jeffrey S,10,0,20,10
1653301788042,SIO 101,A01,088356,Aluwihare; Lihini & Decima; Moira R.,1,0,30,29
1653301788042,SIO 101,A02,088357,Aluwihare; Lihini & Decima; Moira R.,15,0,30,15
1653301788564,SIO 103,A01,088359,Parnell-Turner; Ross Ernes,21,0,25,4
1653301789092,SIO 105,A00,088360,Driscoll; Neal W.,18,0,20,2
1653301789616,SIO 108,A01,088363,Teranes; Jane,15,0,20,5
1653301790138,SIO 109R,A00,088364,Forman; Fonna,27,0,40,13
1653301790661,SIO 110,A01,088366,Staff,8,0,29,21
1653301791189,SIO 117,A01,088368,Keeling; Ralph F.,31,0,36,5
1653301791714,SIO 123,A00,088369,Allen; Andrew Ellis,61,0,70,9
1653301792238,SIO 132,A01,092386,Hechinger; Ryan F. & Kacev; David,17,0,28,11
1653301792238,SIO 132,A02,092387,Hechinger; Ryan F. & Kacev; David,26,0,28,2
1653301792238,SIO 132,A03,092388,Hechinger; Ryan F. & Kacev; David,28,0,28,0
1653301792238,SIO 132,A04,092389,Hechinger; Ryan F. & Kacev; David,23,0,28,5
1653301792238,SIO 132,A05,092390,Hechinger; Ryan F. & Kacev; David,27,0,28,1
1653301792238,SIO 132,A06,092391,Hechinger; Ryan F. & Kacev; David,27,0,28,1
1653301792769,SIO 136,A01,088373,Kacev; David & Bowman; Jeff Shovlowsky,0,0,5,7
1653301792769,SIO 136,B01,088376,Kacev; David & Bowman; Jeff Shovlowsky,0,0,5,5
1653301793292,SIO 155,A01,088379,Day; James M.D.,1,0,5,4
1653301793817,SIO 170,A00,088380,Cook; Geoffrey W,29,0,30,1
1653301794341,SIO 171,A01,088382,Rudnick; Daniel Lars,37,0,40,3
1653301794877,SIO 175,A01,088384,Merrifield; Mark A,22,0,25,3
1653301795407,SIO 177,A00,088385,Becker; Janet Maria,15,0,20,5
1653301795945,SIO 179,A01,088387,Martz; Todd R.,7,0,15,8
1653301796998,SIO 189,A00,088390,Hamdoun; Amr,35,0,60,25
1653301797522,SIO 194,A00,091602,Hill; Seth J,9999,0,9999,0
1653301798047,SOCE 194,A00,091601,Hill; Seth J,9999,0,9999,0
1653301798573,SOCI 1,A01,093704,Skrentny; John David,19,0,20,1
1653301798573,SOCI 1,A02,093705,Skrentny; John David,20,0,20,0
1653301798573,SOCI 1,A03,093706,Skrentny; John David,18,0,20,2
1653301798573,SOCI 1,A04,093707,Skrentny; John David,19,0,20,1
1653301798573,SOCI 1,A05,093708,Skrentny; John David,17,0,20,3
1653301798573,SOCI 1,A06,093709,Skrentny; John David,20,0,20,0
1653301798573,SOCI 1,A07,093710,Skrentny; John David,20,0,20,0
1653301798573,SOCI 1,A08,093711,Skrentny; John David,20,0,20,0
1653301798573,SOCI 1,A09,093712,Skrentny; John David,20,0,20,0
1653301798573,SOCI 1,A10,093713,Skrentny; John David,20,0,20,0
1653301798573,SOCI 1,A11,093714,Skrentny; John David,20,0,20,0
1653301799099,SOCI 30,A01,093716,Staff,30,0,30,0
1653301799099,SOCI 30,A02,093717,Staff,30,0,30,0
1653301799639,SOCI 60,A01,093719,Staff,17,0,20,3
1653301799639,SOCI 60,A02,093720,Staff,18,0,20,2
1653301799639,SOCI 60,A03,093721,Staff,20,0,20,0
1653301799639,SOCI 60,A04,093722,Staff,20,0,20,0
1653301800161,SOCI 87,A00,093819,Blair-Loy; Mary,20,0,20,0
1653301800722,SOCI 100,A01,093724,Estefan; Michel,15,0,20,5
1653301800722,SOCI 100,A02,093725,Estefan; Michel,5,0,20,15
1653301801255,SOCI 104,A00,093728,Gong; Neil M,22,0,25,3
1653301801779,SOCI 104Q,A00,093729,Staff,23,0,25,2
1653301802327,SOCI 106,A00,093730,Staff,25,0,25,0
1653301802851,SOCI 109,A00,093731,Staff,21,0,25,4
1653301803374,SOCI 110,A00,093732,Binder; Amy,24,0,25,1
1653301804947,SOCI 117,A01,091568,Chung; Luz Marina,29,0,35,6
1653301804947,SOCI 117,A02,091569,Chung; Luz Marina,35,0,35,0
1653301805475,SOCI 118,A00,093735,Staff,0,0,0,0
1653301806004,SOCI 120T,A00,093736,Lampland; Martha,50,0,50,0
1653301806004,SOCI 120T,B00,094832,Staff,69,0,70,1
1653301806529,SOCI 122,A00,093737,Lewis; Kevin Michael,62,0,70,8
1653301807052,SOCI 123,A00,094831,Staff,57,0,65,8
1653301807580,SOCI 125,A00,093738,Staff,115,0,120,5
1653301808105,SOCI 127,A00,094894,Staff,54,0,56,2
1653301808628,SOCI 132,A00,093739,Blair-Loy; Mary,51,0,60,9
1653301809677,SOCI 136F,A00,094830,Staff,45,0,56,11
1653301810204,SOCI 138,A00,093741,Navon; Daniel,117,0,120,3
1653301810732,SOCI 140A,A00,093743,Gong; Neil M,53,0,60,7
1653301811254,SOCI 141,A00,093744,Summers; Valerie R.,111,0,120,9
1653301812297,SOCI 144,A00,093746,Staff,0,0,0,0
1653301814396,SOCI 159,A00,094902,Staff,49,0,50,1
1653301814921,SOCI 160,A00,093750,Staff,0,0,0,0
1653301815444,SOCI 165,A00,093751,Rona-Tas; Akos,43,0,48,5
1653301815966,SOCI 165A,A00,094206,Hallin; Daniel C,3,0,4,1
1653301816488,SOCI 166,A00,093752,Lampland; Martha,52,0,56,4
1653301817012,SOCI 176,A00,093753,Turner; Christena L.,44,0,48,4
1653301817536,SOCI 180,A00,094901,Staff,56,0,56,0
1653301818060,SOCI 185,A00,094903,Staff,55,0,56,1
1653301818587,SOCI 196A,A00,093754,Shafir; Gershon,20,0,20,0
1653301819115,SXTH 1,A01,092351,Bronstein; Phoebe Malan,18,0,18,0
1653301819115,SXTH 1,A02,092352,Bronstein; Phoebe Malan,18,0,18,0
1653301819115,SXTH 1,A03,092353,Bronstein; Phoebe Malan,18,0,18,0
1653301819639,SXTH 20A,A00,092355,Chilukuri; Lakshmi N,56,0,56,0
1653301820170,SYN 2,001,091487,Gladstein; Jill M,13,0,15,2
1653301820170,SYN 2,002,091488,Gladstein; Jill M,14,0,15,1
1653301820170,SYN 2,003,091490,Gladstein; Jill M,12,0,15,3
1653301820170,SYN 2,004,091491,Gladstein; Jill M,15,0,15,0
1653301820170,SYN 2,005,091493,Gladstein; Jill M,15,0,15,0
1653301820170,SYN 2,006,091495,Gladstein; Jill M,15,0,15,0
1653301820170,SYN 2,007,091496,Gladstein; Jill M,15,0,15,0
1653301820170,SYN 2,008,091497,Gladstein; Jill M,14,0,15,1
1653301820170,SYN 2,009,091499,Gladstein; Jill M,13,0,15,2
1653301820170,SYN 2,010,091501,Gladstein; Jill M,13,0,15,2
1653301820170,SYN 2,011,091502,Gladstein; Jill M,13,0,15,2
1653301820170,SYN 2,012,091503,Gladstein; Jill M,15,0,15,0
1653301820170,SYN 2,013,091505,Gladstein; Jill M,13,0,15,2
1653301820170,SYN 2,014,091506,Gladstein; Jill M,12,0,15,3
1653301820170,SYN 2,015,091508,Gladstein; Jill M,14,0,15,1
1653301820170,SYN 2,016,091509,Gladstein; Jill M,12,0,15,3
1653301820170,SYN 2,017,091510,Gladstein; Jill M,14,0,15,1
1653301820170,SYN 2,018,091512,Gladstein; Jill M,15,0,15,0
1653301820170,SYN 2,019,091513,Gladstein; Jill M,15,0,15,0
1653301820170,SYN 2,020,091514,Gladstein; Jill M,15,0,15,0
1653301820170,SYN 2,021,091516,Gladstein; Jill M,12,0,15,3
1653301820170,SYN 2,022,091517,Gladstein; Jill M,13,0,15,2
1653301820170,SYN 2,023,091518,Gladstein; Jill M,15,0,15,0
1653301820170,SYN 2,024,091519,Gladstein; Jill M,15,0,15,0
1653301820170,SYN 2,025,091520,Gladstein; Jill M,11,0,15,4
1653301820170,SYN 2,026,091521,Gladstein; Jill M,15,0,15,0
1653301820170,SYN 2,027,091522,Gladstein; Jill M,0,0,0,0
1653301820170,SYN 2,028,091523,Gladstein; Jill M,0,0,0,0
1653301820170,SYN 2,029,091524,Gladstein; Jill M,0,0,0,0
1653301820170,SYN 2,030,091525,Gladstein; Jill M,0,0,0,0
1653301820170,SYN 2,031,091526,Gladstein; Jill M,14,0,15,1
1653301820170,SYN 2,032,091527,Gladstein; Jill M,15,0,15,0
1653301820170,SYN 2,033,091528,Gladstein; Jill M,0,0,0,0
1653301820170,SYN 2,034,091529,Gladstein; Jill M,15,0,15,0
1653301820170,SYN 2,035,091530,Gladstein; Jill M,15,0,15,0
1653301820170,SYN 2,036,091531,Gladstein; Jill M,15,0,15,0
1653301820170,SYN 2,037,091532,Gladstein; Jill M,15,0,15,0
1653301820170,SYN 2,038,091533,Gladstein; Jill M,15,0,15,0
1653301820170,SYN 2,039,091534,Gladstein; Jill M,15,0,15,0
1653301820170,SYN 2,040,091535,Gladstein; Jill M,15,0,15,0
1653301820707,SYN 100,A01,091537,Gladstein; Jill M,26,0,30,4
1653301820707,SYN 100,B01,091539,Gladstein; Jill M,26,0,30,4
1653301820707,SYN 100,C01,091541,Gladstein; Jill M,26,0,30,4
1653301820707,SYN 100,D01,091543,Gladstein; Jill M,25,0,30,5
1653301820707,SYN 100,E01,091545,Gladstein; Jill M,28,0,30,2
1653301821237,TDAC 1,A00,088922,Walsh; Kim C.,10,0,10,0
1653301821237,TDAC 1,B00,088923,Walsh; Kim C.,8,0,10,2
1653301821237,TDAC 1,C00,088924,Walsh; Kim C.,0,0,10,10
1653301821237,TDAC 1,D00,088925,Walsh; Kim C.,7,0,10,3
1653301821237,TDAC 1,E00,088926,Walsh; Kim C.,2,0,10,8
1653301821237,TDAC 1,F00,088927,Walsh; Kim C.,9,0,10,1
1653301821774,TDAC 101,A00,088972,Harting; Carla Kelso,9,0,10,1
1653301821774,TDAC 101,B00,088973,Salovey; Todd,8,0,10,2
1653301821774,TDAC 101,C00,088974,Walsh; Kim C.,6,0,10,4
1653301822297,TDAC 102,A00,088975,Basso; Beatrice,9,0,10,1
1653301822297,TDAC 102,B00,088976,Basso; Beatrice,7,0,10,3
1653301822823,TDAC 103A,A00,094044,Castro; Robert Jess,32,0,35,3
1653301823349,TDAC 108,A00,088977,Staff,20,0,20,0
1653301823895,TDAC 109,A00,088978,Blair; Kyle Adam,20,0,20,0
1653301824419,TDAC 115,A00,088979,Newcomb; James,20,0,20,0
1653301824941,TDAC 122,A00,088981,Staff,30,0,30,0
1653301825464,TDAC 123,A00,088982,Staff,30,0,30,0
1653301825994,TDDE 1,A01,088929,Benzoni; Elisa,9,0,11,2
1653301825994,TDDE 1,A02,088930,Benzoni; Elisa,11,0,11,0
1653301825994,TDDE 1,A03,088931,Benzoni; Elisa,11,0,11,0
1653301825994,TDDE 1,A04,088932,Benzoni; Elisa,10,0,11,1
1653301825994,TDDE 1,A05,088933,Benzoni; Elisa,11,0,11,0
1653301826516,TDDE 130,A00,088983,Staff,20,0,20,0
1653301827043,TDDE 132,A00,094263,Staff,20,0,20,0
1653301827566,TDDE 169A,A00,094046,Petrovich; Victoria A.,18,0,20,2
1653301828094,TDDM 1,A00,088934,Snaith; Yolande,6,0,10,4
1653301828623,TDDM 5,A00,088935,Smith; Alison D,30,0,30,0
1653301829149,TDDR 101,A00,088986,Powell; Lora,34,0,35,1
1653301829688,TDDR 111,A00,088987,Stalling; Vanessa,24,0,30,6
1653301829688,TDDR 111,B00,094045,Castro; Robert Jess,14,0,16,2
1653301830212,TDDR 190,A00,088988,Stalling; Vanessa,10,0,10,0
1653301830741,TDGE 1,A01,088937,Salovey; Todd,12,0,12,0
1653301830741,TDGE 1,A02,088938,Salovey; Todd,10,0,12,2
1653301830741,TDGE 1,A03,088939,Salovey; Todd,8,0,12,4
1653301830741,TDGE 1,A04,088940,Salovey; Todd,12,0,12,0
1653301830741,TDGE 1,A05,088941,Salovey; Todd,11,0,12,1
1653301830741,TDGE 1,A06,088942,Salovey; Todd,12,0,12,0
1653301831364,TDGE 10,A00,088943,Havis; Allan,191,0,200,9
1653301831889,TDGE 11,A00,088944,Staff,200,0,200,0
1653301832420,TDGE 25,A00,088945,Harting; Carla Kelso,19,0,20,1
1653301832420,TDGE 25,B00,088946,Harting; Carla Kelso,19,0,20,1
1653301832420,TDGE 25,C00,088947,Harting; Carla Kelso,20,0,20,0
1653301832420,TDGE 25,D00,088948,Harting; Carla Kelso,19,0,20,1
1653301832420,TDGE 25,E00,088949,Harting; Carla Kelso,20,0,20,0
1653301832420,TDGE 25,F00,088950,Harting; Carla Kelso,19,0,20,1
1653301832420,TDGE 25,G00,088951,Harting; Carla Kelso,19,0,20,1
1653301832944,TDGE 127,A00,088990,Havis; Allan,188,0,200,12
1653301833467,TDHD 21,A00,088952,Jun; Grace Shin Hae,20,0,20,0
1653301833991,TDHT 10,A00,088953,Power; Jade Yukana,14,0,14,0
1653301833991,TDHT 10,B00,088954,Power; Jade Yukana,13,0,14,1
1653301834514,TDHT 21,A01,088956,Power; Jade Yukana,17,0,18,1
1653301834514,TDHT 21,A02,088957,Power; Jade Yukana,7,0,11,4
1653301834514,TDHT 21,A03,088958,Power; Jade Yukana,11,0,11,0
1653301835041,TDHT 101,A00,088994,Burelle; Julie Sara Veronique,21,0,25,4
1653301835570,TDHT 114,A00,094208,Williams; Madison Mae,47,0,50,3
1653301836097,TDHT 119,A00,094299,Burelle; Julie Sara Veronique,25,0,25,0
1653301836621,TDMV 1,A00,088959,Weinberg; Sadie,23,0,30,7
1653301837146,TDMV 2,A00,088960,Sammartano; Tonnie,27,0,30,3
1653301837146,TDMV 2,B00,094043,Duran; Marcos Antonio,29,0,30,1
1653301837674,TDMV 3,A00,088961,Arcidiacono; Kristin,27,0,30,3
1653301838228,TDMV 110,A00,088995,Wilson; Terry A.,0,0,0,0
1653301838752,TDMV 120,A00,088996,Smith; Alison D,17,0,20,3
1653301839279,TDMV 122,A00,088997,Chaleff; Rebecca,28,0,30,2
1653301839802,TDMV 130,A00,094042,Rincon; Alicia,30,0,30,0
1653301840326,TDMV 138,A00,088998,Jun; Grace Shin Hae,12,0,40,28
1653301840850,TDMV 142,A00,088999,Caligagan; Tony,28,0,40,12
1653301841375,TDMV 143,A00,094041,Foster-King; Sandra,37,0,40,3
1653301841902,TDMV 146,A00,089000,Caligagan; Tony,39,0,40,1
1653301842438,TDPF 160,A00,094264,Snaith; Yolande,30,0,30,0
1653301842438,TDPF 160,B00,094265,Smith; Alison D,30,0,30,0
1653301842438,TDPF 160,C00,094266,Weinberg; Sadie,30,0,30,0
1653301842962,TDPR 6,A01,088963,Benzoni; Elisa,25,0,25,0
1653301842962,TDPR 6,A02,088964,Benzoni; Elisa,25,0,25,0
1653301843485,TDPR 102,A00,089003,Staff,15,0,15,0
1653301844011,TDPR 104,A00,089004,Powell; Lora,15,0,15,0
1653301844535,TDPW 1,A00,088965,Staff,10,0,10,0
1653301844535,TDPW 1,B00,088966,Staff,10,0,10,0
1653301844535,TDPW 1,C00,088967,Staff,9,0,10,1
1653301844535,TDPW 1,D00,088968,Staff,9,0,10,1
1653301844535,TDPW 1,E00,088969,Staff,10,0,10,0
1653301844535,TDPW 1,F00,088970,Staff,9,0,10,1
1653301845060,TDTR 10,A00,088971,Wilson; Terry A.,22,0,25,3
1653301845610,TMC 2,A01,092358,Carver; Leslie J.,20,0,20,0
1653301845610,TMC 2,A02,092359,Carver; Leslie J.,20,0,20,0
1653301845610,TMC 2,A03,092360,Carver; Leslie J.,20,0,20,0
1653301845610,TMC 2,A04,092361,Carver; Leslie J.,20,0,20,0
1653301845610,TMC 2,A05,092362,Carver; Leslie J.,20,0,20,0
1653301845610,TMC 2,A06,092363,Carver; Leslie J.,20,0,20,0
1653301846152,TMC 15,A00,092364,Atkinson; Arthur Laird,20,0,20,0
1653301846675,TMC 20,A00,092365,Carver; Leslie J.,20,0,20,0
1653301847220,TMC 90,A00,092366,Mell; Loren K.,20,0,20,0
1653301847745,TMC 120,A01,092368,Staff,20,0,20,0
1653301848276,USP 1,A01,087520,Kwak; Nancy,19,0,20,1
1653301848276,USP 1,A02,087521,Kwak; Nancy,17,0,20,3
1653301848276,USP 1,A03,087522,Kwak; Nancy,16,0,20,4
1653301848276,USP 1,A04,087523,Kwak; Nancy,19,0,20,1
1653301848804,USP 2,A01,087525,Lerner; Amy M,29,0,30,1
1653301848804,USP 2,A02,087526,Lerner; Amy M,29,0,30,1
1653301849331,USP 4,A00,094267,Polat; Soydan Alihan,16,0,20,4
1653301849331,USP 4,B00,094268,Staff,20,0,20,0
1653301849860,USP 5,A01,087532,Staff,26,0,30,4
1653301849860,USP 5,A02,087533,Staff,27,0,30,3
1653301850385,USP 6,A01,094322,Shvartzberg Carrio; Manuel,20,0,20,0
1653301850385,USP 6,A02,094323,Shvartzberg Carrio; Manuel,20,0,20,0
1653301850909,USP 15,A01,087535,Anderson; William Raymond,20,0,25,5
1653301850909,USP 15,A02,087536,Anderson; William Raymond,23,0,25,2
1653301851431,USP 25,A00,087537,Staff,0,0,7,7
1653301851955,USP 50,A00,087538,Martin; Isaac,38,0,40,2
1653301852478,USP 124,A00,087539,Bussell; Mirle Rabinowitz,26,0,35,9
1653301853006,USP 125,A00,087540,Staff,17,0,23,6
1653301853533,USP 136,A00,087541,Staff,23,0,25,2
1653301854061,USP 144,A00,087542,Staff,136,0,146,10
1653301854590,USP 151,A00,087543,Boomhower; Matthew Charles,18,0,20,2
1653301855119,USP 152,A01,087545,Moeder; Nathan L,17,0,20,3
1653301855119,USP 152,A02,087546,Moeder; Nathan L,20,0,20,0
1653301855646,USP 153,A00,087547,Moden; Kelly Kjestine,27,0,30,3
1653301856174,USP 161,A00,094854,Wartell; Julie Dara,25,0,25,0
1653301856701,USP 169,A00,087548,Bajaj; Ravi Siddharth,30,0,35,5
1653301857224,USP 170,A00,087549,Hinds; Juli Beth,30,0,35,5
1653301857751,USP 171,A00,087550,Lerner; Amy M,38,0,50,12
1653301858274,USP 176,A00,094853,Staff,24,0,25,1
1653301858796,USP 177A,A00,087551,Peerson; Susan,20,0,22,2
1653301859341,USP 184,A00,094324,Shvartzberg Carrio; Manuel,24,0,25,1
1653301859865,USP 185A,A01,087553,Norr; Alex Vaughn,28,0,30,2
1653301859865,USP 185A,B01,087555,Boomhower; Matthew Charles,26,0,30,4
1653301860391,USP 186,A01,087557,Pezzoli; Keith,22,0,25,3
1653301860391,USP 186,A02,087558,Pezzoli; Keith,20,0,25,5
1653301861440,USP 191A,A00,087561,Rothberg; Scott Jacob,18,0,20,2
1653301861966,USP 194,A00,091599,Hill; Seth J,9999,0,9999,0
1653301862494,VIS 1,A01,088809,Tonies; Joshua Vanjaymes,10,0,10,0
1653301862494,VIS 1,A02,088810,Tonies; Joshua Vanjaymes,10,0,10,0
1653301862494,VIS 1,A03,088811,Tonies; Joshua Vanjaymes,3,0,10,7
1653301862494,VIS 1,A04,088812,Tonies; Joshua Vanjaymes,8,0,10,2
1653301862494,VIS 1,A05,088813,Tonies; Joshua Vanjaymes,4,0,10,6
1653301862494,VIS 1,A06,088814,Tonies; Joshua Vanjaymes,6,0,10,4
1653301862494,VIS 1,A07,088815,Tonies; Joshua Vanjaymes,6,0,10,4
1653301862494,VIS 1,A08,088816,Tonies; Joshua Vanjaymes,9,0,10,1
1653301862494,VIS 1,A09,088817,Tonies; Joshua Vanjaymes,8,0,10,2
1653301862494,VIS 1,A10,088818,Tonies; Joshua Vanjaymes,8,0,10,2
1653301862494,VIS 1,A11,088819,Tonies; Joshua Vanjaymes,3,0,10,7
1653301862494,VIS 1,A12,088820,Tonies; Joshua Vanjaymes,6,0,10,4
1653301862494,VIS 1,A13,088821,Tonies; Joshua Vanjaymes,6,0,10,4
1653301862494,VIS 1,A14,088822,Tonies; Joshua Vanjaymes,7,0,10,3
1653301862494,VIS 1,A15,088823,Tonies; Joshua Vanjaymes,7,0,10,3
1653301862494,VIS 1,A16,088824,Tonies; Joshua Vanjaymes,8,0,10,2
1653301863020,VIS 20,A01,088826,Woods; Ann,19,0,20,1
1653301863020,VIS 20,A02,088827,Woods; Ann,20,0,20,0
1653301863020,VIS 20,A03,088828,Woods; Ann,18,0,20,2
1653301863020,VIS 20,A04,088829,Woods; Ann,17,0,20,3
1653301863020,VIS 20,A05,088830,Woods; Ann,20,0,20,0
1653301863020,VIS 20,A06,088831,Woods; Ann,20,0,20,0
1653301863020,VIS 20,A07,088832,Woods; Ann,20,0,20,0
1653301863020,VIS 20,A08,088833,Woods; Ann,20,0,20,0
1653301863020,VIS 20,A09,088834,Woods; Ann,18,0,20,2
1653301863020,VIS 20,A10,088835,Woods; Ann,19,0,20,1
1653301863020,VIS 20,A11,088836,Woods; Ann,20,0,20,0
1653301863020,VIS 20,A12,088837,Woods; Ann,20,0,20,0
1653301863559,VIS 23,A00,088838,Rose; Jordan M,3,0,3,0
1653301864090,VIS 30,A01,088840,Stone; Patricia,11,0,11,0
1653301864090,VIS 30,A02,088841,Stone; Patricia,7,0,11,4
1653301864090,VIS 30,A03,094821,Stone; Patricia,8,0,11,3
1653301864090,VIS 30,A04,094822,Stone; Patricia,11,0,11,0
1653301864620,VIS 41,A01,088844,D'Elena-Tweed; Jessica Erin,9,0,10,1
1653301864620,VIS 41,A02,088845,D'Elena-Tweed; Jessica Erin,9,0,10,1
1653301864620,VIS 41,A03,088846,D'Elena-Tweed; Jessica Erin,9,0,10,1
1653301864620,VIS 41,A04,088847,D'Elena-Tweed; Jessica Erin,9,0,10,1
1653301864620,VIS 41,A05,088848,D'Elena-Tweed; Jessica Erin,10,0,10,0
1653301864620,VIS 41,A06,088849,D'Elena-Tweed; Jessica Erin,10,0,10,0
1653301864620,VIS 41,A07,088850,D'Elena-Tweed; Jessica Erin,10,0,10,0
1653301864620,VIS 41,A08,088851,D'Elena-Tweed; Jessica Erin,10,0,10,0
1653301865144,VIS 60,A01,088853,Sepuya; Paul Mpagi,9,0,10,1
1653301865144,VIS 60,A02,088854,Sepuya; Paul Mpagi,10,0,10,0
1653301865144,VIS 60,A03,088855,Sepuya; Paul Mpagi,10,0,10,0
1653301865144,VIS 60,A04,088856,Sepuya; Paul Mpagi,10,0,10,0
1653301865144,VIS 60,A05,088857,Sepuya; Paul Mpagi,10,0,10,0
1653301865144,VIS 60,A06,088858,Sepuya; Paul Mpagi,10,0,10,0
1653301865144,VIS 60,A07,088859,Sepuya; Paul Mpagi,9,0,10,1
1653301865144,VIS 60,A08,093932,Sepuya; Paul Mpagi,10,0,10,0
1653301865671,VIS 70N,A01,088861,Segade; Alexandro Abraham,8,0,8,0
1653301865671,VIS 70N,A02,088862,Segade; Alexandro Abraham,8,0,8,0
1653301865671,VIS 70N,A03,088863,Segade; Alexandro Abraham,8,0,8,0
1653301865671,VIS 70N,A04,088864,Segade; Alexandro Abraham,8,0,8,0
1653301865671,VIS 70N,A05,088865,Segade; Alexandro Abraham,7,0,8,1
1653301865671,VIS 70N,A06,088866,Segade; Alexandro Abraham,8,0,8,0
1653301866193,VIS 80,A01,088868,Adler; Amy,9,0,10,1
1653301866193,VIS 80,A02,088869,Adler; Amy,8,0,10,2
1653301866193,VIS 80,A03,088870,Adler; Amy,9,0,10,1
1653301866193,VIS 80,A04,088871,Adler; Amy,8,0,10,2
1653301866193,VIS 80,A05,088872,Adler; Amy,10,0,10,0
1653301866193,VIS 80,A06,088873,Adler; Amy,7,0,10,3
1653301866729,VIS 100,A00,088874,Cruz; Edwin Teddy,65,0,75,10
1653301867257,VIS 105A,A00,088875,Tonies; Joshua Vanjaymes,26,0,30,4
1653301867790,VIS 105B,A00,088876,Staff,25,0,30,5
1653301868313,VIS 106A,A00,088877,Tobe; Geoffroy,21,0,25,4
1653301868838,VIS 106B,A00,088878,Staff,21,0,25,4
1653301869360,VIS 106C,A00,088879,Staff,9,0,15,6
1653301869888,VIS 107B,A00,088880,Gallaccio; Anya,24,0,25,1
1653301870411,VIS 108,A00,093894,Gallaccio; Anya,5,0,15,10
1653301870938,VIS 110A,A00,093895,Dean; Danielle Adobi,15,0,15,0
1653301871464,VIS 110B,A00,088881,Adler; Amy,14,0,15,1
1653301871994,VIS 125E,A00,093896,Welchman; John C.,75,0,75,0
1653301872523,VIS 126HN,A00,088882,Newsome; Elizabeth Ann,74,0,75,1
1653301873049,VIS 126P,A00,088883,Wardwell; Mariana Razo,72,0,75,3
1653301873576,VIS 128E,A00,088884,Staff,68,0,75,7
1653301874109,VIS 132,A00,088885,Miller; Nicole L,15,0,15,0
1653301874659,VIS 133,A01,094348,D'Elena-Tweed; Jessica Erin,34,0,34,0
1653301874659,VIS 133,A02,094492,D'Elena-Tweed; Jessica Erin,33,0,34,1
1653301875191,VIS 142,A01,088887,Stalbaum; Brett,14,0,15,1
1653301875191,VIS 142,A02,088888,Stalbaum; Brett,10,0,15,5
1653301875191,VIS 142,A03,088889,Stalbaum; Brett,15,0,15,0
1653301875191,VIS 142,A04,088890,Stalbaum; Brett,8,0,15,7
1653301875191,VIS 142,A05,088891,Stalbaum; Brett,14,0,15,1
1653301875191,VIS 142,A06,094828,Stalbaum; Brett,15,0,15,0
1653301875727,VIS 143,A00,088892,Akten; Mehmet,11,0,22,11
1653301876253,VIS 147A,A01,088894,Stalbaum; Brett,20,0,22,2
1653301876253,VIS 147A,A02,088895,Stalbaum; Brett,17,0,22,5
1653301876778,VIS 149,A00,088896,Akten; Mehmet,11,0,15,4
1653301877302,VIS 150,A00,093893,Tufenkian; Armand Yervant,24,0,30,6
1653301877823,VIS 151A,A00,088897,Williams; Alena J,13,0,15,2
1653301878346,VIS 163,A00,088901,Bratton; Benjamin H.,75,0,75,0
1653301878869,VIS 164,A00,088902,Nakayama; Yue,22,0,22,0
1653301879395,VIS 165A,A00,093892,Cross; Brian R,19,0,22,3
1653301879926,VIS 167,A00,088903,Ortiz-Torres; Ruben,19,0,22,3
1653301880454,VIS 174,A00,088905,Staff,21,0,22,1
1653301880454,VIS 174,B00,088906,Kauffmann; Casey,22,0,22,0
1653301880977,VIS 175,A00,093891,Staff,18,0,22,4
1653301881502,VIS 177,A00,088907,Segade; Alexandro Abraham,20,0,22,2
1653301882026,VIS 178,A00,093890,Staff,17,0,22,5
1653301882548,VIS 179,A00,093889,Kauffmann; Casey,21,0,22,1
1653301883075,VIS 180A,A00,093888,Nakayama; Yue,16,0,22,6
1653301883597,VIS 180B,A00,088908,Miller; Nicole L,21,0,22,1
1653301884119,VIS 183A,A00,088909,Sepuya; Paul Mpagi,20,0,22,2
1653301884747,WCWP 10A,001,086588,Gagnon; Jeffrey C,15,0,15,0
1653301884747,WCWP 10A,002,086589,Gagnon; Jeffrey C,14,0,15,1
1653301884747,WCWP 10A,003,086590,Gagnon; Jeffrey C,15,0,15,0
1653301884747,WCWP 10A,004,086591,Gagnon; Jeffrey C,15,0,15,0
1653301884747,WCWP 10A,005,086592,Gagnon; Jeffrey C,15,0,15,0
1653301884747,WCWP 10A,006,086593,Gagnon; Jeffrey C,15,0,15,0
1653301884747,WCWP 10A,007,086594,Gagnon; Jeffrey C,15,0,15,0
1653301884747,WCWP 10A,008,086595,Gagnon; Jeffrey C,15,0,15,0
1653301884747,WCWP 10A,009,086596,Gagnon; Jeffrey C,15,0,15,0
1653301884747,WCWP 10A,010,086597,Gagnon; Jeffrey C,15,0,15,0
1653301884747,WCWP 10A,011,086598,Gagnon; Jeffrey C,20,0,20,0
1653301884747,WCWP 10A,012,086599,Gagnon; Jeffrey C,20,0,20,0
1653301884747,WCWP 10A,013,086600,Gagnon; Jeffrey C,20,0,20,0
1653301884747,WCWP 10A,014,086601,Gagnon; Jeffrey C,20,0,20,0
1653301884747,WCWP 10A,015,086602,Gagnon; Jeffrey C,20,0,20,0
1653301884747,WCWP 10A,016,086603,Gagnon; Jeffrey C,20,0,20,0
1653301884747,WCWP 10A,017,086604,Gagnon; Jeffrey C,20,0,20,0
1653301884747,WCWP 10A,018,086605,Gagnon; Jeffrey C,19,0,20,1
1653301884747,WCWP 10A,019,086606,Gagnon; Jeffrey C,19,0,20,1
1653301884747,WCWP 10A,020,086607,Gagnon; Jeffrey C,20,0,20,0
1653301884747,WCWP 10A,021,086608,Gagnon; Jeffrey C,20,0,20,0
1653301884747,WCWP 10A,022,086609,Gagnon; Jeffrey C,20,0,20,0
1653301884747,WCWP 10A,023,086610,Gagnon; Jeffrey C,19,0,20,1
1653301884747,WCWP 10A,024,086611,Gagnon; Jeffrey C,20,0,20,0
1653301884747,WCWP 10A,025,086612,Gagnon; Jeffrey C,0,0,0,0
1653301884747,WCWP 10A,026,086613,Gagnon; Jeffrey C,0,0,0,0
1653301884747,WCWP 10A,027,086614,Gagnon; Jeffrey C,0,0,0,0
1653301884747,WCWP 10A,028,086615,Gagnon; Jeffrey C,0,0,0,0
1653301884747,WCWP 10A,029,086616,Gagnon; Jeffrey C,0,0,0,0
1653301884747,WCWP 10A,030,086617,Gagnon; Jeffrey C,15,0,15,0
1653301884747,WCWP 10A,031,086618,Gagnon; Jeffrey C,15,0,15,0
1653301884747,WCWP 10A,032,093687,Gagnon; Jeffrey C,15,0,15,0
1653301884747,WCWP 10A,033,093688,Gagnon; Jeffrey C,15,0,15,0
1653301884747,WCWP 10A,034,093689,Gagnon; Jeffrey C,0,0,0,0
1653301884747,WCWP 10A,035,093690,Gagnon; Jeffrey C,0,0,0,0
1653301885271,WCWP 10B,003,086621,Gagnon; Jeffrey C,0,0,0,0
1653301885271,WCWP 10B,004,086622,Gagnon; Jeffrey C,16,0,20,4
1653301885271,WCWP 10B,005,086623,Gagnon; Jeffrey C,18,0,20,2
1653301885271,WCWP 10B,006,086624,Gagnon; Jeffrey C,20,0,20,0
1653301885271,WCWP 10B,007,086625,Gagnon; Jeffrey C,0,0,0,0
1653301885798,WCWP 100,A00,086626,McCleary; Keith Long,20,0,20,0
1653301885798,WCWP 100,B00,086627,McCleary; Keith Long,20,0,20,0
1653301885798,WCWP 100,C00,086628,McCleary; Keith Long,18,0,20,2
1653301885798,WCWP 100,D00,086629,Twohig; Niall Ivan,17,0,20,3
1653301885798,WCWP 100,E00,086630,Twohig; Niall Ivan,17,0,20,3
1653301885798,WCWP 100,F00,086631,Twohig; Niall Ivan,18,0,20,2
1653301885798,WCWP 100,G00,086632,Young; Mark T,20,0,20,0
1653301885798,WCWP 100,H00,086633,Young; Mark T,20,0,20,0
1653301943905,AAS 10,A01,085689,Butler; Elizabeth Annette,28,0,34,6
1653301943905,AAS 10,A02,085690,Butler; Elizabeth Annette,34,0,34,0
1653301944431,AAS 170,A00,085691,Butler; Elizabeth Annette,30,0,32,2
1653301944957,AIP 197,001,085683,Staff,100,0,100,0
1653301944957,AIP 197,002,085684,Rao; Ramesh R,50,0,50,0
1653301945480,AIP 197DC,001,085696,Anderson; Patrick W.,27,0,27,0
1653301946006,AIP 197T,A00,085685,Anderson; Patrick W.,15,0,15,0
1653301946533,ANAR 100,A00,094326,Fortier; Jana,22,0,25,3
1653301947056,ANAR 104,A01,085846,Staff,13,0,15,2
1653301947579,ANAR 120,A00,085847,Staff,15,0,15,0
1653301948106,ANAR 143,A00,094288,Staff,31,0,32,1
1653301948631,ANBI 100,A00,085849,Marchetto; Maria Carolina,31,0,34,3
1653301949156,ANBI 112,A00,085850,Marchetto; Maria Carolina,21,0,28,7
1653301949683,ANBI 118,A00,085851,Fox; Patrick Keolu Ozer,32,0,32,0
1653301950211,ANBI 136,A00,085852,Semendeferi; Ekaterini,20,0,22,2
1653301950739,ANBI 141,A00,085854,Gagneux; Pascal,186,0,192,6
1653301951263,ANBI 145,A00,085855,Staff,30,0,32,2
1653301951786,ANBI 175,A00,085857,Staff,30,0,32,2
1653301952314,ANSC 104,A00,094290,Yeh; Rihan Wen Xin,40,0,46,6
1653301952837,ANSC 105,A00,085859,Olivas Hernandez; Olga Lid,36,0,37,1
1653301953361,ANSC 120,A00,085860,Jassal; Aftab,51,0,56,5
1653301953885,ANSC 121,A00,085861,Staff,29,0,32,3
1653301954933,ANSC 148,A00,085866,Staff,71,0,73,2
1653301955461,ANSC 169,A00,085869,Fortier; Jana,23,0,25,2
1653301955998,ANSC 175,A00,085871,Pedersen; David,28,0,32,4
1653301956521,ANTH 1,A00,085803,Varma; Saiba,146,0,146,0
1653301957050,ANTH 2,A01,085805,Staff,43,0,44,1
1653301957050,ANTH 2,A02,085806,Staff,42,0,44,2
1653301957050,ANTH 2,A03,085807,Staff,44,0,44,0
1653301957050,ANTH 2,A04,085808,Staff,44,0,44,0
1653301957050,ANTH 2,A05,085809,Staff,40,0,40,0
1653301957573,ANTH 4,A01,085811,Yeh; Rihan Wen Xin,32,0,32,0
1653301957573,ANTH 4,A02,095113,Yeh; Rihan Wen Xin,32,0,32,0
1653301957573,ANTH 4,A03,095114,Yeh; Rihan Wen Xin,32,0,32,0
1653301957573,ANTH 4,A04,095115,Yeh; Rihan Wen Xin,34,0,34,0
1653301958095,ANTH 10,A00,085814,Stewart; Alexander B,215,0,216,1
1653301958626,ANTH 21,A01,085816,Kang; Byung Chu,35,0,35,0
1653301958626,ANTH 21,A02,085817,Kang; Byung Chu,35,0,35,0
1653301958626,ANTH 21,A03,085818,Kang; Byung Chu,35,0,35,0
1653301958626,ANTH 21,A04,085819,Kang; Byung Chu,35,0,35,0
1653301958626,ANTH 21,A05,085820,Kang; Byung Chu,33,0,35,2
1653301958626,ANTH 21,A06,085821,Kang; Byung Chu,33,0,35,2
1653301958626,ANTH 21,A07,085822,Kang; Byung Chu,35,0,35,0
1653301958626,ANTH 21,A08,085823,Kang; Byung Chu,35,0,35,0
1653301958626,ANTH 21,A09,085824,Kang; Byung Chu,0,0,0,0
1653301958626,ANTH 21,A10,085825,Kang; Byung Chu,0,0,0,0
1653301958626,ANTH 21,A11,095111,Kang; Byung Chu,30,0,30,0
1653301958626,ANTH 21,A12,095112,Kang; Byung Chu,30,0,30,0
1653301958626,ANTH 21,B01,085827,Staff,36,0,36,0
1653301958626,ANTH 21,B02,085828,Staff,36,0,36,0
1653301958626,ANTH 21,B03,085829,Staff,36,0,36,0
1653301958626,ANTH 21,B04,085830,Staff,38,0,38,0
1653301959150,ANTH 23,A01,085832,Stewart; Alexander B,31,0,31,0
1653301959150,ANTH 23,A02,085833,Stewart; Alexander B,31,0,31,0
1653301959150,ANTH 23,A03,085834,Stewart; Alexander B,31,0,31,0
1653301959150,ANTH 23,A04,085835,Stewart; Alexander B,31,0,31,0
1653301959150,ANTH 23,A05,085836,Stewart; Alexander B,31,0,31,0
1653301959150,ANTH 23,A06,085837,Stewart; Alexander B,0,0,0,0
1653301959150,ANTH 23,A07,085838,Stewart; Alexander B,0,0,0,0
1653301959675,ANTH 87,A00,085842,Staff,20,0,20,0
1653301959675,ANTH 87,B00,085843,Staff,20,0,20,0
1653301960199,ANTH 101,A01,085873,Goldstein; Paul S,33,0,36,3
1653301960199,ANTH 101,A02,085874,Goldstein; Paul S,33,0,36,3
1653301960199,ANTH 101,A03,085875,Goldstein; Paul S,36,0,36,0
1653301960199,ANTH 101,A04,085876,Goldstein; Paul S,36,0,38,2
1653301960727,ANTH 105,A00,085877,Staff,39,0,40,1
1653301961253,ANTH 108,A00,085878,Staff,31,0,32,1
1653301961780,ANTH 192,A00,094234,Kaiser; Bronwyn Nicole & Non; Amy L,20,0,20,0
1653301962306,ANTH 196A,A00,085879,Varma; Saiba,20,0,20,0
1653301962854,AWP 3,001,085697,Staff,13,0,13,0
1653301962854,AWP 3,002,085698,Staff,13,0,13,0
1653301962854,AWP 3,003,085699,Staff,13,0,13,0
1653301962854,AWP 3,004,085700,Staff,0,0,0,0
1653301962854,AWP 3,005,085701,Staff,0,0,0,0
1653301962854,AWP 3,006,085703,Staff,0,0,0,0
1653301962854,AWP 3,007,085704,Staff,13,0,13,0
1653301962854,AWP 3,008,085707,Staff,0,0,0,0
1653301962854,AWP 3,009,085709,Staff,13,0,13,0
1653301962854,AWP 3,010,085710,Staff,13,0,13,0
1653301962854,AWP 3,011,085711,Staff,0,0,0,0
1653301962854,AWP 3,012,085712,Staff,0,0,0,0
1653301962854,AWP 3,013,085713,Staff,13,0,13,0
1653301962854,AWP 3,014,085715,Staff,13,0,13,0
1653301962854,AWP 3,015,085717,Staff,13,0,13,0
1653301962854,AWP 3,016,085719,Staff,13,0,13,0
1653301962854,AWP 3,017,085720,Staff,13,0,13,0
1653301962854,AWP 3,018,085721,Staff,13,0,13,0
1653301962854,AWP 3,019,085722,Staff,13,0,13,0
1653301962854,AWP 3,020,085723,Staff,13,0,13,0
1653301962854,AWP 3,021,085724,Staff,13,0,13,0
1653301962854,AWP 3,022,085725,Staff,13,0,13,0
1653301962854,AWP 3,023,085726,Staff,13,0,13,0
1653301962854,AWP 3,024,085727,Staff,13,0,13,0
1653301962854,AWP 3,025,085728,Staff,13,0,13,0
1653301962854,AWP 3,026,085729,Staff,13,0,13,0
1653301962854,AWP 3,027,085730,Staff,13,0,13,0
1653301962854,AWP 3,028,085731,Staff,13,0,13,0
1653301962854,AWP 3,029,085732,Staff,13,0,13,0
1653301962854,AWP 3,030,085733,Staff,13,0,13,0
1653301962854,AWP 3,031,085734,Staff,13,0,13,0
1653301962854,AWP 3,032,085735,Staff,13,0,13,0
1653301962854,AWP 3,033,085736,Staff,13,0,13,0
1653301962854,AWP 3,034,085737,Staff,13,0,13,0
1653301962854,AWP 3,035,085738,Staff,13,0,13,0
1653301962854,AWP 3,036,085739,Staff,13,0,13,0
1653301962854,AWP 3,037,085740,Staff,13,0,13,0
1653301962854,AWP 3,038,085741,Staff,13,0,13,0
1653301962854,AWP 3,039,085742,Staff,13,0,13,0
1653301962854,AWP 3,040,085743,Staff,13,0,13,0
1653301962854,AWP 3,041,085744,Staff,13,0,13,0
1653301962854,AWP 3,042,085745,Staff,13,0,13,0
1653301962854,AWP 3,043,085746,Staff,13,0,13,0
1653301962854,AWP 3,044,085747,Staff,13,0,13,0
1653301962854,AWP 3,045,085748,Staff,13,0,13,0
1653301962854,AWP 3,046,085749,Staff,13,0,13,0
1653301962854,AWP 3,047,085750,Staff,13,0,13,0
1653301962854,AWP 3,048,085751,Staff,13,0,13,0
1653301962854,AWP 3,049,085752,Staff,13,0,13,0
1653301962854,AWP 3,050,085753,Staff,13,0,13,0
1653301962854,AWP 3,051,085754,Staff,13,0,13,0
1653301962854,AWP 3,052,085755,Staff,0,0,0,0
1653301962854,AWP 3,053,085756,Staff,13,0,13,0
1653301962854,AWP 3,054,085757,Staff,0,0,0,0
1653301962854,AWP 3,055,085758,Staff,13,0,13,0
1653301962854,AWP 3,056,085759,Staff,13,0,13,0
1653301962854,AWP 3,057,085760,Staff,13,0,13,0
1653301962854,AWP 3,058,085761,Staff,13,0,13,0
1653301962854,AWP 3,059,085762,Staff,13,0,13,0
1653301962854,AWP 3,060,085763,Staff,13,0,13,0
1653301962854,AWP 3,061,085764,Staff,13,0,13,0
1653301962854,AWP 3,062,085765,Staff,13,0,13,0
1653301962854,AWP 3,063,085766,Staff,13,0,13,0
1653301962854,AWP 3,064,085767,Staff,13,0,13,0
1653301962854,AWP 3,065,085768,Staff,13,0,13,0
1653301962854,AWP 3,066,085769,Staff,0,0,0,0
1653301963379,AWP 4A,001,085770,Staff,0,0,0,0
1653301963379,AWP 4A,002,085771,Staff,13,0,13,0
1653301963379,AWP 4A,003,085772,Staff,13,0,13,0
1653301963379,AWP 4A,004,085773,Staff,13,0,13,0
1653301963379,AWP 4A,005,085774,Staff,0,0,0,0
1653301963379,AWP 4A,006,085775,Staff,13,0,13,0
1653301963379,AWP 4A,007,085776,Staff,0,0,0,0
1653301963379,AWP 4A,008,085777,Staff,0,0,0,0
1653301963379,AWP 4A,009,085778,Staff,0,0,0,0
1653301963379,AWP 4A,010,085779,Staff,13,0,13,0
1653301963379,AWP 4A,011,085780,Staff,13,0,13,0
1653301963379,AWP 4A,012,085781,Staff,0,0,0,0
1653301963379,AWP 4A,013,085782,Staff,13,0,13,0
1653301963379,AWP 4A,014,085783,Staff,13,0,13,0
1653301963379,AWP 4A,015,085784,Staff,13,0,13,0
1653301963379,AWP 4A,016,085785,Staff,13,0,13,0
1653301963379,AWP 4A,017,085786,Staff,13,0,13,0
1653301963379,AWP 4A,018,085787,Staff,0,0,0,0
1653301963379,AWP 4A,019,085788,Staff,13,0,13,0
1653301963379,AWP 4A,020,085789,Staff,13,0,13,0
1653301963379,AWP 4A,021,085790,Staff,0,0,0,0
1653301963379,AWP 4A,022,085791,Staff,13,0,13,0
1653301963379,AWP 4A,023,085792,Staff,0,0,0,0
1653301963379,AWP 4A,024,085793,Staff,0,0,0,0
1653301963379,AWP 4A,025,085794,Staff,13,0,13,0
1653301963379,AWP 4A,026,085795,Staff,13,0,13,0
1653301963379,AWP 4A,027,085796,Staff,13,0,13,0
1653301963379,AWP 4A,028,085797,Staff,13,0,13,0
1653301963379,AWP 4A,029,085798,Staff,0,0,0,0
1653301963379,AWP 4A,030,085799,Staff,0,0,0,0
1653301963379,AWP 4A,031,093835,Staff,0,0,0,0
1653301963906,AWP 4B,001,085800,Staff,0,0,0,0
1653301963906,AWP 4B,002,085801,Staff,0,0,0,0
1653301964433,BENG 2,A00,085936,Wheeler; Bruce Christopher,28,0,30,2
1653301964961,BENG 110,A01,085939,Mc Culloch; Andrew Douglas,20,0,30,10
1653301964961,BENG 110,A02,085940,Mc Culloch; Andrew Douglas,18,0,30,12
1653301964961,BENG 110,A03,085941,Mc Culloch; Andrew Douglas,27,0,30,3
1653301965487,BENG 119A,A01,085943,Wheeler; Bruce Christopher,29,0,30,1
1653301966012,BENG 122A,A01,085945,Cauwenberghs; Gert,18,0,25,7
1653301966012,BENG 122A,A02,085946,Cauwenberghs; Gert,22,0,25,3
1653301966012,BENG 122A,A03,085947,Cauwenberghs; Gert,22,0,25,3
1653301966544,BENG 126A,A01,085949,Wheeler; Bruce Christopher,30,0,30,0
1653301967066,BENG 127A,A01,085951,Wheeler; Bruce Christopher,28,0,30,2
1653301967590,BENG 128A,A01,085953,Wheeler; Bruce Christopher,29,0,30,1
1653301968114,BENG 134,A01,085955,Smarr; Benjamin,0,0,0,0
1653301968641,BENG 135,A00,085956,Wheeler; Bruce Christopher,23,0,30,7
1653301969165,BENG 141,A00,085958,Lal; Ratnesh,20,0,30,10
1653301969692,BENG 147A,A01,085963,Wheeler; Bruce Christopher,30,0,30,0
1653301970218,BENG 148A,A01,085967,Wheeler; Bruce Christopher,30,0,30,0
1653301970741,BENG 149A,A01,085969,Wheeler; Bruce Christopher,30,0,30,0
1653301971266,BENG 161A,A01,085971,Fraley; Stephanie I.,20,0,25,5
1653301971266,BENG 161A,A02,085972,Fraley; Stephanie I.,13,0,25,12
1653301971266,BENG 161A,A03,085973,Fraley; Stephanie I.,9,0,25,16
1653301971788,BENG 162,A01,085975,Mali; Prashant Gulab Ram,0,0,35,35
1653301971788,BENG 162,A02,085976,Mali; Prashant Gulab Ram,26,0,35,9
1653301972317,BENG 166A,A00,085977,Sah; Robert Lie-Yuan,0,0,0,0
1653301972845,BENG 169A,A01,085982,Wheeler; Bruce Christopher,28,0,30,2
1653301973372,BENG 179A,A01,085984,Wheeler; Bruce Christopher,30,0,30,0
1653301973900,BENG 183,A01,085986,Zhong; Sheng,13,0,30,17
1653301973900,BENG 183,A02,085987,Zhong; Sheng,15,0,30,15
1653301973900,BENG 183,A03,085988,Zhong; Sheng,20,0,30,10
1653301974425,BENG 187B,A00,085989,Wheeler; Bruce Christopher,105,0,170,65
1653301974949,BENG 196,001,094047,Engler; Adam J.,9999,0,9999,0
1653301975475,BIBC 100,A01,092918,Huffaker; Alisa,0,0,19,19
1653301975475,BIBC 100,A02,092919,Huffaker; Alisa,19,0,19,0
1653301975475,BIBC 100,A03,092920,Huffaker; Alisa,18,0,19,1
1653301975475,BIBC 100,A04,092921,Huffaker; Alisa,18,0,19,1
1653301975475,BIBC 100,A05,092922,Huffaker; Alisa,19,0,19,0
1653301975475,BIBC 100,A06,092923,Huffaker; Alisa,18,0,19,1
1653301975475,BIBC 100,A07,092924,Huffaker; Alisa,10,0,19,9
1653301975475,BIBC 100,A08,092925,Huffaker; Alisa,17,0,19,2
1653301975475,BIBC 100,A09,092926,Huffaker; Alisa,19,0,19,0
1653301975475,BIBC 100,A10,092927,Huffaker; Alisa,11,0,19,8
1653301975998,BIBC 102,A01,092997,Schmelz; Eric Alexander,16,0,19,3
1653301975998,BIBC 102,A02,092998,Schmelz; Eric Alexander,5,0,19,14
1653301975998,BIBC 102,A03,092999,Schmelz; Eric Alexander,1,0,19,18
1653301975998,BIBC 102,A04,093000,Schmelz; Eric Alexander,17,0,19,2
1653301975998,BIBC 102,A05,093001,Schmelz; Eric Alexander,9,0,19,10
1653301975998,BIBC 102,A06,093002,Schmelz; Eric Alexander,16,0,19,3
1653301975998,BIBC 102,A07,093003,Schmelz; Eric Alexander,19,0,19,0
1653301975998,BIBC 102,A08,093004,Schmelz; Eric Alexander,19,0,19,0
1653301975998,BIBC 102,A09,093005,Schmelz; Eric Alexander,14,0,19,5
1653301975998,BIBC 102,B01,093064,Coleman; Aaron B.,19,0,19,0
1653301975998,BIBC 102,B02,093065,Coleman; Aaron B.,17,0,19,2
1653301975998,BIBC 102,B03,093066,Coleman; Aaron B.,16,0,19,3
1653301975998,BIBC 102,B04,093067,Coleman; Aaron B.,11,0,19,8
1653301975998,BIBC 102,B05,093068,Coleman; Aaron B.,18,0,19,1
1653301975998,BIBC 102,B06,093069,Coleman; Aaron B.,16,0,19,3
1653301975998,BIBC 102,B07,093070,Coleman; Aaron B.,19,0,19,0
1653301975998,BIBC 102,B08,093071,Coleman; Aaron B.,15,0,19,4
1653301975998,BIBC 102,B09,093072,Coleman; Aaron B.,17,0,19,2
1653301976530,BIBC 103,A01,089887,Bozinovic; Goran,19,0,24,5
1653301976530,BIBC 103,A02,089888,Bozinovic; Goran,23,0,24,1
1653301976530,BIBC 103,B01,089890,Burg; Michael,1,0,24,23
1653301976530,BIBC 103,B02,089891,Burg; Michael,20,0,24,4
1653301976530,BIBC 103,C01,089893,Beyhan; Sinem,14,0,24,10
1653301976530,BIBC 103,C02,089894,Beyhan; Sinem,22,0,24,2
1653301976530,BIBC 103,D01,089896,Coleman; Aaron B.,10,0,24,14
1653301976530,BIBC 103,D02,089897,Coleman; Aaron B.,22,0,24,2
1653301977055,BIBC 194,A00,089898,Hui; Enfu,16,0,27,11
1653301977592,BICD 100,A01,092396,Smith; Laurie,21,0,22,1
1653301977592,BICD 100,A02,092397,Smith; Laurie,22,0,22,0
1653301977592,BICD 100,A03,092398,Smith; Laurie,21,0,22,1
1653301977592,BICD 100,A04,092399,Smith; Laurie,22,0,22,0
1653301977592,BICD 100,A05,092400,Smith; Laurie,21,0,22,1
1653301977592,BICD 100,A06,092401,Smith; Laurie,22,0,22,0
1653301977592,BICD 100,A07,092402,Smith; Laurie,22,0,22,0
1653301977592,BICD 100,A08,092403,Smith; Laurie,22,0,22,0
1653301977592,BICD 100,B01,093073,Mueller; Liam O'Connor,21,0,22,1
1653301977592,BICD 100,B02,093074,Mueller; Liam O'Connor,22,0,22,0
1653301977592,BICD 100,B03,093075,Mueller; Liam O'Connor,22,0,22,0
1653301977592,BICD 100,B04,093076,Mueller; Liam O'Connor,22,0,22,0
1653301977592,BICD 100,B05,093077,Mueller; Liam O'Connor,22,0,22,0
1653301977592,BICD 100,B06,093078,Mueller; Liam O'Connor,22,0,22,0
1653301977592,BICD 100,B07,093079,Mueller; Liam O'Connor,21,0,22,1
1653301977592,BICD 100,B08,093080,Mueller; Liam O'Connor,22,0,22,0
1653301977592,BICD 100,C01,093021,McDonnell; Lisa Marie,21,0,22,1
1653301977592,BICD 100,C02,093022,McDonnell; Lisa Marie,20,0,22,2
1653301977592,BICD 100,C03,093023,McDonnell; Lisa Marie,22,0,22,0
1653301977592,BICD 100,C04,093024,McDonnell; Lisa Marie,22,0,22,0
1653301977592,BICD 100,C05,093025,McDonnell; Lisa Marie,22,0,22,0
1653301977592,BICD 100,C06,093026,McDonnell; Lisa Marie,22,0,22,0
1653301977592,BICD 100,C07,093027,McDonnell; Lisa Marie,20,0,22,2
1653301977592,BICD 100,C08,093028,McDonnell; Lisa Marie,22,0,22,0
1653301977592,BICD 100,D01,093081,Day; Christopher D,22,0,22,0
1653301977592,BICD 100,D02,093082,Day; Christopher D,17,0,22,5
1653301977592,BICD 100,D03,093083,Day; Christopher D,21,0,22,1
1653301977592,BICD 100,D04,093084,Day; Christopher D,19,0,22,3
1653301977592,BICD 100,D05,093085,Day; Christopher D,22,0,22,0
1653301977592,BICD 100,D06,093086,Day; Christopher D,20,0,22,2
1653301977592,BICD 100,D07,093087,Day; Christopher D,19,0,22,3
1653301977592,BICD 100,D08,093088,Day; Christopher D,20,0,22,2
1653301978118,BICD 110,A01,093089,Kiger; Amy,29,0,32,3
1653301978118,BICD 110,A02,093091,Kiger; Amy,32,0,32,0
1653301978118,BICD 110,A03,093092,Kiger; Amy,31,0,32,1
1653301978118,BICD 110,A04,093093,Kiger; Amy,31,0,32,1
1653301978118,BICD 110,A05,093094,Kiger; Amy,26,0,32,6
1653301978118,BICD 110,A06,093095,Kiger; Amy,31,0,32,1
1653301978118,BICD 110,A07,093096,Kiger; Amy,31,0,32,1
1653301978118,BICD 110,B01,093029,Grossman; Emily N,21,0,32,11
1653301978118,BICD 110,B02,093030,Grossman; Emily N,28,0,32,4
1653301978118,BICD 110,B03,093031,Grossman; Emily N,32,0,32,0
1653301978118,BICD 110,B04,093032,Grossman; Emily N,28,0,32,4
1653301978118,BICD 110,B05,093033,Grossman; Emily N,26,0,32,6
1653301978118,BICD 110,B06,093034,Grossman; Emily N,19,0,32,13
1653301978118,BICD 110,B07,093035,Grossman; Emily N,20,0,32,12
1653301978643,BICD 140,A01,093097,Zuniga; Elina I,19,0,32,13
1653301978643,BICD 140,A02,093098,Zuniga; Elina I,17,0,32,15
1653301978643,BICD 140,A03,093099,Zuniga; Elina I,30,0,32,2
1653301978643,BICD 140,A04,093100,Zuniga; Elina I,32,0,32,0
1653301978643,BICD 140,A05,093101,Zuniga; Elina I,29,0,32,3
1653301978643,BICD 140,A06,093102,Zuniga; Elina I,27,0,32,5
1653301979168,BIEB 102,A01,092528,Butler; Shannon Rhey,22,0,27,5
1653301979168,BIEB 102,A02,092529,Butler; Shannon Rhey,17,0,27,10
1653301979168,BIEB 102,A03,092530,Butler; Shannon Rhey,24,0,27,3
1653301979168,BIEB 102,A04,092531,Butler; Shannon Rhey,26,0,27,1
1653301979168,BIEB 102,A05,092532,Butler; Shannon Rhey,25,0,27,2
1653301979168,BIEB 102,A06,092533,Butler; Shannon Rhey,24,0,27,3
1653301979168,BIEB 102,A07,092534,Butler; Shannon Rhey,23,0,27,4
1653301979696,BIEB 121,A00,089907,Holway; David A.,0,0,32,32
1653301980219,BIEB 126,A01,092974,Kohn; Joshua R,24,0,27,3
1653301980219,BIEB 126,A02,092975,Kohn; Joshua R,26,0,27,1
1653301980219,BIEB 126,A03,092976,Kohn; Joshua R,23,0,27,4
1653301980219,BIEB 126,A04,092977,Kohn; Joshua R,25,0,27,2
1653301980219,BIEB 126,A05,092978,Kohn; Joshua R,27,0,27,0
1653301980744,BIEB 146,A01,093054,Petrie; Katherine Lynn,1,0,27,26
1653301980744,BIEB 146,A02,093055,Petrie; Katherine Lynn,4,0,27,23
1653301980744,BIEB 146,A03,093056,Petrie; Katherine Lynn,0,0,27,27
1653301980744,BIEB 146,A04,093057,Petrie; Katherine Lynn,0,0,27,27
1653301980744,BIEB 146,A05,093058,Petrie; Katherine Lynn,20,0,27,7
1653301980744,BIEB 146,A06,093059,Petrie; Katherine Lynn,26,0,27,1
1653301980744,BIEB 146,A07,093060,Petrie; Katherine Lynn,16,0,27,11
1653301980744,BIEB 146,A08,093061,Petrie; Katherine Lynn,25,0,27,2
1653301980744,BIEB 146,A09,093062,Petrie; Katherine Lynn,17,0,27,10
1653301981274,BIEB 150,A01,093103,Rennison; Diana,16,0,27,11
1653301981274,BIEB 150,A02,093104,Rennison; Diana,21,0,27,6
1653301981274,BIEB 150,A03,093105,Rennison; Diana,26,0,27,1
1653301981274,BIEB 150,A04,093106,Rennison; Diana,24,0,27,3
1653301981274,BIEB 150,A05,093107,Rennison; Diana,25,0,27,2
1653301981274,BIEB 150,A06,093108,Rennison; Diana,27,0,27,0
1653301981799,BIEB 158,A01,094057,Reese; Aspen Taylor & Jackrel; Sara,31,0,32,1
1653301981799,BIEB 158,A02,094058,Reese; Aspen Taylor & Jackrel; Sara,28,0,32,4
1653301981799,BIEB 158,A03,094059,Reese; Aspen Taylor & Jackrel; Sara,31,0,32,1
1653301981799,BIEB 158,A04,094060,Reese; Aspen Taylor & Jackrel; Sara,32,0,32,0
1653301982329,BIEB 174,A01,092465,Cleland; Elsa Eleanor & Barton; Andrew David,27,0,27,0
1653301982329,BIEB 174,A02,092466,Cleland; Elsa Eleanor & Barton; Andrew David,27,0,27,0
1653301982329,BIEB 174,A03,092467,Cleland; Elsa Eleanor & Barton; Andrew David,23,0,27,4
1653301982329,BIEB 174,A04,092468,Cleland; Elsa Eleanor & Barton; Andrew David,20,0,27,7
1653301982329,BIEB 174,A05,092469,Cleland; Elsa Eleanor & Barton; Andrew David,25,0,27,2
1653301982329,BIEB 174,A06,092470,Cleland; Elsa Eleanor & Barton; Andrew David,27,0,27,0
1653301982329,BIEB 174,A07,092471,Cleland; Elsa Eleanor & Barton; Andrew David,25,0,27,2
1653301982872,BILD 1,A01,092884,Pickett; Brooke Elizabeth,16,0,19,3
1653301982872,BILD 1,A02,092885,Pickett; Brooke Elizabeth,19,0,19,0
1653301982872,BILD 1,A03,092886,Pickett; Brooke Elizabeth,19,0,19,0
1653301982872,BILD 1,A04,092887,Pickett; Brooke Elizabeth,18,0,19,1
1653301982872,BILD 1,A05,092888,Pickett; Brooke Elizabeth,19,0,19,0
1653301982872,BILD 1,A06,092889,Pickett; Brooke Elizabeth,19,0,19,0
1653301982872,BILD 1,A07,092890,Pickett; Brooke Elizabeth,17,0,19,2
1653301982872,BILD 1,B01,092891,Pekkurnaz Banghart; Gulcin,19,0,19,0
1653301982872,BILD 1,B02,092892,Pekkurnaz Banghart; Gulcin,16,0,19,3
1653301982872,BILD 1,B03,092893,Pekkurnaz Banghart; Gulcin,19,0,19,0
1653301982872,BILD 1,B04,092894,Pekkurnaz Banghart; Gulcin,19,0,19,0
1653301982872,BILD 1,B05,092895,Pekkurnaz Banghart; Gulcin,17,0,19,2
1653301982872,BILD 1,B06,092896,Pekkurnaz Banghart; Gulcin,19,0,19,0
1653301982872,BILD 1,B07,092897,Pekkurnaz Banghart; Gulcin,19,0,19,0
1653301982872,BILD 1,C01,092421,Meaders; Clara Leigh,18,0,19,1
1653301982872,BILD 1,C02,092422,Meaders; Clara Leigh,18,0,19,1
1653301982872,BILD 1,C03,092423,Meaders; Clara Leigh,17,0,19,2
1653301982872,BILD 1,C04,092424,Meaders; Clara Leigh,16,0,19,3
1653301982872,BILD 1,C05,092425,Meaders; Clara Leigh,19,0,19,0
1653301982872,BILD 1,C06,092426,Meaders; Clara Leigh,19,0,19,0
1653301982872,BILD 1,C07,092427,Meaders; Clara Leigh,19,0,19,0
1653301982872,BILD 1,D01,092428,Meaders; Clara Leigh,14,0,19,5
1653301982872,BILD 1,D02,092429,Meaders; Clara Leigh,19,0,19,0
1653301982872,BILD 1,D03,092430,Meaders; Clara Leigh,19,0,19,0
1653301982872,BILD 1,D04,092431,Meaders; Clara Leigh,19,0,19,0
1653301982872,BILD 1,D05,092432,Meaders; Clara Leigh,19,0,19,0
1653301982872,BILD 1,D06,092433,Meaders; Clara Leigh,19,0,19,0
1653301982872,BILD 1,D07,092434,Meaders; Clara Leigh,19,0,19,0
1653301982872,BILD 1,E01,092445,Cooper; Andrew Michael,19,0,19,0
1653301982872,BILD 1,E02,092446,Cooper; Andrew Michael,19,0,19,0
1653301982872,BILD 1,E03,092447,Cooper; Andrew Michael,19,0,19,0
1653301982872,BILD 1,E04,092448,Cooper; Andrew Michael,19,0,19,0
1653301982872,BILD 1,E05,092449,Cooper; Andrew Michael,17,0,19,2
1653301982872,BILD 1,E06,092450,Cooper; Andrew Michael,19,0,19,0
1653301982872,BILD 1,E07,092451,Cooper; Andrew Michael,19,0,19,0
1653301983398,BILD 2,A01,092822,Glasgow; Stacey Marie,25,0,25,0
1653301983398,BILD 2,A02,092823,Glasgow; Stacey Marie,24,0,25,1
1653301983398,BILD 2,A03,092824,Glasgow; Stacey Marie,24,0,25,1
1653301983398,BILD 2,A04,092825,Glasgow; Stacey Marie,25,0,25,0
1653301983398,BILD 2,A05,092826,Glasgow; Stacey Marie,25,0,25,0
1653301983398,BILD 2,A06,092827,Glasgow; Stacey Marie,25,0,25,0
1653301983398,BILD 2,A07,092828,Glasgow; Stacey Marie,25,0,25,0
1653301983398,BILD 2,B01,092830,Owens; Melinda Tsao-Ying,25,0,25,0
1653301983398,BILD 2,B02,092831,Owens; Melinda Tsao-Ying,21,0,25,4
1653301983398,BILD 2,B03,092832,Owens; Melinda Tsao-Ying,23,0,25,2
1653301983398,BILD 2,B04,092833,Owens; Melinda Tsao-Ying,25,0,25,0
1653301983398,BILD 2,B05,092834,Owens; Melinda Tsao-Ying,24,0,25,1
1653301983398,BILD 2,B06,092835,Owens; Melinda Tsao-Ying,21,0,25,4
1653301983398,BILD 2,B07,092836,Owens; Melinda Tsao-Ying,25,0,25,0
1653301983398,BILD 2,C01,092668,Owens; Melinda Tsao-Ying,24,0,25,1
1653301983398,BILD 2,C02,092669,Owens; Melinda Tsao-Ying,23,0,25,2
1653301983398,BILD 2,C03,092670,Owens; Melinda Tsao-Ying,22,0,25,3
1653301983398,BILD 2,C04,092671,Owens; Melinda Tsao-Ying,25,0,25,0
1653301983398,BILD 2,C05,092672,Owens; Melinda Tsao-Ying,25,0,25,0
1653301983398,BILD 2,C06,092673,Owens; Melinda Tsao-Ying,24,0,25,1
1653301983398,BILD 2,C07,092674,Owens; Melinda Tsao-Ying,25,0,25,0
1653301983924,BILD 3,A01,092454,Stockwell; Sarah R,17,0,19,2
1653301983924,BILD 3,A02,092455,Stockwell; Sarah R,17,0,19,2
1653301983924,BILD 3,A03,092456,Stockwell; Sarah R,18,0,19,1
1653301983924,BILD 3,A04,092457,Stockwell; Sarah R,19,0,19,0
1653301983924,BILD 3,A05,092458,Stockwell; Sarah R,19,0,19,0
1653301983924,BILD 3,A06,092459,Stockwell; Sarah R,18,0,19,1
1653301983924,BILD 3,A07,092460,Stockwell; Sarah R,18,0,19,1
1653301983924,BILD 3,A08,092461,Stockwell; Sarah R,19,0,19,0
1653301983924,BILD 3,A09,092462,Stockwell; Sarah R,19,0,19,0
1653301983924,BILD 3,B01,092479,Stockwell; Sarah R,19,0,19,0
1653301983924,BILD 3,B02,092480,Stockwell; Sarah R,18,0,19,1
1653301983924,BILD 3,B03,092481,Stockwell; Sarah R,18,0,19,1
1653301983924,BILD 3,B04,092482,Stockwell; Sarah R,19,0,19,0
1653301983924,BILD 3,B05,092483,Stockwell; Sarah R,19,0,19,0
1653301983924,BILD 3,B06,092484,Stockwell; Sarah R,19,0,19,0
1653301983924,BILD 3,B07,092485,Stockwell; Sarah R,19,0,19,0
1653301983924,BILD 3,B08,092486,Stockwell; Sarah R,18,0,19,1
1653301983924,BILD 3,B09,092487,Stockwell; Sarah R,18,0,19,1
1653301983924,BILD 3,C01,092412,Butler; Shannon Rhey,18,0,19,1
1653301983924,BILD 3,C02,092413,Butler; Shannon Rhey,15,0,19,4
1653301983924,BILD 3,C03,092414,Butler; Shannon Rhey,19,0,19,0
1653301983924,BILD 3,C04,092415,Butler; Shannon Rhey,19,0,19,0
1653301983924,BILD 3,C05,092416,Butler; Shannon Rhey,19,0,19,0
1653301983924,BILD 3,C06,092417,Butler; Shannon Rhey,19,0,19,0
1653301983924,BILD 3,C07,092418,Butler; Shannon Rhey,19,0,19,0
1653301983924,BILD 3,C08,092419,Butler; Shannon Rhey,19,0,19,0
1653301983924,BILD 3,C09,092420,Butler; Shannon Rhey,19,0,19,0
1653301983924,BILD 3,D01,092898,Reuther; Keefe,18,0,19,1
1653301983924,BILD 3,D02,092899,Reuther; Keefe,19,0,19,0
1653301983924,BILD 3,D03,092900,Reuther; Keefe,19,0,19,0
1653301983924,BILD 3,D04,092901,Reuther; Keefe,19,0,19,0
1653301983924,BILD 3,D05,092902,Reuther; Keefe,19,0,19,0
1653301983924,BILD 3,D06,092903,Reuther; Keefe,19,0,19,0
1653301983924,BILD 3,D07,092904,Reuther; Keefe,18,0,19,1
1653301983924,BILD 3,D08,092905,Reuther; Keefe,19,0,19,0
1653301983924,BILD 3,D09,092906,Reuther; Keefe,19,0,19,0
1653301984450,BILD 4,A01,089840,Mel; Stephanie,0,0,0,0
1653301984450,BILD 4,A02,089841,Mel; Stephanie,0,0,0,0
1653301984450,BILD 4,A03,089842,Mel; Stephanie,0,0,0,0
1653301984450,BILD 4,A04,089843,Mel; Stephanie,0,0,0,0
1653301984450,BILD 4,A05,089844,Mel; Stephanie,0,0,0,0
1653301984450,BILD 4,A06,089845,Mel; Stephanie,0,0,0,0
1653301984450,BILD 4,A07,089846,Mel; Stephanie,0,0,0,0
1653301984450,BILD 4,A08,089847,Mel; Stephanie,0,0,0,0
1653301984450,BILD 4,A09,089848,Mel; Stephanie,0,0,0,0
1653301984450,BILD 4,A10,089849,Mel; Stephanie,0,0,0,0
1653301984450,BILD 4,A11,089850,Mel; Stephanie,0,0,0,0
1653301984450,BILD 4,A12,089851,Mel; Stephanie,0,0,0,0
1653301984450,BILD 4,A13,089852,Mel; Stephanie,0,0,0,0
1653301984450,BILD 4,A14,089853,Mel; Stephanie,0,0,0,0
1653301984450,BILD 4,A15,089854,Mel; Stephanie,0,0,0,0
1653301984450,BILD 4,A16,089855,Mel; Stephanie,0,0,0,0
1653301984450,BILD 4,B01,089857,Lo; Stanley M.,0,0,0,0
1653301984450,BILD 4,B02,089858,Lo; Stanley M.,0,0,0,0
1653301984450,BILD 4,B03,089859,Lo; Stanley M.,0,0,0,0
1653301984450,BILD 4,B04,089860,Lo; Stanley M.,0,0,0,0
1653301984450,BILD 4,B05,089861,Lo; Stanley M.,0,0,0,0
1653301984450,BILD 4,B06,089862,Lo; Stanley M.,0,0,0,0
1653301984450,BILD 4,B07,089863,Lo; Stanley M.,0,0,0,0
1653301984450,BILD 4,B08,089864,Lo; Stanley M.,0,0,0,0
1653301984450,BILD 4,B09,089865,Lo; Stanley M.,0,0,0,0
1653301984450,BILD 4,B10,089866,Lo; Stanley M.,0,0,0,0
1653301984450,BILD 4,B11,089867,Lo; Stanley M.,0,0,0,0
1653301984450,BILD 4,B12,089868,Lo; Stanley M.,0,0,0,0
1653301984450,BILD 4,B13,089869,Lo; Stanley M.,0,0,0,0
1653301984450,BILD 4,B14,089870,Lo; Stanley M.,0,0,0,0
1653301984450,BILD 4,B15,089871,Lo; Stanley M.,0,0,0,0
1653301984450,BILD 4,B16,089872,Lo; Stanley M.,0,0,0,0
1653301984979,BILD 5,A01,092907,Reuther; Keefe,31,0,32,1
1653301984979,BILD 5,A02,092908,Reuther; Keefe,30,0,32,2
1653301985506,BILD 10,A01,092909,Gustafson-Brown; Cindy,27,0,27,0
1653301985506,BILD 10,A02,092910,Gustafson-Brown; Cindy,27,0,27,0
1653301985506,BILD 10,A03,092911,Gustafson-Brown; Cindy,27,0,27,0
1653301985506,BILD 10,A04,092912,Gustafson-Brown; Cindy,27,0,27,0
1653301985506,BILD 10,A05,092913,Gustafson-Brown; Cindy,25,0,27,2
1653301985506,BILD 10,A06,092914,Gustafson-Brown; Cindy,26,0,27,1
1653301985506,BILD 10,A07,092915,Gustafson-Brown; Cindy,27,0,27,0
1653301985506,BILD 10,A08,092916,Gustafson-Brown; Cindy,27,0,27,0
1653301985506,BILD 10,A09,092917,Gustafson-Brown; Cindy,27,0,27,0
1653301986035,BILD 20,A01,092956,Rana; Brinda Kanti,24,0,27,3
1653301986035,BILD 20,A02,092957,Rana; Brinda Kanti,24,0,27,3
1653301986035,BILD 20,A03,092958,Rana; Brinda Kanti,27,0,27,0
1653301986035,BILD 20,A04,092959,Rana; Brinda Kanti,27,0,27,0
1653301986562,BILD 32,A01,092990,Burg; Michael,27,0,27,0
1653301986562,BILD 32,A02,092991,Burg; Michael,26,0,27,1
1653301986562,BILD 32,A03,092992,Burg; Michael,27,0,27,0
1653301986562,BILD 32,A04,092993,Burg; Michael,26,0,27,1
1653301986562,BILD 32,A05,092994,Burg; Michael,27,0,27,0
1653301986562,BILD 32,A06,092995,Burg; Michael,27,0,27,0
1653301986562,BILD 32,A07,092996,Burg; Michael,27,0,27,0
1653301987085,BILD 60,A01,092392,Hammond; LaTisha Marie,24,0,24,0
1653301987085,BILD 60,A02,092393,Hammond; LaTisha Marie,24,0,24,0
1653301987085,BILD 60,B01,092394,Macagno; Eduardo R.,23,0,24,1
1653301987085,BILD 60,B02,092395,Macagno; Eduardo R.,24,0,24,0
1653301987609,BILD 62,A01,092949,Aljadeff; Johnatan,31,0,32,1
1653301987609,BILD 62,A02,092950,Aljadeff; Johnatan,32,0,32,0
1653301987609,BILD 62,A03,092951,Aljadeff; Johnatan,32,0,32,0
1653301988137,BILD 80,A00,089880,Pogliano; Joseph,27,0,30,3
1653301988663,BIMM 100,A01,092435,Pasquinelli; Amy,32,0,32,0
1653301988663,BIMM 100,A02,092436,Pasquinelli; Amy,30,0,32,2
1653301988663,BIMM 100,A03,092437,Pasquinelli; Amy,32,0,32,0
1653301988663,BIMM 100,A04,092438,Pasquinelli; Amy,31,0,32,1
1653301988663,BIMM 100,A05,092439,Pasquinelli; Amy,32,0,32,0
1653301988663,BIMM 100,A06,092440,Pasquinelli; Amy,32,0,32,0
1653301988663,BIMM 100,A07,092441,Pasquinelli; Amy,32,0,32,0
1653301988663,BIMM 100,A08,092442,Pasquinelli; Amy,32,0,32,0
1653301988663,BIMM 100,A09,092443,Pasquinelli; Amy,32,0,32,0
1653301988663,BIMM 100,A10,092444,Pasquinelli; Amy,32,0,32,0
1653301988663,BIMM 100,B01,092518,Pruneda-Paz; Jose L.,26,0,32,6
1653301988663,BIMM 100,B02,092519,Pruneda-Paz; Jose L.,19,0,32,13
1653301988663,BIMM 100,B03,092520,Pruneda-Paz; Jose L.,20,0,32,12
1653301988663,BIMM 100,B04,092521,Pruneda-Paz; Jose L.,24,0,32,8
1653301988663,BIMM 100,B05,092522,Pruneda-Paz; Jose L.,23,0,32,9
1653301988663,BIMM 100,B06,092523,Pruneda-Paz; Jose L.,24,0,32,8
1653301988663,BIMM 100,B07,092524,Pruneda-Paz; Jose L.,28,0,32,4
1653301988663,BIMM 100,B08,092525,Pruneda-Paz; Jose L.,25,0,32,7
1653301988663,BIMM 100,B09,092526,Pruneda-Paz; Jose L.,26,0,32,6
1653301988663,BIMM 100,B10,092527,Pruneda-Paz; Jose L.,24,0,32,8
1653301989195,BIMM 101,A01,089915,Rusert; Jessica Marie,22,0,24,2
1653301989195,BIMM 101,A02,089916,Rusert; Jessica Marie,21,0,24,3
1653301989195,BIMM 101,A03,089917,Rusert; Jessica Marie,21,0,24,3
1653301989195,BIMM 101,A04,089918,Rusert; Jessica Marie,20,0,24,4
1653301989195,BIMM 101,B01,089920,Grossman; Emily N,0,0,24,24
1653301989195,BIMM 101,B02,089921,Grossman; Emily N,1,0,24,23
1653301989195,BIMM 101,C01,089923,Day; Christopher D,0,0,24,24
1653301989195,BIMM 101,C02,089924,Day; Christopher D,0,0,24,24
1653301989195,BIMM 101,D01,089926,Cooper; Andrew Michael,18,0,24,6
1653301989195,BIMM 101,D02,089927,Cooper; Andrew Michael,24,0,24,0
1653301989195,BIMM 101,E01,089929,McDonnell; Lisa Marie,1,0,24,23
1653301989195,BIMM 101,E02,089930,McDonnell; Lisa Marie,12,0,24,12
1653301989722,BIMM 110,A01,092472,Tour; Ella,26,0,32,6
1653301989722,BIMM 110,A02,092473,Tour; Ella,23,0,32,9
1653301989722,BIMM 110,A03,092474,Tour; Ella,29,0,32,3
1653301989722,BIMM 110,A04,092475,Tour; Ella,27,0,32,5
1653301989722,BIMM 110,A05,092476,Tour; Ella,32,0,32,0
1653301989722,BIMM 110,A06,092477,Tour; Ella,30,0,32,2
1653301989722,BIMM 110,A07,092478,Tour; Ella,29,0,32,3
1653301990245,BIMM 120,A01,092979,Allen; Eric,28,0,32,4
1653301990245,BIMM 120,A02,092980,Allen; Eric,1,0,32,31
1653301990245,BIMM 120,A03,092981,Allen; Eric,14,0,32,18
1653301990245,BIMM 120,A04,092982,Allen; Eric,27,0,32,5
1653301990245,BIMM 120,A05,092983,Allen; Eric,30,0,32,2
1653301990245,BIMM 120,A06,092984,Allen; Eric,29,0,32,3
1653301990245,BIMM 120,A07,092985,Allen; Eric,20,0,32,12
1653301990245,BIMM 120,A08,092986,Allen; Eric,30,0,32,2
1653301990245,BIMM 120,A09,092987,Allen; Eric,30,0,32,2
1653301990245,BIMM 120,A10,092988,Allen; Eric,30,0,32,2
1653301990245,BIMM 120,A11,092989,Allen; Eric,32,0,32,0
1653301990773,BIMM 121,A01,089934,Petrie; Katherine Lynn,0,0,24,24
1653301990773,BIMM 121,A02,089935,Petrie; Katherine Lynn,0,0,24,24
1653301990773,BIMM 121,B01,089937,Pickett; Brooke Elizabeth,0,0,24,24
1653301990773,BIMM 121,B02,089938,Pickett; Brooke Elizabeth,0,0,24,24
1653301990773,BIMM 121,C01,089940,Pirino; Giorgia,0,0,24,24
1653301990773,BIMM 121,C02,089941,Pirino; Giorgia,0,0,24,24
1653301990773,BIMM 121,C03,089942,Pirino; Giorgia,0,0,24,24
1653301990773,BIMM 121,C04,089943,Pirino; Giorgia,0,0,24,24
1653301991295,BIMM 122,A01,093006,Russell; Alistair B,18,0,32,14
1653301991295,BIMM 122,A02,093007,Russell; Alistair B,16,0,32,16
1653301991295,BIMM 122,A03,093008,Russell; Alistair B,26,0,32,6
1653301991295,BIMM 122,A04,093009,Russell; Alistair B,32,0,32,0
1653301991295,BIMM 122,A05,093010,Russell; Alistair B,30,0,32,2
1653301991823,BIMM 124,A01,092404,Gustafson-Brown; Cindy,26,0,32,6
1653301991823,BIMM 124,A02,092405,Gustafson-Brown; Cindy,29,0,32,3
1653301991823,BIMM 124,A03,092406,Gustafson-Brown; Cindy,30,0,32,2
1653301991823,BIMM 124,A04,092407,Gustafson-Brown; Cindy,32,0,32,0
1653301991823,BIMM 124,A05,092408,Gustafson-Brown; Cindy,28,0,32,4
1653301991823,BIMM 124,A06,092409,Gustafson-Brown; Cindy,31,0,32,1
1653301991823,BIMM 124,A07,092410,Gustafson-Brown; Cindy,32,0,32,0
1653301992420,BIMM 140,A01,089947,Suel; Gurol Mehmet & Hao; Nan,16,0,27,11
1653301992420,BIMM 140,A02,089948,Suel; Gurol Mehmet & Hao; Nan,24,0,27,3
1653301992420,BIMM 140,A03,089949,Suel; Gurol Mehmet & Hao; Nan,21,0,27,6
1653301992420,BIMM 140,A04,089950,Suel; Gurol Mehmet & Hao; Nan,25,0,27,2
1653301992420,BIMM 140,A05,089951,Suel; Gurol Mehmet & Hao; Nan,24,0,27,3
1653301992942,BIMM 143,A01,089953,Grant; Barry J,0,0,40,40
1653301992942,BIMM 143,B01,089955,Fan; Chun Chieh,39,0,40,1
1653301992942,BIMM 143,C01,089957,Bozinovic; Goran,29,0,40,11
1653301993468,BIMM 194,A00,089958,Hasty; Jeff M,15,0,27,12
1653301993468,BIMM 194,B00,089959,Golden; James W,19,0,27,8
1653301993468,BIMM 194,C00,089960,Lykke-Andersen; Jens,2,0,27,25
1653301993468,BIMM 194,D00,094317,Golden; Susan S.,25,0,27,2
1653301993999,BIPN 100,A01,093011,Cooke; James Edward,7,0,19,12
1653301993999,BIPN 100,A02,093012,Cooke; James Edward,10,0,19,9
1653301993999,BIPN 100,A03,093013,Cooke; James Edward,8,0,19,11
1653301993999,BIPN 100,A04,093014,Cooke; James Edward,12,0,19,7
1653301993999,BIPN 100,A05,093015,Cooke; James Edward,17,0,19,2
1653301993999,BIPN 100,A06,093016,Cooke; James Edward,12,0,19,7
1653301993999,BIPN 100,A07,093017,Cooke; James Edward,12,0,19,7
1653301993999,BIPN 100,A08,093018,Cooke; James Edward,18,0,19,1
1653301993999,BIPN 100,A09,093019,Cooke; James Edward,17,0,19,2
1653301993999,BIPN 100,A10,093020,Cooke; James Edward,18,0,19,1
1653301993999,BIPN 100,B01,093036,Reyes Gonzalez; Catalina,17,0,19,2
1653301993999,BIPN 100,B02,093037,Reyes Gonzalez; Catalina,14,0,19,5
1653301993999,BIPN 100,B03,093038,Reyes Gonzalez; Catalina,16,0,19,3
1653301993999,BIPN 100,B04,093039,Reyes Gonzalez; Catalina,19,0,19,0
1653301993999,BIPN 100,B05,093040,Reyes Gonzalez; Catalina,19,0,19,0
1653301993999,BIPN 100,B06,093041,Reyes Gonzalez; Catalina,19,0,19,0
1653301993999,BIPN 100,B07,093042,Reyes Gonzalez; Catalina,14,0,19,5
1653301993999,BIPN 100,B08,093043,Reyes Gonzalez; Catalina,16,0,19,3
1653301993999,BIPN 100,B09,093044,Reyes Gonzalez; Catalina,19,0,19,0
1653301993999,BIPN 100,B10,093045,Reyes Gonzalez; Catalina,19,0,19,0
1653301994522,BIPN 102,A01,093046,Reyes Gonzalez; Catalina,28,0,32,4
1653301994522,BIPN 102,A02,093047,Reyes Gonzalez; Catalina,17,0,32,15
1653301994522,BIPN 102,A05,093050,Reyes Gonzalez; Catalina,29,0,32,3
1653301994522,BIPN 102,A06,093051,Reyes Gonzalez; Catalina,15,0,32,17
1653301994522,BIPN 102,A07,093052,Reyes Gonzalez; Catalina,29,0,32,3
1653301994522,BIPN 102,A08,093053,Reyes Gonzalez; Catalina,31,0,32,1
1653301995053,BIPN 105,A01,089966,Armour; Jon Christopher,0,0,21,21
1653301995053,BIPN 105,A02,089967,Armour; Jon Christopher,0,0,21,21
1653301995053,BIPN 105,A03,089968,Armour; Jon Christopher,3,0,21,18
1653301995053,BIPN 105,A04,089969,Armour; Jon Christopher,10,0,21,11
1653301995577,BIPN 140,A01,092514,Spitzer; Nicholas & Su; Chih-Ying,9,0,19,10
1653301995577,BIPN 140,A02,092515,Spitzer; Nicholas & Su; Chih-Ying,12,0,19,7
1653301995577,BIPN 140,A03,092516,Spitzer; Nicholas & Su; Chih-Ying,11,0,19,8
1653301995577,BIPN 140,A04,092517,Spitzer; Nicholas & Su; Chih-Ying,15,0,19,4
1653301995577,BIPN 140,B01,092952,Banghart; Matthew Ryan,12,0,19,7
1653301995577,BIPN 140,B02,092953,Banghart; Matthew Ryan,19,0,19,0
1653301995577,BIPN 140,B03,092954,Banghart; Matthew Ryan,19,0,19,0
1653301995577,BIPN 140,B04,092955,Banghart; Matthew Ryan,19,0,19,0
1653301996101,BIPN 145,A01,089973,Marino; Marc J,35,0,42,7
1653301996101,BIPN 145,A02,089974,Marino; Marc J,36,0,42,6
1653301996101,BIPN 145,B01,089976,Juavinett; Ashley Lauren,0,0,42,42
1653301996632,BIPN 148,A01,092960,Leutgeb; Jill K.,31,0,32,1
1653301996632,BIPN 148,A02,092961,Leutgeb; Jill K.,25,0,32,7
1653301996632,BIPN 148,A03,092962,Leutgeb; Jill K.,29,0,31,2
1653301996632,BIPN 148,A04,092963,Leutgeb; Jill K.,31,0,31,0
1653301996632,BIPN 148,A05,092964,Leutgeb; Jill K.,31,0,31,0
1653301996632,BIPN 148,A06,094351,Leutgeb; Jill K.,26,0,31,5
1653301996632,BIPN 148,A07,092966,Leutgeb; Jill K.,26,0,31,5
1653301996632,BIPN 148,A08,092967,Leutgeb; Jill K.,26,0,31,5
1653301997157,BIPN 189,A00,090665,Gentner; Tim,0,0,25,25
1653301997684,BIPN 194,A00,089978,Pekkurnaz Banghart; Gulcin,17,0,27,10
1653301997684,BIPN 194,B00,089979,Leutgeb; Stefan,24,0,27,3
1653301998206,BISP 194,A00,089980,Wertheim; Joel Okrent,8,0,27,19
1653301998747,CAT 1,A01,086671,Bronstein; Phoebe Malan,17,0,17,0
1653301998747,CAT 1,A02,086672,Bronstein; Phoebe Malan,13,0,17,4
1653301998747,CAT 1,A03,086673,Bronstein; Phoebe Malan,17,0,17,0
1653301998747,CAT 1,A04,086674,Bronstein; Phoebe Malan,15,0,17,2
1653301998747,CAT 1,A05,086675,Bronstein; Phoebe Malan,17,0,17,0
1653301998747,CAT 1,A06,086676,Bronstein; Phoebe Malan,17,0,17,0
1653301998747,CAT 1,A07,086677,Bronstein; Phoebe Malan,16,0,17,1
1653301998747,CAT 1,A08,086678,Bronstein; Phoebe Malan,17,0,17,0
1653301998747,CAT 1,A09,086679,Bronstein; Phoebe Malan,16,0,17,1
1653301998747,CAT 1,A10,086680,Bronstein; Phoebe Malan,17,0,17,0
1653301998747,CAT 1,A11,086681,Bronstein; Phoebe Malan,16,0,17,1
1653301998747,CAT 1,A12,086682,Bronstein; Phoebe Malan,17,0,17,0
1653301998747,CAT 1,A13,086683,Bronstein; Phoebe Malan,17,0,17,0
1653301998747,CAT 1,A14,086684,Bronstein; Phoebe Malan,17,0,17,0
1653301998747,CAT 1,A15,086685,Bronstein; Phoebe Malan,17,0,17,0
1653301998747,CAT 1,A16,086686,Bronstein; Phoebe Malan,17,0,17,0
1653301998747,CAT 1,B01,086688,Bigham; David Joseph,17,0,17,0
1653301998747,CAT 1,B02,086689,Bigham; David Joseph,16,0,17,1
1653301998747,CAT 1,B03,086690,Bigham; David Joseph,17,0,17,0
1653301998747,CAT 1,B04,086691,Bigham; David Joseph,17,0,17,0
1653301998747,CAT 1,B05,086692,Bigham; David Joseph,16,0,17,1
1653301998747,CAT 1,B06,086693,Bigham; David Joseph,17,0,17,0
1653301998747,CAT 1,B07,086694,Bigham; David Joseph,17,0,17,0
1653301998747,CAT 1,B08,086695,Bigham; David Joseph,17,0,17,0
1653301998747,CAT 1,B09,086696,Bigham; David Joseph,17,0,17,0
1653301998747,CAT 1,B10,086697,Bigham; David Joseph,17,0,17,0
1653301998747,CAT 1,B11,086698,Bigham; David Joseph,17,0,17,0
1653301998747,CAT 1,B12,086699,Bigham; David Joseph,17,0,17,0
1653301998747,CAT 1,B13,086700,Bigham; David Joseph,15,0,17,2
1653301998747,CAT 1,B14,086701,Bigham; David Joseph,17,0,17,0
1653301998747,CAT 1,C01,086703,Algaze; Guillermo,17,0,17,0
1653301998747,CAT 1,C02,086704,Algaze; Guillermo,17,0,17,0
1653301998747,CAT 1,C03,086705,Algaze; Guillermo,17,0,17,0
1653301998747,CAT 1,C04,086706,Algaze; Guillermo,17,0,17,0
1653301998747,CAT 1,C05,086707,Algaze; Guillermo,17,0,17,0
1653301998747,CAT 1,C06,086708,Algaze; Guillermo,17,0,17,0
1653301998747,CAT 1,C07,086709,Algaze; Guillermo,17,0,17,0
1653301998747,CAT 1,C08,086710,Algaze; Guillermo,17,0,17,0
1653301998747,CAT 1,C09,086711,Algaze; Guillermo,17,0,17,0
1653301998747,CAT 1,C10,086712,Algaze; Guillermo,17,0,17,0
1653301998747,CAT 1,C11,086713,Algaze; Guillermo,17,0,17,0
1653301998747,CAT 1,C12,086714,Algaze; Guillermo,17,0,17,0
1653301998747,CAT 1,C13,086715,Algaze; Guillermo,17,0,17,0
1653301998747,CAT 1,C14,086716,Algaze; Guillermo,16,0,17,1
1653301998747,CAT 1,C15,086717,Algaze; Guillermo,17,0,17,0
1653301998747,CAT 1,C16,086718,Algaze; Guillermo,16,0,17,1
1653301998747,CAT 1,D01,086720,Staff,17,0,17,0
1653301998747,CAT 1,D02,086721,Staff,17,0,17,0
1653301998747,CAT 1,D03,086722,Staff,17,0,17,0
1653301998747,CAT 1,D04,086723,Staff,17,0,17,0
1653301998747,CAT 1,D05,086724,Staff,16,0,17,1
1653301998747,CAT 1,D06,086725,Staff,16,0,17,1
1653301998747,CAT 1,D07,086726,Staff,17,0,17,0
1653301998747,CAT 1,D08,086727,Staff,17,0,17,0
1653301998747,CAT 1,D09,086728,Staff,16,0,17,1
1653301998747,CAT 1,D10,086729,Staff,17,0,17,0
1653301998747,CAT 1,D11,086730,Staff,17,0,17,0
1653301998747,CAT 1,D12,086731,Staff,17,0,17,0
1653301998747,CAT 1,D13,086732,Staff,17,0,17,0
1653301998747,CAT 1,D14,086733,Staff,17,0,17,0
1653301999271,CAT 3,A01,086735,Gumm; Elizabeth Ashley,14,0,15,1
1653301999271,CAT 3,A02,086736,Gumm; Elizabeth Ashley,14,0,15,1
1653301999271,CAT 3,A03,086737,Gumm; Elizabeth Ashley,15,0,15,0
1653301999271,CAT 3,A04,086738,Gumm; Elizabeth Ashley,15,0,15,0
1653301999271,CAT 3,A05,086739,Gumm; Elizabeth Ashley,15,0,15,0
1653301999271,CAT 3,A06,086740,Gumm; Elizabeth Ashley,15,0,15,0
1653301999795,CAT 124,A01,086742,Staff,15,0,15,0
1653302000327,CAT 125R,A01,094882,Staff,14,0,16,2
1653302000327,CAT 125R,A02,086745,Staff,16,0,16,0
1653302000327,CAT 125R,A03,086746,Staff,14,0,16,2
1653302000327,CAT 125R,A04,086747,Staff,13,0,16,3
1653302000327,CAT 125R,A05,086748,Staff,15,0,16,1
1653302000327,CAT 125R,A06,086749,Staff,12,0,16,4
1653302000327,CAT 125R,A07,086750,Staff,14,0,16,2
1653302000327,CAT 125R,A08,094883,Staff,14,0,16,2
1653302000327,CAT 125R,A09,094884,Staff,16,0,16,0
1653302000327,CAT 125R,A10,094885,Staff,15,0,16,1
1653302000327,CAT 125R,A14,086761,Staff,15,0,16,1
1653302000327,CAT 125R,A15,086762,Staff,16,0,16,0
1653302000327,CAT 125R,A16,086763,Staff,13,0,16,3
1653302000327,CAT 125R,A17,086764,Staff,14,0,16,2
1653302000327,CAT 125R,A18,086765,Staff,14,0,16,2
1653302000327,CAT 125R,A19,086766,Staff,14,0,16,2
1653302000853,CCS 101,A00,088353,Staff,29,0,35,6
1653302001376,CENG 4,A01,086204,Bae; Jinhye,30,0,30,0
1653302001376,CENG 4,A02,086205,Bae; Jinhye,30,0,30,0
1653302001376,CENG 4,B01,086207,Drews; Aaron,30,0,30,0
1653302001376,CENG 4,B02,086208,Drews; Aaron,30,0,30,0
1653302001901,CENG 15,A01,086210,Lubarda; Vlado,63,0,65,2
1653302001901,CENG 15,B01,086212,Lubarda; Vlado,65,0,65,0
1653302002430,CENG 100,A00,086213,Chen; Zheng,147,0,150,3
1653302002954,CENG 101A,A00,086214,Bae; Jinhye,142,0,150,8
1653302003477,CENG 120,A00,086215,Opatkiewicz; Justin Paul,125,0,150,25
1653302004007,CENG 122,A00,086216,Opatkiewicz; Justin Paul,137,0,150,13
1653302004532,CGS 2A,A01,086271,Shelby; Karen Lee,12,0,15,3
1653302004532,CGS 2A,A02,086272,Shelby; Karen Lee,13,0,15,2
1653302004532,CGS 2A,A03,086273,Shelby; Karen Lee,14,0,15,1
1653302004532,CGS 2A,A04,086274,Shelby; Karen Lee,15,0,15,0
1653302005056,CGS 100A,A00,086275,Perez; Roy,26,0,32,6
1653302005581,CGS 101,A00,086276,Shelby; Karen Lee,30,0,30,0
1653302006105,CGS 106,A00,086277,Shelby; Karen Lee,24,0,30,6
1653302006632,CGS 119,A00,086279,Nguyen; Hoang Tan,27,0,30,3
1653302007158,CGS 121,A00,086280,Martin Sandino; Amanda Maria Yoland,19,0,20,1
1653302007682,CGS 122,A00,086281,Whitley; Leila Marie,20,0,20,0
1653302008208,CGS 123,A00,086282,Staff,0,0,0,0
1653302008735,CGS 127,A00,086283,Whitley; Leila Marie,15,0,15,0
1653302009261,CGS 130,A00,086284,Martin Sandino; Amanda Maria Yoland,15,0,15,0
1653302009784,CGS 187,A00,086285,Perez; Roy,15,0,16,1
1653302010307,CGS 190,A00,086286,Staff,5,0,5,0
1653302010831,CHEM 4,A01,089669,Bussey; Thomas J,40,0,40,0
1653302010831,CHEM 4,A02,089670,Bussey; Thomas J,42,0,42,0
1653302010831,CHEM 4,A03,089671,Bussey; Thomas J,40,0,42,2
1653302010831,CHEM 4,A04,089672,Bussey; Thomas J,42,0,42,0
1653302010831,CHEM 4,A05,089673,Bussey; Thomas J,40,0,42,2
1653302010831,CHEM 4,A06,089674,Bussey; Thomas J,40,0,42,2
1653302010831,CHEM 4,A07,089675,Bussey; Thomas J,42,0,42,0
1653302010831,CHEM 4,A08,089676,Bussey; Thomas J,42,0,42,0
1653302010831,CHEM 4,A09,089677,Bussey; Thomas J,41,0,41,0
1653302010831,CHEM 4,A10,089678,Bussey; Thomas J,40,0,40,0
1653302011365,CHEM 6A,A01,092734,Pomeroy; Robert S.,4,0,4,0
1653302011365,CHEM 6A,A02,092735,Pomeroy; Robert S.,4,0,4,0
1653302011365,CHEM 6A,A03,092736,Pomeroy; Robert S.,4,0,4,0
1653302011365,CHEM 6A,A04,092737,Pomeroy; Robert S.,4,0,4,0
1653302011365,CHEM 6A,A05,092738,Pomeroy; Robert S.,4,0,4,0
1653302011365,CHEM 6A,A06,092739,Pomeroy; Robert S.,4,0,4,0
1653302011365,CHEM 6A,A07,092740,Pomeroy; Robert S.,4,0,4,0
1653302011365,CHEM 6A,A08,092741,Pomeroy; Robert S.,4,0,4,0
1653302011365,CHEM 6A,A09,092742,Pomeroy; Robert S.,0,0,0,0
1653302011365,CHEM 6A,B01,092744,Schurmeier; Kimberly,4,0,4,0
1653302011365,CHEM 6A,B02,092746,Schurmeier; Kimberly,4,0,4,0
1653302011365,CHEM 6A,B03,092749,Schurmeier; Kimberly,4,0,4,0
1653302011365,CHEM 6A,B04,092751,Schurmeier; Kimberly,4,0,4,0
1653302011365,CHEM 6A,B05,092753,Schurmeier; Kimberly,4,0,4,0
1653302011365,CHEM 6A,B06,092755,Schurmeier; Kimberly,3,0,4,1
1653302011365,CHEM 6A,B07,092756,Schurmeier; Kimberly,4,0,4,0
1653302011365,CHEM 6A,B08,092757,Schurmeier; Kimberly,4,0,4,0
1653302011365,CHEM 6A,B09,092758,Schurmeier; Kimberly,0,0,0,0
1653302011365,CHEM 6A,C01,092805,Schurmeier; Kimberly,4,0,4,0
1653302011365,CHEM 6A,C02,092806,Schurmeier; Kimberly,4,0,4,0
1653302011365,CHEM 6A,C03,092807,Schurmeier; Kimberly,4,0,4,0
1653302011365,CHEM 6A,C04,092808,Schurmeier; Kimberly,4,0,4,0
1653302011365,CHEM 6A,C05,092809,Schurmeier; Kimberly,4,0,4,0
1653302011365,CHEM 6A,C06,092810,Schurmeier; Kimberly,4,0,4,0
1653302011365,CHEM 6A,C07,092811,Schurmeier; Kimberly,4,0,4,0
1653302011365,CHEM 6A,C08,092812,Schurmeier; Kimberly,4,0,4,0
1653302011365,CHEM 6A,C09,092813,Schurmeier; Kimberly,0,0,0,0
1653302011365,CHEM 6A,D01,092837,Stallings; Dontarie M,4,0,4,0
1653302011365,CHEM 6A,D02,092838,Stallings; Dontarie M,4,0,4,0
1653302011365,CHEM 6A,D03,092839,Stallings; Dontarie M,4,0,4,0
1653302011365,CHEM 6A,D04,092840,Stallings; Dontarie M,4,0,4,0
1653302011365,CHEM 6A,D05,092841,Stallings; Dontarie M,4,0,4,0
1653302011365,CHEM 6A,D06,092842,Stallings; Dontarie M,4,0,4,0
1653302011365,CHEM 6A,D07,092843,Stallings; Dontarie M,4,0,4,0
1653302011365,CHEM 6A,D08,092844,Stallings; Dontarie M,4,0,4,0
1653302011365,CHEM 6A,D09,092845,Stallings; Dontarie M,0,0,0,0
1653302011365,CHEM 6A,E01,092796,Brydges; Stacey,4,0,4,0
1653302011365,CHEM 6A,E02,092797,Brydges; Stacey,3,0,4,1
1653302011365,CHEM 6A,E03,092798,Brydges; Stacey,4,0,4,0
1653302011365,CHEM 6A,E04,092799,Brydges; Stacey,3,0,4,1
1653302011365,CHEM 6A,E05,092800,Brydges; Stacey,4,0,4,0
1653302011365,CHEM 6A,E06,092801,Brydges; Stacey,4,0,4,0
1653302011365,CHEM 6A,E07,092802,Brydges; Stacey,4,0,4,0
1653302011365,CHEM 6A,E08,092803,Brydges; Stacey,4,0,4,0
1653302011365,CHEM 6A,E09,092804,Brydges; Stacey,0,0,0,0
1653302011365,CHEM 6A,F01,092759,Brydges; Stacey,4,0,4,0
1653302011365,CHEM 6A,F02,092760,Brydges; Stacey,4,0,4,0
1653302011365,CHEM 6A,F03,092761,Brydges; Stacey,3,0,4,1
1653302011365,CHEM 6A,F04,092762,Brydges; Stacey,4,0,4,0
1653302011365,CHEM 6A,F05,092763,Brydges; Stacey,4,0,4,0
1653302011365,CHEM 6A,F06,092764,Brydges; Stacey,4,0,4,0
1653302011365,CHEM 6A,F07,092765,Brydges; Stacey,4,0,4,0
1653302011365,CHEM 6A,F08,092766,Brydges; Stacey,4,0,4,0
1653302011365,CHEM 6A,F09,092767,Brydges; Stacey,0,0,0,0
1653302011365,CHEM 6A,G01,092774,Zid; Brian M,0,0,4,4
1653302011365,CHEM 6A,G02,092775,Zid; Brian M,2,0,4,2
1653302011365,CHEM 6A,G03,092776,Zid; Brian M,2,0,4,2
1653302011365,CHEM 6A,G04,092777,Zid; Brian M,2,0,4,2
1653302011365,CHEM 6A,G05,092778,Zid; Brian M,4,0,4,0
1653302011365,CHEM 6A,G06,092779,Zid; Brian M,4,0,4,0
1653302011365,CHEM 6A,G07,092780,Zid; Brian M,3,0,4,1
1653302011365,CHEM 6A,G08,092781,Zid; Brian M,3,0,4,1
1653302011365,CHEM 6A,G09,092782,Zid; Brian M,0,0,0,0
1653302011365,CHEM 6A,H01,092846,Stallings; Dontarie M,4,0,4,0
1653302011365,CHEM 6A,H02,092847,Stallings; Dontarie M,3,0,4,1
1653302011365,CHEM 6A,H03,092848,Stallings; Dontarie M,4,0,4,0
1653302011365,CHEM 6A,H04,092849,Stallings; Dontarie M,4,0,4,0
1653302011365,CHEM 6A,H05,092850,Stallings; Dontarie M,4,0,4,0
1653302011365,CHEM 6A,H06,092851,Stallings; Dontarie M,3,0,4,1
1653302011365,CHEM 6A,H07,092852,Stallings; Dontarie M,4,0,4,0
1653302011365,CHEM 6A,H08,092853,Stallings; Dontarie M,3,0,4,1
1653302011365,CHEM 6A,H09,092854,Stallings; Dontarie M,0,0,0,0
1653302011365,CHEM 6A,I01,092814,Staff,0,0,0,0
1653302011365,CHEM 6A,I02,092815,Staff,0,0,0,0
1653302011365,CHEM 6A,I04,092816,Staff,0,0,0,0
1653302011365,CHEM 6A,I05,092817,Staff,0,0,0,0
1653302011365,CHEM 6A,I06,092818,Staff,0,0,0,0
1653302011365,CHEM 6A,I07,092819,Staff,0,0,0,0
1653302011365,CHEM 6A,I08,092820,Staff,0,0,0,0
1653302011365,CHEM 6A,I09,092821,Staff,0,0,0,0
1653302011890,CHEM 6AH,A01,092793,Paesani; Francesco,15,0,16,1
1653302011890,CHEM 6AH,A02,092794,Paesani; Francesco,16,0,16,0
1653302011890,CHEM 6AH,A03,092795,Paesani; Francesco,16,0,16,0
1653302012419,CHEM 6B,A01,092691,Hopkins; Patrycja Anna,21,0,25,4
1653302012419,CHEM 6B,A02,092692,Hopkins; Patrycja Anna,23,0,25,2
1653302012419,CHEM 6B,A03,092693,Hopkins; Patrycja Anna,25,0,25,0
1653302012419,CHEM 6B,A04,092694,Hopkins; Patrycja Anna,0,0,0,0
1653302012419,CHEM 6B,A05,092695,Hopkins; Patrycja Anna,24,0,25,1
1653302012419,CHEM 6B,A06,092696,Hopkins; Patrycja Anna,22,0,25,3
1653302012419,CHEM 6B,A07,092697,Hopkins; Patrycja Anna,24,0,25,1
1653302012948,CHEM 6C,A01,092708,Albizati; Kim F.,31,0,38,7
1653302012948,CHEM 6C,A02,092709,Albizati; Kim F.,32,0,38,6
1653302012948,CHEM 6C,A03,092710,Albizati; Kim F.,37,0,38,1
1653302012948,CHEM 6C,A04,092711,Albizati; Kim F.,36,0,38,2
1653302012948,CHEM 6C,A05,092712,Albizati; Kim F.,0,0,0,0
1653302012948,CHEM 6C,A06,092714,Albizati; Kim F.,33,0,38,5
1653302012948,CHEM 6C,A07,092715,Albizati; Kim F.,32,0,38,6
1653302012948,CHEM 6C,A08,092716,Albizati; Kim F.,37,0,38,1
1653302012948,CHEM 6C,A09,092717,Albizati; Kim F.,38,0,38,0
1653302013485,CHEM 7L,A01,089692,Leigh; Brian,11,0,19,8
1653302013485,CHEM 7L,A02,089693,Leigh; Brian,23,0,24,1
1653302013485,CHEM 7L,A03,089694,Leigh; Brian,24,0,24,0
1653302013485,CHEM 7L,A04,089695,Leigh; Brian,24,0,24,0
1653302013485,CHEM 7L,A05,089696,Leigh; Brian,23,0,24,1
1653302013485,CHEM 7L,A06,089697,Leigh; Brian,22,0,24,2
1653302013485,CHEM 7L,A07,089698,Leigh; Brian,21,0,21,0
1653302013485,CHEM 7L,A08,089699,Leigh; Brian,17,0,24,7
1653302013485,CHEM 7L,A09,089700,Leigh; Brian,23,0,24,1
1653302013485,CHEM 7L,A10,089701,Leigh; Brian,0,0,0,0
1653302013485,CHEM 7L,B01,089703,Leigh; Brian,18,0,24,6
1653302013485,CHEM 7L,B02,089704,Leigh; Brian,18,0,24,6
1653302013485,CHEM 7L,B03,089705,Leigh; Brian,23,0,24,1
1653302013485,CHEM 7L,B04,089706,Leigh; Brian,20,0,21,1
1653302013485,CHEM 7L,B05,089707,Leigh; Brian,17,0,24,7
1653302013485,CHEM 7L,B06,089708,Leigh; Brian,17,0,24,7
1653302013485,CHEM 7L,B07,089709,Leigh; Brian,17,0,24,7
1653302013485,CHEM 7L,B08,089710,Leigh; Brian,21,0,24,3
1653302013485,CHEM 7L,B09,089711,Leigh; Brian,21,0,24,3
1653302013485,CHEM 7L,B10,089712,Leigh; Brian,0,0,0,0
1653302013485,CHEM 7L,C01,089714,Staff,23,0,24,1
1653302013485,CHEM 7L,C02,089715,Staff,22,0,24,2
1653302013485,CHEM 7L,C03,089716,Staff,23,0,24,1
1653302013485,CHEM 7L,C04,089717,Staff,24,0,24,0
1653302013485,CHEM 7L,C05,089718,Staff,21,0,24,3
1653302013485,CHEM 7L,C06,089719,Staff,22,0,24,2
1653302013485,CHEM 7L,C07,089720,Staff,23,0,24,1
1653302013485,CHEM 7L,C08,089721,Staff,24,0,24,0
1653302013485,CHEM 7L,C09,089722,Staff,24,0,24,0
1653302013485,CHEM 7L,C10,089723,Staff,0,0,0,0
1653302014011,CHEM 40A,A01,092871,Schmidt; Valerie A,31,0,31,0
1653302014011,CHEM 40A,A02,092872,Schmidt; Valerie A,31,0,31,0
1653302014011,CHEM 40A,A03,092873,Schmidt; Valerie A,31,0,31,0
1653302014011,CHEM 40A,A04,092874,Schmidt; Valerie A,0,0,0,0
1653302014011,CHEM 40A,A05,092875,Schmidt; Valerie A,31,0,31,0
1653302014011,CHEM 40A,A06,092876,Schmidt; Valerie A,29,0,31,2
1653302014011,CHEM 40A,A07,092877,Schmidt; Valerie A,31,0,31,0
1653302014011,CHEM 40A,A08,092878,Schmidt; Valerie A,28,0,28,0
1653302014011,CHEM 40A,B01,089726,Lam; Tin Yiu,31,0,31,0
1653302014011,CHEM 40A,B02,089727,Lam; Tin Yiu,31,0,31,0
1653302014011,CHEM 40A,B03,089728,Lam; Tin Yiu,31,0,31,0
1653302014011,CHEM 40A,B04,089729,Lam; Tin Yiu,30,0,31,1
1653302014011,CHEM 40A,B05,089730,Lam; Tin Yiu,31,0,31,0
1653302014011,CHEM 40A,B06,089731,Lam; Tin Yiu,30,0,31,1
1653302014011,CHEM 40A,B07,089732,Lam; Tin Yiu,29,0,31,2
1653302014011,CHEM 40A,B08,089733,Lam; Tin Yiu,0,0,0,0
1653302014011,CHEM 40A,C01,092718,Albizati; Kim F.,17,0,31,14
1653302014011,CHEM 40A,C02,092719,Albizati; Kim F.,24,0,31,7
1653302014011,CHEM 40A,C03,092720,Albizati; Kim F.,12,0,31,19
1653302014011,CHEM 40A,C04,092721,Albizati; Kim F.,24,0,31,7
1653302014011,CHEM 40A,C05,092722,Albizati; Kim F.,21,0,31,10
1653302014011,CHEM 40A,C06,092723,Albizati; Kim F.,24,0,31,7
1653302014011,CHEM 40A,C07,092724,Albizati; Kim F.,30,0,31,1
1653302014011,CHEM 40A,C08,092725,Albizati; Kim F.,0,0,0,0
1653302014011,CHEM 40A,D01,092863,Yang; Jerry,28,0,31,3
1653302014011,CHEM 40A,D02,092864,Yang; Jerry,28,0,31,3
1653302014011,CHEM 40A,D03,092865,Yang; Jerry,31,0,31,0
1653302014011,CHEM 40A,D04,092866,Yang; Jerry,31,0,31,0
1653302014011,CHEM 40A,D05,092867,Yang; Jerry,0,0,0,0
1653302014011,CHEM 40A,D06,092868,Yang; Jerry,31,0,31,0
1653302014011,CHEM 40A,D07,092869,Yang; Jerry,31,0,31,0
1653302014011,CHEM 40A,D08,092870,Yang; Jerry,31,0,31,0
1653302014539,CHEM 40B,A01,092698,Oconnor; Joseph M.,24,0,34,10
1653302014539,CHEM 40B,A02,092699,Oconnor; Joseph M.,34,0,34,0
1653302014539,CHEM 40B,A03,092700,Oconnor; Joseph M.,0,0,0,0
1653302014539,CHEM 40B,A04,092701,Oconnor; Joseph M.,30,0,34,4
1653302014539,CHEM 40B,A05,092702,Oconnor; Joseph M.,33,0,34,1
1653302014539,CHEM 40B,A06,092703,Oconnor; Joseph M.,34,0,34,0
1653302014539,CHEM 40B,A07,092704,Oconnor; Joseph M.,32,0,34,2
1653302014539,CHEM 40B,A08,092705,Oconnor; Joseph M.,33,0,34,1
1653302014539,CHEM 40B,A09,092706,Oconnor; Joseph M.,34,0,34,0
1653302015065,CHEM 40C,A01,089739,Lam; Tin Yiu,0,0,0,0
1653302015065,CHEM 40C,A02,089740,Lam; Tin Yiu,0,0,0,0
1653302015065,CHEM 40C,A03,089741,Lam; Tin Yiu,0,0,0,0
1653302015065,CHEM 40C,A04,089742,Lam; Tin Yiu,13,0,34,21
1653302015065,CHEM 40C,A05,089743,Lam; Tin Yiu,32,0,34,2
1653302015065,CHEM 40C,A06,089744,Lam; Tin Yiu,31,0,34,3
1653302015596,CHEM 41A,A01,093840,Ternansky; Robert J.,29,0,33,4
1653302015596,CHEM 41A,A02,093841,Ternansky; Robert J.,32,0,33,1
1653302015596,CHEM 41A,A03,093842,Ternansky; Robert J.,33,0,33,0
1653302015596,CHEM 41A,A04,093843,Ternansky; Robert J.,30,0,33,3
1653302015596,CHEM 41A,A05,093844,Ternansky; Robert J.,31,0,33,2
1653302015596,CHEM 41A,A06,093845,Ternansky; Robert J.,27,0,27,0
1653302015596,CHEM 41A,A07,093846,Ternansky; Robert J.,32,0,33,1
1653302015596,CHEM 41A,A08,093847,Ternansky; Robert J.,33,0,33,0
1653302016129,CHEM 43A,A01,089746,Klosterman; Jeremy K,11,0,24,13
1653302016129,CHEM 43A,A02,089747,Klosterman; Jeremy K,16,0,24,8
1653302016129,CHEM 43A,A03,089748,Klosterman; Jeremy K,21,0,24,3
1653302016129,CHEM 43A,A04,089749,Klosterman; Jeremy K,22,0,24,2
1653302016129,CHEM 43A,A05,089750,Klosterman; Jeremy K,23,0,24,1
1653302016129,CHEM 43A,A06,089751,Klosterman; Jeremy K,8,0,24,16
1653302016129,CHEM 43A,A07,089752,Klosterman; Jeremy K,17,0,24,7
1653302016129,CHEM 43A,A08,089753,Klosterman; Jeremy K,16,0,24,8
1653302016129,CHEM 43A,A09,089754,Klosterman; Jeremy K,21,0,24,3
1653302016129,CHEM 43A,A10,089755,Klosterman; Jeremy K,21,0,24,3
1653302016129,CHEM 43A,A11,089756,Klosterman; Jeremy K,0,0,0,0
1653302016129,CHEM 43A,A12,089757,Klosterman; Jeremy K,0,0,0,0
1653302016129,CHEM 43A,A13,089758,Klosterman; Jeremy K,0,0,0,0
1653302016129,CHEM 43A,B01,089760,Klosterman; Jeremy K,0,0,0,0
1653302016129,CHEM 43A,B02,089761,Klosterman; Jeremy K,0,0,0,0
1653302016129,CHEM 43A,B03,089762,Klosterman; Jeremy K,16,0,24,8
1653302016129,CHEM 43A,B04,089763,Klosterman; Jeremy K,22,0,24,2
1653302016129,CHEM 43A,B05,089764,Klosterman; Jeremy K,23,0,24,1
1653302016129,CHEM 43A,B06,089765,Klosterman; Jeremy K,23,0,24,1
1653302016129,CHEM 43A,B07,089766,Klosterman; Jeremy K,17,0,24,7
1653302016129,CHEM 43A,B08,089767,Klosterman; Jeremy K,23,0,24,1
1653302016129,CHEM 43A,B09,089768,Klosterman; Jeremy K,24,0,24,0
1653302016129,CHEM 43A,B10,089769,Klosterman; Jeremy K,23,0,24,1
1653302016129,CHEM 43A,B11,089770,Klosterman; Jeremy K,22,0,24,2
1653302016129,CHEM 43A,B12,089771,Klosterman; Jeremy K,21,0,24,3
1653302016651,CHEM 87,A00,089772,Bussey; Thomas J,20,0,20,0
1653302017176,CHEM 96,A00,089773,Bussey; Thomas J,20,0,25,5
1653302017710,CHEM 100A,A01,089775,Pomeroy; Robert S.,22,0,24,2
1653302017710,CHEM 100A,A02,089776,Pomeroy; Robert S.,19,0,24,5
1653302017710,CHEM 100A,A03,089777,Pomeroy; Robert S.,13,0,24,11
1653302017710,CHEM 100A,A04,089778,Pomeroy; Robert S.,18,0,24,6
1653302017710,CHEM 100A,A05,089779,Pomeroy; Robert S.,19,0,24,5
1653302017710,CHEM 100A,A06,089780,Pomeroy; Robert S.,24,0,24,0
1653302017710,CHEM 100A,A07,089781,Pomeroy; Robert S.,0,0,0,0
1653302018234,CHEM 105A,A01,089783,Young; Mark,0,0,39,39
1653302018234,CHEM 105A,B01,089785,Young; Mark,26,0,39,13
1653302018759,CHEM 108,A01,089787,Ghosh; Gourisankar,1,0,22,21
1653302018759,CHEM 108,A02,089788,Ghosh; Gourisankar,6,0,22,16
1653302018759,CHEM 108,B01,089790,Ghosh; Gourisankar,13,0,22,9
1653302018759,CHEM 108,B02,089791,Ghosh; Gourisankar,20,0,22,2
1653302019281,CHEM 109,A01,089793,Hamaoka; Brent Y,4,0,22,18
1653302019281,CHEM 109,A02,089794,Hamaoka; Brent Y,10,0,22,12
1653302019281,CHEM 109,B01,089796,Hamaoka; Brent Y,6,0,22,16
1653302019281,CHEM 109,B02,089797,Hamaoka; Brent Y,18,0,22,4
1653302019806,CHEM 114A,A01,092855,Toor; Navtej,21,0,25,4
1653302019806,CHEM 114A,A02,092856,Toor; Navtej,25,0,25,0
1653302019806,CHEM 114A,A03,092857,Toor; Navtej,19,0,25,6
1653302019806,CHEM 114A,A04,092858,Toor; Navtej,24,0,25,1
1653302019806,CHEM 114A,A05,092859,Toor; Navtej,0,0,0,0
1653302019806,CHEM 114A,A06,092860,Toor; Navtej,14,0,25,11
1653302019806,CHEM 114A,A07,092861,Toor; Navtej,24,0,25,1
1653302019806,CHEM 114A,A08,092862,Toor; Navtej,24,0,25,1
1653302020329,CHEM 116,A01,092707,Ferguson; Fleur,6,0,35,29
1653302020329,CHEM 116,A02,094887,Ferguson; Fleur,31,0,35,4
1653302020856,CHEM 120A,A01,092785,Schimpf; Alina M,16,0,28,12
1653302020856,CHEM 120A,A02,092786,Schimpf; Alina M,26,0,28,2
1653302020856,CHEM 120A,A03,092787,Schimpf; Alina M,20,0,28,8
1653302020856,CHEM 120A,A04,092788,Schimpf; Alina M,27,0,28,1
1653302020856,CHEM 120A,A05,092789,Schimpf; Alina M,27,0,28,1
1653302020856,CHEM 120A,A06,092790,Schimpf; Alina M,0,0,0,0
1653302020856,CHEM 120A,A07,092791,Schimpf; Alina M,15,0,28,13
1653302020856,CHEM 120A,A08,092792,Schimpf; Alina M,0,0,0,0
1653302021381,CHEM 126A,A01,092768,Schoeneberg; Johannes,16,0,35,19
1653302021381,CHEM 126A,A02,092769,Schoeneberg; Johannes,35,0,35,0
1653302021381,CHEM 126A,A03,092770,Schoeneberg; Johannes,29,0,35,6
1653302021381,CHEM 126A,A04,092771,Schoeneberg; Johannes,0,0,0,0
1653302021381,CHEM 126A,A05,092772,Schoeneberg; Johannes,30,0,35,5
1653302021381,CHEM 126A,A06,092773,Schoeneberg; Johannes,33,0,35,2
1653302021904,CHEM 130,A01,092685,Sinha; Amitabha,28,0,38,10
1653302021904,CHEM 130,A02,092686,Sinha; Amitabha,31,0,38,7
1653302021904,CHEM 130,A03,092687,Sinha; Amitabha,34,0,38,4
1653302022430,CHEM 142,A00,089803,Esko; Jeffrey D. & Godula; Kamil,9,0,46,37
1653302022954,CHEM 143C,A01,089805,Ternansky; Robert J.,17,0,22,5
1653302022954,CHEM 143C,A02,089806,Ternansky; Robert J.,18,0,22,4
1653302022954,CHEM 143C,A03,089807,Ternansky; Robert J.,19,0,22,3
1653302022954,CHEM 143C,A04,089808,Ternansky; Robert J.,20,0,22,2
1653302023478,CHEM 152,A00,089809,Romero; Nathan A & Schmidt; Valerie A,35,0,40,5
1653302024007,CHEM 171,A01,092688,Slade; Jonathan,35,0,45,10
1653302024007,CHEM 171,A02,092689,Slade; Jonathan,44,0,45,1
1653302024007,CHEM 171,A03,092690,Slade; Jonathan,45,0,45,0
1653302024534,CHEM 186,A00,089811,Paesani; Francesco,9,0,15,6
1653302025057,CHIN 10AD,A01,086223,Staff,13,0,13,0
1653302025057,CHIN 10AD,A02,086224,Staff,12,0,13,1
1653302025057,CHIN 10AD,B01,086227,Staff,14,0,15,1
1653302025581,CHIN 10AM,A01,086230,Chen; Pei-Chia,16,0,16,0
1653302025581,CHIN 10AM,A02,086231,Chen; Pei-Chia,16,0,16,0
1653302026106,CHIN 10AN,A01,086234,Xu; Li,14,0,14,0
1653302026106,CHIN 10AN,A02,086235,Xu; Li,14,0,14,0
1653302026106,CHIN 10AN,B01,086240,Xu; Li,14,0,14,0
1653302026106,CHIN 10AN,B02,086242,Xu; Li,0,0,0,0
1653302026106,CHIN 10AN,C01,086245,Xu; Li,14,0,14,0
1653302026106,CHIN 10AN,C02,086246,Xu; Li,14,0,14,0
1653302026630,CHIN 20AD,A01,086248,Wang; Xiao,14,0,14,0
1653302026630,CHIN 20AD,A02,086249,Wang; Xiao,14,0,14,0
1653302026630,CHIN 20AD,B01,086251,Wang; Xiao,13,0,14,1
1653302026630,CHIN 20AD,B02,086252,Wang; Xiao,14,0,14,0
1653302027155,CHIN 20AM,A01,086254,Wang; Xiao,11,0,14,3
1653302027155,CHIN 20AM,A02,086255,Wang; Xiao,13,0,14,1
1653302027155,CHIN 20AM,B01,086257,Staff,15,0,15,0
1653302027680,CHIN 20AN,A01,086259,Anderson; Qin-Hong,11,0,12,1
1653302027680,CHIN 20AN,A02,086260,Anderson; Qin-Hong,12,0,12,0
1653302027680,CHIN 20AN,A03,086261,Anderson; Qin-Hong,0,0,0,0
1653302027680,CHIN 20AN,B01,086263,Anderson; Qin-Hong,12,0,13,1
1653302027680,CHIN 20AN,B02,086264,Anderson; Qin-Hong,13,0,13,0
1653302028206,CHIN 100AM,A00,086265,Anderson; Qin-Hong,20,0,20,0
1653302028731,CHIN 100AN,A00,086266,Chen; Pei-Chia,17,0,20,3
1653302029258,CHIN 185A,A00,086268,Staff,20,0,20,0
1653302029783,COGS 1,A01,087834,Barrera; Steven James,57,0,60,3
1653302029783,COGS 1,A02,087835,Barrera; Steven James,52,0,60,8
1653302029783,COGS 1,A03,087836,Barrera; Steven James,57,0,60,3
1653302029783,COGS 1,A04,087837,Barrera; Steven James,59,0,60,1
1653302029783,COGS 1,A05,087838,Barrera; Steven James,60,0,60,0
1653302029783,COGS 1,A06,087839,Barrera; Steven James,59,0,60,1
1653302029783,COGS 1,A07,087840,Barrera; Steven James,54,0,57,3
1653302030307,COGS 2,A01,087842,Boyle; Mary E. T.,64,0,64,0
1653302030307,COGS 2,A02,087843,Boyle; Mary E. T.,61,0,64,3
1653302030307,COGS 2,A03,087844,Boyle; Mary E. T.,64,0,64,0
1653302030829,COGS 3,A01,094312,Boyle; Mary E. T.,30,0,35,5
1653302030829,COGS 3,A02,094313,Boyle; Mary E. T.,33,0,35,2
1653302030829,COGS 3,A03,094314,Boyle; Mary E. T.,35,0,35,0
1653302030829,COGS 3,A04,094315,Boyle; Mary E. T.,35,0,35,0
1653302030829,COGS 3,A05,094316,Boyle; Mary E. T.,35,0,35,0
1653302031353,COGS 8,A01,087846,Staff,35,0,35,0
1653302031877,COGS 10,A01,094357,Hollan; James D.,53,0,60,7
1653302031877,COGS 10,A02,094358,Hollan; James D.,58,0,60,2
1653302031877,COGS 10,A03,094359,Hollan; James D.,59,0,60,1
1653302031877,COGS 10,A04,094360,Hollan; James D.,60,0,60,0
1653302031877,COGS 10,A05,094361,Hollan; James D.,60,0,60,0
1653302032410,COGS 11,A01,087848,Boyle; Mary E. T.,46,0,47,1
1653302032410,COGS 11,A02,087849,Boyle; Mary E. T.,44,0,47,3
1653302032410,COGS 11,A03,087850,Boyle; Mary E. T.,46,0,46,0
1653302032938,COGS 13,A01,087852,Davis; Joshua Daniel,56,0,60,4
1653302032938,COGS 13,A02,087853,Davis; Joshua Daniel,55,0,60,5
1653302032938,COGS 13,A03,087854,Davis; Joshua Daniel,57,0,60,3
1653302032938,COGS 13,A04,087855,Davis; Joshua Daniel,58,0,60,2
1653302033462,COGS 14A,A01,087857,Creel; Sarah,58,0,65,7
1653302033462,COGS 14A,A02,087858,Creel; Sarah,62,0,65,3
1653302033462,COGS 14A,A03,087859,Creel; Sarah,63,0,65,2
1653302033462,COGS 14A,A04,087860,Creel; Sarah,63,0,65,2
1653302033987,COGS 14B,A01,087862,Hoffman; Drew Ellen,56,0,60,4
1653302033987,COGS 14B,A02,087863,Hoffman; Drew Ellen,53,0,60,7
1653302033987,COGS 14B,A03,087864,Hoffman; Drew Ellen,60,0,60,0
1653302034515,COGS 15,A01,087866,Bergen; Benjamin,60,0,60,0
1653302034515,COGS 15,A02,087867,Bergen; Benjamin,59,0,60,1
1653302035043,COGS 17,A01,087869,Johnson; Christine M.,55,0,60,5
1653302035043,COGS 17,A02,087870,Johnson; Christine M.,58,0,60,2
1653302035043,COGS 17,A03,087871,Johnson; Christine M.,55,0,60,5
1653302035043,COGS 17,A04,087872,Johnson; Christine M.,60,0,60,0
1653302035043,COGS 17,A05,087873,Johnson; Christine M.,59,0,60,1
1653302035043,COGS 17,A06,087874,Johnson; Christine M.,60,0,60,0
1653302035571,COGS 18,A01,087876,Fleischer; Jason G,22,0,35,13
1653302035571,COGS 18,A02,087877,Fleischer; Jason G,31,0,35,4
1653302035571,COGS 18,A03,087878,Fleischer; Jason G,33,0,35,2
1653302035571,COGS 18,A04,087879,Fleischer; Jason G,33,0,35,2
1653302035571,COGS 18,A05,087880,Fleischer; Jason G,28,0,35,7
1653302035571,COGS 18,A06,087881,Fleischer; Jason G,34,0,35,1
1653302035571,COGS 18,A07,087882,Fleischer; Jason G,33,0,35,2
1653302035571,COGS 18,A08,087883,Fleischer; Jason G,31,0,35,4
1653302035571,COGS 18,A09,087884,Fleischer; Jason G,33,0,35,2
1653302036094,COGS 20,A01,090761,Borgo; David Garcia,5,0,5,0
1653302036094,COGS 20,A02,090762,Borgo; David Garcia,5,0,5,0
1653302036094,COGS 20,A03,090763,Borgo; David Garcia,5,0,5,0
1653302036616,COGS 87,A00,087885,Deak; Gedeon O.,20,0,20,0
1653302036616,COGS 87,B00,087886,Fleischer; Jason G,20,0,20,0
1653302037140,COGS 100,A01,087892,Kirsh; David Joel,56,0,60,4
1653302037140,COGS 100,A02,087893,Kirsh; David Joel,54,0,60,6
1653302037140,COGS 100,A03,087894,Kirsh; David Joel,54,0,60,6
1653302037140,COGS 100,A04,087895,Kirsh; David Joel,51,0,60,9
1653302037140,COGS 100,A05,087896,Kirsh; David Joel,48,0,60,12
1653302037668,COGS 101A,A01,087898,Hoffman; Drew Ellen,48,0,60,12
1653302037668,COGS 101A,A02,087899,Hoffman; Drew Ellen,58,0,60,2
1653302037668,COGS 101A,A03,087900,Hoffman; Drew Ellen,55,0,60,5
1653302037668,COGS 101A,A04,087901,Hoffman; Drew Ellen,58,0,60,2
1653302037668,COGS 101A,A05,087902,Hoffman; Drew Ellen,59,0,60,1
1653302037668,COGS 101A,A06,087903,Hoffman; Drew Ellen,56,0,60,4
1653302038191,COGS 101B,A01,087905,Barrera; Steven James,30,0,60,30
1653302038191,COGS 101B,A02,087906,Barrera; Steven James,52,0,60,8
1653302038191,COGS 101B,A03,087907,Barrera; Steven James,54,0,60,6
1653302038719,COGS 101C,A01,094240,Cooperrider; Kensy A,70,0,75,5
1653302038719,COGS 101C,A02,094241,Cooperrider; Kensy A,73,0,75,2
1653302039247,COGS 102A,A01,087909,Scott; Taylor Jackson,58,0,60,2
1653302039247,COGS 102A,A02,087910,Scott; Taylor Jackson,51,0,60,9
1653302039774,COGS 107A,A01,087912,Rangel; Lara M,51,0,60,9
1653302039774,COGS 107A,A02,087913,Rangel; Lara M,54,0,60,6
1653302039774,COGS 107A,A03,087914,Rangel; Lara M,47,0,60,13
1653302039774,COGS 107A,A04,087915,Rangel; Lara M,53,0,60,7
1653302039774,COGS 107A,A05,087916,Rangel; Lara M,55,0,60,5
1653302039774,COGS 107A,A06,087917,Rangel; Lara M,50,0,60,10
1653302040296,COGS 108,A01,087919,Fleischer; Jason G,14,0,60,46
1653302040296,COGS 108,A02,087920,Fleischer; Jason G,25,0,60,35
1653302040296,COGS 108,A03,087921,Fleischer; Jason G,40,0,60,20
1653302040296,COGS 108,A04,087922,Fleischer; Jason G,40,0,60,20
1653302040296,COGS 108,A05,087923,Fleischer; Jason G,48,0,60,12
1653302040296,COGS 108,A06,087924,Fleischer; Jason G,55,0,60,5
1653302040296,COGS 108,A07,087925,Fleischer; Jason G,42,0,57,15
1653302040820,COGS 110,A01,087927,Deak; Gedeon O.,30,0,35,5
1653302040820,COGS 110,A02,087928,Deak; Gedeon O.,33,0,35,2
1653302041348,COGS 116,A01,094228,Greene; Deanna Jacquelyn,51,0,52,1
1653302041348,COGS 116,A02,094229,Greene; Deanna Jacquelyn,52,0,52,0
1653302041348,COGS 116,A03,094230,Greene; Deanna Jacquelyn,50,0,52,2
1653302041872,COGS 118B,A01,087930,De Sa; Virginia,24,0,35,11
1653302041872,COGS 118B,A02,087931,De Sa; Virginia,28,0,35,7
1653302041872,COGS 118B,A03,087932,De Sa; Virginia,18,0,35,17
1653302041872,COGS 118B,A04,087933,De Sa; Virginia,29,0,35,6
1653302041872,COGS 118B,A05,087934,De Sa; Virginia,27,0,35,8
1653302041872,COGS 118B,A06,087935,De Sa; Virginia,27,0,35,8
1653302042395,COGS 120,A01,087937,Xia; Haijun,38,0,50,12
1653302042395,COGS 120,A02,087938,Xia; Haijun,32,0,50,18
1653302042395,COGS 120,A03,087939,Xia; Haijun,26,0,50,24
1653302042395,COGS 120,A04,087940,Xia; Haijun,1,0,50,49
1653302042919,COGS 128,A01,087944,Scott; Taylor Jackson,11,0,56,45
1653302043443,COGS 143,A01,087947,Johnson; Christine M.,23,0,40,17
1653302043970,COGS 153,A00,087949,Davis; Joshua Daniel,46,0,75,29
1653302044497,COGS 160,A00,087950,Deak; Gedeon O.,20,0,20,0
1653302044497,COGS 160,B00,094232,Saygin; Ayse P,40,0,40,0
1653302045024,COGS 175,A01,094238,Staff,27,0,40,13
1653302045635,COGS 187A,A01,087958,Kirsh; David Joel,22,0,50,28
1653302045635,COGS 187A,A02,087959,Kirsh; David Joel,30,0,50,20
1653302045635,COGS 187A,A03,087960,Kirsh; David Joel,34,0,45,11
1653302046163,COGS 190A,A00,087961,Staff,9999,0,9999,0
1653302046687,COGS 194,A00,087962,Hill; Seth J,9999,0,9999,0
1653302047220,COMM 10,A02,090628,Schmidt; Thomas Rainer,1,0,5,4
1653302047220,COMM 10,A03,090629,Schmidt; Thomas Rainer,3,0,5,2
1653302047220,COMM 10,A04,090630,Schmidt; Thomas Rainer,4,0,5,1
1653302047220,COMM 10,A05,090631,Schmidt; Thomas Rainer,4,0,5,1
1653302047220,COMM 10,A06,090632,Schmidt; Thomas Rainer,5,0,5,0
1653302047220,COMM 10,A07,090633,Schmidt; Thomas Rainer,5,0,5,0
1653302047220,COMM 10,A08,090634,Schmidt; Thomas Rainer,5,0,5,0
1653302047220,COMM 10,A09,090635,Schmidt; Thomas Rainer,5,0,5,0
1653302047220,COMM 10,A10,090636,Schmidt; Thomas Rainer,2,0,5,3
1653302047220,COMM 10,A11,090637,Schmidt; Thomas Rainer,4,0,5,1
1653302047220,COMM 10,A12,094013,Schmidt; Thomas Rainer,2,0,5,3
1653302047220,COMM 10,A13,094014,Schmidt; Thomas Rainer,5,0,5,0
1653302047220,COMM 10,A14,094015,Schmidt; Thomas Rainer,4,0,5,1
1653302047220,COMM 10,A15,094016,Schmidt; Thomas Rainer,5,0,5,0
1653302047780,COMM 100A,A01,090639,Irani; Lilly C,5,0,5,0
1653302047780,COMM 100A,A02,090640,Irani; Lilly C,4,0,5,1
1653302047780,COMM 100A,A03,090641,Irani; Lilly C,5,0,5,0
1653302047780,COMM 100A,A04,090642,Irani; Lilly C,3,0,5,2
1653302047780,COMM 100A,A05,090643,Irani; Lilly C,3,0,5,2
1653302047780,COMM 100A,A06,090644,Irani; Lilly C,4,0,5,1
1653302047780,COMM 100A,A07,090645,Irani; Lilly C,5,0,5,0
1653302047780,COMM 100A,A08,090646,Irani; Lilly C,5,0,5,0
1653302047780,COMM 100A,A09,090647,Irani; Lilly C,5,0,5,0
1653302047780,COMM 100A,A10,090648,Irani; Lilly C,5,0,5,0
1653302047780,COMM 100A,A11,090649,Irani; Lilly C,3,0,5,2
1653302047780,COMM 100A,A12,090650,Irani; Lilly C,5,0,5,0
1653302048305,COMM 101,A01,090652,Halm; Gavin Patrick,14,0,15,1
1653302048305,COMM 101,A02,090653,Halm; Gavin Patrick,14,0,15,1
1653302048305,COMM 101,A03,090654,Halm; Gavin Patrick,12,0,15,3
1653302048305,COMM 101,A04,090655,Halm; Gavin Patrick,13,0,15,2
1653302048830,COMM 101D,A00,090656,Halm; Gavin Patrick,14,0,15,1
1653302049354,COMM 101K,A00,090657,Ahn; Patricia Jeehyun,16,0,20,4
1653302049880,COMM 101T,A00,093701,Staff,20,0,20,0
1653302050407,COMM 102C,A01,090660,Staff,4,0,6,2
1653302050407,COMM 102C,A02,090661,Staff,6,0,6,0
1653302050407,COMM 102C,A03,090662,Staff,4,0,6,2
1653302050933,COMM 103D,A00,090663,Davis; Zeinabu I.,38,0,40,2
1653302051460,COMM 106E,A00,090667,Geiger; Richard Stuart,26,0,30,4
1653302051985,COMM 106G,A00,090668,Cordoba Azcarate; Matilde,25,0,30,5
1653302052509,COMM 108G,A00,090670,Walkover; Lillian B,30,0,30,0
1653302053033,COMM 109I,A00,090671,Tanaka; Stefan A.,30,0,30,0
1653302053556,COMM 109N,A00,094205,Hallin; Daniel C,25,0,30,5
1653302054085,COMM 110G,A00,090672,Whitworth-Smith; Andrew C,45,0,50,5
1653302054609,COMM 111P,A00,090673,Conner; Thomas Hartnell,27,0,30,3
1653302055133,COMM 111T,A00,090674,Iatarola; Briana Marie,27,0,30,3
1653302055659,COMM 124A,A00,090677,Sims; Christopher O,79,0,80,1
1653302056186,COMM 131,A00,090678,Fields; Gary,22,0,25,3
1653302056710,COMM 134,A00,090679,Kidman; Shawna F,16,0,25,9
1653302057234,COMM 146,A00,090680,Staff,22,0,25,3
1653302057759,COMM 166,A00,094493,Staff,24,0,25,1
1653302058287,COMM 172,A00,094066,Staff,23,0,25,2
1653302058810,COMM 182,A00,094063,Staff,25,0,25,0
1653302059346,COMM 190,A00,090686,Kidman; Shawna F,17,0,23,6
1653302059346,COMM 190,B00,090687,Irani; Lilly C,0,0,0,0
1653302059346,COMM 190,C00,090688,Keith; Kerry,21,0,23,2
1653302059346,COMM 190,D00,090689,Zilberg; Elana,23,0,23,0
1653302059873,COMM 194,A00,091600,Hill; Seth J,9999,0,9999,0
1653302060400,COMM 196A,A00,090690,Schmidt; Thomas Rainer,0,0,0,0
1653302060927,COMM 198,001,091397,Ahn; Patricia Jeehyun,9999,0,9999,0
1653302060927,COMM 198,002,091398,Alac; Morana,9999,0,9999,0
1653302060927,COMM 198,003,091399,Anderson; Patrick W.,9999,0,9999,0
1653302060927,COMM 198,004,091400,Boateng; Boatema,9999,0,9999,0
1653302060927,COMM 198,005,091401,Booker; Angela N,9999,0,9999,0
1653302060927,COMM 198,008,091402,Cordoba Azcarate; Matilde,9999,0,9999,0
1653302060927,COMM 198,009,091403,Davis; Zeinabu I.,9999,0,9999,0
1653302060927,COMM 198,010,091404,Dewaard; Andrew Michael,9999,0,9999,0
1653302060927,COMM 198,011,091405,Dominguez Rubio; Fernando,9999,0,9999,0
1653302060927,COMM 198,012,091406,Fattal; Alexander Leor,9999,0,9999,0
1653302060927,COMM 198,013,091407,Fields; Gary,9999,0,9999,0
1653302060927,COMM 198,014,091408,Gates; Kelly,9999,0,9999,0
1653302060927,COMM 198,015,091409,Goldfarb; Brian,9999,0,9999,0
1653302060927,COMM 198,018,091410,Hill; Erin Truesdell,9999,0,9999,0
1653302060927,COMM 198,019,091411,Horwitz; Robert B,9999,0,9999,0
1653302060927,COMM 198,021,091412,Irani; Lilly C,9999,0,9999,0
1653302060927,COMM 198,022,091413,Jack; Caroline Sarah,9999,0,9999,0
1653302060927,COMM 198,023,091414,Kidman; Shawna F,9999,0,9999,0
1653302060927,COMM 198,024,091415,Martinico; Daniel J,9999,0,9999,0
1653302060927,COMM 198,026,091416,Schmidt; Thomas Rainer,9999,0,9999,0
1653302060927,COMM 198,027,091417,Serlin; David,9999,0,9999,0
1653302060927,COMM 198,028,091418,Sims; Christopher O,9999,0,9999,0
1653302060927,COMM 198,029,091419,Tanaka; Stefan A.,9999,0,9999,0
1653302060927,COMM 198,030,091420,Zilberg; Elana,9999,0,9999,0
1653302060927,COMM 198,031,091421,Walkover; Lillian B,9999,0,9999,0
1653302060927,COMM 198,032,091422,Geiger; Richard Stuart,9999,0,9999,0
1653302061451,CSE 8A,A50,089985,Soosai Raj; Adalbert Geral,7,0,10,3
1653302061451,CSE 8A,A51,089986,Soosai Raj; Adalbert Geral,1,0,10,9
1653302061451,CSE 8A,A52,089987,Soosai Raj; Adalbert Geral,5,0,10,5
1653302061451,CSE 8A,A53,089988,Soosai Raj; Adalbert Geral,9,0,10,1
1653302061451,CSE 8A,B50,089990,Soosai Raj; Adalbert Geral,0,0,10,10
1653302061451,CSE 8A,B51,089991,Soosai Raj; Adalbert Geral,5,0,10,5
1653302061451,CSE 8A,B52,089992,Soosai Raj; Adalbert Geral,5,0,10,5
1653302061451,CSE 8A,B53,089993,Soosai Raj; Adalbert Geral,9,0,10,1
1653302061451,CSE 8A,C50,089995,Lerner; Sorin,0,0,10,10
1653302061451,CSE 8A,C51,089996,Lerner; Sorin,6,0,10,4
1653302061451,CSE 8A,C52,089997,Lerner; Sorin,9,0,10,1
1653302061451,CSE 8A,C53,089998,Lerner; Sorin,8,0,10,2
1653302061975,CSE 8B,A01,090000,Ochoa; Benjamin Lawrence,94,0,100,6
1653302062500,CSE 11,A01,090002,Cao; Yingjun,39,0,49,10
1653302062500,CSE 11,B01,090004,Cao; Yingjun,45,0,49,4
1653302062500,CSE 11,C01,090006,Cao; Yingjun,35,0,49,14
1653302063025,CSE 12,A01,090008,Staff,73,0,73,0
1653302063025,CSE 12,B01,090010,Staff,67,0,73,6
1653302063025,CSE 12,C01,090012,Staff,60,0,73,13
1653302063550,CSE 15L,A01,090014,Politz; Joseph Gibbs,4,0,10,6
1653302063550,CSE 15L,A02,090015,Politz; Joseph Gibbs,7,0,10,3
1653302063550,CSE 15L,A03,090016,Politz; Joseph Gibbs,9,0,10,1
1653302063550,CSE 15L,A04,090017,Politz; Joseph Gibbs,9,0,10,1
1653302063550,CSE 15L,A05,090018,Politz; Joseph Gibbs,9,0,10,1
1653302063550,CSE 15L,B01,090020,Politz; Joseph Gibbs,8,0,10,2
1653302063550,CSE 15L,B02,090021,Politz; Joseph Gibbs,6,0,10,4
1653302063550,CSE 15L,B03,090022,Politz; Joseph Gibbs,7,0,10,3
1653302063550,CSE 15L,B04,090023,Politz; Joseph Gibbs,7,0,10,3
1653302063550,CSE 15L,B05,090024,Politz; Joseph Gibbs,7,0,10,3
1653302064075,CSE 20,A01,090026,Staff,204,0,210,6
1653302064602,CSE 21,A01,090028,Impagliazzo; Russell,0,0,0,0
1653302064602,CSE 21,A02,094488,Impagliazzo; Russell,0,0,0,0
1653302064602,CSE 21,A03,094489,Impagliazzo; Russell,0,0,0,0
1653302065126,CSE 30,A01,092463,Muller; P Keith,73,0,100,27
1653302065126,CSE 30,A02,092464,Staff,97,0,100,3
1653302065651,CSE 87,A00,094193,Moshiri; Alexander Niema,20,0,20,0
1653302066179,CSE 95,A00,090030,Minnes Kemp; Mor Mia,35,0,35,0
1653302066179,CSE 95,B00,093883,Minnes Kemp; Mor Mia,35,0,35,0
1653302066179,CSE 95,C00,093885,Minnes Kemp; Mor Mia,35,0,35,0
1653302066702,CSE 100,A01,090033,Moshiri; Alexander Niema,68,0,114,46
1653302067225,CSE 100R,A01,093837,Moshiri; Alexander Niema,334,0,350,16
1653302067754,CSE 101,A01,090035,Saha; Barna,152,0,237,85
1653302068277,CSE 103,A01,090037,Freund; Yoav,60,0,75,15
1653302068800,CSE 105,A01,090039,Lovett; Shachar,201,0,225,24
1653302069324,CSE 106,A50,090042,Paturi; Ramamohan,11,0,30,19
1653302069857,CSE 107,A01,090044,Bellare; Mihir,94,0,120,26
1653302070389,CSE 110,A50,090047,Powell; Thomas Allan,39,0,50,11
1653302070389,CSE 110,A51,090048,Powell; Thomas Allan,39,0,50,11
1653302070389,CSE 110,A52,090049,Powell; Thomas Allan,48,0,50,2
1653302070389,CSE 110,A53,090050,Powell; Thomas Allan,49,0,50,1
1653302070389,CSE 110,A54,090051,Powell; Thomas Allan,45,0,50,5
1653302070389,CSE 110,A55,090052,Powell; Thomas Allan,50,0,50,0
1653302070389,CSE 110,A56,090053,Powell; Thomas Allan,49,0,50,1
1653302070389,CSE 110,A57,090054,Powell; Thomas Allan,41,0,45,4
1653302070925,CSE 118,A00,094897,Weibel; Nadir,0,0,0,0
1653302071449,CSE 120,A01,090056,Voelker; Geoffrey M.,226,0,300,74
1653302071977,CSE 124,A01,090058,Porter; George M,123,0,189,66
1653302072500,CSE 127,A01,090060,Savage; Stefan,46,0,189,143
1653302073025,CSE 130,A01,090062,Polikarpova; Nadezhda,171,0,189,18
1653302073552,CSE 132A,A01,090064,Deutsch; Alin Bernard,46,0,189,143
1653302074075,CSE 140,A01,090068,Eldon; John,169,0,196,27
1653302074075,CSE 140,B01,090070,Orailoglu; Alex,48,0,49,1
1653302074607,CSE 140L,A01,090072,Eldon; John,161,0,192,31
1653302074607,CSE 140L,B01,090075,Orailoglu; Alex,44,0,49,5
1653302075132,CSE 142,A01,090078,Porter; Leonard Emerson,86,0,146,60
1653302075132,CSE 142,B01,090080,Porter; Leonard Emerson,107,0,146,39
1653302075655,CSE 142L,A01,090082,Swanson; Steven James,48,0,146,98
1653302075655,CSE 142L,B01,090084,Swanson; Steven James,120,0,146,26
1653302076182,CSE 151B,A01,090088,Cottrell; Garrison W,258,0,328,70
1653302076710,CSE 152A,A01,090090,Chandraker; Manmohan Krishna,153,0,189,36
1653302077237,CSE 158,A01,090092,McAuley; Julian John,84,0,197,113
1653302077763,CSE 158R,A01,090094,McAuley; Julian John,306,0,353,47
1653302078295,CSE 167,A01,090096,Chern; Albert Ren-Haur,165,0,189,24
1653302078827,CSE 170,A01,090098,Vaccaro; Kristen Marie,20,0,20,0
1653302078827,CSE 170,A02,090099,Vaccaro; Kristen Marie,14,0,20,6
1653302078827,CSE 170,A03,090100,Vaccaro; Kristen Marie,14,0,20,6
1653302078827,CSE 170,A04,090101,Vaccaro; Kristen Marie,14,0,20,6
1653302078827,CSE 170,A05,090102,Vaccaro; Kristen Marie,18,0,20,2
1653302079351,CSE 190,A00,090103,Shalev; Aaron D,40,0,40,0
1653302079351,CSE 190,B00,090104,Vaccaro; Kristen Marie,100,0,100,0
1653302079351,CSE 190,C00,090105,Pannuto; Patrick William,25,0,25,0
1653302079877,CSE 191,A00,093848,Minnes Kemp; Mor Mia,9999,0,9999,0
1653302080402,CSE 193,A01,090107,Elsherif; May Elhussein,49,0,49,0
1653302080929,CSE 194,A01,090109,Munyaka; Imani N. S.,20,0,49,29
1653302081457,CSS 1,A01,086486,Staff,22,0,24,2
1653302081457,CSS 1,A02,086487,Staff,21,0,24,3
1653302081457,CSS 1,A03,086488,Staff,20,0,24,4
1653302081457,CSS 1,A04,086489,Staff,23,0,24,1
1653302081987,DOC 1,A01,086773,Solomon; Amanda Lee Albaniel,0,0,0,0
1653302081987,DOC 1,A02,086774,Solomon; Amanda Lee Albaniel,0,0,0,0
1653302081987,DOC 1,A03,086775,Solomon; Amanda Lee Albaniel,5,0,6,1
1653302081987,DOC 1,A04,086776,Solomon; Amanda Lee Albaniel,6,0,6,0
1653302081987,DOC 1,A05,086777,Solomon; Amanda Lee Albaniel,6,0,6,0
1653302081987,DOC 1,A06,086778,Solomon; Amanda Lee Albaniel,6,0,6,0
1653302081987,DOC 1,A07,086779,Solomon; Amanda Lee Albaniel,5,0,6,1
1653302081987,DOC 1,A08,086849,Solomon; Amanda Lee Albaniel,6,0,6,0
1653302081987,DOC 1,A09,086780,Solomon; Amanda Lee Albaniel,6,0,6,0
1653302081987,DOC 1,A10,086781,Solomon; Amanda Lee Albaniel,6,0,6,0
1653302081987,DOC 1,A11,086782,Solomon; Amanda Lee Albaniel,5,0,6,1
1653302081987,DOC 1,A12,086783,Solomon; Amanda Lee Albaniel,6,0,6,0
1653302081987,DOC 1,A13,086784,Solomon; Amanda Lee Albaniel,6,0,6,0
1653302081987,DOC 1,A14,086785,Solomon; Amanda Lee Albaniel,6,0,6,0
1653302081987,DOC 1,A15,086786,Solomon; Amanda Lee Albaniel,6,0,6,0
1653302081987,DOC 1,A16,086787,Solomon; Amanda Lee Albaniel,6,0,6,0
1653302081987,DOC 1,A17,086788,Solomon; Amanda Lee Albaniel,0,0,0,0
1653302081987,DOC 1,A18,086789,Solomon; Amanda Lee Albaniel,0,0,0,0
1653302081987,DOC 1,B01,086791,Solomon; Amanda Lee Albaniel,6,0,6,0
1653302081987,DOC 1,B02,086792,Solomon; Amanda Lee Albaniel,6,0,6,0
1653302081987,DOC 1,B03,086793,Solomon; Amanda Lee Albaniel,6,0,6,0
1653302081987,DOC 1,B04,086794,Solomon; Amanda Lee Albaniel,6,0,6,0
1653302081987,DOC 1,B05,086795,Solomon; Amanda Lee Albaniel,3,0,6,3
1653302081987,DOC 1,B06,086796,Solomon; Amanda Lee Albaniel,6,0,6,0
1653302081987,DOC 1,B07,086797,Solomon; Amanda Lee Albaniel,6,0,6,0
1653302081987,DOC 1,B08,086798,Solomon; Amanda Lee Albaniel,6,0,6,0
1653302081987,DOC 1,B09,086799,Solomon; Amanda Lee Albaniel,6,0,6,0
1653302081987,DOC 1,B10,086800,Solomon; Amanda Lee Albaniel,6,0,6,0
1653302081987,DOC 1,B11,086801,Solomon; Amanda Lee Albaniel,5,0,6,1
1653302081987,DOC 1,B12,086802,Solomon; Amanda Lee Albaniel,6,0,6,0
1653302081987,DOC 1,B13,086803,Solomon; Amanda Lee Albaniel,6,0,6,0
1653302081987,DOC 1,B14,086804,Solomon; Amanda Lee Albaniel,6,0,6,0
1653302081987,DOC 1,B15,086805,Solomon; Amanda Lee Albaniel,5,0,6,1
1653302081987,DOC 1,B16,086806,Solomon; Amanda Lee Albaniel,6,0,6,0
1653302081987,DOC 1,B17,086807,Solomon; Amanda Lee Albaniel,0,0,0,0
1653302081987,DOC 1,B18,086808,Solomon; Amanda Lee Albaniel,0,0,0,0
1653302081987,DOC 1,C01,086810,Strom; Megan C.,6,0,6,0
1653302081987,DOC 1,C02,086811,Strom; Megan C.,5,0,6,1
1653302081987,DOC 1,C03,086812,Strom; Megan C.,6,0,6,0
1653302081987,DOC 1,C04,086813,Strom; Megan C.,5,0,6,1
1653302081987,DOC 1,C05,086814,Strom; Megan C.,5,0,6,1
1653302081987,DOC 1,C06,086815,Strom; Megan C.,6,0,6,0
1653302081987,DOC 1,C07,086816,Strom; Megan C.,6,0,6,0
1653302081987,DOC 1,C08,086817,Strom; Megan C.,6,0,6,0
1653302081987,DOC 1,C09,086818,Strom; Megan C.,6,0,6,0
1653302081987,DOC 1,C10,086819,Strom; Megan C.,6,0,6,0
1653302081987,DOC 1,C11,086820,Strom; Megan C.,6,0,6,0
1653302081987,DOC 1,C12,086821,Strom; Megan C.,6,0,6,0
1653302081987,DOC 1,C13,086822,Strom; Megan C.,6,0,6,0
1653302081987,DOC 1,C14,086823,Strom; Megan C.,6,0,6,0
1653302081987,DOC 1,C15,086824,Strom; Megan C.,6,0,6,0
1653302081987,DOC 1,C16,086825,Strom; Megan C.,6,0,6,0
1653302081987,DOC 1,C17,086826,Strom; Megan C.,0,0,0,0
1653302081987,DOC 1,C18,086827,Strom; Megan C.,0,0,0,0
1653302081987,DOC 1,D01,086829,Strom; Megan C.,6,0,6,0
1653302081987,DOC 1,D02,086830,Strom; Megan C.,6,0,6,0
1653302081987,DOC 1,D03,086831,Strom; Megan C.,5,0,6,1
1653302081987,DOC 1,D04,086832,Strom; Megan C.,6,0,6,0
1653302081987,DOC 1,D05,086833,Strom; Megan C.,6,0,6,0
1653302081987,DOC 1,D06,086834,Strom; Megan C.,6,0,6,0
1653302081987,DOC 1,D07,086835,Strom; Megan C.,6,0,6,0
1653302081987,DOC 1,D08,086836,Strom; Megan C.,6,0,6,0
1653302081987,DOC 1,D09,086837,Strom; Megan C.,0,0,0,0
1653302081987,DOC 1,D10,086838,Strom; Megan C.,0,0,0,0
1653302081987,DOC 1,D11,086839,Strom; Megan C.,6,0,6,0
1653302081987,DOC 1,D12,086840,Strom; Megan C.,6,0,6,0
1653302081987,DOC 1,D13,086841,Strom; Megan C.,6,0,6,0
1653302081987,DOC 1,D14,086842,Strom; Megan C.,5,0,6,1
1653302081987,DOC 1,D15,086843,Strom; Megan C.,6,0,6,0
1653302081987,DOC 1,D16,086844,Strom; Megan C.,5,0,6,1
1653302082520,DOC 100D,A00,086845,Pass; Natalye Joann,0,0,0,0
1653302082520,DOC 100D,B00,086846,Pass; Natalye Joann,21,0,25,4
1653302082520,DOC 100D,C00,086847,Pass; Natalye Joann,23,0,25,2
1653302083046,DSC 10,A01,088092,Tiefenbruck; Janine LoBue,13,0,15,2
1653302083046,DSC 10,B01,088095,Tiefenbruck; Janine LoBue,9,0,15,6
1653302083046,DSC 10,C01,088098,Rampure; Suraj,0,0,15,15
1653302083570,DSC 20,A01,088101,Langlois; Marina,148,0,150,2
1653302084097,DSC 30,A01,088105,Langlois; Marina,74,0,75,1
1653302084621,DSC 40A,A01,088107,Rampure; Suraj,97,0,100,3
1653302084621,DSC 40A,B01,088109,Rampure; Suraj,99,0,100,1
1653302085143,DSC 40B,A01,088111,Eldridge; Justin Matthew,73,0,75,2
1653302085143,DSC 40B,B01,088113,Wang; Yusu,75,0,75,0
1653302085669,DSC 80,A01,088115,Eldridge; Justin Matthew,95,0,100,5
1653302086196,DSC 95,A01,088117,Langlois; Marina,20,0,20,0
1653302086724,DSC 96,A00,088118,Liao; Soohyun Nam,50,0,50,0
1653302087251,DSC 100,A01,088120,Salimi; Babak,164,0,175,11
1653302087779,DSC 102,A01,094320,Kumar; Arun Kumar,77,0,125,48
1653302088305,DSC 180A,A01,088124,Fraenkel; Aaron Mcmillan,0,0,0,0
1653302088305,DSC 180A,A02,088125,Fraenkel; Aaron Mcmillan,0,0,0,0
1653302088305,DSC 180A,A03,088126,Fraenkel; Aaron Mcmillan,0,0,0,0
1653302088305,DSC 180A,A04,088127,Fraenkel; Aaron Mcmillan,0,0,0,0
1653302088305,DSC 180A,A05,088128,Fraenkel; Aaron Mcmillan,0,0,0,0
1653302088305,DSC 180A,A06,088129,Fraenkel; Aaron Mcmillan,0,0,0,0
1653302088305,DSC 180A,A07,088130,Fraenkel; Aaron Mcmillan,0,0,0,0
1653302088305,DSC 180A,A08,088131,Fraenkel; Aaron Mcmillan,0,0,0,0
1653302088305,DSC 180A,A09,088132,Fraenkel; Aaron Mcmillan,0,0,0,0
1653302088305,DSC 180A,A10,088133,Fraenkel; Aaron Mcmillan,0,0,0,0
1653302088305,DSC 180A,A11,088134,Fraenkel; Aaron Mcmillan,0,0,0,0
1653302088305,DSC 180A,A12,088135,Fraenkel; Aaron Mcmillan,0,0,0,0
1653302088305,DSC 180A,A13,088136,Fraenkel; Aaron Mcmillan,0,0,0,0
1653302088305,DSC 180A,A14,088137,Fraenkel; Aaron Mcmillan,0,0,0,0
1653302088305,DSC 180A,A15,088138,Fraenkel; Aaron Mcmillan,0,0,0,0
1653302088305,DSC 180A,B01,088141,Fraenkel; Aaron Mcmillan,0,0,0,0
1653302088305,DSC 180A,B02,088142,Fraenkel; Aaron Mcmillan,0,0,0,0
1653302088305,DSC 180A,B03,088143,Fraenkel; Aaron Mcmillan,0,0,0,0
1653302088305,DSC 180A,B04,088144,Fraenkel; Aaron Mcmillan,0,0,0,0
1653302088305,DSC 180A,B05,088145,Fraenkel; Aaron Mcmillan,0,0,0,0
1653302088305,DSC 180A,B06,088146,Fraenkel; Aaron Mcmillan,0,0,0,0
1653302088305,DSC 180A,B07,088147,Fraenkel; Aaron Mcmillan,0,0,0,0
1653302088305,DSC 180A,B08,088148,Fraenkel; Aaron Mcmillan,0,0,0,0
1653302088305,DSC 180A,B09,088149,Fraenkel; Aaron Mcmillan,0,0,0,0
1653302088305,DSC 180A,B10,088150,Fraenkel; Aaron Mcmillan,0,0,0,0
1653302088305,DSC 180A,B11,088151,Fraenkel; Aaron Mcmillan,0,0,0,0
1653302088305,DSC 180A,B12,088152,Fraenkel; Aaron Mcmillan,0,0,0,0
1653302088305,DSC 180A,B13,088153,Fraenkel; Aaron Mcmillan,0,0,0,0
1653302088305,DSC 180A,B14,088154,Fraenkel; Aaron Mcmillan,0,0,0,0
1653302088305,DSC 180A,B15,088155,Fraenkel; Aaron Mcmillan,0,0,0,0
1653302088832,DSC 190,A01,088158,Mishne; Gal,48,0,50,2
1653302088832,DSC 190,B01,088160,Silberman; Jack,16,0,21,5
1653302089356,DSC 197,001,088161,Eldridge; Justin Matthew,9999,0,9999,0
1653302089879,DSGN 1,A01,087888,Meyer; Michael Wayne,49,0,53,4
1653302089879,DSGN 1,A02,087889,Meyer; Michael Wayne,47,0,53,6
1653302089879,DSGN 1,A03,087890,Meyer; Michael Wayne,43,0,53,10
1653302090410,DSGN 100,A01,087983,Dow; Steven P,39,0,40,1
1653302090410,DSGN 100,A02,087984,Dow; Steven P,40,0,40,0
1653302090410,DSGN 100,A03,087985,Dow; Steven P,34,0,40,6
1653302090938,DSGN 118,A01,087987,Xia; Haijun,55,0,60,5
1653302090938,DSGN 118,A02,087988,Xia; Haijun,56,0,60,4
1653302091463,DSGN 119,A00,087989,Staff,51,0,70,19
1653302091991,ECE 5,A01,090699,Morris; Karcher William,0,0,0,0
1653302091991,ECE 5,A02,090700,Morris; Karcher William,0,0,0,0
1653302091991,ECE 5,A03,090701,Morris; Karcher William,0,0,0,0
1653302091991,ECE 5,A04,090702,Morris; Karcher William,0,0,0,0
1653302091991,ECE 5,A05,090703,Morris; Karcher William,0,0,0,0
1653302091991,ECE 5,A06,090704,Morris; Karcher William,0,0,0,0
1653302092515,ECE 15,A01,090706,Schurgers; Curt,0,0,0,0
1653302092515,ECE 15,A02,090707,Schurgers; Curt,0,0,0,0
1653302093048,ECE 16,A01,090709,Khoshabeh; Ramsin,24,0,30,6
1653302093571,ECE 17,A01,090711,Gilja; Vikash,55,0,60,5
1653302094100,ECE 25,A50,090714,Liu; Zhaowei,0,0,0,0
1653302094100,ECE 25,A51,090715,Liu; Zhaowei,0,0,0,0
1653302094100,ECE 25,A52,090716,Liu; Zhaowei,0,0,0,0
1653302094625,ECE 30,A50,094300,Mir Arabbaygi; Siavash,25,0,30,5
1653302094625,ECE 30,A51,094301,Mir Arabbaygi; Siavash,29,0,30,1
1653302094625,ECE 30,A52,094302,Mir Arabbaygi; Siavash,27,0,30,3
1653302094625,ECE 30,A53,094303,Mir Arabbaygi; Siavash,29,0,30,1
1653302094625,ECE 30,A54,094304,Mir Arabbaygi; Siavash,25,0,25,0
1653302095151,ECE 35,A50,090720,Schurgers; Curt,0,0,0,0
1653302095151,ECE 35,A51,090721,Schurgers; Curt,0,0,0,0
1653302095151,ECE 35,A52,090722,Schurgers; Curt,0,0,0,0
1653302095151,ECE 35,A53,090723,Schurgers; Curt,0,0,0,0
1653302095151,ECE 35,A54,090724,Schurgers; Curt,0,0,0,0
1653302095151,ECE 35,A55,090725,Schurgers; Curt,0,0,0,0
1653302095151,ECE 35,B50,090729,Schurgers; Curt,0,0,0,0
1653302095151,ECE 35,B51,090730,Schurgers; Curt,0,0,0,0
1653302095151,ECE 35,B52,090731,Schurgers; Curt,0,0,0,0
1653302095151,ECE 35,B53,090732,Schurgers; Curt,0,0,0,0
1653302095151,ECE 35,B54,090733,Schurgers; Curt,0,0,0,0
1653302095151,ECE 35,B55,090734,Schurgers; Curt,0,0,0,0
1653302095681,ECE 45,A01,090736,Franceschetti; Massimo,56,0,57,1
1653302095681,ECE 45,A02,090737,Franceschetti; Massimo,50,0,58,8
1653302096211,ECE 65,A50,090741,Baghdadchi; Saharnaz,13,0,15,2
1653302096211,ECE 65,A51,090742,Baghdadchi; Saharnaz,5,0,10,5
1653302096211,ECE 65,A52,090743,Baghdadchi; Saharnaz,14,0,15,1
1653302096211,ECE 65,A53,090744,Baghdadchi; Saharnaz,8,0,10,2
1653302096211,ECE 65,A54,094865,Baghdadchi; Saharnaz,14,0,15,1
1653302096211,ECE 65,A55,094866,Baghdadchi; Saharnaz,9,0,10,1
1653302096211,ECE 65,A56,094867,Baghdadchi; Saharnaz,14,0,15,1
1653302096211,ECE 65,A57,094868,Baghdadchi; Saharnaz,15,0,15,0
1653302096211,ECE 65,A58,094869,Baghdadchi; Saharnaz,10,0,10,0
1653302096741,ECE 100,A01,090746,Baghdadchi; Saharnaz,16,0,20,4
1653302096741,ECE 100,A02,090747,Baghdadchi; Saharnaz,20,0,20,0
1653302096741,ECE 100,A03,090748,Baghdadchi; Saharnaz,18,0,20,2
1653302096741,ECE 100,A04,090749,Baghdadchi; Saharnaz,20,0,20,0
1653302096741,ECE 100,A05,090750,Baghdadchi; Saharnaz,18,0,20,2
1653302096741,ECE 100,A06,090751,Baghdadchi; Saharnaz,18,0,20,2
1653302096741,ECE 100,A07,090752,Baghdadchi; Saharnaz,20,0,20,0
1653302097276,ECE 101,A01,090754,Siegel; Paul H.,62,0,75,13
1653302097276,ECE 101,A02,090755,Siegel; Paul H.,71,0,75,4
1653302097804,ECE 102,A00,090756,Hsueh; Tzu-Chien,57,0,75,18
1653302098329,ECE 103,A01,090767,Lo; Yu-Hwa,45,0,50,5
1653302098925,ECE 107,A01,090769,Lomakin; Vitaliy,72,0,75,3
1653302099449,ECE 109,A01,090771,Zeger; Kenneth A.,176,0,180,4
1653302099973,ECE 111,A01,090774,Koushanfar; Farinaz,100,0,120,20
1653302100507,ECE 121A,A50,090777,Esmaili; Gholamreza,17,0,24,7
1653302100507,ECE 121A,A51,090778,Esmaili; Gholamreza,9,0,24,15
1653302100507,ECE 121A,A52,090779,Esmaili; Gholamreza,22,0,24,2
1653302101032,ECE 128A,A00,090780,Staff,40,0,70,30
1653302101561,ECE 135A,A00,090781,Kuzum; Duygu,30,0,30,0
1653302102092,ECE 143,A00,090782,Unpingco; Jose H.,0,0,0,2
1653302102617,ECE 148,A01,090784,Staff,32,0,32,0
1653302103139,ECE 155,A01,090786,Milstein; Laurence B.,16,0,20,4
1653302103662,ECE 158A,A01,090788,Franceschetti; Massimo,56,0,65,9
1653302104190,ECE 161A,A01,090790,Rao; Bhaskar D.,103,0,115,12
1653302104713,ECE 164,A00,090791,Hall; Drew A.,87,0,115,28
1653302105245,ECE 166,A50,090796,Rebeiz; Gabriel,6,0,12,6
1653302105245,ECE 166,A51,090797,Rebeiz; Gabriel,9,0,12,3
1653302105245,ECE 166,A52,090799,Rebeiz; Gabriel,1,0,12,11
1653302105245,ECE 166,A53,090800,Rebeiz; Gabriel,6,0,12,6
1653302105245,ECE 166,A54,094335,Rebeiz; Gabriel,11,0,12,1
1653302105245,ECE 166,A55,094336,Rebeiz; Gabriel,12,0,12,0
1653302105245,ECE 166,A56,094349,Rebeiz; Gabriel,13,0,15,2
1653302105245,ECE 166,A57,094350,Rebeiz; Gabriel,14,0,15,1
1653302105773,ECE 171A,A01,090802,Atanasov; Nikolay A.,45,0,60,15
1653302106295,ECE 171B,A01,090804,Shi; Yuanyuan,44,0,50,6
1653302106820,ECE 174,A01,090806,Pal; Piya,125,0,146,21
1653302107344,ECE 182,A01,090808,Lomakin; Vitaliy,23,0,23,0
1653302107872,ECE 187,A00,090809,Liu; Zhaowei,19,0,20,1
1653302108399,ECE 196,A00,090812,Morris; Karcher William,19,0,24,5
1653302108399,ECE 196,B00,094833,Morris; Karcher William,24,0,24,0
1653302108924,ECE 197,001,090813,Sievenpiper; Daniel F.,9999,0,9999,0
1653302109448,ECON 1,A01,092535,Staff,0,0,0,0
1653302109448,ECON 1,A02,092536,Staff,0,0,0,0
1653302109448,ECON 1,A03,092537,Staff,0,0,0,0
1653302109448,ECON 1,A04,092538,Staff,0,0,0,0
1653302109448,ECON 1,A05,092539,Staff,0,0,0,0
1653302109448,ECON 1,B01,092540,Ma; Alyson Chan,42,0,45,3
1653302109448,ECON 1,B02,092541,Ma; Alyson Chan,45,0,45,0
1653302109448,ECON 1,B03,092542,Ma; Alyson Chan,45,0,45,0
1653302109448,ECON 1,B04,092543,Ma; Alyson Chan,40,0,40,0
1653302109448,ECON 1,B05,092544,Ma; Alyson Chan,40,0,40,0
1653302109448,ECON 1,C01,092545,Tocoian; Oana,0,0,0,0
1653302109448,ECON 1,C02,092546,Tocoian; Oana,0,0,0,0
1653302109448,ECON 1,C03,092547,Tocoian; Oana,0,0,0,0
1653302109448,ECON 1,C04,092548,Tocoian; Oana,0,0,0,0
1653302109448,ECON 1,D01,094253,Levkoff; Steven B.,41,0,45,4
1653302109448,ECON 1,D02,094254,Levkoff; Steven B.,44,0,45,1
1653302109448,ECON 1,D03,094255,Levkoff; Steven B.,45,0,45,0
1653302109448,ECON 1,D04,094256,Levkoff; Steven B.,36,0,40,4
1653302109448,ECON 1,D05,094257,Levkoff; Steven B.,40,0,40,0
1653302109974,ECON 2,A01,092549,Staff,0,0,0,0
1653302109974,ECON 2,A02,092550,Staff,0,0,0,0
1653302109974,ECON 2,A03,092551,Staff,0,0,0,0
1653302110497,ECON 4,A01,092554,Levkoff; Steven B.,29,0,30,1
1653302110497,ECON 4,A02,092555,Levkoff; Steven B.,27,0,30,3
1653302110497,ECON 4,A03,092556,Levkoff; Steven B.,30,0,30,0
1653302111022,ECON 100A,A01,092557,Newhouse; Herbert S,23,0,30,7
1653302111022,ECON 100A,A02,092558,Newhouse; Herbert S,28,0,30,2
1653302111022,ECON 100A,A03,092559,Newhouse; Herbert S,29,0,30,1
1653302111022,ECON 100A,A04,092560,Newhouse; Herbert S,35,0,35,0
1653302111022,ECON 100A,B01,092561,Newhouse; Herbert S,20,0,30,10
1653302111022,ECON 100A,B02,092562,Newhouse; Herbert S,28,0,30,2
1653302111022,ECON 100A,B03,092563,Newhouse; Herbert S,15,0,30,15
1653302111022,ECON 100A,B04,092564,Newhouse; Herbert S,35,0,35,0
1653302111554,ECON 100B,A01,092565,Galperti; Simone,27,0,30,3
1653302111554,ECON 100B,A02,092566,Galperti; Simone,18,0,20,2
1653302111554,ECON 100B,A03,094496,Staff,27,0,30,3
1653302111554,ECON 100B,A04,094497,Staff,16,0,20,4
1653302111554,ECON 100B,B01,092567,Galperti; Simone,16,0,25,9
1653302112081,ECON 100C,A01,092569,Du; Songzi,62,0,75,13
1653302112081,ECON 100C,B01,092570,Du; Songzi,70,0,75,5
1653302112081,ECON 100C,B02,094258,Du; Songzi,75,0,75,0
1653302112606,ECON 100CH,A00,088284,Andreoni; James,20,0,20,0
1653302113133,ECON 109,A01,092572,Watson; Joel Christopher,68,0,75,7
1653302113133,ECON 109,B01,092573,Watson; Joel Christopher,68,0,75,7
1653302113658,ECON 110A,A01,092574,Alon; Titan Michael,12,0,25,13
1653302113658,ECON 110A,A02,092575,Alon; Titan Michael,24,0,25,1
1653302113658,ECON 110A,B01,092576,Alon; Titan Michael,24,0,25,1
1653302113658,ECON 110A,B02,092577,Alon; Titan Michael,25,0,25,0
1653302114181,ECON 110B,A01,092578,Trottner; Fabian Gunter We,16,0,25,9
1653302114181,ECON 110B,A02,094054,Trottner; Fabian Gunter We,23,0,25,2
1653302114181,ECON 110B,B01,092579,Trottner; Fabian Gunter We,7,0,25,18
1653302114181,ECON 110B,B02,094055,Trottner; Fabian Gunter We,24,0,25,1
1653302114705,ECON 116,A00,088291,Lowes; Sara Rachel,58,0,70,12
1653302115230,ECON 120A,A01,092580,Elliott; Graham,18,0,25,7
1653302115230,ECON 120A,A02,092581,Elliott; Graham,22,0,25,3
1653302115230,ECON 120A,B01,092582,Elliott; Graham,18,0,25,7
1653302115230,ECON 120A,B02,092583,Elliott; Graham,20,0,25,5
1653302115230,ECON 120A,C01,092584,Tocoian; Oana,27,0,30,3
1653302115230,ECON 120A,C02,092585,Tocoian; Oana,28,0,30,2
1653302115230,ECON 120A,C03,092586,Tocoian; Oana,40,0,40,0
1653302115760,ECON 120B,A01,092587,Candido; Maria Teresa,58,0,70,12
1653302115760,ECON 120B,A02,092588,Candido; Maria Teresa,51,0,60,9
1653302115760,ECON 120B,A03,092589,Candido; Maria Teresa,56,0,60,4
1653302116286,ECON 120C,A01,092590,Candido; Maria Teresa,48,0,60,12
1653302116286,ECON 120C,A02,092591,Candido; Maria Teresa,59,0,60,1
1653302116286,ECON 120C,A03,094310,Candido; Maria Teresa,73,0,75,2
1653302116809,ECON 121,A00,088298,Vogl; Tom Saul,36,0,50,14
1653302117337,ECON 130,A00,088299,Staff,59,0,75,16
1653302117861,ECON 131,A00,088300,Jacobsen; Mark,129,0,150,21
1653302117861,ECON 131,B00,088301,Jacobsen; Mark,15,0,30,15
1653302118387,ECON 152,A00,088302,Fadlon; Yizhak,34,0,50,16
1653302118387,ECON 152,B00,088303,Fadlon; Yizhak,49,0,50,1
1653302118911,ECON 168,A00,088304,Staff,54,0,60,6
1653302119439,ECON 191B,A00,088312,Galperti; Simone,20,0,20,0
1653302119963,EDS 25,A01,087581,Staff,9,0,10,1
1653302119963,EDS 25,A02,087582,Staff,10,0,10,0
1653302119963,EDS 25,A03,087583,Staff,7,0,10,3
1653302119963,EDS 25,A04,087584,Staff,10,0,10,0
1653302120487,EDS 31,A00,087585,Bussey; Thomas J,9,0,10,1
1653302121015,EDS 110R,A01,087597,Cohen; Shana R,43,0,50,7
1653302121015,EDS 110R,B01,093579,Cohen; Shana R,10,0,10,0
1653302121539,EDS 113,A00,087598,Staff,45,0,50,5
1653302122066,EDS 114,A01,088091,Eguchi; Emi,17,0,20,3
1653302122066,EDS 114,A02,087600,Eguchi; Emi,19,0,20,1
1653302122590,EDS 117,A01,087603,Chung; Luz Marina,25,0,35,10
1653302122590,EDS 117,A02,087604,Chung; Luz Marina,34,0,35,1
1653302123122,EDS 124AR,A01,087606,Simon; Elizabeth A,0,0,19,19
1653302123122,EDS 124AR,A02,087607,Simon; Elizabeth A,13,0,19,6
1653302123122,EDS 124AR,A03,087608,Simon; Elizabeth A,15,0,19,4
1653302123122,EDS 124AR,A04,087609,Simon; Elizabeth A,4,0,19,15
1653302123122,EDS 124AR,B01,087611,Simon; Elizabeth A,14,0,19,5
1653302123122,EDS 124AR,B02,087612,Simon; Elizabeth A,18,0,19,1
1653302123122,EDS 124AR,B03,087613,Simon; Elizabeth A,18,0,19,1
1653302123122,EDS 124AR,B04,087614,Simon; Elizabeth A,19,0,19,0
1653302123122,EDS 124AR,C01,094210,Simon; Elizabeth A,6,0,6,0
1653302123122,EDS 124AR,C02,094211,Simon; Elizabeth A,6,0,6,0
1653302123122,EDS 124AR,C03,094212,Simon; Elizabeth A,6,0,6,0
1653302123122,EDS 124AR,C04,094213,Simon; Elizabeth A,6,0,6,0
1653302123122,EDS 124AR,D01,094215,Simon; Elizabeth A,6,0,6,0
1653302123122,EDS 124AR,D02,094216,Simon; Elizabeth A,6,0,6,0
1653302123122,EDS 124AR,D03,094217,Simon; Elizabeth A,6,0,6,0
1653302123122,EDS 124AR,D04,094218,Simon; Elizabeth A,6,0,6,0
1653302123651,EDS 124BR,A00,087615,Eguchi; Emi,65,0,75,10
1653302123651,EDS 124BR,B00,093580,Eguchi; Emi,25,0,25,0
1653302124177,EDS 125,A00,087616,Jones; Gabrielle Anastasia,51,0,60,9
1653302124702,EDS 129A,A01,087618,Heinzman; Erica M.,43,0,50,7
1653302125231,EDS 130,A01,087620,Holtzman; Caren Lynn,17,0,20,3
1653302125231,EDS 130,A02,087621,Holtzman; Caren Lynn,20,0,20,0
1653302125231,EDS 130,A03,087622,Holtzman; Caren Lynn,20,0,20,0
1653302125753,EDS 131,A01,087624,Wishard Guerra; Alison G.,37,0,40,3
1653302126293,EDS 133,A01,087627,Bintliff; Amy S.V.,17,0,20,3
1653302126293,EDS 133,A02,087628,Bintliff; Amy S.V.,19,0,20,1
1653302126817,EDS 139,A00,087629,Holtzman; Caren Lynn,55,0,60,5
1653302126817,EDS 139,B00,087630,Heinzman; Erica M.,51,0,60,9
1653302126817,EDS 139,C00,087631,Bintliff; Amy S.V.,57,0,60,3
1653302126817,EDS 139,D00,087632,Wishard Guerra; Alison G.,58,0,60,2
1653302126817,EDS 139,E00,087633,Holtzman; Caren Lynn,30,0,30,0
1653302126817,EDS 139,F00,094886,Staff,25,0,25,0
1653302127343,EDS 146,A01,094220,Staff,25,0,25,0
1653302127867,EDS 164R,A01,087644,Wishard Guerra; Alison G.,37,0,40,3
1653302127867,EDS 164R,B01,093582,Wishard Guerra; Alison G.,20,0,20,0
1653302128392,EDS 190,A00,087645,Bresser; Bernard George,20,0,20,0
1653302128392,EDS 190,B00,087646,Pappas; Elizabeth,20,0,20,0
1653302128392,EDS 190,C00,087647,Scharton; Susan Michelle,20,0,20,0
1653302128392,EDS 190,E00,087648,Staff,20,0,20,0
1653302128916,ENG 10,A00,086288,Staff,30,0,30,0
1653302128916,ENG 10,B00,086289,Staff,30,0,30,0
1653302129443,ENG 15,A01,086291,Staff,35,0,35,0
1653302129968,ENG 20,A00,086292,Evdokimenko; Ekaterina,33,0,35,2
1653302130494,ENG 100D,A00,086293,Ngo; Anh-Thu T.,45,0,50,5
1653302130494,ENG 100D,B00,094309,Staff,46,0,50,4
1653302131021,ENG 100L,A00,086295,Kleissl; Jan,6,0,6,0
1653302131021,ENG 100L,B00,086296,Bratton; Maryann,8,0,8,0
1653302131021,ENG 100L,C00,086297,Nguyen; Truong Quang,10,0,10,0
1653302131021,ENG 100L,E00,086299,de Oliveira; Mauricio,8,0,8,0
1653302131021,ENG 100L,F00,086300,Goldberg; Charles G.,6,0,6,0
1653302131021,ENG 100L,G00,086301,Bratton; Maryann,6,0,6,0
1653302131021,ENG 100L,H00,086302,Staff,6,0,6,0
1653302131550,ENVR 30,A01,093565,Staff,29,0,30,1
1653302131550,ENVR 30,A02,093567,Staff,28,0,30,2
1653302131550,ENVR 30,A03,093568,Staff,25,0,30,5
1653302131550,ENVR 30,A04,093569,Staff,30,0,30,0
1653302131550,ENVR 30,A05,093570,Staff,29,0,30,1
1653302131550,ENVR 30,A06,093566,Staff,29,0,30,1
1653302132082,ENVR 102,A00,093571,Daly; Heather Marie,25,0,30,5
1653302133132,ERC 1,A01,092328,Herbst; Matthew,20,0,20,0
1653302133132,ERC 1,A02,092330,Herbst; Matthew,20,0,20,0
1653302133132,ERC 1,A03,092331,Herbst; Matthew,20,0,20,0
1653302133132,ERC 1,A04,092332,Herbst; Matthew,20,0,20,0
1653302133132,ERC 1,A05,092333,Herbst; Matthew,20,0,20,0
1653302133132,ERC 1,A06,092334,Herbst; Matthew,20,0,20,0
1653302133661,ERC 2,A01,092336,Rahimi; Babak,20,0,20,0
1653302133661,ERC 2,A02,092337,Rahimi; Babak,20,0,20,0
1653302133661,ERC 2,A03,092338,Rahimi; Babak,20,0,20,0
1653302133661,ERC 2,A04,092339,Rahimi; Babak,20,0,20,0
1653302134188,ERC 20,A00,092340,Evans; Ivan T,30,0,30,0
1653302134188,ERC 20,B00,092341,Evans; Ivan T,30,0,30,0
1653302134711,ERC 87,A00,093850,Herbst; Matthew,20,0,20,0
1653302135241,ERC 92,A00,092342,Staff,1,0,1,0
1653302135241,ERC 92,B00,092343,Staff,1,0,1,0
1653302135241,ERC 92,C00,092344,Staff,1,0,1,0
1653302135241,ERC 92,D00,092345,Staff,1,0,1,0
1653302135241,ERC 92,E00,092346,Staff,1,0,1,0
1653302135241,ERC 92,F00,092347,Staff,1,0,1,0
1653302135770,ESYS 90,A00,086303,Teranes; Jane,12,0,12,0
1653302136293,ESYS 101,A01,086305,Taylor; Jennifer Rebecca & Diaz; Julia Michelle,25,0,27,2
1653302136293,ESYS 101,A02,086306,Taylor; Jennifer Rebecca & Diaz; Julia Michelle,15,0,27,12
1653302136293,ESYS 101,A03,086307,Taylor; Jennifer Rebecca & Diaz; Julia Michelle,21,0,27,6
1653302136293,ESYS 101,A04,086308,Taylor; Jennifer Rebecca & Diaz; Julia Michelle,27,0,27,0
1653302136820,ESYS 187A,A01,086310,Teranes; Jane,38,0,40,2
1653302136820,ESYS 187A,B01,086312,Teranes; Jane,30,0,40,10
1653302137351,ETHN 1,A01,086314,Frank; Ross H.,15,0,15,0
1653302137351,ETHN 1,A02,086315,Frank; Ross H.,15,0,15,0
1653302137351,ETHN 1,A03,086316,Frank; Ross H.,14,0,15,1
1653302137351,ETHN 1,A04,086317,Frank; Ross H.,15,0,15,0
1653302137351,ETHN 1,A05,086318,Frank; Ross H.,15,0,15,0
1653302137351,ETHN 1,A06,086319,Frank; Ross H.,13,0,15,2
1653302137351,ETHN 1,A07,086320,Frank; Ross H.,15,0,15,0
1653302137351,ETHN 1,A08,086321,Frank; Ross H.,14,0,15,1
1653302137351,ETHN 1,A09,086322,Frank; Ross H.,15,0,15,0
1653302137351,ETHN 1,A10,086323,Frank; Ross H.,15,0,15,0
1653302137351,ETHN 1,A11,086324,Frank; Ross H.,15,0,15,0
1653302137351,ETHN 1,A12,086325,Frank; Ross H.,15,0,15,0
1653302137351,ETHN 1,A13,086326,Frank; Ross H.,15,0,15,0
1653302137351,ETHN 1,A14,086327,Frank; Ross H.,15,0,15,0
1653302137351,ETHN 1,A15,086328,Frank; Ross H.,15,0,15,0
1653302137351,ETHN 1,A16,086329,Frank; Ross H.,15,0,15,0
1653302137875,ETHN 100A,A00,086330,Patel; Shaista,41,0,48,7
1653302138402,ETHN 103,A00,086331,Perreira; Christopher Michael,63,0,70,7
1653302138926,ETHN 104,A00,086332,Staff,0,0,0,0
1653302139452,ETHN 106,A00,086333,Staff,0,0,0,0
1653302139975,ETHN 121,A00,086341,Sasaki; Christen T,20,0,28,8
1653302140504,ETHN 139,A00,086342,Ruiz; Ariana,16,0,20,4
1653302141031,ETHN 144M,A00,086343,Jolivette; Andrew J,66,0,70,4
1653302141557,ETHN 159,A00,088427,Graham; Jessica Lynn,0,0,0,0
1653302142082,ETHN 163E,A00,086344,Patel; Shaista,37,0,40,3
1653302142607,ETHN 178R,A00,090798,Borgo; David Garcia,15,0,20,5
1653302143133,ETHN 187,A00,086345,Perez; Roy,14,0,16,2
1653302143661,EXPR 100,A00,085686,Staff,9999,0,9999,0
1653302144186,FMPH 40,A00,086370,Emory; Kristen,70,0,75,5
1653302144186,FMPH 40,B00,086371,Romero; Sally Ann Dominick,71,0,75,4
1653302144714,FMPH 101,A00,086372,Brouwer; Kimberly,43,0,55,12
1653302145235,FMPH 102,A50,094498,Rana; Brinda Kanti,42,0,55,13
1653302145760,FMPH 110,A00,086374,Zoumas-Morse; Christine E.,61,0,65,4
1653302146287,FMPH 120,A00,086375,Nguyen-Grozavu; France T.,45,0,65,20
1653302146287,FMPH 120,B00,086376,Nguyen-Grozavu; France T.,60,0,65,5
1653302146811,FMPH 130,A00,086377,Staff,48,0,65,17
1653302147860,FMPH 161,A00,086379,Zoumas-Morse; Christine E.,58,0,65,7
1653302148390,FMPH 191,A00,086380,Harrell; Maralee Mae,58,0,60,2
1653302148919,FMPH 196A,A00,086381,Binkin; Nancy Jeanne,0,0,0,0
1653302149442,GLBH 20,A00,086407,Walkover; Lillian B,85,0,90,5
1653302149970,GLBH 100,A00,086408,Staff,55,0,56,1
1653302149970,GLBH 100,B00,086409,Wu; Hua,52,0,56,4
1653302149970,GLBH 100,D00,086411,Staff,38,0,40,2
1653302150497,GLBH 103,A00,086412,Hannah; Seth Donal,48,0,50,2
1653302151022,GLBH 105,A00,086413,Olivas Hernandez; Olga Lid,36,0,38,2
1653302151545,GLBH 106,A00,086414,Kayser; Georgia Lyn,40,0,40,0
1653302152157,GLBH 111,A01,094330,Burgos; Jose L.,0,0,0,0
1653302152157,GLBH 111,B01,094332,Burgos; Jose L.,0,0,0,0
1653302152684,GLBH 148,A00,086415,Staff,69,0,73,4
1653302153220,GLBH 181,A00,086417,Burgos; Jose L.,144,0,146,2
1653302153745,GSS 20,A00,094269,Staff,73,0,75,2
1653302154267,HDS 1,A01,086423,Staff,24,0,25,1
1653302154267,HDS 1,A02,086424,Staff,24,0,25,1
1653302154267,HDS 1,A03,086425,Staff,23,0,25,2
1653302154267,HDS 1,A04,086426,Staff,25,0,25,0
1653302154267,HDS 1,A05,086427,Staff,24,0,25,1
1653302154267,HDS 1,A06,086428,Staff,25,0,25,0
1653302154267,HDS 1,A07,086429,Staff,30,0,30,0
1653302154790,HDS 60,A01,086431,Staff,23,0,25,2
1653302155316,HDS 111,A00,086432,Staff,73,0,80,7
1653302155840,HDS 121,A01,086434,Deak; Gedeon O.,11,0,15,4
1653302155840,HDS 121,A02,086435,Deak; Gedeon O.,13,0,15,2
1653302156365,HDS 150,A00,086436,Staff,25,0,25,0
1653302156365,HDS 150,B00,086437,Staff,25,0,25,0
1653302156888,HDS 173,A00,086439,Staff,27,0,30,3
1653302157422,HDS 181,A01,086441,Staff,30,0,30,0
1653302157950,HDS 191,A01,086443,Staff,25,0,25,0
1653302158473,HIEA 129,A00,088057,Schneewind; Sarah,0,0,0,0
1653302158998,HIEA 137,A00,088058,Lu; Weijing,53,0,55,2
1653302159522,HIEA 144,A00,088059,Henry; Todd A.,43,0,45,2
1653302160048,HIEA 171,A00,088060,Lu; Weijing,15,0,15,0
1653302160585,HIEU 102,A00,088061,Watts; Edward J.,0,0,0,0
1653302161109,HIEU 107,A00,088062,Caciola; Nancy A,0,0,0,0
1653302161638,HIEU 108,A00,088063,Balberg; Mira,53,0,60,7
1653302162160,HIEU 128,A00,088064,Neuheiser; Joerg,0,0,0,0
1653302162684,HIEU 144,A00,094327,Staff,48,0,50,2
1653302163211,HIEU 149,A00,088065,Devereux; Andrew W,38,0,45,7
1653302163739,HIEU 154,A00,088066,Biess; Frank Peter,58,0,65,7
1653302164264,HIGL 114,A00,088067,Edington; Claire Ellen,53,0,55,2
1653302164793,HILA 119,A00,088068,Vitz; Matthew,49,0,51,2
1653302165318,HILA 122,A00,088069,Widener; Daniel,61,0,65,4
1653302165843,HILD 2A,A01,088024,Hanna; Mark G.,28,0,28,0
1653302165843,HILD 2A,A02,088025,Hanna; Mark G.,25,0,25,0
1653302165843,HILD 2A,A03,088026,Hanna; Mark G.,27,0,28,1
1653302165843,HILD 2A,A04,088027,Hanna; Mark G.,28,0,28,0
1653302165843,HILD 2A,A05,088028,Hanna; Mark G.,28,0,28,0
1653302165843,HILD 2A,A06,088029,Hanna; Mark G.,28,0,28,0
1653302166371,HILD 7A,A01,088031,Graham; Jessica Lynn,28,0,28,0
1653302166371,HILD 7A,A02,088032,Graham; Jessica Lynn,27,0,28,1
1653302166371,HILD 7A,A03,088033,Graham; Jessica Lynn,27,0,28,1
1653302166371,HILD 7A,A04,088034,Graham; Jessica Lynn,26,0,28,2
1653302166371,HILD 7A,A05,088035,Graham; Jessica Lynn,26,0,28,2
1653302166371,HILD 7A,A06,088037,Graham; Jessica Lynn,22,0,28,6
1653302166371,HILD 7A,A07,088038,Graham; Jessica Lynn,28,0,28,0
1653302166371,HILD 7A,A08,088039,Graham; Jessica Lynn,28,0,28,0
1653302166371,HILD 7A,A09,088040,Graham; Jessica Lynn,27,0,28,1
1653302166371,HILD 7A,A10,088041,Graham; Jessica Lynn,28,0,28,0
1653302166371,HILD 7A,A11,088042,Graham; Jessica Lynn,28,0,28,0
1653302166371,HILD 7A,A12,088043,Graham; Jessica Lynn,28,0,28,0
1653302166897,HILD 10,A01,088045,Muscolino; Micah S,27,0,28,1
1653302166897,HILD 10,A02,088046,Muscolino; Micah S,27,0,28,1
1653302166897,HILD 10,A03,088047,Muscolino; Micah S,28,0,28,0
1653302166897,HILD 10,A04,088048,Muscolino; Micah S,27,0,28,1
1653302166897,HILD 10,A05,088049,Muscolino; Micah S,28,0,28,0
1653302166897,HILD 10,A06,088050,Muscolino; Micah S,27,0,28,1
1653302167422,HILD 30,A01,088052,Edington; Claire Ellen,24,0,28,4
1653302167422,HILD 30,A02,088053,Edington; Claire Ellen,28,0,28,0
1653302167951,HILD 41,A01,088055,Devereux; Andrew W,28,0,28,0
1653302167951,HILD 41,A02,088056,Devereux; Andrew W,28,0,28,0
1653302168475,HINE 116,A00,088070,Kayali; Hasan,47,0,50,3
1653302169003,HINE 144,A00,088071,Provence; Michael,40,0,45,5
1653302169529,HISC 106,A00,088072,Pineda De Avila; Nydia,47,0,50,3
1653302170067,HISC 115,A00,088073,Gere; Catherina M.,103,0,110,7
1653302170591,HITO 87,A00,094352,Patterson; Patrick H.,20,0,20,0
1653302170591,HITO 87,C00,094354,Patterson; Patrick H.,20,0,20,0
1653302170591,HITO 87,B00,094353,Hanna; Mark G.,20,0,20,0
1653302171114,HITO 100,A00,088074,Hanna; Mark G.,8,0,12,4
1653302171639,HITO 193,A00,091603,Hill; Seth J,9999,0,9999,0
1653302172165,HITO 196,A00,088075,Hendrickson; Gerald M.,20,0,20,0
1653302172693,HIUS 108B,A00,088076,Klann; Mary Cameron,48,0,51,3
1653302173218,HIUS 112,A00,088077,Plant; Rebecca Jo,144,0,148,4
1653302173745,HIUS 152A,A00,088078,Vandevelde; Kenneth Joseph,40,0,45,5
1653302174270,HIUS 155,A00,088079,Alvarez; Luis A,37,0,45,8
1653302174797,HIUS 183,A00,088080,Graham; Jessica Lynn,19,0,20,1
1653302175327,HUM 3,A01,087224,West; Geoffrey Scott,27,0,28,1
1653302175327,HUM 3,A02,087225,West; Geoffrey Scott,28,0,28,0
1653302175327,HUM 3,A03,087226,West; Geoffrey Scott,26,0,28,2
1653302175327,HUM 3,A04,087227,West; Geoffrey Scott,27,0,28,1
1653302175327,HUM 3,A05,087228,West; Geoffrey Scott,27,0,28,1
1653302175327,HUM 3,A06,087229,West; Geoffrey Scott,24,0,28,4
1653302175327,HUM 3,A07,087230,West; Geoffrey Scott,27,0,28,1
1653302175327,HUM 3,A08,087231,West; Geoffrey Scott,28,0,28,0
1653302175327,HUM 3,B01,087233,Staff,28,0,28,0
1653302175327,HUM 3,B02,087234,Staff,28,0,28,0
1653302175327,HUM 3,B03,087235,Staff,28,0,28,0
1653302175327,HUM 3,B04,087236,Staff,28,0,28,0
1653302175327,HUM 3,B05,087237,Staff,28,0,28,0
1653302175327,HUM 3,B06,087238,Staff,28,0,28,0
1653302175327,HUM 3,B07,087239,Staff,0,0,0,0
1653302175327,HUM 3,B08,087240,Staff,0,0,0,0
1653302175327,HUM 3,B09,087241,Staff,30,0,30,0
1653302175327,HUM 3,B10,087242,Staff,28,0,30,2
1653302175327,HUM 3,C01,087244,Patterson; Patrick H.,0,0,0,0
1653302175327,HUM 3,C02,087245,Patterson; Patrick H.,0,0,0,0
1653302175327,HUM 3,C03,087246,Patterson; Patrick H.,23,0,28,5
1653302175327,HUM 3,C04,087247,Patterson; Patrick H.,28,0,28,0
1653302175327,HUM 3,C05,087248,Patterson; Patrick H.,27,0,28,1
1653302175327,HUM 3,C06,087249,Patterson; Patrick H.,25,0,28,3
1653302175327,HUM 3,C07,087250,Patterson; Patrick H.,27,0,28,1
1653302175327,HUM 3,C08,087251,Patterson; Patrick H.,28,0,28,0
1653302175327,HUM 3,C09,087252,Patterson; Patrick H.,28,0,28,0
1653302175327,HUM 3,C10,087253,Patterson; Patrick H.,27,0,28,1
1653302175327,HUM 3,D01,087255,Lyon; Antony J.,24,0,28,4
1653302175327,HUM 3,D02,087256,Lyon; Antony J.,28,0,28,0
1653302175327,HUM 3,D03,087257,Lyon; Antony J.,0,0,0,0
1653302175327,HUM 3,D04,087258,Lyon; Antony J.,0,0,0,0
1653302175327,HUM 3,D05,087259,Lyon; Antony J.,27,0,28,1
1653302175327,HUM 3,D06,087260,Lyon; Antony J.,28,0,28,0
1653302175327,HUM 3,D07,087261,Lyon; Antony J.,21,0,28,7
1653302175327,HUM 3,D08,087262,Lyon; Antony J.,20,0,28,8
1653302175327,HUM 3,D09,087263,Lyon; Antony J.,28,0,28,0
1653302175327,HUM 3,D10,087264,Lyon; Antony J.,27,0,28,1
1653302175327,HUM 3,D11,087265,Lyon; Antony J.,30,0,30,0
1653302175327,HUM 3,D12,087266,Lyon; Antony J.,30,0,30,0
1653302175327,HUM 3,D13,087267,Lyon; Antony J.,26,0,28,2
1653302175327,HUM 3,D14,087268,Lyon; Antony J.,25,0,28,3
1653302175857,INTL 101,A01,088176,Day; Joel Keith,19,0,20,1
1653302175857,INTL 101,A02,088177,Day; Joel Keith,20,0,20,0
1653302175857,INTL 101,A03,088178,Day; Joel Keith,17,0,20,3
1653302175857,INTL 101,A04,088179,Day; Joel Keith,19,0,20,1
1653302175857,INTL 101,A05,088180,Day; Joel Keith,19,0,20,1
1653302175857,INTL 101,A06,088181,Day; Joel Keith,18,0,20,2
1653302176387,INTL 102,A01,088183,Walter; Barbara Florence,19,0,20,1
1653302176387,INTL 102,A02,088184,Walter; Barbara Florence,19,0,20,1
1653302176387,INTL 102,A03,088185,Walter; Barbara Florence,18,0,20,2
1653302176387,INTL 102,A04,088186,Walter; Barbara Florence,16,0,20,4
1653302176387,INTL 102,A05,088187,Walter; Barbara Florence,19,0,20,1
1653302176387,INTL 102,A06,088188,Walter; Barbara Florence,19,0,20,1
1653302176918,INTL 190,A00,088189,Auerbach; Bradford C,0,0,0,0
1653302176918,INTL 190,B00,088190,Auerbach; Bradford C,0,0,0,0
1653302176918,INTL 190,C00,088191,Fortier; Jana,0,0,0,0
1653302176918,INTL 190,D00,088192,Kshatriya; Krista C,0,0,0,0
1653302176918,INTL 190,E00,088193,Nadkarni; Vidya,0,0,0,0
1653302176918,INTL 190,F00,088194,Scott; Jeffrey F,0,0,0,0
1653302176918,INTL 190,G00,088195,Segui; Alan S,0,0,0,0
1653302176918,INTL 190,H00,088196,Segui; Alan S,0,0,0,0
1653302177443,INTL 190H,A00,088197,Gibson; Clark C,0,0,0,0
1653302178007,JAPN 10A,A01,086851,Maruyama; Rie,15,0,15,0
1653302178007,JAPN 10A,A02,086852,Maruyama; Rie,15,0,15,0
1653302178007,JAPN 10A,B01,086854,Staff,13,0,13,0
1653302178007,JAPN 10A,B02,086855,Staff,13,0,13,0
1653302178007,JAPN 10A,C01,086857,McKee; Mayumi Mochizuki,13,0,13,0
1653302178007,JAPN 10A,C02,086858,McKee; Mayumi Mochizuki,11,0,13,2
1653302178007,JAPN 10A,D01,086860,Sato; Kyoko,13,0,13,0
1653302178007,JAPN 10A,D02,086861,Sato; Kyoko,13,0,13,0
1653302178007,JAPN 10A,E01,086863,Kamioka; Sachiko,12,0,13,1
1653302178007,JAPN 10A,E02,086864,Kamioka; Sachiko,12,0,13,1
1653302178007,JAPN 10A,F01,086866,Sato; Kyoko,13,0,13,0
1653302178007,JAPN 10A,F02,086867,Sato; Kyoko,13,0,13,0
1653302178007,JAPN 10A,G01,086869,Maruyama; Rie,8,0,13,5
1653302178007,JAPN 10A,G02,086870,Maruyama; Rie,13,0,13,0
1653302178007,JAPN 10A,H01,086872,Kamioka; Sachiko,12,0,13,1
1653302178007,JAPN 10A,H02,086873,Kamioka; Sachiko,11,0,13,2
1653302178007,JAPN 10A,I01,086875,Staff,12,0,13,1
1653302178007,JAPN 10A,I02,086876,Staff,13,0,13,0
1653302178007,JAPN 10A,J01,086878,McKee; Mayumi Mochizuki,12,0,13,1
1653302178007,JAPN 10A,J02,086879,McKee; Mayumi Mochizuki,13,0,13,0
1653302178007,JAPN 10A,K01,086881,Inada; Minori,13,0,13,0
1653302178007,JAPN 10A,K02,086882,Inada; Minori,12,0,13,1
1653302178007,JAPN 10A,L01,086884,Tipton; Yuko,13,0,13,0
1653302178007,JAPN 10A,L02,086885,Tipton; Yuko,13,0,13,0
1653302178007,JAPN 10A,M01,086887,Inada; Minori,12,0,13,1
1653302178007,JAPN 10A,M02,086888,Inada; Minori,13,0,13,0
1653302178007,JAPN 10A,N01,086890,McKee; Mayumi Mochizuki,13,0,13,0
1653302178007,JAPN 10A,N02,086891,McKee; Mayumi Mochizuki,11,0,13,2
1653302178007,JAPN 10A,O01,086893,Staff,13,0,13,0
1653302178007,JAPN 10A,O02,086894,Staff,12,0,13,1
1653302178007,JAPN 10A,P01,086896,Tipton; Yuko,15,0,15,0
1653302178007,JAPN 10A,P02,086897,Tipton; Yuko,15,0,15,0
1653302178534,JAPN 20A,A01,086899,Simpson; Junko Tokuda,11,0,13,2
1653302178534,JAPN 20A,A02,086900,Simpson; Junko Tokuda,12,0,13,1
1653302178534,JAPN 20A,B01,086902,Takeda; Izumi,11,0,13,2
1653302178534,JAPN 20A,B02,086903,Takeda; Izumi,12,0,13,1
1653302178534,JAPN 20A,C01,086905,Ross; Kayoko F,12,0,13,1
1653302178534,JAPN 20A,C02,086906,Ross; Kayoko F,12,0,13,1
1653302178534,JAPN 20A,D01,086908,Takeda; Izumi,10,0,13,3
1653302178534,JAPN 20A,D02,086909,Takeda; Izumi,13,0,13,0
1653302178534,JAPN 20A,E01,086911,Maruyama; Rie,11,0,13,2
1653302178534,JAPN 20A,E02,086912,Maruyama; Rie,11,0,13,2
1653302178534,JAPN 20A,F01,086914,Kamioka; Sachiko,7,0,13,6
1653302178534,JAPN 20A,F02,086915,Kamioka; Sachiko,9,0,13,4
1653302178534,JAPN 20A,G01,086917,Ross; Kayoko F,13,0,13,0
1653302178534,JAPN 20A,G02,086918,Ross; Kayoko F,12,0,13,1
1653302179061,JAPN 130A,A01,086920,Simpson; Junko Tokuda,6,0,10,4
1653302179061,JAPN 130A,A02,086921,Simpson; Junko Tokuda,5,0,10,5
1653302179061,JAPN 130A,B01,086923,Ross; Kayoko F,9,0,10,1
1653302179061,JAPN 130A,B02,086924,Ross; Kayoko F,9,0,10,1
1653302179589,JAPN 135A,A00,086925,Inada; Minori,14,0,15,1
1653302179589,JAPN 135A,B00,086926,Takeda; Izumi,15,0,15,0
1653302180113,JAPN 140A,A00,086927,Sato; Kyoko,19,0,20,1
1653302180648,JWSP 1,A01,086445,Shuster; Alana,15,0,15,0
1653302180648,JWSP 1,A02,086446,Shuster; Alana,15,0,15,0
1653302181175,JWSP 104,A01,086448,Shuster; Alana,15,0,15,0
1653302181699,LATI 10,A01,093588,Kennemore; Amy Michelle,31,0,32,1
1653302181699,LATI 10,A02,093589,Kennemore; Amy Michelle,32,0,32,0
1653302181699,LATI 10,A03,093590,Kennemore; Amy Michelle,32,0,32,0
1653302182240,LATI 50,A01,093592,Kokinis; Troy Andreas,32,0,32,0
1653302182240,LATI 50,A02,093593,Kokinis; Troy Andreas,31,0,32,1
1653302182240,LATI 50,A03,093595,Kokinis; Troy Andreas,32,0,32,0
1653302182764,LATI 122A,A00,093649,Andrews; Abigail Leslie,0,0,0,0
1653302183333,LATI 180,A00,093597,Staff,36,0,40,4
1653302183866,LIAB 1A,A00,087085,Saab; Dima,13,0,14,1
1653302183866,LIAB 1A,B00,087086,Saab; Dima,13,0,14,1
1653302183866,LIAB 1A,C00,087087,Saab; Dima,14,0,14,0
1653302183866,LIAB 1A,D00,087088,El Cheddadi; Youniss,14,0,14,0
1653302184393,LIAB 1AX,A00,087089,Akjeje; Abdelhak,28,0,28,0
1653302184393,LIAB 1AX,B00,087091,Akjeje; Abdelhak,28,0,28,0
1653302184917,LIAB 1D,A00,087093,El Cheddadi; Youniss,13,0,14,1
1653302184917,LIAB 1D,B00,087094,El Cheddadi; Youniss,12,0,14,2
1653302185440,LIAB 1DX,A00,087095,Akjeje; Abdelhak,27,0,28,1
1653302185966,LIDS 19,001,095098,Goodall; Grant Todd,9999,0,9999,0
1653302185966,LIDS 19,002,095099,Goodall; Grant Todd,9999,0,9999,0
1653302185966,LIDS 19,003,095100,Goodall; Grant Todd,9999,0,9999,0
1653302185966,LIDS 19,004,095101,Goodall; Grant Todd,9999,0,9999,0
1653302185966,LIDS 19,005,095102,Goodall; Grant Todd,9999,0,9999,0
1653302185966,LIDS 19,006,095103,Goodall; Grant Todd,9999,0,9999,0
1653302185966,LIDS 19,007,095104,Goodall; Grant Todd,9999,0,9999,0
1653302185966,LIDS 19,008,095105,Goodall; Grant Todd,9999,0,9999,0
1653302185966,LIDS 19,009,095106,Goodall; Grant Todd,9999,0,9999,0
1653302185966,LIDS 19,010,095107,Goodall; Grant Todd,9999,0,9999,0
1653302185966,LIDS 19,011,095108,Goodall; Grant Todd,9999,0,9999,0
1653302185966,LIDS 19,012,095109,Goodall; Grant Todd,9999,0,9999,0
1653302186496,LIFR 1A,A00,087097,Goodall; Grant Todd,13,0,14,1
1653302186496,LIFR 1A,B00,087098,Goodall; Grant Todd,13,0,14,1
1653302186496,LIFR 1A,C00,087099,Goodall; Grant Todd,12,0,14,2
1653302186496,LIFR 1A,D00,087100,Goodall; Grant Todd,12,0,14,2
1653302186496,LIFR 1A,E00,087101,Goodall; Grant Todd,14,0,14,0
1653302186496,LIFR 1A,F00,087102,Goodall; Grant Todd,13,0,14,1
1653302187023,LIFR 1AX,A00,087103,Goodall; Grant Todd,27,0,28,1
1653302187023,LIFR 1AX,B00,087104,Goodall; Grant Todd,27,0,28,1
1653302187023,LIFR 1AX,C00,087105,Goodall; Grant Todd,25,0,28,3
1653302187550,LIFR 1B,A00,087106,Goodall; Grant Todd,14,0,14,0
1653302187550,LIFR 1B,B00,087107,Goodall; Grant Todd,13,0,14,1
1653302187550,LIFR 1B,C00,087108,Goodall; Grant Todd,13,0,14,1
1653302187550,LIFR 1B,D00,087109,Goodall; Grant Todd,13,0,14,1
1653302188077,LIFR 1BX,A00,087110,Goodall; Grant Todd,26,0,28,2
1653302188077,LIFR 1BX,B00,087111,Goodall; Grant Todd,26,0,28,2
1653302188605,LIFR 1D,A00,087112,Goodall; Grant Todd,14,0,14,0
1653302188605,LIFR 1D,B00,087113,Goodall; Grant Todd,12,0,14,2
1653302188605,LIFR 1D,C00,087114,Goodall; Grant Todd,11,0,14,3
1653302188605,LIFR 1D,D00,087115,Goodall; Grant Todd,10,0,14,4
1653302189128,LIFR 1DX,A00,087116,Goodall; Grant Todd,26,0,28,2
1653302189128,LIFR 1DX,B00,087117,Goodall; Grant Todd,23,0,28,5
1653302189652,LIFR 11,A00,087118,Goodall; Grant Todd,10,0,10,0
1653302190182,LIGM 1A,A00,087119,Riebeling; Elke,14,0,14,0
1653302190182,LIGM 1A,B00,087120,Riebeling; Elke,14,0,14,0
1653302190182,LIGM 1A,C00,087121,Riebeling; Elke,12,0,14,2
1653302190182,LIGM 1A,D00,087122,Riebeling; Elke,14,0,14,0
1653302190182,LIGM 1A,E00,087123,Riebeling; Elke,14,0,14,0
1653302190709,LIGM 1AX,A00,087124,Riebeling; Elke,28,0,28,0
1653302190709,LIGM 1AX,B00,087125,Riebeling; Elke,28,0,28,0
1653302190709,LIGM 1AX,C00,087126,Riebeling; Elke,27,0,28,1
1653302191234,LIGM 1D,A00,087127,Riebeling; Elke,14,0,14,0
1653302191234,LIGM 1D,B00,087128,Riebeling; Elke,12,0,14,2
1653302191757,LIGM 1DX,A00,087129,Riebeling; Elke,26,0,28,2
1653302192282,LIGM 11,A00,087130,Goodall; Grant Todd,10,0,10,0
1653302192812,LIGN 5,A00,087005,Goodall; Grant Todd,74,0,75,1
1653302193339,LIGN 7,A00,087006,Mayberry; Rachel,139,0,146,7
1653302193862,LIGN 8,A00,087007,McIntosh; Justin Daniel,244,0,250,6
1653302194387,LIGN 17,A00,087008,Kehler; Andrew Scott,218,0,220,2
1653302194912,LIGN 101,A01,087010,Styler; William Francis,29,0,30,1
1653302194912,LIGN 101,A02,087011,Styler; William Francis,29,0,30,1
1653302194912,LIGN 101,A03,087012,Styler; William Francis,29,0,30,1
1653302194912,LIGN 101,A04,087013,Styler; William Francis,29,0,30,1
1653302195436,LIGN 110,A01,087015,Garellek; Marc,29,0,30,1
1653302195436,LIGN 110,A02,087016,Garellek; Marc,26,0,30,4
1653302195436,LIGN 110,A03,087017,Garellek; Marc,26,0,30,4
1653302195436,LIGN 110,A04,087018,Garellek; Marc,28,0,30,2
1653302195959,LIGN 121,A01,087020,Drake; Emily C,23,0,25,2
1653302195959,LIGN 121,A02,087021,Drake; Emily C,24,0,25,1
1653302196484,LIGN 150,A00,093702,Staff,71,0,75,4
1653302197007,LIGN 152,A00,087023,Caballero; Gabriela Hernandez,16,0,20,4
1653302197534,LIGN 154,A00,087024,Kluender; Robert,70,0,70,0
1653302198062,LIGN 167,A00,087025,Bergen; Leon,70,0,100,30
1653302198590,LIGN 187,A00,087026,McIntosh; Justin Daniel,20,0,20,0
1653302199122,LIHL 112F,A00,086505,Alicio; Atilio,25,0,28,3
1653302199651,LIHL 114F,A00,086506,Staff,21,0,28,7
1653302200180,LIHL 117F,A00,086508,Sadegholvad; Elham,20,0,20,0
1653302200706,LIHL 118,A00,086509,Staff,25,0,28,3
1653302201227,LIHL 119F,A00,086510,Staff,26,0,28,2
1653302201751,LIHL 124F,A00,086511,Staff,27,0,28,1
1653302202274,LIHL 132F,A00,086512,Alicio; Atilio,28,0,28,0
1653302202799,LIIT 1A,A00,087131,Riebeling; Elke,14,0,14,0
1653302202799,LIIT 1A,B00,087132,Riebeling; Elke,14,0,14,0
1653302202799,LIIT 1A,C00,087133,Riebeling; Elke,12,0,14,2
1653302202799,LIIT 1A,D00,087134,Riebeling; Elke,14,0,14,0
1653302203322,LIIT 1AX,A00,087135,Riebeling; Elke,28,0,28,0
1653302203322,LIIT 1AX,B00,087136,Riebeling; Elke,26,0,28,2
1653302203846,LIPO 1A,A00,087137,Paladini; Denise,14,0,14,0
1653302203846,LIPO 1A,B00,087138,Paladini; Denise,10,0,14,4
1653302204370,LIPO 1AX,A00,087139,De Abreu; Cassia,18,0,22,4
1653302204370,LIPO 1AX,B00,087140,De Abreu; Cassia,22,0,22,0
1653302204894,LIPO 1D,A00,087141,Paladini; Denise,10,0,14,4
1653302205491,LIPO 1DX,A00,087143,De Abreu; Cassia,10,0,14,4
1653302206016,LISL 1A,A00,087145,Lott; Margaret S.,10,0,14,4
1653302206016,LISL 1A,B00,087146,Lott; Margaret S.,14,0,14,0
1653302206016,LISL 1A,C00,087147,Lott; Margaret S.,10,0,14,4
1653302206016,LISL 1A,D00,087148,Lott; Margaret S.,11,0,14,3
1653302206016,LISL 1A,E00,087149,Lott; Margaret S.,13,0,14,1
1653302206016,LISL 1A,F00,087150,Lott; Margaret S.,12,0,14,2
1653302206016,LISL 1A,G00,087151,Lott; Margaret S.,13,0,14,1
1653302206016,LISL 1A,H00,087152,Lott; Margaret S.,13,0,14,1
1653302206544,LISL 1AX,A00,087153,Lott; Margaret S.,28,0,28,0
1653302206544,LISL 1AX,B00,087154,Lott; Margaret S.,25,0,28,3
1653302206544,LISL 1AX,C00,087155,Lott; Margaret S.,25,0,28,3
1653302206544,LISL 1AX,D00,087156,Lott; Margaret S.,24,0,28,4
1653302207074,LISL 1B,A00,087157,Lott; Margaret S.,13,0,14,1
1653302207074,LISL 1B,B00,087158,Lott; Margaret S.,12,0,14,2
1653302207074,LISL 1B,C00,087159,Lott; Margaret S.,11,0,14,3
1653302207074,LISL 1B,D00,087160,Lott; Margaret S.,13,0,14,1
1653302207074,LISL 1B,E00,087161,Lott; Margaret S.,13,0,14,1
1653302207074,LISL 1B,F00,087162,Lott; Margaret S.,13,0,14,1
1653302207605,LISL 1BX,A00,087163,Lott; Margaret S.,23,0,28,5
1653302207605,LISL 1BX,B00,087164,Lott; Margaret S.,26,0,28,2
1653302207605,LISL 1BX,C00,087165,Lott; Margaret S.,28,0,28,0
1653302208133,LISL 1D,A00,087166,Lott; Margaret S.,14,0,14,0
1653302208133,LISL 1D,B00,087167,Lott; Margaret S.,14,0,14,0
1653302208133,LISL 1D,C00,087168,Lott; Margaret S.,8,0,14,6
1653302208133,LISL 1D,D00,087169,Lott; Margaret S.,13,0,14,1
1653302208658,LISL 1DX,A00,087170,Lott; Margaret S.,23,0,28,5
1653302208658,LISL 1DX,B00,087171,Lott; Margaret S.,26,0,28,2
1653302209183,LISP 1A,001,087172,Munoz Sanchez; Alicia,13,0,14,1
1653302209183,LISP 1A,002,087173,Munoz Sanchez; Alicia,12,0,14,2
1653302209183,LISP 1A,003,087174,Munoz Sanchez; Alicia,13,0,14,1
1653302209183,LISP 1A,004,087175,Munoz Sanchez; Alicia,12,0,14,2
1653302209183,LISP 1A,005,087176,Munoz Sanchez; Alicia,10,0,14,4
1653302209183,LISP 1A,006,087177,Munoz Sanchez; Alicia,12,0,14,2
1653302209183,LISP 1A,007,087178,Munoz Sanchez; Alicia,12,0,14,2
1653302209183,LISP 1A,008,087179,Munoz Sanchez; Alicia,14,0,14,0
1653302209706,LISP 1AX,A00,087180,Munoz Sanchez; Alicia,27,0,28,1
1653302209706,LISP 1AX,B00,087181,Munoz Sanchez; Alicia,24,0,28,4
1653302209706,LISP 1AX,C00,087182,Munoz Sanchez; Alicia,25,0,28,3
1653302209706,LISP 1AX,D00,087183,Munoz Sanchez; Alicia,25,0,28,3
1653302210238,LISP 1B,001,087184,Munoz Sanchez; Alicia,14,0,14,0
1653302210238,LISP 1B,002,087185,Munoz Sanchez; Alicia,14,0,14,0
1653302210238,LISP 1B,003,087186,Munoz Sanchez; Alicia,11,0,14,3
1653302210238,LISP 1B,004,087187,Munoz Sanchez; Alicia,12,0,14,2
1653302210238,LISP 1B,005,087188,Munoz Sanchez; Alicia,13,0,14,1
1653302210238,LISP 1B,006,087189,Munoz Sanchez; Alicia,13,0,14,1
1653302210238,LISP 1B,007,087190,Munoz Sanchez; Alicia,14,0,14,0
1653302210238,LISP 1B,008,087191,Munoz Sanchez; Alicia,13,0,14,1
1653302210238,LISP 1B,009,087192,Munoz Sanchez; Alicia,14,0,14,0
1653302210238,LISP 1B,010,087193,Munoz Sanchez; Alicia,13,0,14,1
1653302210238,LISP 1B,011,087194,Munoz Sanchez; Alicia,14,0,14,0
1653302210767,LISP 1BX,A00,087195,Munoz Sanchez; Alicia,28,0,28,0
1653302210767,LISP 1BX,B00,087196,Munoz Sanchez; Alicia,26,0,28,2
1653302210767,LISP 1BX,C00,087197,Munoz Sanchez; Alicia,26,0,28,2
1653302210767,LISP 1BX,D00,087198,Munoz Sanchez; Alicia,26,0,28,2
1653302210767,LISP 1BX,E00,087199,Munoz Sanchez; Alicia,28,0,28,0
1653302211293,LISP 1D,001,087200,Munoz Sanchez; Alicia,13,0,14,1
1653302211293,LISP 1D,002,087201,Munoz Sanchez; Alicia,14,0,14,0
1653302211293,LISP 1D,003,087202,Munoz Sanchez; Alicia,8,0,14,6
1653302211293,LISP 1D,004,087203,Munoz Sanchez; Alicia,5,0,14,9
1653302211293,LISP 1D,005,087204,Munoz Sanchez; Alicia,11,0,14,3
1653302211293,LISP 1D,006,087205,Munoz Sanchez; Alicia,13,0,14,1
1653302211293,LISP 1D,007,087206,Munoz Sanchez; Alicia,13,0,14,1
1653302211293,LISP 1D,008,087207,Munoz Sanchez; Alicia,13,0,14,1
1653302211293,LISP 1D,009,087208,Munoz Sanchez; Alicia,14,0,14,0
1653302211293,LISP 1D,010,087209,Munoz Sanchez; Alicia,12,0,14,2
1653302211293,LISP 1D,011,087210,Munoz Sanchez; Alicia,13,0,14,1
1653302211293,LISP 1D,012,087211,Munoz Sanchez; Alicia,14,0,14,0
1653302211293,LISP 1D,013,087212,Munoz Sanchez; Alicia,14,0,14,0
1653302211293,LISP 1D,014,087213,Munoz Sanchez; Alicia,14,0,14,0
1653302211819,LISP 1DX,A00,087214,Munoz Sanchez; Alicia,27,0,28,1
1653302211819,LISP 1DX,B00,087215,Munoz Sanchez; Alicia,23,0,28,5
1653302211819,LISP 1DX,C00,087216,Munoz Sanchez; Alicia,23,0,28,5
1653302211819,LISP 1DX,D00,087217,Munoz Sanchez; Alicia,25,0,28,3
1653302211819,LISP 1DX,E00,087218,Munoz Sanchez; Alicia,27,0,28,1
1653302211819,LISP 1DX,F00,087219,Munoz Sanchez; Alicia,25,0,28,3
1653302211819,LISP 1DX,G00,087220,Munoz Sanchez; Alicia,28,0,28,0
1653302212345,LISP 15,A00,087221,Munoz Sanchez; Alicia,19,0,20,1
1653302212873,LISP 18,A00,087222,Munoz Sanchez; Alicia,15,0,20,5
1653302213399,LTAM 110,A00,087352,Chacon; Gloria Elizabeth,35,0,40,5
1653302213923,LTCS 87,A00,094011,Nguyen; Hoang Tan,19,0,20,1
1653302214447,LTCS 111,A00,087353,Vitkus; Daniel J.,40,0,40,0
1653302214976,LTCS 119,A00,087354,Nguyen; Hoang Tan,29,0,30,1
1653302215506,LTCS 130,A00,087355,Kim; Joo Ok,37,0,40,3
1653302216031,LTCS 165,A00,087356,Kim; Joo Ok,38,0,40,2
1653302216556,LTEA 120A,A00,087357,Fiss; Geraldine Anna,291,0,300,9
1653302217084,LTEA 140,A00,094009,Lee; Jin-Kyung,28,0,32,4
1653302217612,LTEA 142,A00,087358,Lee; Jin-Kyung,102,0,120,18
1653302218139,LTEN 21,A01,087275,Lampert-Weissig; Lisa,25,0,25,0
1653302218139,LTEN 21,A02,087276,Lampert-Weissig; Lisa,25,0,25,0
1653302218139,LTEN 21,A03,087277,Lampert-Weissig; Lisa,25,0,25,0
1653302218139,LTEN 21,A04,087278,Lampert-Weissig; Lisa,25,0,25,0
1653302218664,LTEN 25,A01,087280,Johnson; Sara E.,25,0,25,0
1653302218664,LTEN 25,A02,087281,Johnson; Sara E.,25,0,25,0
1653302218664,LTEN 25,A03,087282,Johnson; Sara E.,23,0,25,2
1653302218664,LTEN 25,A04,087283,Johnson; Sara E.,25,0,25,0
1653302219189,LTEN 29,A01,087285,Ruiz; Ariana,24,0,25,1
1653302219189,LTEN 29,A02,087286,Ruiz; Ariana,25,0,25,0
1653302219189,LTEN 29,A03,087287,Ruiz; Ariana,24,0,25,1
1653302219189,LTEN 29,A04,087288,Ruiz; Ariana,24,0,25,1
1653302219712,LTEN 107,A00,087359,Lampert-Weissig; Lisa,39,0,40,1
1653302220238,LTEN 117,A00,087360,Vitkus; Daniel J.,40,0,40,0
1653302220762,LTEN 127,A00,087361,Loose; Margaret,38,0,40,2
1653302221286,LTEN 142,A00,094010,Loose; Margaret,38,0,40,2
1653302221809,LTEN 148,A00,087363,Walkiewicz; Kathryn A,40,0,40,0
1653302222333,LTEN 152,A00,087364,Walkiewicz; Kathryn A,37,0,40,3
1653302222861,LTEN 180,A00,087365,Ruiz; Ariana,18,0,20,2
1653302223384,LTFR 2A,A01,087290,Ploye; Catherine,23,0,25,2
1653302223909,LTFR 2B,A01,087292,Ploye; Catherine,25,0,25,0
1653302224433,LTFR 104,A00,087366,Ploye; Catherine,25,0,25,0
1653302224961,LTFR 116,A00,087367,Zhiri; Oumelbanine,13,0,15,2
1653302225485,LTGK 1,A00,087293,Myerston Santana; Jacobo,27,0,30,3
1653302226009,LTGK 103,A00,087368,duBois; Page Ann,14,0,15,1
1653302226535,LTGM 2A,A01,087295,Fischer-Grunski; Eva K,24,0,25,1
1653302227062,LTIT 2A,A01,087297,De Marchi Gherini; Adriana,24,0,25,1
1653302227588,LTKO 1A,A01,087299,Staff,24,0,25,1
1653302227588,LTKO 1A,B01,087301,Staff,25,0,25,0
1653302227588,LTKO 1A,C01,087303,Staff,25,0,25,0
1653302227588,LTKO 1A,D01,087305,Staff,25,0,25,0
1653302227588,LTKO 1A,E01,087307,Staff,24,0,25,1
1653302227588,LTKO 1A,F01,087309,Staff,25,0,25,0
1653302227588,LTKO 1A,G01,087311,Staff,25,0,25,0
1653302227588,LTKO 1A,H01,087313,Staff,24,0,25,1
1653302227588,LTKO 1A,I01,087315,Staff,25,0,25,0
1653302228115,LTKO 2A,A01,087317,Staff,24,0,25,1
1653302228115,LTKO 2A,B01,087319,Staff,22,0,25,3
1653302228115,LTKO 2A,C01,087321,Lee; Jeyseon,24,0,25,1
1653302228649,LTKO 130,A00,087369,Lee; Jeyseon,25,0,25,0
1653302229176,LTLA 1,A00,087322,Murray; Kourtney Kristine,38,0,40,2
1653302229704,LTLA 100,A00,087371,Kelting; Edward William,23,0,25,2
1653302230228,LTRU 1A,A01,087324,Wells; Patricia Rebecca,23,0,25,2
1653302230753,LTRU 2A,A01,087326,Wells; Patricia Rebecca,20,0,20,0
1653302231281,LTRU 104B,A01,087373,Wells; Patricia Rebecca,14,0,15,1
1653302231810,LTSP 2A,A01,087328,Staff,25,0,25,0
1653302231810,LTSP 2A,B01,087330,Staff,22,0,25,3
1653302231810,LTSP 2A,C01,087332,Staff,22,0,25,3
1653302232335,LTSP 2B,A01,087334,Staff,22,0,25,3
1653302232335,LTSP 2B,B01,087336,Staff,19,0,25,6
1653302232859,LTSP 2D,A00,087337,Staff,25,0,25,0
1653302232859,LTSP 2D,B00,087338,Staff,25,0,25,0
1653302232859,LTSP 2D,C00,087339,Staff,25,0,25,0
1653302233385,LTSP 100A,A00,087374,Arcos Herrera; Carol,23,0,25,2
1653302233912,LTSP 116,A00,087375,Blanco; John D,29,0,30,1
1653302234441,LTSP 140,A00,087376,Chacon; Gloria Elizabeth,30,0,30,0
1653302234963,LTSP 175,A00,087377,Arcos Herrera; Carol,30,0,30,0
1653302235488,LTTH 150,A00,087379,Cohen; Alain J. J.,40,0,40,0
1653302236011,LTWL 19A,A00,087340,Myerston Santana; Jacobo,39,0,40,1
1653302236537,LTWL 87,A00,094012,Lampert-Weissig; Lisa,20,0,20,0
1653302237059,LTWL 116,A00,087380,Nguyen; Hoang Tan,60,0,60,0
1653302237587,LTWL 120,A00,087381,Fiss; Geraldine Anna,37,0,40,3
1653302238111,LTWL 172,A00,087382,De Marchi Gherini; Adriana,40,0,40,0
1653302238634,LTWL 180,A00,087383,Kontje; Todd Curtis,39,0,40,1
1653302239158,LTWL 194,A00,087384,Suzuki; Erin M.,31,0,32,1
1653302239681,LTWR 8A,A01,087342,Jemc; Jaclyn,24,0,25,1
1653302239681,LTWR 8A,A02,087343,Jemc; Jaclyn,25,0,25,0
1653302239681,LTWR 8A,A03,087344,Jemc; Jaclyn,24,0,25,1
1653302239681,LTWR 8A,A04,087345,Jemc; Jaclyn,24,0,25,1
1653302240209,LTWR 8C,A01,087348,Forbes; Camille,25,0,25,0
1653302240209,LTWR 8C,A02,087349,Forbes; Camille,25,0,25,0
1653302240209,LTWR 8C,A03,087350,Forbes; Camille,25,0,25,0
1653302240209,LTWR 8C,A04,087351,Forbes; Camille,23,0,25,2
1653302240733,LTWR 100,A00,087385,Staff,12,0,15,3
1653302241256,LTWR 102,A00,087386,Staff,14,0,15,1
1653302241779,LTWR 115,A00,087387,Carroll; Amy Sara,24,0,30,6
1653302242302,LTWR 119,A00,087388,Staff,22,0,30,8
1653302242831,LTWR 140,A00,087389,Carroll; Amy Sara,37,0,40,3
1653302243391,LTWR 194,A00,087390,Som; Brandon D,35,0,40,5
1653302243923,MAE 2,A01,090334,Anderson; Mark Ronald,8,0,8,0
1653302243923,MAE 2,A02,090335,Anderson; Mark Ronald,8,0,8,0
1653302243923,MAE 2,A03,090336,Anderson; Mark Ronald,8,0,8,0
1653302243923,MAE 2,A04,090337,Anderson; Mark Ronald,8,0,8,0
1653302243923,MAE 2,A05,090338,Anderson; Mark Ronald,8,0,8,0
1653302243923,MAE 2,A06,090339,Anderson; Mark Ronald,8,0,8,0
1653302243923,MAE 2,A07,090340,Anderson; Mark Ronald,8,0,8,0
1653302243923,MAE 2,A08,090341,Anderson; Mark Ronald,7,0,8,1
1653302243923,MAE 2,A09,090342,Anderson; Mark Ronald,8,0,8,0
1653302244446,MAE 3,A01,090344,Delson; Nathan Joseph,21,0,22,1
1653302244446,MAE 3,A02,090345,Delson; Nathan Joseph,20,0,22,2
1653302244446,MAE 3,A03,090346,Delson; Nathan Joseph,21,0,22,1
1653302244446,MAE 3,A04,090347,Delson; Nathan Joseph,22,0,22,0
1653302244446,MAE 3,B01,090349,Qi; Huihui,18,0,22,4
1653302244446,MAE 3,B02,090350,Qi; Huihui,17,0,22,5
1653302244446,MAE 3,B03,090351,Qi; Huihui,20,0,22,2
1653302244446,MAE 3,B04,090352,Qi; Huihui,19,0,22,3
1653302244971,MAE 8,A01,090354,Pham; Hieu Tan,182,0,185,3
1653302245495,MAE 11,A00,090355,Nomura; Keiko K.,155,0,165,10
1653302246019,MAE 20,A00,090356,Bandaru; Prabhakar,160,0,160,0
1653302246019,MAE 20,B00,090357,Evdokimenko; Ekaterina,145,0,160,15
1653302246544,MAE 21,A01,090359,Cai; Shengqiang,8,0,9,1
1653302246544,MAE 21,A02,090360,Cai; Shengqiang,9,0,9,0
1653302246544,MAE 21,A03,090361,Cai; Shengqiang,6,0,9,3
1653302246544,MAE 21,A04,090362,Cai; Shengqiang,7,0,9,2
1653302246544,MAE 21,A05,090363,Cai; Shengqiang,0,0,0,0
1653302246544,MAE 21,A06,090364,Cai; Shengqiang,9,0,9,0
1653302246544,MAE 21,A07,090365,Cai; Shengqiang,9,0,9,0
1653302246544,MAE 21,A08,090366,Cai; Shengqiang,8,0,9,1
1653302246544,MAE 21,A09,090367,Cai; Shengqiang,8,0,9,1
1653302246544,MAE 21,A10,090368,Cai; Shengqiang,0,0,0,0
1653302246544,MAE 21,A11,090369,Cai; Shengqiang,9,0,9,0
1653302246544,MAE 21,A12,090370,Cai; Shengqiang,8,0,9,1
1653302247074,MAE 30A,A00,090371,Lal; Ratnesh,72,0,75,3
1653302247603,MAE 40,A00,090372,Bitmead; Robert R.,167,0,175,8
1653302248130,MAE 101A,A00,090373,Bahadori; Mohammad Yousef,105,0,115,10
1653302248655,MAE 101C,A00,090374,Poulikakos; Lisa Voula,41,0,110,69
1653302248655,MAE 101C,B00,090375,Chen; Renkun,96,0,110,14
1653302249181,MAE 104,A00,090376,Sanchez; Antonio Luis,78,0,120,42
1653302249705,MAE 105,A00,090377,Saintillan; David,154,0,170,16
1653302250227,MAE 107,A00,090378,Lindsey; Stephanie,104,0,110,6
1653302250227,MAE 107,B00,090379,Tolley; Michael Thomas,85,0,110,25
1653302250750,MAE 118,A00,090380,Krasheninnikov; Sergei,27,0,45,18
1653302251274,MAE 131A,A00,090381,Ghazinejad; Maziar,70,0,75,5
1653302251803,MAE 133,A00,090382,Frazier; Michael,26,0,33,7
1653302252328,MAE 143A,A00,090383,de Oliveira; Mauricio,74,0,100,26
1653302252858,MAE 144,A00,090384,Bewley; Thomas R,50,0,70,20
1653302253387,MAE 148,A01,091597,Staff,32,0,32,0
1653302253911,MAE 150,A00,090385,Friend; James Robert,69,0,90,21
1653302253911,MAE 150,B00,090386,Ghazinejad; Maziar,4,0,90,86
1653302254439,MAE 152,A00,090387,Tynan; George Robert,0,0,16,16
1653302254439,MAE 152,B00,090388,Tynan; George Robert,0,0,16,16
1653302254439,MAE 152,C00,090389,Tynan; George Robert,0,0,16,16
1653302254439,MAE 152,D00,090390,Tynan; George Robert,0,0,16,16
1653302254969,MAE 156A,A01,090392,Delson; Nathan Joseph,2,0,12,10
1653302254969,MAE 156A,A02,090393,Delson; Nathan Joseph,1,0,12,11
1653302254969,MAE 156A,A03,090394,Delson; Nathan Joseph,4,0,12,8
1653302255499,MAE 170,A01,090396,Lubarda; Marko,14,0,30,16
1653302255499,MAE 170,A02,090397,Lubarda; Marko,19,0,30,11
1653302255499,MAE 170,A03,090398,Lubarda; Marko,28,0,30,2
1653302255499,MAE 170,A04,090399,Lubarda; Marko,20,0,30,10
1653302255499,MAE 170,B01,090401,Diagne; Mamadou Lamine,30,0,30,0
1653302255499,MAE 170,B02,090402,Diagne; Mamadou Lamine,27,0,30,3
1653302255499,MAE 170,B03,090403,Diagne; Mamadou Lamine,28,0,30,2
1653302255499,MAE 170,B04,090404,Diagne; Mamadou Lamine,28,0,30,2
1653302256022,MAE 180A,A00,090405,McEneaney; William Michael,110,0,125,15
1653302256546,MAE 181,A00,090406,Bahadori; Mohammad Yousef,46,0,60,14
1653302257071,MAE 190,A00,090407,Anderson; Mark Ronald,27,0,45,18
1653302257595,MAE 191,A01,090409,Qi; Huihui,25,0,32,7
1653302258137,MATH 2,A01,089123,Hammock; Frances H,0,0,0,0
1653302258137,MATH 2,B01,089126,Hammock; Frances H,0,0,0,0
1653302258137,MATH 2,C01,089129,Hammock; Frances H,0,0,0,0
1653302258137,MATH 2,D01,094201,Harel; Guershon,0,0,0,0
1653302258769,MATH 3C,A01,089132,Bowers; Adam R.,0,0,0,0
1653302258769,MATH 3C,A02,089133,Bowers; Adam R.,0,0,0,0
1653302258769,MATH 3C,A03,089134,Bowers; Adam R.,0,0,0,0
1653302258769,MATH 3C,A04,089135,Bowers; Adam R.,0,0,0,0
1653302258769,MATH 3C,A05,089136,Bowers; Adam R.,0,0,0,0
1653302258769,MATH 3C,A06,089137,Bowers; Adam R.,0,0,0,0
1653302258769,MATH 3C,A07,089138,Bowers; Adam R.,0,0,0,0
1653302258769,MATH 3C,A08,089139,Bowers; Adam R.,0,0,0,0
1653302258769,MATH 3C,A09,089140,Bowers; Adam R.,0,0,0,0
1653302258769,MATH 3C,A10,089141,Bowers; Adam R.,0,0,0,0
1653302258769,MATH 3C,A11,089142,Bowers; Adam R.,0,0,0,0
1653302258769,MATH 3C,A12,089143,Bowers; Adam R.,0,0,0,0
1653302258769,MATH 3C,A13,089144,Bowers; Adam R.,0,0,0,0
1653302258769,MATH 3C,A14,089145,Bowers; Adam R.,0,0,0,0
1653302258769,MATH 3C,A15,089146,Bowers; Adam R.,0,0,0,0
1653302258769,MATH 3C,A16,089147,Bowers; Adam R.,0,0,0,0
1653302258769,MATH 3C,A17,089148,Bowers; Adam R.,0,0,0,0
1653302258769,MATH 3C,A18,089149,Bowers; Adam R.,0,0,0,0
1653302258769,MATH 3C,A19,089150,Bowers; Adam R.,0,0,0,0
1653302258769,MATH 3C,A20,089151,Bowers; Adam R.,0,0,0,0
1653302258769,MATH 3C,A21,089152,Bowers; Adam R.,0,0,0,0
1653302258769,MATH 3C,A22,089153,Bowers; Adam R.,0,0,0,0
1653302258769,MATH 3C,A23,089154,Bowers; Adam R.,0,0,0,0
1653302258769,MATH 3C,A24,089155,Bowers; Adam R.,0,0,0,0
1653302258769,MATH 3C,B01,089158,Staff,0,0,0,0
1653302258769,MATH 3C,B02,089159,Staff,0,0,0,0
1653302258769,MATH 3C,B03,089160,Staff,0,0,0,0
1653302258769,MATH 3C,B04,089161,Staff,0,0,0,0
1653302258769,MATH 3C,C01,094244,Staff,0,0,0,0
1653302258769,MATH 3C,C02,094245,Staff,0,0,0,0
1653302258769,MATH 3C,C03,094246,Staff,0,0,0,0
1653302258769,MATH 3C,C04,094247,Staff,0,0,0,0
1653302259301,MATH 4C,A01,089164,Staff,0,0,0,0
1653302259301,MATH 4C,A02,089165,Staff,0,0,0,0
1653302259301,MATH 4C,A03,089166,Staff,0,0,0,0
1653302259301,MATH 4C,B01,089169,Ganzberger; Geoffrey Michael,0,0,0,0
1653302259301,MATH 4C,B02,089170,Ganzberger; Geoffrey Michael,0,0,0,0
1653302259301,MATH 4C,B03,089171,Ganzberger; Geoffrey Michael,0,0,0,0
1653302259301,MATH 4C,C01,089174,Ganzberger; Geoffrey Michael,0,0,0,0
1653302259301,MATH 4C,C02,089175,Ganzberger; Geoffrey Michael,0,0,0,0
1653302259301,MATH 4C,C03,089176,Ganzberger; Geoffrey Michael,0,0,0,0
1653302259301,MATH 4C,D01,094249,Ganzberger; Geoffrey Michael,0,0,0,0
1653302259301,MATH 4C,D02,094250,Ganzberger; Geoffrey Michael,0,0,0,0
1653302259301,MATH 4C,D03,094251,Ganzberger; Geoffrey Michael,0,0,0,0
1653302259833,MATH 10A,A01,089179,Jin; Muzhi,5,0,5,0
1653302259833,MATH 10A,A02,089180,Jin; Muzhi,5,0,5,0
1653302259833,MATH 10A,A03,089181,Jin; Muzhi,4,0,5,1
1653302259833,MATH 10A,A04,089182,Jin; Muzhi,4,0,5,1
1653302259833,MATH 10A,A05,089183,Jin; Muzhi,5,0,5,0
1653302259833,MATH 10A,A06,089184,Jin; Muzhi,5,0,5,0
1653302259833,MATH 10A,A07,089185,Jin; Muzhi,5,0,5,0
1653302259833,MATH 10A,A08,089186,Jin; Muzhi,5,0,5,0
1653302259833,MATH 10A,B01,089188,Stevens; Laura Jeanne,1,0,5,4
1653302259833,MATH 10A,B02,089189,Stevens; Laura Jeanne,4,0,5,1
1653302259833,MATH 10A,B03,089190,Stevens; Laura Jeanne,4,0,5,1
1653302259833,MATH 10A,B04,089191,Stevens; Laura Jeanne,5,0,5,0
1653302259833,MATH 10A,B05,089192,Stevens; Laura Jeanne,4,0,5,1
1653302259833,MATH 10A,B06,089193,Stevens; Laura Jeanne,5,0,5,0
1653302259833,MATH 10A,B07,089194,Stevens; Laura Jeanne,5,0,5,0
1653302259833,MATH 10A,B08,089195,Stevens; Laura Jeanne,4,0,5,1
1653302259833,MATH 10A,C01,089197,Jin; Muzhi,1,0,5,4
1653302259833,MATH 10A,C02,089198,Jin; Muzhi,5,0,5,0
1653302259833,MATH 10A,C03,089199,Jin; Muzhi,5,0,5,0
1653302259833,MATH 10A,C04,089200,Jin; Muzhi,5,0,5,0
1653302259833,MATH 10A,C05,089201,Jin; Muzhi,5,0,5,0
1653302259833,MATH 10A,C06,089202,Jin; Muzhi,5,0,5,0
1653302259833,MATH 10A,D01,089204,Upton; James Thomas,4,0,5,1
1653302259833,MATH 10A,D02,089205,Upton; James Thomas,5,0,5,0
1653302259833,MATH 10A,D03,089206,Upton; James Thomas,5,0,5,0
1653302259833,MATH 10A,D04,089207,Upton; James Thomas,5,0,5,0
1653302259833,MATH 10A,E01,089211,Greenfeld; Be'Eri,5,0,5,0
1653302259833,MATH 10A,E02,089212,Greenfeld; Be'Eri,3,0,5,2
1653302259833,MATH 10A,E03,089213,Greenfeld; Be'Eri,4,0,5,1
1653302259833,MATH 10A,E04,089214,Greenfeld; Be'Eri,5,0,5,0
1653302259833,MATH 10A,E05,089215,Greenfeld; Be'Eri,5,0,5,0
1653302259833,MATH 10A,E06,089216,Greenfeld; Be'Eri,5,0,5,0
1653302260368,MATH 10B,A01,089218,Stevens; Laura Jeanne,7,0,8,1
1653302260368,MATH 10B,A02,089219,Stevens; Laura Jeanne,7,0,8,1
1653302260368,MATH 10B,A03,089220,Stevens; Laura Jeanne,8,0,8,0
1653302260368,MATH 10B,A04,089221,Stevens; Laura Jeanne,6,0,8,2
1653302260368,MATH 10B,A05,089222,Stevens; Laura Jeanne,2,0,8,6
1653302260368,MATH 10B,A06,089223,Stevens; Laura Jeanne,0,0,8,8
1653302260368,MATH 10B,A07,089224,Stevens; Laura Jeanne,6,0,8,2
1653302260368,MATH 10B,A08,089225,Stevens; Laura Jeanne,4,0,8,4
1653302260368,MATH 10B,B01,089227,Staff,8,0,8,0
1653302260368,MATH 10B,B02,089228,Staff,8,0,8,0
1653302260368,MATH 10B,B03,089229,Staff,7,0,8,1
1653302260368,MATH 10B,B04,089230,Staff,8,0,8,0
1653302260368,MATH 10B,B05,089231,Staff,8,0,8,0
1653302260368,MATH 10B,B06,089232,Staff,8,0,8,0
1653302260368,MATH 10B,B07,089233,Staff,8,0,8,0
1653302260368,MATH 10B,B08,089234,Staff,8,0,8,0
1653302260368,MATH 10B,C01,089236,McKinley; Gweneth Anne,4,0,8,4
1653302260368,MATH 10B,C02,089237,McKinley; Gweneth Anne,8,0,8,0
1653302260368,MATH 10B,C03,089238,McKinley; Gweneth Anne,8,0,8,0
1653302260368,MATH 10B,C04,089239,McKinley; Gweneth Anne,8,0,8,0
1653302260368,MATH 10B,C05,089240,McKinley; Gweneth Anne,8,0,8,0
1653302260368,MATH 10B,C06,089241,McKinley; Gweneth Anne,8,0,8,0
1653302260896,MATH 10C,A01,089243,Staff,13,0,20,7
1653302260896,MATH 10C,A02,089244,Staff,20,0,20,0
1653302260896,MATH 10C,A03,089245,Staff,18,0,20,2
1653302260896,MATH 10C,A04,089246,Staff,20,0,20,0
1653302260896,MATH 10C,A05,089247,Staff,19,0,20,1
1653302260896,MATH 10C,A06,089248,Staff,20,0,20,0
1653302260896,MATH 10C,A07,094505,Staff,20,0,20,0
1653302260896,MATH 10C,A08,094506,Staff,20,0,20,0
1653302260896,MATH 10C,B01,089250,Staff,19,0,20,1
1653302260896,MATH 10C,B02,089251,Staff,19,0,20,1
1653302260896,MATH 10C,B03,089252,Staff,14,0,20,6
1653302260896,MATH 10C,B04,089253,Staff,20,0,20,0
1653302260896,MATH 10C,B05,089254,Staff,20,0,20,0
1653302260896,MATH 10C,B06,089255,Staff,18,0,20,2
1653302261422,MATH 11,A01,089258,Rava; Denise,1,0,15,14
1653302261422,MATH 11,A02,089260,Rava; Denise,9,0,15,6
1653302261422,MATH 11,A03,089263,Rava; Denise,10,0,15,5
1653302261422,MATH 11,A04,089265,Rava; Denise,13,0,15,2
1653302261422,MATH 11,A05,089267,Rava; Denise,10,0,15,5
1653302261422,MATH 11,A06,089269,Rava; Denise,14,0,15,1
1653302261422,MATH 11,A07,089271,Rava; Denise,14,0,15,1
1653302261422,MATH 11,A08,089273,Rava; Denise,13,0,15,2
1653302261422,MATH 11,B01,089279,Staff,4,0,15,11
1653302261422,MATH 11,B02,089281,Staff,14,0,15,1
1653302261422,MATH 11,B03,089283,Staff,14,0,15,1
1653302261422,MATH 11,B04,089284,Staff,15,0,15,0
1653302261422,MATH 11,B05,089286,Staff,14,0,15,1
1653302261422,MATH 11,B06,089288,Staff,15,0,15,0
1653302261422,MATH 11,B07,089289,Staff,14,0,15,1
1653302261422,MATH 11,B08,089290,Staff,14,0,15,1
1653302261951,MATH 18,A01,089303,Anzaldo; Leesa B,5,0,10,5
1653302261951,MATH 18,A02,089304,Anzaldo; Leesa B,6,0,10,4
1653302261951,MATH 18,A03,089305,Anzaldo; Leesa B,10,0,10,0
1653302261951,MATH 18,A04,089306,Anzaldo; Leesa B,8,0,10,2
1653302261951,MATH 18,A05,089307,Anzaldo; Leesa B,10,0,10,0
1653302261951,MATH 18,A06,089308,Anzaldo; Leesa B,9,0,10,1
1653302261951,MATH 18,A07,089309,Anzaldo; Leesa B,10,0,10,0
1653302261951,MATH 18,A08,089310,Anzaldo; Leesa B,10,0,10,0
1653302261951,MATH 18,A09,089311,Anzaldo; Leesa B,10,0,10,0
1653302261951,MATH 18,A10,089312,Anzaldo; Leesa B,10,0,10,0
1653302261951,MATH 18,A11,089313,Anzaldo; Leesa B,9,0,10,1
1653302261951,MATH 18,A12,089314,Anzaldo; Leesa B,10,0,10,0
1653302261951,MATH 18,A13,089315,Anzaldo; Leesa B,9,0,10,1
1653302261951,MATH 18,A14,089316,Anzaldo; Leesa B,10,0,10,0
1653302261951,MATH 18,A15,089317,Anzaldo; Leesa B,9,0,10,1
1653302261951,MATH 18,A16,089318,Anzaldo; Leesa B,10,0,10,0
1653302261951,MATH 18,A17,089319,Anzaldo; Leesa B,9,0,10,1
1653302261951,MATH 18,A18,089320,Anzaldo; Leesa B,10,0,10,0
1653302261951,MATH 18,A19,089321,Anzaldo; Leesa B,0,0,0,0
1653302261951,MATH 18,A20,089322,Anzaldo; Leesa B,0,0,0,0
1653302261951,MATH 18,A21,089323,Anzaldo; Leesa B,9,0,10,1
1653302261951,MATH 18,A22,089324,Anzaldo; Leesa B,7,0,10,3
1653302261951,MATH 18,A23,089325,Anzaldo; Leesa B,10,0,10,0
1653302261951,MATH 18,A24,089326,Anzaldo; Leesa B,9,0,10,1
1653302261951,MATH 18,B01,089329,Staff,13,0,13,0
1653302261951,MATH 18,B02,089330,Staff,12,0,13,1
1653302261951,MATH 18,B03,089331,Staff,12,0,13,1
1653302261951,MATH 18,B04,089332,Staff,13,0,13,0
1653302261951,MATH 18,B05,089333,Staff,12,0,13,1
1653302261951,MATH 18,C01,089336,Staff,13,0,13,0
1653302261951,MATH 18,C02,089337,Staff,11,0,13,2
1653302261951,MATH 18,C03,089338,Staff,0,0,0,0
1653302261951,MATH 18,C04,089339,Staff,0,0,0,0
1653302261951,MATH 18,C05,089340,Staff,0,0,0,1
1653302261951,MATH 18,D01,094194,Staff,0,0,0,0
1653302261951,MATH 18,D02,094195,Staff,0,0,0,0
1653302261951,MATH 18,D03,094196,Staff,0,0,0,0
1653302261951,MATH 18,D04,094197,Staff,0,0,0,0
1653302261951,MATH 18,D05,094198,Staff,0,0,0,0
1653302262478,MATH 20A,A01,089343,Staff,5,0,5,0
1653302262478,MATH 20A,A02,089344,Staff,5,0,5,0
1653302262478,MATH 20A,A03,089345,Staff,5,0,5,0
1653302262478,MATH 20A,B01,089347,Suk; Andrew Hoon,2,0,3,1
1653302262478,MATH 20A,B02,089348,Suk; Andrew Hoon,3,0,3,0
1653302262478,MATH 20A,B03,089349,Suk; Andrew Hoon,3,0,3,0
1653302262478,MATH 20A,B04,089350,Suk; Andrew Hoon,3,0,3,0
1653302262478,MATH 20A,B05,089351,Suk; Andrew Hoon,3,0,3,0
1653302262478,MATH 20A,B06,089352,Suk; Andrew Hoon,2,0,3,1
1653302262478,MATH 20A,B07,089353,Suk; Andrew Hoon,3,0,3,0
1653302262478,MATH 20A,B08,089354,Suk; Andrew Hoon,3,0,3,0
1653302262478,MATH 20A,B09,089355,Suk; Andrew Hoon,3,0,3,0
1653302262478,MATH 20A,B10,089356,Suk; Andrew Hoon,3,0,3,0
1653302262478,MATH 20A,B11,089357,Suk; Andrew Hoon,3,0,3,0
1653302262478,MATH 20A,B12,089358,Suk; Andrew Hoon,3,0,3,0
1653302262478,MATH 20A,B13,089359,Suk; Andrew Hoon,2,0,3,1
1653302262478,MATH 20A,B14,089360,Suk; Andrew Hoon,3,0,3,0
1653302262478,MATH 20A,B15,089361,Suk; Andrew Hoon,3,0,3,0
1653302262478,MATH 20A,B16,089362,Suk; Andrew Hoon,3,0,3,0
1653302262478,MATH 20A,B17,089363,Suk; Andrew Hoon,3,0,3,0
1653302262478,MATH 20A,B18,089364,Suk; Andrew Hoon,0,0,0,0
1653302262478,MATH 20A,B19,089365,Suk; Andrew Hoon,3,0,3,0
1653302262478,MATH 20A,B20,089366,Suk; Andrew Hoon,3,0,3,0
1653302262478,MATH 20A,B21,089367,Suk; Andrew Hoon,3,0,3,0
1653302262478,MATH 20A,B22,089368,Suk; Andrew Hoon,3,0,3,0
1653302262478,MATH 20A,B23,089369,Suk; Andrew Hoon,3,0,3,0
1653302262478,MATH 20A,B24,089370,Suk; Andrew Hoon,3,0,3,0
1653302263015,MATH 20B,A01,089372,Quarfoot; David James,8,0,8,0
1653302263015,MATH 20B,A02,089373,Quarfoot; David James,8,0,8,0
1653302263015,MATH 20B,A03,089374,Quarfoot; David James,7,0,8,1
1653302263015,MATH 20B,A04,089375,Quarfoot; David James,7,0,8,1
1653302263015,MATH 20B,A05,089376,Quarfoot; David James,0,0,0,0
1653302263015,MATH 20B,A06,089377,Quarfoot; David James,0,0,0,0
1653302263015,MATH 20B,A07,089378,Quarfoot; David James,0,0,0,0
1653302263015,MATH 20B,A08,089379,Quarfoot; David James,0,0,0,0
1653302263015,MATH 20B,A09,089380,Quarfoot; David James,0,0,0,0
1653302263015,MATH 20B,A10,089381,Quarfoot; David James,0,0,0,0
1653302263015,MATH 20B,A11,089382,Quarfoot; David James,0,0,0,0
1653302263015,MATH 20B,A12,089383,Quarfoot; David James,0,0,0,0
1653302263015,MATH 20B,A13,089384,Quarfoot; David James,0,0,0,0
1653302263015,MATH 20B,A14,089385,Quarfoot; David James,0,0,0,0
1653302263015,MATH 20B,A15,089386,Quarfoot; David James,0,0,0,0
1653302263015,MATH 20B,A16,089387,Quarfoot; David James,0,0,0,0
1653302263015,MATH 20B,A17,089388,Quarfoot; David James,8,0,8,0
1653302263015,MATH 20B,A18,089389,Quarfoot; David James,8,0,8,0
1653302263015,MATH 20B,A19,089390,Quarfoot; David James,8,0,8,0
1653302263015,MATH 20B,A20,089391,Quarfoot; David James,8,0,8,0
1653302263015,MATH 20B,A21,089392,Quarfoot; David James,8,0,8,0
1653302263015,MATH 20B,A22,089393,Quarfoot; David James,7,0,8,1
1653302263015,MATH 20B,A23,089394,Quarfoot; David James,7,0,8,1
1653302263015,MATH 20B,A24,089395,Quarfoot; David James,8,0,8,0
1653302263015,MATH 20B,B01,089397,Lahiri; Aranya,7,0,10,3
1653302263015,MATH 20B,B02,089398,Lahiri; Aranya,10,0,10,0
1653302263015,MATH 20B,B03,089399,Lahiri; Aranya,10,0,10,0
1653302263015,MATH 20B,B04,089400,Lahiri; Aranya,10,0,10,0
1653302263015,MATH 20B,B05,089401,Lahiri; Aranya,10,0,10,0
1653302263015,MATH 20B,C01,089403,Lahiri; Aranya,0,0,0,0
1653302263015,MATH 20B,C02,089404,Lahiri; Aranya,8,0,10,2
1653302263015,MATH 20B,C03,089405,Lahiri; Aranya,10,0,10,0
1653302263015,MATH 20B,C04,089406,Lahiri; Aranya,9,0,10,1
1653302263015,MATH 20B,C05,089407,Lahiri; Aranya,9,0,10,1
1653302263556,MATH 20C,A01,089409,Um; Ko Woon,10,0,10,0
1653302263556,MATH 20C,A02,089410,Um; Ko Woon,10,0,10,0
1653302263556,MATH 20C,A03,089411,Um; Ko Woon,9,0,10,1
1653302263556,MATH 20C,A04,089412,Um; Ko Woon,9,0,10,1
1653302263556,MATH 20C,A05,089413,Um; Ko Woon,10,0,10,0
1653302263556,MATH 20C,A06,089414,Um; Ko Woon,9,0,10,1
1653302263556,MATH 20C,A07,094270,Um; Ko Woon,10,0,10,0
1653302263556,MATH 20C,A08,094271,Um; Ko Woon,10,0,10,0
1653302263556,MATH 20C,A09,094272,Um; Ko Woon,7,0,10,3
1653302263556,MATH 20C,A10,094273,Um; Ko Woon,10,0,10,0
1653302263556,MATH 20C,A11,094274,Um; Ko Woon,10,0,10,0
1653302263556,MATH 20C,A12,094275,Um; Ko Woon,8,0,10,2
1653302263556,MATH 20C,A13,094276,Um; Ko Woon,10,0,10,0
1653302263556,MATH 20C,A14,094277,Um; Ko Woon,10,0,10,0
1653302263556,MATH 20C,A15,094278,Um; Ko Woon,10,0,10,0
1653302263556,MATH 20C,A16,094279,Um; Ko Woon,10,0,10,0
1653302263556,MATH 20C,B03,089418,Zhang; Ming,7,0,15,8
1653302263556,MATH 20C,B04,089419,Zhang; Ming,13,0,15,2
1653302263556,MATH 20C,B05,089420,Zhang; Ming,13,0,15,2
1653302263556,MATH 20C,C01,089423,Staff,15,0,15,0
1653302263556,MATH 20C,C02,089424,Staff,15,0,15,0
1653302263556,MATH 20C,C03,089425,Staff,15,0,15,0
1653302263556,MATH 20C,C04,089426,Staff,15,0,15,0
1653302263556,MATH 20C,C05,089427,Staff,15,0,15,0
1653302263556,MATH 20C,D04,089433,Zhang; Ming,13,0,15,2
1653302263556,MATH 20C,D05,089434,Zhang; Ming,15,0,15,0
1653302263556,MATH 20C,E01,089439,Staff,15,0,15,0
1653302263556,MATH 20C,E02,089440,Staff,15,0,15,0
1653302263556,MATH 20C,E03,089441,Staff,15,0,15,0
1653302263556,MATH 20C,E04,089442,Staff,15,0,15,0
1653302263556,MATH 20C,E05,089443,Staff,15,0,15,0
1653302263556,MATH 20C,E06,089444,Staff,15,0,15,0
1653302263556,MATH 20C,A17,094280,Um; Ko Woon,0,0,0,0
1653302263556,MATH 20C,A18,094281,Um; Ko Woon,0,0,0,0
1653302263556,MATH 20C,A19,094282,Um; Ko Woon,0,0,0,0
1653302263556,MATH 20C,A20,094283,Um; Ko Woon,0,0,0,0
1653302263556,MATH 20C,A21,094284,Um; Ko Woon,0,0,0,0
1653302263556,MATH 20C,A22,094285,Um; Ko Woon,0,0,0,0
1653302263556,MATH 20C,A23,094286,Um; Ko Woon,0,0,0,0
1653302263556,MATH 20C,A24,094287,Um; Ko Woon,0,0,0,0
1653302263556,MATH 20C,B01,089416,Zhang; Ming,0,0,0,0
1653302263556,MATH 20C,B02,089417,Zhang; Ming,0,0,0,0
1653302263556,MATH 20C,D01,089430,Zhang; Ming,0,0,0,0
1653302263556,MATH 20C,D02,089431,Zhang; Ming,0,0,0,0
1653302263556,MATH 20C,D03,089432,Zhang; Ming,0,0,0,0
1653302264088,MATH 20D,A01,089455,Lee; Kisun,11,0,25,14
1653302264088,MATH 20D,A02,089456,Lee; Kisun,24,0,25,1
1653302264088,MATH 20D,A03,089457,Lee; Kisun,24,0,25,1
1653302264088,MATH 20D,A04,089458,Lee; Kisun,25,0,25,0
1653302264088,MATH 20D,A05,089459,Lee; Kisun,25,0,25,0
1653302264088,MATH 20D,A06,089460,Lee; Kisun,25,0,25,0
1653302264088,MATH 20D,B01,089463,Lee; Kisun,20,0,25,5
1653302264088,MATH 20D,B02,089464,Lee; Kisun,25,0,25,0
1653302264088,MATH 20D,B03,089465,Lee; Kisun,24,0,25,1
1653302264088,MATH 20D,B04,089466,Lee; Kisun,25,0,25,0
1653302264088,MATH 20D,B05,089467,Lee; Kisun,23,0,25,2
1653302264088,MATH 20D,B06,089468,Lee; Kisun,24,0,25,1
1653302264088,MATH 20D,C01,089471,Staff,23,0,25,2
1653302264088,MATH 20D,C02,089472,Staff,25,0,25,0
1653302264088,MATH 20D,C03,089473,Staff,25,0,25,0
1653302264088,MATH 20D,C04,089474,Staff,25,0,25,0
1653302264088,MATH 20D,C05,089475,Staff,25,0,25,0
1653302264088,MATH 20D,C06,089476,Staff,25,0,25,0
1653302264615,MATH 20E,A01,089479,Eggers; John Dietrich,17,0,24,7
1653302264615,MATH 20E,A02,089480,Eggers; John Dietrich,24,0,25,1
1653302264615,MATH 20E,A03,089481,Eggers; John Dietrich,25,0,25,0
1653302264615,MATH 20E,A04,089482,Eggers; John Dietrich,25,0,25,0
1653302264615,MATH 20E,A05,089483,Eggers; John Dietrich,19,0,25,6
1653302264615,MATH 20E,A06,089484,Eggers; John Dietrich,25,0,25,0
1653302264615,MATH 20E,A07,089485,Eggers; John Dietrich,24,0,25,1
1653302264615,MATH 20E,A08,089486,Eggers; John Dietrich,24,0,25,1
1653302264615,MATH 20E,B01,089488,Staff,15,0,25,10
1653302264615,MATH 20E,B02,089489,Staff,21,0,25,4
1653302264615,MATH 20E,B03,089490,Staff,25,0,25,0
1653302264615,MATH 20E,B04,089491,Staff,25,0,25,0
1653302264615,MATH 20E,B05,089492,Staff,24,0,25,1
1653302264615,MATH 20E,B06,089493,Staff,24,0,25,1
1653302264615,MATH 20E,B07,089494,Staff,25,0,25,0
1653302264615,MATH 20E,B08,089495,Staff,25,0,25,0
1653302264615,MATH 20E,C01,089497,Staff,23,0,25,2
1653302264615,MATH 20E,C02,089498,Staff,25,0,25,0
1653302264615,MATH 20E,C03,089499,Staff,25,0,25,0
1653302264615,MATH 20E,C04,089500,Staff,25,0,25,0
1653302264615,MATH 20E,C05,089501,Staff,25,0,25,0
1653302264615,MATH 20E,C06,089502,Staff,25,0,25,0
1653302264615,MATH 20E,C07,089503,Staff,25,0,25,0
1653302264615,MATH 20E,C08,089504,Staff,25,0,25,0
1653302265143,MATH 31AH,A01,089506,Rabin; Jeffrey Mark,35,0,35,0
1653302265143,MATH 31AH,A02,089507,Rabin; Jeffrey Mark,35,0,35,0
1653302265670,MATH 87,A00,094827,Meyer; David A.,20,0,20,0
1653302266197,MATH 96,A00,094836,Kane; Daniel Mertz,11,0,30,19
1653302266722,MATH 100A,A01,089509,Kedlaya; Kiran S.,23,0,30,7
1653302266722,MATH 100A,A02,089510,Kedlaya; Kiran S.,28,0,30,2
1653302266722,MATH 100A,B01,089512,Greenfeld; Be'Eri,24,0,30,6
1653302266722,MATH 100A,B02,089513,Greenfeld; Be'Eri,30,0,30,0
1653302267253,MATH 102,A01,089515,Hodges; Reuven Moses,25,0,30,5
1653302267253,MATH 102,A02,089516,Hodges; Reuven Moses,30,0,30,0
1653302267253,MATH 102,A03,089517,Hodges; Reuven Moses,30,0,30,0
1653302267253,MATH 102,A04,089518,Hodges; Reuven Moses,29,0,30,1
1653302267253,MATH 102,B01,089520,Hodges; Reuven Moses,29,0,30,1
1653302267253,MATH 102,B02,089521,Hodges; Reuven Moses,29,0,30,1
1653302267253,MATH 102,B03,089522,Hodges; Reuven Moses,29,0,30,1
1653302267253,MATH 102,B04,089523,Hodges; Reuven Moses,30,0,30,0
1653302267784,MATH 103A,A01,089525,Staff,27,0,30,3
1653302267784,MATH 103A,A02,089526,Staff,30,0,30,0
1653302267784,MATH 103A,B01,089528,Seward; Brandon M.,9,0,30,21
1653302267784,MATH 103A,B02,089529,Seward; Brandon M.,22,0,30,8
1653302267784,MATH 103A,C01,089531,Staff,27,0,30,3
1653302267784,MATH 103A,C02,089532,Staff,28,0,30,2
1653302267784,MATH 103A,D01,089534,Staff,28,0,30,2
1653302267784,MATH 103A,D02,089535,Staff,28,0,30,2
1653302268318,MATH 109,A01,089537,Chung; Kwun,9,0,10,1
1653302268318,MATH 109,A02,089538,Chung; Kwun,10,0,10,0
1653302268318,MATH 109,B01,089540,Belmont; Eva Kinoshita,9,0,10,1
1653302268318,MATH 109,B02,089541,Belmont; Eva Kinoshita,6,0,10,4
1653302268318,MATH 109,C01,089543,Chow; Bennett,8,0,10,2
1653302268318,MATH 109,C02,089544,Chow; Bennett,10,0,10,0
1653302268318,MATH 109,D01,089546,Chung; Kwun,9,0,10,1
1653302268318,MATH 109,D02,089547,Chung; Kwun,9,0,10,1
1653302268318,MATH 109,E01,089549,Schweinsberg; Jason,6,0,10,4
1653302268318,MATH 109,E02,089550,Schweinsberg; Jason,10,0,10,0
1653302268844,MATH 110,A01,089552,Wenzl; Hans G,27,0,35,8
1653302268844,MATH 110,A02,089553,Wenzl; Hans G,33,0,35,2
1653302269367,MATH 111A,A01,089555,Meyer; David A.,0,0,0,1
1653302269895,MATH 120A,A01,089557,Manners; Frederick,30,0,35,5
1653302269895,MATH 120A,A02,089558,Manners; Frederick,33,0,35,2
1653302270431,MATH 140A,A01,089560,Seward; Brandon M.,25,0,30,5
1653302270431,MATH 140A,A02,089561,Seward; Brandon M.,29,0,30,1
1653302270431,MATH 140A,B01,089563,Chan; Pak Yeung,30,0,30,0
1653302270431,MATH 140A,B02,089564,Chan; Pak Yeung,22,0,30,8
1653302270958,MATH 142A,A01,089566,Staff,29,0,30,1
1653302270958,MATH 142A,A02,089567,Staff,29,0,30,1
1653302270958,MATH 142A,B01,089569,Staff,30,0,30,0
1653302270958,MATH 142A,B02,089570,Staff,29,0,30,1
1653302270958,MATH 142A,C01,089572,Staff,26,0,30,4
1653302270958,MATH 142A,C02,089573,Staff,29,0,30,1
1653302270958,MATH 142A,D01,089575,Eggers; John Dietrich,15,0,30,15
1653302270958,MATH 142A,D02,089576,Eggers; John Dietrich,27,0,30,3
1653302271485,MATH 144,A01,089578,Bejenaru; Ioan,29,0,30,1
1653302272009,MATH 150A,A01,089580,Chow; Bennett,29,0,35,6
1653302272009,MATH 150A,A02,089581,Chow; Bennett,34,0,35,1
1653302273062,MATH 153,A01,094204,Harel; Guershon,33,0,35,2
1653302273587,MATH 154,A01,089590,Verstraete; Jacques Allan,3,0,30,27
1653302273587,MATH 154,A02,089591,Verstraete; Jacques Allan,23,0,30,7
1653302273587,MATH 154,A03,089592,Verstraete; Jacques Allan,28,0,30,2
1653302273587,MATH 154,A04,089593,Verstraete; Jacques Allan,26,0,30,4
1653302274115,MATH 155A,A01,089595,Buss; Samuel R,22,0,35,13
1653302274115,MATH 155A,A02,089596,Buss; Samuel R,32,0,35,3
1653302274642,MATH 160A,A01,089598,Manners; Frederick,28,0,35,7
1653302274642,MATH 160A,A02,094207,Manners; Frederick,34,0,35,1
1653302275176,MATH 170A,A01,089600,Liu; Shuang,24,0,25,1
1653302275176,MATH 170A,A02,089601,Liu; Shuang,24,0,25,1
1653302275176,MATH 170A,A03,089602,Liu; Shuang,24,0,25,1
1653302275176,MATH 170A,A04,089603,Liu; Shuang,23,0,25,2
1653302275176,MATH 170A,B01,089605,Dumitriu; Ioana,8,0,25,17
1653302275176,MATH 170A,B02,089606,Dumitriu; Ioana,20,0,25,5
1653302275176,MATH 170A,B03,089607,Dumitriu; Ioana,21,0,25,4
1653302275176,MATH 170A,B04,089608,Dumitriu; Ioana,25,0,25,0
1653302275704,MATH 173A,A01,089610,Cloninger; Alexander,0,0,35,35
1653302275704,MATH 173A,A02,089611,Cloninger; Alexander,2,0,35,33
1653302275704,MATH 173A,A03,089612,Cloninger; Alexander,20,0,35,15
1653302276231,MATH 174,A01,089614,Cheng; Li-Tien,23,0,25,2
1653302276231,MATH 174,A02,089615,Cheng; Li-Tien,25,0,25,0
1653302276757,MATH 180A,A01,089617,Jekel; David Andrew,0,0,25,25
1653302276757,MATH 180A,A02,089618,Jekel; David Andrew,23,0,25,2
1653302276757,MATH 180A,A03,089619,Jekel; David Andrew,22,0,25,3
1653302276757,MATH 180A,A04,089620,Jekel; David Andrew,22,0,25,3
1653302276757,MATH 180A,A05,089621,Jekel; David Andrew,24,0,25,1
1653302276757,MATH 180A,A06,089622,Jekel; David Andrew,23,0,25,2
1653302276757,MATH 180A,B01,089624,Agarwal; Pooja,23,0,25,2
1653302276757,MATH 180A,B02,089625,Agarwal; Pooja,24,0,25,1
1653302276757,MATH 180A,B03,089626,Agarwal; Pooja,22,0,25,3
1653302276757,MATH 180A,B04,089627,Agarwal; Pooja,25,0,25,0
1653302276757,MATH 180A,B05,089628,Agarwal; Pooja,24,0,25,1
1653302276757,MATH 180A,B06,089629,Agarwal; Pooja,25,0,25,0
1653302276757,MATH 180A,C01,089631,Staff,22,0,25,3
1653302276757,MATH 180A,C02,089632,Staff,25,0,25,0
1653302276757,MATH 180A,C03,089633,Staff,25,0,25,0
1653302276757,MATH 180A,C04,089634,Staff,25,0,25,0
1653302277289,MATH 180C,A01,089636,Fitzsimmons; Patrick J,4,0,25,21
1653302277289,MATH 180C,A02,089637,Fitzsimmons; Patrick J,21,0,25,4
1653302277813,MATH 181B,A01,089639,Rava; Denise,31,0,35,4
1653302277813,MATH 181B,A02,089640,Rava; Denise,34,0,35,1
1653302277813,MATH 181B,A03,089641,Rava; Denise,31,0,35,4
1653302277813,MATH 181B,A04,089642,Rava; Denise,35,0,35,0
1653302278339,MATH 183,A01,089644,Staff,10,0,25,15
1653302278339,MATH 183,A02,089645,Staff,23,0,25,2
1653302278339,MATH 183,A03,089646,Staff,23,0,25,2
1653302278339,MATH 183,A04,089647,Staff,25,0,25,0
1653302278339,MATH 183,A05,089648,Staff,19,0,25,6
1653302278339,MATH 183,A06,089649,Staff,22,0,25,3
1653302278339,MATH 183,A07,089650,Staff,25,0,25,0
1653302278339,MATH 183,A08,089651,Staff,25,0,25,0
1653302278866,MATH 184,A01,089653,Kane; Daniel Mertz,24,0,30,6
1653302278866,MATH 184,A02,089654,Kane; Daniel Mertz,30,0,30,0
1653302278866,MATH 184,A03,089655,Kane; Daniel Mertz,30,0,30,0
1653302278866,MATH 184,A04,089656,Kane; Daniel Mertz,30,0,30,0
1653302279396,MATH 187A,A01,089658,Bucur; Alina Ioana,0,0,25,25
1653302279396,MATH 187A,A02,089659,Bucur; Alina Ioana,12,0,25,13
1653302279396,MATH 187A,A03,089660,Bucur; Alina Ioana,0,0,25,25
1653302279396,MATH 187A,A04,089661,Bucur; Alina Ioana,17,0,25,8
1653302279920,MATH 187B,A01,089663,Bucur; Alina Ioana,28,0,35,7
1653302279920,MATH 187B,A02,089664,Bucur; Alina Ioana,34,0,35,1
1653302280448,MATH 188,A01,094817,Sam; Steven V,33,0,35,2
1653302280976,MATH 190A,A01,089666,Sam; Steven V,21,0,35,14
1653302281499,MATH 196,A00,089667,Spolaor; Luca,33,0,45,12
1653302282066,MCWP 40,004,093486,Wastal; Carrie King,0,0,3,3
1653302282066,MCWP 40,005,093487,Wastal; Carrie King,0,0,3,3
1653302282066,MCWP 40,006,093488,Wastal; Carrie King,3,0,3,0
1653302282066,MCWP 40,007,093489,Wastal; Carrie King,3,0,3,0
1653302282066,MCWP 40,008,093490,Wastal; Carrie King,2,0,3,1
1653302282066,MCWP 40,009,093491,Wastal; Carrie King,2,0,3,1
1653302282066,MCWP 40,013,093495,Wastal; Carrie King,3,0,3,0
1653302282066,MCWP 40,014,093496,Wastal; Carrie King,0,0,3,3
1653302282066,MCWP 40,015,093497,Wastal; Carrie King,3,0,3,0
1653302282066,MCWP 40,016,093498,Wastal; Carrie King,3,0,3,0
1653302282066,MCWP 40,017,093499,Wastal; Carrie King,3,0,3,0
1653302282066,MCWP 40,018,093500,Wastal; Carrie King,1,0,3,2
1653302282066,MCWP 40,020,093502,Wastal; Carrie King,0,0,0,0
1653302282066,MCWP 40,021,093503,Wastal; Carrie King,3,0,3,0
1653302282066,MCWP 40,022,093504,Wastal; Carrie King,2,0,3,1
1653302282066,MCWP 40,023,093505,Wastal; Carrie King,2,0,3,1
1653302282066,MCWP 40,024,093506,Wastal; Carrie King,2,0,3,1
1653302282066,MCWP 40,026,093508,Wastal; Carrie King,3,0,3,0
1653302282066,MCWP 40,027,093509,Wastal; Carrie King,3,0,3,0
1653302282066,MCWP 40,028,093510,Wastal; Carrie King,3,0,3,0
1653302282066,MCWP 40,029,093511,Wastal; Carrie King,3,0,3,0
1653302282066,MCWP 40,030,093512,Wastal; Carrie King,2,0,3,1
1653302282066,MCWP 40,032,093514,Wastal; Carrie King,2,0,3,1
1653302282066,MCWP 40,033,093515,Wastal; Carrie King,3,0,3,0
1653302282066,MCWP 40,034,093516,Wastal; Carrie King,3,0,3,0
1653302282066,MCWP 40,035,093517,Wastal; Carrie King,3,0,3,0
1653302282066,MCWP 40,038,093520,Wastal; Carrie King,2,0,3,1
1653302282066,MCWP 40,039,093521,Wastal; Carrie King,3,0,3,0
1653302282066,MCWP 40,041,093523,Wastal; Carrie King,2,0,3,1
1653302282066,MCWP 40,042,093524,Wastal; Carrie King,3,0,3,0
1653302282066,MCWP 40,043,093525,Wastal; Carrie King,0,0,0,0
1653302282066,MCWP 40,049,093531,Wastal; Carrie King,2,0,3,1
1653302282066,MCWP 40,050,093532,Wastal; Carrie King,3,0,3,0
1653302282066,MCWP 40,051,093533,Wastal; Carrie King,3,0,3,0
1653302282610,MCWP 50,001,093534,Wastal; Carrie King,0,0,0,0
1653302282610,MCWP 50,002,093535,Wastal; Carrie King,0,0,3,3
1653302282610,MCWP 50,003,093536,Wastal; Carrie King,0,0,3,3
1653302282610,MCWP 50,004,093537,Wastal; Carrie King,0,0,3,3
1653302282610,MCWP 50,005,093538,Wastal; Carrie King,0,0,3,3
1653302282610,MCWP 50,006,093539,Wastal; Carrie King,2,0,3,1
1653302282610,MCWP 50,007,093540,Wastal; Carrie King,0,0,3,3
1653302282610,MCWP 50,008,093541,Wastal; Carrie King,0,0,3,3
1653302282610,MCWP 50,009,093542,Wastal; Carrie King,0,0,3,3
1653302282610,MCWP 50,010,093543,Wastal; Carrie King,0,0,3,3
1653302282610,MCWP 50,013,093546,Wastal; Carrie King,1,0,3,2
1653302282610,MCWP 50,014,093547,Wastal; Carrie King,0,0,3,3
1653302282610,MCWP 50,015,093548,Wastal; Carrie King,0,0,3,3
1653302282610,MCWP 50,016,093549,Wastal; Carrie King,0,0,0,0
1653302283140,MCWP 125,A00,093550,Wilson; Marion E.,3,0,3,0
1653302283140,MCWP 125,B00,093551,Guillen; Melinda,3,0,3,0
1653302283140,MCWP 125,C00,093552,Guillen; Melinda,3,0,3,0
1653302283140,MCWP 125,D00,093553,Guillen; Melinda,3,0,3,0
1653302283140,MCWP 125,E00,093554,Miller; Elizabeth Deen,3,0,3,0
1653302283140,MCWP 125,F00,093555,Miller; Elizabeth Deen,3,0,3,0
1653302283140,MCWP 125,G00,093556,Miller; Elizabeth Deen,3,0,3,0
1653302283668,MGT 3,A00,087704,Wagner; Timothy Ryan,90,0,90,0
1653302284202,MGT 4,A01,087706,Levkoff; Steven B.,2,0,3,1
1653302284202,MGT 4,A02,087707,Levkoff; Steven B.,3,0,3,0
1653302284202,MGT 4,A03,092659,Levkoff; Steven B.,1,0,4,3
1653302284726,MGT 5,A00,087708,Houskeeper; Robert,194,0,196,2
1653302285250,MGT 12,A00,087709,Pecore; Joseph P.,91,0,100,9
1653302285250,MGT 12,B00,087710,Lindenberger; Wade Douglas,91,0,100,9
1653302285785,MGT 16,A00,087711,Campbell; Robert Harold,108,0,110,2
1653302285785,MGT 16,B00,087712,Campbell; Robert Harold,110,0,110,0
1653302285785,MGT 16,C00,087713,Lindenberger; Wade Douglas,100,0,110,10
1653302285785,MGT 16,D00,087714,Lindenberger; Wade Douglas,107,0,110,3
1653302285785,MGT 16,E00,094819,Buchanan; Harold G,99,0,100,1
1653302286314,MGT 18,A00,087715,McKay; Michael J,88,0,90,2
1653302286314,MGT 18,B00,087716,McKay; Michael J,90,0,90,0
1653302286314,MGT 18,C00,087717,McKay; Michael J,88,0,90,2
1653302286314,MGT 18,D00,087718,McKay; Mary A,90,0,90,0
1653302286314,MGT 18,E00,087719,McKay; Mary A,87,0,90,3
1653302286837,MGT 45,A00,087720,Pecore; Joseph P.,136,0,150,14
1653302286837,MGT 45,B00,087721,Pecore; Joseph P.,140,0,150,10
1653302287361,MGT 52,A00,087722,Deal; Jennifer Jean,83,0,90,7
1653302287889,MGT 71,A00,087723,August; Terrence,60,0,90,30
1653302288940,MGT 103,A00,087726,Ehrich; Kristine R,86,0,90,4
1653302288940,MGT 103,B00,087727,Ehrich; Kristine R,89,0,90,1
1653302288940,MGT 103,C00,087728,Eberhard; Craig A,89,0,90,1
1653302288940,MGT 103,D00,087729,Eberhard; Craig A,88,0,90,2
1653302288940,MGT 103,E00,087730,Demill; Burritt,75,0,90,15
1653302288940,MGT 103,F00,087731,Bates; Kenneth Walter,81,0,90,9
1653302288940,MGT 103,G00,087732,Bates; Kenneth Walter,88,0,90,2
1653302289473,MGT 105,A00,087733,Campbell; Robert Harold,102,0,120,18
1653302289997,MGT 106,A00,087734,Eberhard; Craig A,81,0,90,9
1653302290526,MGT 108R,A00,087735,Amir; On,84,0,90,6
1653302291051,MGT 109,A00,087736,Staff,77,0,90,13
1653302291581,MGT 112,A00,087737,Somasundaram; Tyagarajan,89,0,90,1
1653302291581,MGT 112,B00,087738,Somasundaram; Tyagarajan,86,0,90,4
1653302291581,MGT 112,C00,087739,Ehrich; Kristine R,86,0,90,4
1653302291581,MGT 112,D00,087740,Zimmermann; Carsten,65,0,90,25
1653302292103,MGT 121A,A00,087741,Wang; Helen Shan,65,0,70,5
1653302292103,MGT 121A,B00,087742,Wang; Helen Shan,64,0,70,6
1653302292630,MGT 131A,A00,087743,Houskeeper; Robert,146,0,150,4
1653302293153,MGT 132,A00,087744,Blakley; Bruce,88,0,90,2
1653302293681,MGT 134,A00,087745,Houskeeper; Robert,84,0,90,6
1653302294211,MGT 135,A00,087746,Anderson; John Charles,83,0,90,7
1653302294736,MGT 139,A00,087747,Perols; Johan Lars,88,0,90,2
1653302295259,MGT 153,A00,087748,Perols; Johan Lars,82,0,90,8
1653302295259,MGT 153,B00,087749,Phiroz; Zal Navroze,75,0,90,15
1653302295259,MGT 153,C00,087750,Phiroz; Zal Navroze,87,0,90,3
1653302295783,MGT 162R,A00,087751,Gneezy; Uri,64,0,90,26
1653302296313,MGT 164,A00,087752,McKay; Mary A,90,0,90,0
1653302296313,MGT 164,B00,087753,Meyer; Alison Bloomfield,0,0,0,0
1653302296313,MGT 164,C00,087754,Smith; Pamela Karen,82,0,90,8
1653302296838,MGT 166,A00,087755,Moran; Cathleen L.,89,0,90,1
1653302296838,MGT 166,B00,087756,Moran; Cathleen L.,90,0,90,0
1653302296838,MGT 166,C00,087757,Moran; Cathleen L.,90,0,90,0
1653302296838,MGT 166,D00,087758,Demill; Burritt,56,0,90,34
1653302297369,MGT 167,A00,087759,Klaas; Jeffrey David,88,0,90,2
1653302297369,MGT 167,B00,087760,Jacob; Jo Dee C,83,0,90,7
1653302297896,MGT 171,A00,087761,Phiroz; Zal Navroze,85,0,90,5
1653302298424,MGT 172,A00,087762,Hedges; Kathleen & Royal; Rebecca,96,0,100,4
1653302298424,MGT 172,B00,087763,Hedges; Kathleen,79,0,90,11
1653302298424,MGT 172,C00,087764,Zimmermann; Carsten,90,0,90,0
1653302298947,MGT 172R,A00,094888,Erat; Sanjiv,90,0,90,0
1653302299470,MGT 173,A00,087765,Hayes; Sherry Lorine,80,0,100,20
1653302299994,MGT 175,A00,087766,Gopal; Christopher S.,84,0,90,6
1653302300520,MGT 181,A00,087767,Buchanan; Harold G,114,0,120,6
1653302300520,MGT 181,B00,087768,Buchanan; Harold G,110,0,120,10
1653302300520,MGT 181,C00,087769,Bliss; Barbara Ann,109,0,120,11
1653302301568,MGT 185,A00,087771,Dunn; Louis Jean,83,0,90,7
1653302302096,MGT 187,A00,087772,Dunn; Louis Jean,138,0,146,8
1653302302633,MMW 11,A01,086931,duBois; Page Ann,4,0,4,0
1653302302633,MMW 11,A02,086932,duBois; Page Ann,4,0,4,0
1653302302633,MMW 11,A03,086933,duBois; Page Ann,3,0,4,1
1653302302633,MMW 11,A04,086934,duBois; Page Ann,3,0,4,1
1653302302633,MMW 11,A05,086935,duBois; Page Ann,4,0,4,0
1653302302633,MMW 11,A06,086936,duBois; Page Ann,3,0,4,1
1653302302633,MMW 11,A07,086937,duBois; Page Ann,4,0,4,0
1653302302633,MMW 11,A08,086938,duBois; Page Ann,4,0,4,0
1653302302633,MMW 11,A09,086939,duBois; Page Ann,4,0,4,0
1653302302633,MMW 11,A10,086940,duBois; Page Ann,4,0,4,0
1653302302633,MMW 11,A11,086941,duBois; Page Ann,4,0,4,0
1653302302633,MMW 11,A12,093877,duBois; Page Ann,3,0,4,1
1653302303159,MMW 11R,A01,093852,Herbst; Matthew,4,0,4,0
1653302303159,MMW 11R,A02,093853,Herbst; Matthew,4,0,4,0
1653302303159,MMW 11R,A03,093854,Herbst; Matthew,4,0,4,0
1653302303159,MMW 11R,A04,093855,Herbst; Matthew,4,0,4,0
1653302303159,MMW 11R,A05,093856,Herbst; Matthew,4,0,4,0
1653302303159,MMW 11R,A06,093857,Herbst; Matthew,4,0,4,0
1653302303159,MMW 11R,A07,093858,Herbst; Matthew,4,0,4,0
1653302303159,MMW 11R,A08,093859,Herbst; Matthew,4,0,4,0
1653302303159,MMW 11R,A09,093860,Herbst; Matthew,4,0,4,0
1653302303159,MMW 11R,A10,093861,Herbst; Matthew,4,0,4,0
1653302303159,MMW 11R,A11,093862,Herbst; Matthew,4,0,4,0
1653302303159,MMW 11R,A12,093863,Herbst; Matthew,4,0,4,0
1653302303159,MMW 11R,B01,093865,Herbst; Matthew,4,0,4,0
1653302303159,MMW 11R,B02,093866,Herbst; Matthew,4,0,4,0
1653302303159,MMW 11R,B03,093867,Herbst; Matthew,4,0,4,0
1653302303159,MMW 11R,B04,093868,Herbst; Matthew,4,0,4,0
1653302303159,MMW 11R,B05,093869,Herbst; Matthew,4,0,4,0
1653302303159,MMW 11R,B06,093870,Herbst; Matthew,4,0,4,0
1653302303159,MMW 11R,B07,093871,Herbst; Matthew,4,0,4,0
1653302303159,MMW 11R,B08,093872,Herbst; Matthew,4,0,4,0
1653302303159,MMW 11R,B09,093873,Herbst; Matthew,4,0,4,0
1653302303159,MMW 11R,B10,093874,Herbst; Matthew,4,0,4,0
1653302303159,MMW 11R,B11,093875,Herbst; Matthew,4,0,4,0
1653302303159,MMW 11R,B12,093876,Herbst; Matthew,4,0,4,0
1653302303685,MMW 14,A01,086968,Chang; Edmond Yi-Teh,28,0,28,0
1653302303685,MMW 14,A02,086969,Chang; Edmond Yi-Teh,27,0,28,1
1653302303685,MMW 14,A03,086970,Chang; Edmond Yi-Teh,21,0,28,7
1653302303685,MMW 14,A04,086971,Chang; Edmond Yi-Teh,27,0,28,1
1653302303685,MMW 14,A05,086972,Chang; Edmond Yi-Teh,26,0,28,2
1653302303685,MMW 14,A06,086973,Chang; Edmond Yi-Teh,28,0,28,0
1653302303685,MMW 14,A07,086974,Chang; Edmond Yi-Teh,27,0,28,1
1653302303685,MMW 14,A08,086975,Chang; Edmond Yi-Teh,25,0,28,3
1653302303685,MMW 14,A09,086976,Chang; Edmond Yi-Teh,0,0,0,0
1653302303685,MMW 14,A10,086977,Chang; Edmond Yi-Teh,27,0,28,1
1653302303685,MMW 14,A11,086978,Chang; Edmond Yi-Teh,26,0,28,2
1653302303685,MMW 14,A12,086979,Chang; Edmond Yi-Teh,27,0,28,1
1653302303685,MMW 14,A13,086980,Chang; Edmond Yi-Teh,28,0,28,0
1653302304210,MMW 121,A01,086982,Chang; Edmond Yi-Teh,0,0,0,0
1653302304210,MMW 121,A02,086983,Chang; Edmond Yi-Teh,0,0,0,0
1653302304210,MMW 121,A03,086984,Chang; Edmond Yi-Teh,2,0,4,2
1653302304210,MMW 121,A04,086985,Chang; Edmond Yi-Teh,4,0,4,0
1653302304210,MMW 121,A05,086986,Chang; Edmond Yi-Teh,4,0,4,0
1653302304210,MMW 121,A06,086987,Chang; Edmond Yi-Teh,4,0,4,0
1653302304210,MMW 121,A07,086988,Chang; Edmond Yi-Teh,4,0,4,0
1653302304210,MMW 121,A08,086989,Chang; Edmond Yi-Teh,4,0,4,0
1653302304210,MMW 121,B01,086991,Patterson; Patrick H.,4,0,4,0
1653302304210,MMW 121,B02,086992,Patterson; Patrick H.,4,0,4,0
1653302304210,MMW 121,B03,086993,Patterson; Patrick H.,4,0,4,0
1653302304210,MMW 121,B04,086994,Patterson; Patrick H.,3,0,4,1
1653302304210,MMW 121,B05,086995,Patterson; Patrick H.,4,0,4,0
1653302304210,MMW 121,B06,086996,Patterson; Patrick H.,4,0,4,0
1653302304210,MMW 121,B07,086997,Patterson; Patrick H.,4,0,4,0
1653302304210,MMW 121,B08,086998,Patterson; Patrick H.,4,0,4,0
1653302304210,MMW 121,B09,086999,Patterson; Patrick H.,4,0,4,0
1653302304210,MMW 121,B10,087000,Patterson; Patrick H.,4,0,4,0
1653302304210,MMW 121,B11,087001,Patterson; Patrick H.,0,0,0,0
1653302304210,MMW 121,B12,087002,Patterson; Patrick H.,0,0,0,0
1653302304736,MUS 1A,A01,090497,Staff,19,0,20,1
1653302304736,MUS 1A,A02,090498,Staff,13,0,20,7
1653302304736,MUS 1A,A03,090499,Staff,18,0,20,2
1653302304736,MUS 1A,A04,090500,Staff,19,0,20,1
1653302304736,MUS 1A,A05,090501,Staff,20,0,20,0
1653302304736,MUS 1A,A06,090502,Staff,20,0,20,0
1653302304736,MUS 1A,B01,090504,Staff,18,0,20,2
1653302304736,MUS 1A,B02,090505,Staff,20,0,20,0
1653302304736,MUS 1A,B03,090506,Staff,18,0,20,2
1653302304736,MUS 1A,B04,090507,Staff,18,0,20,2
1653302304736,MUS 1A,B05,090508,Staff,16,0,20,4
1653302304736,MUS 1A,B06,090509,Staff,20,0,20,0
1653302305261,MUS 2A,A01,090511,Carlson; Erik Norman,19,0,20,1
1653302305789,MUS 2AK,A00,090512,Ohnishi; Takae,24,0,25,1
1653302305789,MUS 2AK,B00,090513,Ohnishi; Takae,15,0,15,0
1653302306313,MUS 4,A01,090515,Staff,24,0,25,1
1653302306313,MUS 4,A02,090516,Staff,24,0,25,1
1653302306313,MUS 4,A03,090517,Staff,22,0,25,3
1653302306313,MUS 4,A04,090518,Staff,24,0,25,1
1653302306313,MUS 4,A05,090519,Staff,25,0,25,0
1653302306313,MUS 4,A06,090520,Staff,25,0,25,0
1653302306313,MUS 4,A07,090521,Staff,24,0,25,1
1653302306313,MUS 4,A08,090522,Staff,24,0,25,1
1653302306837,MUS 5,A01,090524,Staff,20,0,20,0
1653302306837,MUS 5,A02,090525,Staff,18,0,20,2
1653302306837,MUS 5,A03,090526,Staff,20,0,20,0
1653302306837,MUS 5,A04,090527,Staff,20,0,20,0
1653302306837,MUS 5,A05,090528,Staff,19,0,20,1
1653302307364,MUS 6,A01,090530,Staff,22,0,25,3
1653302307364,MUS 6,A02,090531,Staff,25,0,25,0
1653302307364,MUS 6,A03,090532,Staff,25,0,25,0
1653302307364,MUS 6,A04,090533,Staff,23,0,25,2
1653302307891,MUS 8,A01,090535,Kenyatta; Kamau,17,0,25,8
1653302307891,MUS 8,A02,090536,Kenyatta; Kamau,19,0,25,6
1653302307891,MUS 8,A03,090537,Kenyatta; Kamau,17,0,25,8
1653302307891,MUS 8,A04,090538,Kenyatta; Kamau,21,0,25,4
1653302308422,MUS 12,A01,090540,Narucki; Susan M,20,0,20,0
1653302308422,MUS 12,A02,090541,Narucki; Susan M,20,0,20,0
1653302308422,MUS 12,A03,090542,Narucki; Susan M,17,0,20,3
1653302308947,MUS 15,A01,090544,Staff,21,0,25,4
1653302308947,MUS 15,A02,090545,Staff,23,0,25,2
1653302308947,MUS 15,A03,090546,Staff,24,0,25,1
1653302308947,MUS 15,A04,090547,Staff,22,0,25,3
1653302308947,MUS 15,A05,090548,Staff,25,0,25,0
1653302308947,MUS 15,A06,090549,Staff,24,0,25,1
1653302309481,MUS 19R,A01,090551,Britt; King James,17,0,20,3
1653302309481,MUS 19R,A02,090552,Britt; King James,19,0,20,1
1653302309481,MUS 19R,A03,090553,Britt; King James,20,0,20,0
1653302309481,MUS 19R,A04,090554,Britt; King James,19,0,20,1
1653302309481,MUS 19R,A05,090555,Britt; King James,20,0,20,0
1653302309481,MUS 19R,A06,090556,Britt; King James,18,0,20,2
1653302309481,MUS 19R,A07,090557,Britt; King James,19,0,20,1
1653302309481,MUS 19R,A08,090558,Britt; King James,19,0,20,1
1653302309481,MUS 19R,A09,090559,Britt; King James,20,0,20,0
1653302309481,MUS 19R,A10,090560,Britt; King James,20,0,20,0
1653302309481,MUS 19R,B01,090562,Britt; King James,10,0,10,0
1653302309481,MUS 19R,B02,090563,Britt; King James,10,0,10,0
1653302309481,MUS 19R,B03,090564,Britt; King James,10,0,10,0
1653302309481,MUS 19R,B04,090565,Britt; King James,10,0,10,0
1653302309481,MUS 19R,B05,090566,Britt; King James,10,0,10,0
1653302309481,MUS 19R,B06,090567,Britt; King James,10,0,10,0
1653302309481,MUS 19R,B07,090568,Britt; King James,10,0,10,0
1653302309481,MUS 19R,B08,090569,Britt; King James,10,0,10,0
1653302309481,MUS 19R,B09,090570,Britt; King James,10,0,10,0
1653302309481,MUS 19R,B10,090571,Britt; King James,10,0,10,0
1653302310009,MUS 20,A01,090573,Borgo; David Garcia,12,0,15,3
1653302310009,MUS 20,A02,090574,Borgo; David Garcia,14,0,15,1
1653302310009,MUS 20,A03,090575,Borgo; David Garcia,13,0,15,2
1653302310537,MUS 32,001,094074,Staff,10,0,10,0
1653302310537,MUS 32,002,094075,Kenyatta; Kamau,10,0,10,0
1653302310537,MUS 32,003,094076,Curtis; Charles Rector,10,0,10,0
1653302310537,MUS 32,005,094078,Terrazas Perez; Wilfrido D,10,0,10,0
1653302310537,MUS 32,006,094079,Ohnishi; Takae,10,0,10,0
1653302310537,MUS 32,007,094080,Burr; Anthony I,10,0,10,0
1653302310537,MUS 32,008,094081,Carlson; Erik Norman,10,0,10,0
1653302310537,MUS 32,009,094082,Dresser; Mark Stuart,10,0,10,0
1653302310537,MUS 32,011,094084,Richards; Stephanie F,10,0,10,0
1653302310537,MUS 32,012,094085,Borgo; David Garcia,10,0,10,0
1653302310537,MUS 32,013,094086,Paganos Koukakis; Dimitrios,10,0,10,0
1653302310537,MUS 32,014,094087,Jones; Michael David,10,0,10,0
1653302311065,MUS 32V,A00,094355,Zazueta Cervera; Miguel Angel,10,0,10,0
1653302311065,MUS 32V,B00,094089,Flores; Mariana,10,0,10,0
1653302311589,MUS 32VM,A00,094090,Zazueta Cervera; Miguel Angel,15,0,15,0
1653302312186,MUS 33A,A00,090576,Liang; Lei,24,0,25,1
1653302312709,MUS 43,A00,090577,Burr; Anthony I,92,0,100,8
1653302313233,MUS 95C,B00,094829,Staff,28,0,30,2
1653302313771,MUS 95D,A00,090579,Staff,30,0,30,0
1653302314306,MUS 95E,A00,090580,Staff,30,0,30,0
1653302314832,MUS 95G,A00,090581,Anderson; Kenneth,384,0,395,11
1653302314832,MUS 95G,B00,090582,Anderson; Kenneth,393,0,395,2
1653302315361,MUS 95JC,A00,090583,Kenyatta; Kamau,35,0,35,0
1653302315884,MUS 95L,A00,090584,Staff,30,0,30,0
1653302316411,MUS 95W,A00,090585,Seshadri; Kartik,60,0,60,0
1653302316411,MUS 95W,B00,090586,Seshadri; Kartik,30,0,30,0
1653302316934,MUS 101A,A01,090588,Staff,29,0,30,1
1653302317463,MUS 103A,A00,090589,Ung; Chinary,15,0,15,0
1653302317989,MUS 107,A00,090590,Terrazas Perez; Wilfrido D,30,0,30,0
1653302318519,MUS 111,A00,090591,Yadegari; Shahrokh D,124,0,130,6
1653302319043,MUS 114,A00,090592,Curtis; Charles Rector,117,0,125,8
1653302319567,MUS 120A,A01,090594,Cimini; Amy Marie,29,0,30,1
1653302320102,MUS 126R,A00,090595,Borgo; David Garcia,106,0,115,9
1653302320625,MUS 130,A00,090596,Ohnishi; Takae,30,0,30,0
1653302321149,MUS 132,001,094091,Nourai; Keyarash,10,0,10,0
1653302321149,MUS 132,002,094093,Kenyatta; Kamau,10,0,10,0
1653302321149,MUS 132,003,094094,Curtis; Charles Rector,10,0,10,0
1653302321149,MUS 132,005,094096,Terrazas Perez; Wilfrido D,10,0,10,0
1653302321149,MUS 132,006,094097,Ohnishi; Takae,10,0,10,0
1653302321149,MUS 132,007,094098,Burr; Anthony I,10,0,10,0
1653302321149,MUS 132,008,094099,Carlson; Erik Norman,10,0,10,0
1653302321149,MUS 132,009,094100,Dresser; Mark Stuart,10,0,10,0
1653302321149,MUS 132,011,094102,Richards; Stephanie F,10,0,10,0
1653302321149,MUS 132,012,094103,Borgo; David Garcia,10,0,10,0
1653302321149,MUS 132,013,094104,Jones; Michael David,10,0,10,0
1653302321149,MUS 132,014,094105,Staff,10,0,10,0
1653302321672,MUS 132V,A00,094106,Narucki; Susan M,15,0,15,0
1653302322198,MUS 134,A00,090597,Staff,30,0,30,0
1653302322724,MUS 137A,A00,090598,Kenyatta; Kamau,30,0,30,0
1653302323248,MUS 143,A00,090599,Staff,26,0,30,4
1653302324302,MUS 173,A00,090600,Britt; King James,19,0,30,11
1653302324828,MUS 174A,A00,090601,Staff,8,0,15,7
1653302325882,NANO 4,A01,088199,Vazquez Mena; Oscar,20,0,20,0
1653302325882,NANO 4,B01,088201,Vazquez Mena; Oscar,20,0,20,0
1653302325882,NANO 4,C01,088203,Vazquez Mena; Oscar,20,0,20,0
1653302326410,NANO 15,A01,088205,Lubarda; Vlado,50,0,50,0
1653302326410,NANO 15,B01,088207,Lubarda; Vlado,50,0,50,0
1653302326933,NANO 20L,A00,088208,Sirbuly; Donald,27,0,30,3
1653302326933,NANO 20L,B00,088209,Sirbuly; Donald,29,0,30,1
1653302327456,NANO 100L,A00,088210,Vecchio; Kenneth S,24,0,30,6
1653302327986,NANO 102,A00,088211,Tao; Andrea Rae,94,0,100,6
1653302328509,NANO 110,A00,088212,Pascal; Tod A,99,0,100,1
1653302329041,NANO 111,A00,088213,Fenning; David,45,0,50,5
1653302329571,NANO 117,A00,088214,Cubukcu; Ertugrul,71,0,75,4
1653302330094,NANO 119,A00,088215,Vazquez Mena; Oscar,50,0,50,0
1653302330618,NANO 159,A00,088216,Wang; Joseph,33,0,40,7
1653302331150,NANO 181,A01,088218,Ong; Shyue Ping,22,0,25,3
1653302331678,PHIL 1,A00,090815,Sher; Gila,57,0,60,3
1653302332206,PHIL 10,A01,090817,Grush; Rick Scott,37,0,40,3
1653302332206,PHIL 10,A02,090818,Grush; Rick Scott,37,0,40,3
1653302332206,PHIL 10,A03,090819,Grush; Rick Scott,38,0,40,2
1653302332206,PHIL 10,A04,090820,Grush; Rick Scott,40,0,40,0
1653302332206,PHIL 10,A05,090821,Grush; Rick Scott,38,0,40,2
1653302332206,PHIL 10,A06,090822,Grush; Rick Scott,39,0,40,1
1653302332735,PHIL 12,A01,090824,Bechtel; William,20,0,25,5
1653302332735,PHIL 12,A02,090825,Bechtel; William,24,0,25,1
1653302332735,PHIL 12,A03,090826,Bechtel; William,25,0,25,0
1653302332735,PHIL 12,A04,090827,Bechtel; William,25,0,25,0
1653302333261,PHIL 13,A01,090829,Wonderly; Monique L.,25,0,25,0
1653302333261,PHIL 13,A02,090830,Wonderly; Monique L.,24,0,25,1
1653302333261,PHIL 13,A03,090831,Wonderly; Monique L.,24,0,25,1
1653302333261,PHIL 13,A04,090832,Wonderly; Monique L.,25,0,25,0
1653302333790,PHIL 27,A01,090834,Harrell; Maralee Mae,23,0,35,12
1653302333790,PHIL 27,A02,090835,Harrell; Maralee Mae,35,0,35,0
1653302333790,PHIL 27,A03,090836,Harrell; Maralee Mae,33,0,35,2
1653302333790,PHIL 27,A04,090837,Harrell; Maralee Mae,33,0,35,2
1653302333790,PHIL 27,A05,090838,Harrell; Maralee Mae,35,0,35,0
1653302333790,PHIL 27,A06,090839,Harrell; Maralee Mae,35,0,35,0
1653302334316,PHIL 28,A01,090841,Bazargan-Forward; Saba,31,0,35,4
1653302334316,PHIL 28,A02,090842,Bazargan-Forward; Saba,31,0,35,4
1653302334316,PHIL 28,A03,090843,Bazargan-Forward; Saba,35,0,35,0
1653302334316,PHIL 28,A04,090844,Bazargan-Forward; Saba,30,0,35,5
1653302334316,PHIL 28,A05,090845,Bazargan-Forward; Saba,33,0,35,2
1653302334316,PHIL 28,A06,090846,Bazargan-Forward; Saba,34,0,35,1
1653302334316,PHIL 28,A07,090847,Bazargan-Forward; Saba,32,0,35,3
1653302334316,PHIL 28,A08,090848,Bazargan-Forward; Saba,33,0,35,2
1653302334845,PHIL 31,A00,090849,Johnson; Monte,59,0,60,1
1653302335372,PHIL 100,A00,090852,Nelkin; Dana Kay,28,0,35,7
1653302335899,PHIL 110,A00,090853,Johnson; Monte,29,0,30,1
1653302336422,PHIL 120,A00,090854,Rickless; Samuel Charles,23,0,35,12
1653302336953,PHIL 123,A00,090855,Sher; Gila,38,0,40,2
1653302337479,PHIL 131,A00,090856,Cohen; Jonathan David,34,0,35,1
1653302338006,PHIL 132,A00,090857,Carr; Jennifer Rose,33,0,35,2
1653302338531,PHIL 138,A00,090858,Brink; David O.,34,0,40,6
1653302339055,PHIL 147,A00,090860,Fulkerson; Matthew Todd,33,0,35,2
1653302339584,PHIL 150,A00,090861,Bechtel; William,36,0,40,4
1653302340107,PHIL 155,A00,090862,Vargas; Manuel Rogelio,38,0,40,2
1653302340644,PHIL 165,A00,090863,Rickless; Samuel Charles,59,0,70,11
1653302341168,PHIL 172,A00,090864,Bazargan-Forward; Saba,37,0,40,3
1653302341690,PHIL 173,A00,090865,Wonderly; Monique L.,33,0,40,7
1653302342217,PHYS 1A,A00,088555,Koslover; Elena F,354,0,362,8
1653302342217,PHYS 1A,B00,088556,Koslover; Elena F,343,0,362,19
1653302342217,PHYS 1A,C00,088557,Shpyrko; Oleg,326,0,362,36
1653302342747,PHYS 1AL,001,088558,Tsai; Philbert S,30,0,30,0
1653302342747,PHYS 1AL,002,088559,Tsai; Philbert S,30,0,30,0
1653302342747,PHYS 1AL,003,088560,Tsai; Philbert S,23,0,30,7
1653302342747,PHYS 1AL,004,088561,Tsai; Philbert S,26,0,30,4
1653302342747,PHYS 1AL,005,088562,Tsai; Philbert S,24,0,30,6
1653302342747,PHYS 1AL,006,088563,Tsai; Philbert S,30,0,30,0
1653302342747,PHYS 1AL,007,088564,Tsai; Philbert S,26,0,30,4
1653302342747,PHYS 1AL,008,088565,Tsai; Philbert S,29,0,30,1
1653302342747,PHYS 1AL,009,088566,Tsai; Philbert S,28,0,30,2
1653302342747,PHYS 1AL,010,088567,Tsai; Philbert S,30,0,30,0
1653302342747,PHYS 1AL,011,088568,Tsai; Philbert S,29,0,30,1
1653302342747,PHYS 1AL,012,088569,Tsai; Philbert S,29,0,30,1
1653302342747,PHYS 1AL,013,088570,Tsai; Philbert S,30,0,30,0
1653302342747,PHYS 1AL,014,088571,Tsai; Philbert S,29,0,30,1
1653302342747,PHYS 1AL,015,088572,Tsai; Philbert S,23,0,30,7
1653302342747,PHYS 1AL,016,088573,Tsai; Philbert S,28,0,30,2
1653302342747,PHYS 1AL,017,088574,Tsai; Philbert S,29,0,30,1
1653302342747,PHYS 1AL,018,088575,Tsai; Philbert S,28,0,30,2
1653302342747,PHYS 1AL,019,088576,Tsai; Philbert S,26,0,30,4
1653302342747,PHYS 1AL,020,088577,Tsai; Philbert S,29,0,30,1
1653302342747,PHYS 1AL,021,088578,Tsai; Philbert S,30,0,30,0
1653302342747,PHYS 1AL,022,088579,Tsai; Philbert S,30,0,30,0
1653302342747,PHYS 1AL,023,088580,Tsai; Philbert S,30,0,30,0
1653302342747,PHYS 1AL,024,088581,Tsai; Philbert S,30,0,30,0
1653302342747,PHYS 1AL,025,088582,Tsai; Philbert S,26,0,30,4
1653302342747,PHYS 1AL,026,088583,Tsai; Philbert S,29,0,30,1
1653302342747,PHYS 1AL,027,088584,Tsai; Philbert S,28,0,30,2
1653302342747,PHYS 1AL,028,088585,Tsai; Philbert S,30,0,30,0
1653302342747,PHYS 1AL,029,088586,Tsai; Philbert S,27,0,30,3
1653302342747,PHYS 1AL,030,088587,Tsai; Philbert S,29,0,30,1
1653302342747,PHYS 1AL,031,088588,Tsai; Philbert S,30,0,30,0
1653302342747,PHYS 1AL,032,088589,Tsai; Philbert S,30,0,30,0
1653302342747,PHYS 1AL,033,088590,Tsai; Philbert S,30,0,30,0
1653302342747,PHYS 1AL,034,088591,Tsai; Philbert S,30,0,30,0
1653302342747,PHYS 1AL,035,088592,Tsai; Philbert S,29,0,30,1
1653302342747,PHYS 1AL,036,088593,Tsai; Philbert S,30,0,30,0
1653302343275,PHYS 1B,A00,088594,Groisman; Alexander,351,0,360,9
1653302343799,PHYS 1BL,001,088595,Tsai; Philbert S,30,0,30,0
1653302343799,PHYS 1BL,002,088596,Tsai; Philbert S,25,0,30,5
1653302343799,PHYS 1BL,003,088597,Tsai; Philbert S,27,0,30,3
1653302343799,PHYS 1BL,004,088598,Tsai; Philbert S,30,0,30,0
1653302343799,PHYS 1BL,005,088599,Tsai; Philbert S,29,0,30,1
1653302343799,PHYS 1BL,006,088600,Tsai; Philbert S,25,0,30,5
1653302343799,PHYS 1BL,007,088601,Tsai; Philbert S,30,0,30,0
1653302343799,PHYS 1BL,008,088602,Tsai; Philbert S,29,0,30,1
1653302343799,PHYS 1BL,009,088603,Tsai; Philbert S,30,0,30,0
1653302343799,PHYS 1BL,010,088604,Tsai; Philbert S,30,0,30,0
1653302343799,PHYS 1BL,011,088605,Tsai; Philbert S,28,0,30,2
1653302343799,PHYS 1BL,012,088606,Tsai; Philbert S,26,0,30,4
1653302344326,PHYS 1C,A00,088607,Tsai; Philbert S,334,0,360,26
1653302344858,PHYS 1CL,001,088608,Tsai; Philbert S,30,0,30,0
1653302344858,PHYS 1CL,002,088609,Tsai; Philbert S,24,0,30,6
1653302344858,PHYS 1CL,003,088610,Tsai; Philbert S,24,0,30,6
1653302344858,PHYS 1CL,004,088611,Tsai; Philbert S,29,0,30,1
1653302344858,PHYS 1CL,005,088612,Tsai; Philbert S,17,0,30,13
1653302344858,PHYS 1CL,006,088613,Tsai; Philbert S,19,0,30,11
1653302344858,PHYS 1CL,007,088614,Tsai; Philbert S,30,0,30,0
1653302344858,PHYS 1CL,008,088615,Tsai; Philbert S,26,0,30,4
1653302344858,PHYS 1CL,009,088616,Tsai; Philbert S,27,0,30,3
1653302344858,PHYS 1CL,010,088617,Tsai; Philbert S,29,0,30,1
1653302344858,PHYS 1CL,011,088618,Tsai; Philbert S,27,0,30,3
1653302344858,PHYS 1CL,012,088619,Tsai; Philbert S,24,0,30,6
1653302345391,PHYS 2A,A01,092602,Meyertholen; Andrew D.,26,0,30,4
1653302345391,PHYS 2A,A02,092603,Meyertholen; Andrew D.,28,0,30,2
1653302345391,PHYS 2A,A03,092604,Meyertholen; Andrew D.,29,0,30,1
1653302345391,PHYS 2A,A04,092605,Meyertholen; Andrew D.,30,0,30,0
1653302345391,PHYS 2A,A05,092606,Meyertholen; Andrew D.,29,0,30,1
1653302345391,PHYS 2A,A06,092607,Meyertholen; Andrew D.,29,0,30,1
1653302345391,PHYS 2A,A07,092608,Meyertholen; Andrew D.,30,0,30,0
1653302345391,PHYS 2A,A08,092609,Meyertholen; Andrew D.,30,0,30,0
1653302345391,PHYS 2A,A09,092610,Meyertholen; Andrew D.,27,0,30,3
1653302345391,PHYS 2A,A10,092611,Meyertholen; Andrew D.,30,0,30,0
1653302345391,PHYS 2A,A11,092612,Meyertholen; Andrew D.,30,0,30,0
1653302345391,PHYS 2A,A12,094499,Meyertholen; Andrew D.,27,0,30,3
1653302345916,PHYS 2B,A01,092613,Branson; James G,28,0,30,2
1653302345916,PHYS 2B,A02,092614,Branson; James G,29,0,30,1
1653302345916,PHYS 2B,A03,092615,Branson; James G,30,0,30,0
1653302345916,PHYS 2B,A04,092616,Branson; James G,30,0,30,0
1653302345916,PHYS 2B,A05,092617,Branson; James G,29,0,30,1
1653302345916,PHYS 2B,A06,092618,Branson; James G,29,0,30,1
1653302345916,PHYS 2B,A07,092619,Branson; James G,29,0,30,1
1653302345916,PHYS 2B,A08,092620,Branson; James G,0,0,0,0
1653302345916,PHYS 2B,A09,092621,Branson; James G,0,0,0,0
1653302345916,PHYS 2B,A10,092622,Branson; James G,0,0,0,0
1653302345916,PHYS 2B,A11,092623,Branson; James G,0,0,0,0
1653302345916,PHYS 2B,A12,092624,Branson; James G,30,0,30,0
1653302346442,PHYS 2C,A01,092625,Barreiro Guerrero; Julio,26,0,30,4
1653302346442,PHYS 2C,A02,092626,Barreiro Guerrero; Julio,28,0,30,2
1653302346442,PHYS 2C,A03,092627,Barreiro Guerrero; Julio,29,0,30,1
1653302346442,PHYS 2C,A04,092628,Barreiro Guerrero; Julio,29,0,30,1
1653302346442,PHYS 2C,A05,092629,Barreiro Guerrero; Julio,30,0,30,0
1653302346442,PHYS 2C,A06,092630,Barreiro Guerrero; Julio,30,0,30,0
1653302346442,PHYS 2C,A07,092631,Barreiro Guerrero; Julio,30,0,30,0
1653302346442,PHYS 2C,A08,092632,Barreiro Guerrero; Julio,30,0,30,0
1653302346442,PHYS 2C,A09,092633,Barreiro Guerrero; Julio,29,0,30,1
1653302346442,PHYS 2C,A10,092634,Barreiro Guerrero; Julio,29,0,30,1
1653302346442,PHYS 2C,A11,092635,Barreiro Guerrero; Julio,27,0,30,3
1653302346442,PHYS 2C,A12,092636,Barreiro Guerrero; Julio,29,0,30,1
1653302346442,PHYS 2C,B01,092637,Barreiro Guerrero; Julio,29,0,30,1
1653302346442,PHYS 2C,B02,092638,Barreiro Guerrero; Julio,30,0,30,0
1653302346442,PHYS 2C,B03,092639,Barreiro Guerrero; Julio,28,0,30,2
1653302346442,PHYS 2C,B04,092640,Barreiro Guerrero; Julio,29,0,30,1
1653302346442,PHYS 2C,B05,092641,Barreiro Guerrero; Julio,26,0,30,4
1653302346442,PHYS 2C,B06,092642,Barreiro Guerrero; Julio,28,0,30,2
1653302346442,PHYS 2C,B07,092643,Barreiro Guerrero; Julio,29,0,30,1
1653302346442,PHYS 2C,B08,092644,Barreiro Guerrero; Julio,30,0,30,0
1653302346442,PHYS 2C,B09,092645,Barreiro Guerrero; Julio,29,0,30,1
1653302346442,PHYS 2C,B10,092646,Barreiro Guerrero; Julio,29,0,30,1
1653302346442,PHYS 2C,B11,092647,Barreiro Guerrero; Julio,30,0,30,0
1653302346442,PHYS 2C,B12,092648,Barreiro Guerrero; Julio,30,0,30,0
1653302346967,PHYS 2CL,A01,088625,Du; Chunhui,26,0,30,4
1653302346967,PHYS 2CL,A02,088626,Du; Chunhui,29,0,30,1
1653302346967,PHYS 2CL,A03,088627,Du; Chunhui,21,0,30,9
1653302346967,PHYS 2CL,A04,088628,Du; Chunhui,30,0,30,0
1653302346967,PHYS 2CL,A05,088629,Du; Chunhui,29,0,30,1
1653302346967,PHYS 2CL,A06,088630,Du; Chunhui,24,0,30,6
1653302346967,PHYS 2CL,A07,088631,Du; Chunhui,28,0,30,2
1653302346967,PHYS 2CL,A08,088632,Du; Chunhui,28,0,30,2
1653302346967,PHYS 2CL,A09,088633,Du; Chunhui,24,0,30,6
1653302346967,PHYS 2CL,A10,088634,Du; Chunhui,29,0,30,1
1653302346967,PHYS 2CL,A11,088635,Du; Chunhui,27,0,30,3
1653302346967,PHYS 2CL,A12,088636,Du; Chunhui,30,0,30,0
1653302347492,PHYS 2D,A01,092649,Hirsch; Jorge Eduardo,30,0,30,0
1653302347492,PHYS 2D,A02,092650,Hirsch; Jorge Eduardo,28,0,30,2
1653302347492,PHYS 2D,A03,092651,Hirsch; Jorge Eduardo,30,0,30,0
1653302347492,PHYS 2D,A04,092652,Hirsch; Jorge Eduardo,30,0,30,0
1653302347492,PHYS 2D,A05,092653,Hirsch; Jorge Eduardo,30,0,30,0
1653302347492,PHYS 2D,A06,092654,Hirsch; Jorge Eduardo,30,0,30,0
1653302348015,PHYS 2DL,A01,088639,Butov; Leonid,7,0,16,9
1653302348015,PHYS 2DL,A02,088640,Butov; Leonid,13,0,16,3
1653302348015,PHYS 2DL,A03,094501,Butov; Leonid,13,0,16,3
1653302348015,PHYS 2DL,A04,094502,Butov; Leonid,16,0,16,0
1653302348539,PHYS 4C,A01,092655,Averitt; Richard Douglas,28,0,30,2
1653302348539,PHYS 4C,A02,092656,Averitt; Richard Douglas,30,0,30,0
1653302348539,PHYS 4C,A03,092657,Averitt; Richard Douglas,30,0,30,0
1653302348539,PHYS 4C,A04,092658,Staff,30,0,30,0
1653302349066,PHYS 5,A01,092662,Konopacky; Quinn Morgan,197,0,200,3
1653302349592,PHYS 10,A01,092663,Tytler; David Robert,191,0,192,1
1653302350120,PHYS 100A,A01,092660,Shpyrko; Oleg,114,0,120,6
1653302350643,PHYS 110A,A01,092664,Arovas; Daniel P,116,0,120,4
1653302351173,PHYS 122,A01,088647,Yang; Liang,30,0,40,10
1653302351698,PHYS 130B,A01,092661,Grover; Tarun,106,0,120,14
1653302352221,PHYS 139,A00,088649,Kuti; Julius,19,0,20,1
1653302352750,PHYS 140A,A01,092665,Shotwell; Brian,105,0,120,15
1653302353274,PHYS 161,A01,092666,Fuller; George Michael,46,0,65,19
1653302353798,PHYS 163,A01,092667,Keres; Dusan,48,0,50,2
1653302354322,PHYS 175,A00,088653,Dudko; Olga,18,0,20,2
1653302354847,PHYS 191,A00,088654,Shpyrko; Oleg,26,0,30,4
1653302355371,POLI 11D,A01,090896,Ferree; Karen E,29,0,30,1
1653302355371,POLI 11D,A02,090897,Ferree; Karen E,28,0,30,2
1653302355371,POLI 11D,A03,090899,Ferree; Karen E,28,0,30,2
1653302355371,POLI 11D,A04,090900,Ferree; Karen E,29,0,30,1
1653302355894,POLI 12D,A01,090902,Roeder; Philip G,26,0,30,4
1653302355894,POLI 12D,A02,090903,Roeder; Philip G,27,0,30,3
1653302355894,POLI 12D,A05,090906,Roeder; Philip G,28,0,30,2
1653302355894,POLI 12D,A06,090907,Roeder; Philip G,30,0,30,0
1653302356426,POLI 13DR,A01,090909,Forman; Fonna,26,0,30,4
1653302356426,POLI 13DR,A02,090910,Forman; Fonna,30,0,30,0
1653302356426,POLI 13DR,A03,090911,Forman; Fonna,28,0,30,2
1653302356426,POLI 13DR,A04,090912,Forman; Fonna,30,0,30,0
1653302356426,POLI 13DR,A05,090913,Forman; Fonna,28,0,30,2
1653302356426,POLI 13DR,A06,090914,Forman; Fonna,34,0,34,0
1653302356951,POLI 27,A01,090916,Elgin; Samuel Zincke,23,0,30,7
1653302356951,POLI 27,A02,090917,Elgin; Samuel Zincke,26,0,30,4
1653302356951,POLI 27,A03,090918,Elgin; Samuel Zincke,30,0,30,0
1653302356951,POLI 27,A04,090919,Elgin; Samuel Zincke,28,0,30,2
1653302356951,POLI 27,A05,090920,Elgin; Samuel Zincke,24,0,30,6
1653302356951,POLI 27,A06,090921,Elgin; Samuel Zincke,29,0,30,1
1653302357476,POLI 28,A01,090923,Elgin; Samuel Zincke,23,0,30,7
1653302357476,POLI 28,A02,090924,Elgin; Samuel Zincke,26,0,30,4
1653302357476,POLI 28,A05,090927,Elgin; Samuel Zincke,23,0,30,7
1653302357476,POLI 28,A06,090928,Elgin; Samuel Zincke,23,0,30,7
1653302358006,POLI 30D,A01,090930,Desposato; Scott,22,0,24,2
1653302358006,POLI 30D,A02,090931,Desposato; Scott,22,0,24,2
1653302358006,POLI 30D,A03,090932,Desposato; Scott,23,0,24,1
1653302358006,POLI 30D,A04,090933,Desposato; Scott,24,0,24,0
1653302358006,POLI 30D,A05,090934,Desposato; Scott,23,0,24,1
1653302358006,POLI 30D,A06,090935,Desposato; Scott,24,0,24,0
1653302358531,POLI 100G,A00,090936,Fletcher; Nathan,199,0,208,9
1653302359064,POLI 100V,A00,090937,Gause; LaGina,111,0,115,4
1653302359595,POLI 100W,A00,090938,Paglayan; Agustina,161,0,165,4
1653302360119,POLI 104A,A00,090940,Smith; Glenn Chatmas,186,0,195,9
1653302360643,POLI 104F,A00,090941,Smith; Glenn Chatmas,11,0,19,8
1653302361168,POLI 104M,A00,090942,Stephens; Mattheus E,156,0,165,9
1653302361693,POLI 110A,A00,090943,Wiens; David,39,0,44,5
1653302362224,POLI 110F,A00,090944,Elgin; Samuel Zincke,50,0,50,0
1653302362749,POLI 113A,A00,090945,Magagna; Victor Valentine,469,0,475,6
1653302362749,POLI 113A,B00,090946,Magagna; Victor Valentine,467,0,475,8
1653302363277,POLI 117R,A00,090947,Forman; Fonna,16,0,40,24
1653302363802,POLI 120E,A00,090948,Strom; Kaare,47,0,50,3
1653302364325,POLI 120G,A00,090949,Fisk; David Lee,110,0,115,5
1653302364848,POLI 120H,A00,090950,Fisk; David Lee,111,0,115,4
1653302365446,POLI 133A,A00,090951,Naoi; Megumi,156,0,165,9
1653302365973,POLI 135,A00,090952,Fisk; David Lee,111,0,115,4
1653302366497,POLI 142J,A00,090953,Slantchev; Branislav,45,0,50,5
1653302367023,POLI 143,A00,090954,Gartzke; Erik,111,0,115,4
1653302367547,POLI 149,A00,090955,Joseph; Michael F,152,0,165,13
1653302368076,POLI 151,A00,090956,Schneider; Christina,92,0,100,8
1653302368604,POLI 165,A00,090957,Warren; Scott,45,0,50,5
1653302369127,POLI 178,A00,090958,Joseph; Michael F,34,0,50,16
1653302369654,POLI 191A,A00,090959,Forman; Fonna & Hoston; Germaine,25,0,25,0
1653302370176,POLI 194,A00,090960,Hill; Seth J,9999,0,9999,0
1653302370702,POLI 194SD,A00,090961,Nichter; Maysa,9999,0,9999,0
1653302371225,POLI 197SD,001,090962,Nichter; Maysa,9999,0,9999,0
1653302371749,PSYC 1,A00,088391,Ferreira; Victor,194,0,200,6
1653302372273,PSYC 2,A00,093916,Moranton; Nirelia Melbina-,192,0,195,3
1653302372797,PSYC 3,A00,088392,Pilegard; Celeste Cristine,221,0,225,4
1653302373326,PSYC 6,A00,088393,McCullough; Michael E,198,0,200,2
1653302373852,PSYC 7,A00,088394,Powell; Lindsey Jane,196,0,200,4
1653302374388,PSYC 60,A01,088397,Lowe; Angela Beth,12,0,25,13
1653302374388,PSYC 60,A02,088398,Lowe; Angela Beth,25,0,25,0
1653302374388,PSYC 60,A03,088399,Lowe; Angela Beth,24,0,25,1
1653302374388,PSYC 60,A04,088400,Lowe; Angela Beth,23,0,25,2
1653302374388,PSYC 60,A05,088401,Lowe; Angela Beth,24,0,25,1
1653302374388,PSYC 60,A06,088402,Lowe; Angela Beth,25,0,25,0
1653302374388,PSYC 60,A07,088403,Lowe; Angela Beth,24,0,25,1
1653302374388,PSYC 60,B01,088405,Rickard; Timothy C.,25,0,25,0
1653302374388,PSYC 60,B02,088406,Rickard; Timothy C.,25,0,25,0
1653302374388,PSYC 60,B03,088407,Rickard; Timothy C.,25,0,25,0
1653302374388,PSYC 60,B04,088408,Rickard; Timothy C.,23,0,25,2
1653302374388,PSYC 60,B05,088410,Rickard; Timothy C.,24,0,25,1
1653302374388,PSYC 60,B06,088411,Rickard; Timothy C.,24,0,25,1
1653302374388,PSYC 60,B07,088412,Rickard; Timothy C.,24,0,25,1
1653302374913,PSYC 70,A01,088414,Pilegard; Celeste Cristine,17,0,25,8
1653302374913,PSYC 70,A02,088415,Pilegard; Celeste Cristine,24,0,25,1
1653302374913,PSYC 70,A03,088416,Pilegard; Celeste Cristine,25,0,25,0
1653302374913,PSYC 70,A04,088417,Pilegard; Celeste Cristine,25,0,25,0
1653302374913,PSYC 70,A05,088418,Pilegard; Celeste Cristine,22,0,25,3
1653302374913,PSYC 70,A06,088419,Pilegard; Celeste Cristine,19,0,25,6
1653302375437,PSYC 71,A01,088421,Lowe; Angela Beth,15,0,25,10
1653302375437,PSYC 71,A02,088422,Lowe; Angela Beth,21,0,25,4
1653302375437,PSYC 71,B01,088424,Steiner; Eric Tomas,20,0,25,5
1653302375437,PSYC 71,B02,088425,Steiner; Eric Tomas,23,0,25,2
1653302375962,PSYC 87,A00,093915,Gorman; Michael R.,20,0,20,0
1653302376486,PSYC 88,A00,088426,Dobkins; Karen R.,61,0,65,4
1653302377010,PSYC 100,A00,088428,Chapman; Eddie Nathaniel,125,0,170,45
1653302377534,PSYC 101,A00,088429,Heyman; Gail D.,148,0,170,22
1653302378058,PSYC 102,A00,093917,Moranton; Nirelia Melbina-,162,0,170,8
1653302378583,PSYC 104,A00,088430,Fine; Rachel,163,0,175,12
1653302379114,PSYC 116A,A01,088433,Lang; Ariel,25,0,25,0
1653302379641,PSYC 122,A00,088434,Miller; Cory T.,103,0,115,12
1653302380166,PSYC 125,A00,088436,Rose; Fred E.,90,0,120,30
1653302380694,PSYC 134,A00,088437,Kaye; Walter H.,235,0,250,15
1653302381223,PSYC 137,A00,088438,Fine; Rachel,210,0,216,6
1653302381746,PSYC 145,A00,093918,Staff,73,0,90,17
1653302382274,PSYC 147,A00,088441,Wong; Lauren Hitomi,120,0,146,26
1653302382799,PSYC 154,A00,093919,Lacefield; Katharine I,270,0,295,25
1653302383327,PSYC 158,A00,088443,Willis; Jarryd Thomas,250,0,295,45
1653302383856,PSYC 162,A00,088444,Wixted; John T,210,0,225,15
1653302384380,PSYC 167,A00,088445,Walker; Caren Michelle,0,0,30,30
1653302384908,PSYC 168,A00,088446,Chapman; Eddie Nathaniel,222,0,250,28
1653302385435,PSYC 171,A00,088447,Mukku; Dhananjaya,66,0,75,9
1653302385959,PSYC 178,A00,088448,Glaser; Dale,105,0,120,15
1653302386484,PSYC 179,A00,088449,Lacefield; Katharine I,193,0,250,57
1653302387008,PSYC 181,A00,088450,Anagnostaras; Stephan,284,0,300,16
1653302387537,PSYC 189,A00,088451,Gentner; Tim,19,0,31,12
1653302388061,PSYC 193,A00,088452,Gremel; Christina M,19,0,20,1
1653302388061,PSYC 193,B00,088453,Staff,19,0,20,1
1653302388589,PSYC 193L,A01,088455,Staff,33,0,35,2
1653302389117,PSYC 194A,A01,088461,Heyman; Gail D.,35,0,35,0
1653302389643,RELI 1,A01,086478,Kalleres; Dayna,20,0,20,0
1653302389643,RELI 1,A02,086479,Kalleres; Dayna,19,0,20,1
1653302390168,RELI 147,A00,088409,Caciola; Nancy A,0,0,0,0
1653302390701,REV 1,A01,092308,Leigh; Brian,24,0,24,0
1653302390701,REV 1,A02,092310,Leigh; Brian,24,0,24,0
1653302390701,REV 1,A03,092312,Leigh; Brian,24,0,24,0
1653302390701,REV 1,A04,092314,Leigh; Brian,24,0,24,0
1653302390701,REV 1,A05,092316,Leigh; Brian,24,0,24,0
1653302391231,REV 2,A01,092318,Staff,28,0,28,0
1653302391231,REV 2,A02,092319,Staff,28,0,28,0
1653302391758,REV 20,A00,092320,Staff,40,0,40,0
1653302392287,REV 87,A00,092321,Lyon; Antony J.,20,0,20,0
1653302392812,SE 1,A01,088674,Van Den Einde; Yael Dahlia,48,0,48,0
1653302392812,SE 1,A02,088675,Van Den Einde; Yael Dahlia,47,0,48,1
1653302392812,SE 1,A03,088676,Van Den Einde; Yael Dahlia,46,0,48,2
1653302393340,SE 101A,A00,088677,Morrison; Machel Leigh,191,0,200,9
1653302393868,SE 101C,A00,088678,Zhu; Qiang,137,0,145,8
1653302394397,SE 125,A00,088679,Conte; Joel P,143,0,145,2
1653302394921,SE 130A,A00,088680,Loh; Kenneth J. H.,110,0,115,5
1653302395445,SE 131B,A00,088681,Krysl; Petr,84,0,115,31
1653302395973,SE 142,A01,088683,Staff,11,0,18,7
1653302395973,SE 142,A02,088684,Staff,13,0,18,5
1653302396499,SE 164,A01,088686,Loh; Kenneth J. H.,14,0,16,2
1653302397034,SE 180,A00,088687,Elgamal; Ahmed,66,0,75,9
1653302397560,SE 181,A01,088689,McCartney; John Scott,25,0,30,5
1653302397560,SE 181,A02,088690,McCartney; John Scott,14,0,30,16
1653302397560,SE 181,A03,088691,McCartney; John Scott,25,0,25,0
1653302397560,SE 181,A04,088692,McCartney; John Scott,25,0,25,0
1653302398083,SIO 12,A00,088342,Staff,141,0,146,5
1653302398613,SIO 15,A00,088343,Laske; Gabi,333,0,340,7
1653302399144,SIO 30,A01,092382,Castillo; Paterno R.,28,0,35,7
1653302399144,SIO 30,A02,092383,Castillo; Paterno R.,32,0,35,3
1653302399144,SIO 30,A03,092384,Castillo; Paterno R.,35,0,35,0
1653302399144,SIO 30,A04,092385,Castillo; Paterno R.,35,0,35,0
1653302399668,SIO 40,A00,088345,Barbeau; Katherine,144,0,146,2
1653302400207,SIO 50,A01,088347,Cook; Geoffrey W,11,0,14,3
1653302400207,SIO 50,A02,088348,Cook; Geoffrey W,11,0,14,3
1653302400737,SIO 87,A00,088350,Cook; Geoffrey W,20,0,20,0
1653302400737,SIO 87,B00,088351,Cook; Geoffrey W,20,0,20,0
1653302400737,SIO 87,C00,094017,Gilbert; Jack Anthony,20,0,20,0
1653302400737,SIO 87,D00,094018,Gerwick; William Henry,20,0,20,0
1653302401266,SIO 90,A00,088352,Staff,56,0,60,4
1653302401798,SIO 100,A00,088354,Norris; Richard D. & Gee; Jeffrey S,10,0,20,10
1653302402325,SIO 101,A01,088356,Aluwihare; Lihini & Decima; Moira R.,1,0,30,29
1653302402325,SIO 101,A02,088357,Aluwihare; Lihini & Decima; Moira R.,15,0,30,15
1653302402855,SIO 103,A01,088359,Parnell-Turner; Ross Ernes,21,0,25,4
1653302403385,SIO 105,A00,088360,Driscoll; Neal W.,18,0,20,2
1653302403909,SIO 108,A01,088363,Teranes; Jane,15,0,20,5
1653302404434,SIO 109R,A00,088364,Forman; Fonna,27,0,40,13
1653302404958,SIO 110,A01,088366,Staff,8,0,29,21
1653302405483,SIO 117,A01,088368,Keeling; Ralph F.,31,0,36,5
1653302406007,SIO 123,A00,088369,Allen; Andrew Ellis,61,0,70,9
1653302406552,SIO 132,A01,092386,Hechinger; Ryan F. & Kacev; David,17,0,28,11
1653302406552,SIO 132,A02,092387,Hechinger; Ryan F. & Kacev; David,26,0,28,2
1653302406552,SIO 132,A03,092388,Hechinger; Ryan F. & Kacev; David,28,0,28,0
1653302406552,SIO 132,A04,092389,Hechinger; Ryan F. & Kacev; David,23,0,28,5
1653302406552,SIO 132,A05,092390,Hechinger; Ryan F. & Kacev; David,27,0,28,1
1653302406552,SIO 132,A06,092391,Hechinger; Ryan F. & Kacev; David,27,0,28,1
1653302407083,SIO 136,A01,088373,Kacev; David & Bowman; Jeff Shovlowsky,0,0,5,7
1653302407083,SIO 136,B01,088376,Kacev; David & Bowman; Jeff Shovlowsky,0,0,5,5
1653302407607,SIO 155,A01,088379,Day; James M.D.,1,0,5,4
1653302408132,SIO 170,A00,088380,Cook; Geoffrey W,29,0,30,1
1653302408656,SIO 171,A01,088382,Rudnick; Daniel Lars,37,0,40,3
1653302409184,SIO 175,A01,088384,Merrifield; Mark A,22,0,25,3
1653302409713,SIO 177,A00,088385,Becker; Janet Maria,15,0,20,5
1653302410236,SIO 179,A01,088387,Martz; Todd R.,7,0,15,8
1653302411285,SIO 189,A00,088390,Hamdoun; Amr,35,0,60,25
1653302411812,SIO 194,A00,091602,Hill; Seth J,9999,0,9999,0
1653302412345,SOCE 194,A00,091601,Hill; Seth J,9999,0,9999,0
1653302412873,SOCI 1,A01,093704,Skrentny; John David,19,0,20,1
1653302412873,SOCI 1,A02,093705,Skrentny; John David,20,0,20,0
1653302412873,SOCI 1,A03,093706,Skrentny; John David,18,0,20,2
1653302412873,SOCI 1,A04,093707,Skrentny; John David,19,0,20,1
1653302412873,SOCI 1,A05,093708,Skrentny; John David,17,0,20,3
1653302412873,SOCI 1,A06,093709,Skrentny; John David,20,0,20,0
1653302412873,SOCI 1,A07,093710,Skrentny; John David,20,0,20,0
1653302412873,SOCI 1,A08,093711,Skrentny; John David,20,0,20,0
1653302412873,SOCI 1,A09,093712,Skrentny; John David,20,0,20,0
1653302412873,SOCI 1,A10,093713,Skrentny; John David,20,0,20,0
1653302412873,SOCI 1,A11,093714,Skrentny; John David,20,0,20,0
1653302413399,SOCI 30,A01,093716,Staff,30,0,30,0
1653302413399,SOCI 30,A02,093717,Staff,30,0,30,0
1653302413925,SOCI 60,A01,093719,Staff,17,0,20,3
1653302413925,SOCI 60,A02,093720,Staff,18,0,20,2
1653302413925,SOCI 60,A03,093721,Staff,20,0,20,0
1653302413925,SOCI 60,A04,093722,Staff,20,0,20,0
1653302414450,SOCI 87,A00,093819,Blair-Loy; Mary,20,0,20,0
1653302414975,SOCI 100,A01,093724,Estefan; Michel,15,0,20,5
1653302414975,SOCI 100,A02,093725,Estefan; Michel,5,0,20,15
1653302415500,SOCI 104,A00,093728,Gong; Neil M,22,0,25,3
1653302416026,SOCI 104Q,A00,093729,Staff,23,0,25,2
1653302416550,SOCI 106,A00,093730,Staff,25,0,25,0
1653302417079,SOCI 109,A00,093731,Staff,21,0,25,4
1653302417613,SOCI 110,A00,093732,Binder; Amy,24,0,25,1
1653302419266,SOCI 117,A01,091568,Chung; Luz Marina,29,0,35,6
1653302419266,SOCI 117,A02,091569,Chung; Luz Marina,35,0,35,0
1653302419790,SOCI 118,A00,093735,Staff,0,0,0,0
1653302420314,SOCI 120T,A00,093736,Lampland; Martha,50,0,50,0
1653302420314,SOCI 120T,B00,094832,Staff,69,0,70,1
1653302420838,SOCI 122,A00,093737,Lewis; Kevin Michael,62,0,70,8
1653302421364,SOCI 123,A00,094831,Staff,57,0,65,8
1653302421889,SOCI 125,A00,093738,Staff,115,0,120,5
1653302422412,SOCI 127,A00,094894,Staff,54,0,56,2
1653302422936,SOCI 132,A00,093739,Blair-Loy; Mary,51,0,60,9
1653302424033,SOCI 136F,A00,094830,Staff,45,0,56,11
1653302424562,SOCI 138,A00,093741,Navon; Daniel,117,0,120,3
1653302425085,SOCI 140A,A00,093743,Gong; Neil M,53,0,60,7
1653302425615,SOCI 141,A00,093744,Summers; Valerie R.,111,0,120,9
1653302426662,SOCI 144,A00,093746,Staff,0,0,0,0
1653302428758,SOCI 159,A00,094902,Staff,49,0,50,1
1653302429281,SOCI 160,A00,093750,Staff,0,0,0,0
1653302429809,SOCI 165,A00,093751,Rona-Tas; Akos,43,0,48,5
1653302430332,SOCI 165A,A00,094206,Hallin; Daniel C,3,0,4,1
1653302430859,SOCI 166,A00,093752,Lampland; Martha,52,0,56,4
1653302431384,SOCI 176,A00,093753,Turner; Christena L.,44,0,48,4
1653302431909,SOCI 180,A00,094901,Staff,56,0,56,0
1653302432432,SOCI 185,A00,094903,Staff,55,0,56,1
1653302432960,SOCI 196A,A00,093754,Shafir; Gershon,20,0,20,0
1653302433484,SXTH 1,A01,092351,Bronstein; Phoebe Malan,18,0,18,0
1653302433484,SXTH 1,A02,092352,Bronstein; Phoebe Malan,18,0,18,0
1653302433484,SXTH 1,A03,092353,Bronstein; Phoebe Malan,18,0,18,0
1653302434006,SXTH 20A,A00,092355,Chilukuri; Lakshmi N,56,0,56,0
1653302434538,SYN 2,001,091487,Gladstein; Jill M,13,0,15,2
1653302434538,SYN 2,002,091488,Gladstein; Jill M,14,0,15,1
1653302434538,SYN 2,003,091490,Gladstein; Jill M,12,0,15,3
1653302434538,SYN 2,004,091491,Gladstein; Jill M,15,0,15,0
1653302434538,SYN 2,005,091493,Gladstein; Jill M,15,0,15,0
1653302434538,SYN 2,006,091495,Gladstein; Jill M,15,0,15,0
1653302434538,SYN 2,007,091496,Gladstein; Jill M,15,0,15,0
1653302434538,SYN 2,008,091497,Gladstein; Jill M,14,0,15,1
1653302434538,SYN 2,009,091499,Gladstein; Jill M,13,0,15,2
1653302434538,SYN 2,010,091501,Gladstein; Jill M,13,0,15,2
1653302434538,SYN 2,011,091502,Gladstein; Jill M,13,0,15,2
1653302434538,SYN 2,012,091503,Gladstein; Jill M,15,0,15,0
1653302434538,SYN 2,013,091505,Gladstein; Jill M,13,0,15,2
1653302434538,SYN 2,014,091506,Gladstein; Jill M,12,0,15,3
1653302434538,SYN 2,015,091508,Gladstein; Jill M,14,0,15,1
1653302434538,SYN 2,016,091509,Gladstein; Jill M,12,0,15,3
1653302434538,SYN 2,017,091510,Gladstein; Jill M,14,0,15,1
1653302434538,SYN 2,018,091512,Gladstein; Jill M,15,0,15,0
1653302434538,SYN 2,019,091513,Gladstein; Jill M,15,0,15,0
1653302434538,SYN 2,020,091514,Gladstein; Jill M,15,0,15,0
1653302434538,SYN 2,021,091516,Gladstein; Jill M,12,0,15,3
1653302434538,SYN 2,022,091517,Gladstein; Jill M,13,0,15,2
1653302434538,SYN 2,023,091518,Gladstein; Jill M,15,0,15,0
1653302434538,SYN 2,024,091519,Gladstein; Jill M,15,0,15,0
1653302434538,SYN 2,025,091520,Gladstein; Jill M,11,0,15,4
1653302434538,SYN 2,026,091521,Gladstein; Jill M,15,0,15,0
1653302434538,SYN 2,027,091522,Gladstein; Jill M,0,0,0,0
1653302434538,SYN 2,028,091523,Gladstein; Jill M,0,0,0,0
1653302434538,SYN 2,029,091524,Gladstein; Jill M,0,0,0,0
1653302434538,SYN 2,030,091525,Gladstein; Jill M,0,0,0,0
1653302434538,SYN 2,031,091526,Gladstein; Jill M,14,0,15,1
1653302434538,SYN 2,032,091527,Gladstein; Jill M,15,0,15,0
1653302434538,SYN 2,033,091528,Gladstein; Jill M,0,0,0,0
1653302434538,SYN 2,034,091529,Gladstein; Jill M,15,0,15,0
1653302434538,SYN 2,035,091530,Gladstein; Jill M,15,0,15,0
1653302434538,SYN 2,036,091531,Gladstein; Jill M,15,0,15,0
1653302434538,SYN 2,037,091532,Gladstein; Jill M,15,0,15,0
1653302434538,SYN 2,038,091533,Gladstein; Jill M,15,0,15,0
1653302434538,SYN 2,039,091534,Gladstein; Jill M,15,0,15,0
1653302434538,SYN 2,040,091535,Gladstein; Jill M,15,0,15,0
1653302435063,SYN 100,A01,091537,Gladstein; Jill M,26,0,30,4
1653302435063,SYN 100,B01,091539,Gladstein; Jill M,26,0,30,4
1653302435063,SYN 100,C01,091541,Gladstein; Jill M,26,0,30,4
1653302435063,SYN 100,D01,091543,Gladstein; Jill M,25,0,30,5
1653302435063,SYN 100,E01,091545,Gladstein; Jill M,28,0,30,2
1653302435588,TDAC 1,A00,088922,Walsh; Kim C.,10,0,10,0
1653302435588,TDAC 1,B00,088923,Walsh; Kim C.,8,0,10,2
1653302435588,TDAC 1,C00,088924,Walsh; Kim C.,0,0,10,10
1653302435588,TDAC 1,D00,088925,Walsh; Kim C.,7,0,10,3
1653302435588,TDAC 1,E00,088926,Walsh; Kim C.,2,0,10,8
1653302435588,TDAC 1,F00,088927,Walsh; Kim C.,9,0,10,1
1653302436113,TDAC 101,A00,088972,Harting; Carla Kelso,9,0,10,1
1653302436113,TDAC 101,B00,088973,Salovey; Todd,8,0,10,2
1653302436113,TDAC 101,C00,088974,Walsh; Kim C.,6,0,10,4
1653302436639,TDAC 102,A00,088975,Basso; Beatrice,9,0,10,1
1653302436639,TDAC 102,B00,088976,Basso; Beatrice,7,0,10,3
1653302437165,TDAC 103A,A00,094044,Castro; Robert Jess,32,0,35,3
1653302437691,TDAC 108,A00,088977,Staff,20,0,20,0
1653302438218,TDAC 109,A00,088978,Blair; Kyle Adam,20,0,20,0
1653302438743,TDAC 115,A00,088979,Newcomb; James,20,0,20,0
1653302439264,TDAC 122,A00,088981,Staff,30,0,30,0
1653302439792,TDAC 123,A00,088982,Staff,30,0,30,0
1653302440323,TDDE 1,A01,088929,Benzoni; Elisa,9,0,11,2
1653302440323,TDDE 1,A02,088930,Benzoni; Elisa,11,0,11,0
1653302440323,TDDE 1,A03,088931,Benzoni; Elisa,11,0,11,0
1653302440323,TDDE 1,A04,088932,Benzoni; Elisa,10,0,11,1
1653302440323,TDDE 1,A05,088933,Benzoni; Elisa,11,0,11,0
1653302440847,TDDE 130,A00,088983,Staff,20,0,20,0
1653302441373,TDDE 132,A00,094263,Staff,20,0,20,0
1653302441903,TDDE 169A,A00,094046,Petrovich; Victoria A.,18,0,20,2
1653302442428,TDDM 1,A00,088934,Snaith; Yolande,6,0,10,4
1653302442958,TDDM 5,A00,088935,Smith; Alison D,30,0,30,0
1653302443491,TDDR 101,A00,088986,Powell; Lora,34,0,35,1
1653302444015,TDDR 111,A00,088987,Stalling; Vanessa,24,0,30,6
1653302444015,TDDR 111,B00,094045,Castro; Robert Jess,14,0,16,2
1653302444541,TDDR 190,A00,088988,Stalling; Vanessa,10,0,10,0
1653302445073,TDGE 1,A01,088937,Salovey; Todd,12,0,12,0
1653302445073,TDGE 1,A02,088938,Salovey; Todd,10,0,12,2
1653302445073,TDGE 1,A03,088939,Salovey; Todd,8,0,12,4
1653302445073,TDGE 1,A04,088940,Salovey; Todd,12,0,12,0
1653302445073,TDGE 1,A05,088941,Salovey; Todd,11,0,12,1
1653302445073,TDGE 1,A06,088942,Salovey; Todd,12,0,12,0
1653302445598,TDGE 10,A00,088943,Havis; Allan,191,0,200,9
1653302446122,TDGE 11,A00,088944,Staff,200,0,200,0
1653302446653,TDGE 25,A00,088945,Harting; Carla Kelso,19,0,20,1
1653302446653,TDGE 25,B00,088946,Harting; Carla Kelso,19,0,20,1
1653302446653,TDGE 25,C00,088947,Harting; Carla Kelso,20,0,20,0
1653302446653,TDGE 25,D00,088948,Harting; Carla Kelso,19,0,20,1
1653302446653,TDGE 25,E00,088949,Harting; Carla Kelso,20,0,20,0
1653302446653,TDGE 25,F00,088950,Harting; Carla Kelso,19,0,20,1
1653302446653,TDGE 25,G00,088951,Harting; Carla Kelso,19,0,20,1
1653302447184,TDGE 127,A00,088990,Havis; Allan,188,0,200,12
1653302447708,TDHD 21,A00,088952,Jun; Grace Shin Hae,20,0,20,0
1653302448244,TDHT 10,A00,088953,Power; Jade Yukana,14,0,14,0
1653302448244,TDHT 10,B00,088954,Power; Jade Yukana,13,0,14,1
1653302448769,TDHT 21,A01,088956,Power; Jade Yukana,17,0,18,1
1653302448769,TDHT 21,A02,088957,Power; Jade Yukana,7,0,11,4
1653302448769,TDHT 21,A03,088958,Power; Jade Yukana,11,0,11,0
1653302449295,TDHT 101,A00,088994,Burelle; Julie Sara Veronique,21,0,25,4
1653302449820,TDHT 114,A00,094208,Williams; Madison Mae,47,0,50,3
1653302450344,TDHT 119,A00,094299,Burelle; Julie Sara Veronique,25,0,25,0
1653302450871,TDMV 1,A00,088959,Weinberg; Sadie,23,0,30,7
1653302451402,TDMV 2,A00,088960,Sammartano; Tonnie,27,0,30,3
1653302451402,TDMV 2,B00,094043,Duran; Marcos Antonio,29,0,30,1
1653302451925,TDMV 3,A00,088961,Arcidiacono; Kristin,27,0,30,3
1653302452449,TDMV 110,A00,088995,Wilson; Terry A.,0,0,0,0
1653302452977,TDMV 120,A00,088996,Smith; Alison D,17,0,20,3
1653302453522,TDMV 122,A00,088997,Chaleff; Rebecca,28,0,30,2
1653302454050,TDMV 130,A00,094042,Rincon; Alicia,30,0,30,0
1653302454574,TDMV 138,A00,088998,Jun; Grace Shin Hae,12,0,40,28
1653302455098,TDMV 142,A00,088999,Caligagan; Tony,28,0,40,12
1653302455622,TDMV 143,A00,094041,Foster-King; Sandra,37,0,40,3
1653302456147,TDMV 146,A00,089000,Caligagan; Tony,39,0,40,1
1653302456676,TDPF 160,A00,094264,Snaith; Yolande,30,0,30,0
1653302456676,TDPF 160,B00,094265,Smith; Alison D,30,0,30,0
1653302456676,TDPF 160,C00,094266,Weinberg; Sadie,30,0,30,0
1653302457201,TDPR 6,A01,088963,Benzoni; Elisa,25,0,25,0
1653302457201,TDPR 6,A02,088964,Benzoni; Elisa,25,0,25,0
1653302457734,TDPR 102,A00,089003,Staff,15,0,15,0
1653302458259,TDPR 104,A00,089004,Powell; Lora,15,0,15,0
1653302458783,TDPW 1,A00,088965,Staff,10,0,10,0
1653302458783,TDPW 1,B00,088966,Staff,10,0,10,0
1653302458783,TDPW 1,C00,088967,Staff,9,0,10,1
1653302458783,TDPW 1,D00,088968,Staff,9,0,10,1
1653302458783,TDPW 1,E00,088969,Staff,10,0,10,0
1653302458783,TDPW 1,F00,088970,Staff,9,0,10,1
1653302459309,TDTR 10,A00,088971,Wilson; Terry A.,22,0,25,3
1653302459834,TMC 2,A01,092358,Carver; Leslie J.,20,0,20,0
1653302459834,TMC 2,A02,092359,Carver; Leslie J.,20,0,20,0
1653302459834,TMC 2,A03,092360,Carver; Leslie J.,20,0,20,0
1653302459834,TMC 2,A04,092361,Carver; Leslie J.,20,0,20,0
1653302459834,TMC 2,A05,092362,Carver; Leslie J.,20,0,20,0
1653302459834,TMC 2,A06,092363,Carver; Leslie J.,20,0,20,0
1653302460359,TMC 15,A00,092364,Atkinson; Arthur Laird,20,0,20,0
1653302460883,TMC 20,A00,092365,Carver; Leslie J.,20,0,20,0
1653302461410,TMC 90,A00,092366,Mell; Loren K.,20,0,20,0
1653302461934,TMC 120,A01,092368,Staff,20,0,20,0
1653302462470,USP 1,A01,087520,Kwak; Nancy,19,0,20,1
1653302462470,USP 1,A02,087521,Kwak; Nancy,17,0,20,3
1653302462470,USP 1,A03,087522,Kwak; Nancy,16,0,20,4
1653302462470,USP 1,A04,087523,Kwak; Nancy,19,0,20,1
1653302462995,USP 2,A01,087525,Lerner; Amy M,29,0,30,1
1653302462995,USP 2,A02,087526,Lerner; Amy M,29,0,30,1
1653302463521,USP 4,A00,094267,Polat; Soydan Alihan,16,0,20,4
1653302463521,USP 4,B00,094268,Staff,20,0,20,0
1653302464044,USP 5,A01,087532,Staff,26,0,30,4
1653302464044,USP 5,A02,087533,Staff,27,0,30,3
1653302464569,USP 6,A01,094322,Shvartzberg Carrio; Manuel,20,0,20,0
1653302464569,USP 6,A02,094323,Shvartzberg Carrio; Manuel,20,0,20,0
1653302465095,USP 15,A01,087535,Anderson; William Raymond,20,0,25,5
1653302465095,USP 15,A02,087536,Anderson; William Raymond,23,0,25,2
1653302465618,USP 25,A00,087537,Staff,0,0,7,7
1653302466147,USP 50,A00,087538,Martin; Isaac,38,0,40,2
1653302466673,USP 124,A00,087539,Bussell; Mirle Rabinowitz,26,0,35,9
1653302467198,USP 125,A00,087540,Staff,17,0,23,6
1653302467722,USP 136,A00,087541,Staff,23,0,25,2
1653302468246,USP 144,A00,087542,Staff,136,0,146,10
1653302468770,USP 151,A00,087543,Boomhower; Matthew Charles,18,0,20,2
1653302469296,USP 152,A01,087545,Moeder; Nathan L,17,0,20,3
1653302469296,USP 152,A02,087546,Moeder; Nathan L,20,0,20,0
1653302469825,USP 153,A00,087547,Moden; Kelly Kjestine,27,0,30,3
1653302470349,USP 161,A00,094854,Wartell; Julie Dara,25,0,25,0
1653302470873,USP 169,A00,087548,Bajaj; Ravi Siddharth,30,0,35,5
1653302471399,USP 170,A00,087549,Hinds; Juli Beth,30,0,35,5
1653302472012,USP 171,A00,087550,Lerner; Amy M,38,0,50,12
1653302472536,USP 176,A00,094853,Staff,24,0,25,1
1653302473060,USP 177A,A00,087551,Peerson; Susan,20,0,22,2
1653302473584,USP 184,A00,094324,Shvartzberg Carrio; Manuel,24,0,25,1
1653302474109,USP 185A,A01,087553,Norr; Alex Vaughn,28,0,30,2
1653302474109,USP 185A,B01,087555,Boomhower; Matthew Charles,26,0,30,4
1653302474632,USP 186,A01,087557,Pezzoli; Keith,22,0,25,3
1653302474632,USP 186,A02,087558,Pezzoli; Keith,20,0,25,5
1653302475681,USP 191A,A00,087561,Rothberg; Scott Jacob,18,0,20,2
1653302476215,USP 194,A00,091599,Hill; Seth J,9999,0,9999,0
1653302476742,VIS 1,A01,088809,Tonies; Joshua Vanjaymes,10,0,10,0
1653302476742,VIS 1,A02,088810,Tonies; Joshua Vanjaymes,10,0,10,0
1653302476742,VIS 1,A03,088811,Tonies; Joshua Vanjaymes,3,0,10,7
1653302476742,VIS 1,A04,088812,Tonies; Joshua Vanjaymes,8,0,10,2
1653302476742,VIS 1,A05,088813,Tonies; Joshua Vanjaymes,4,0,10,6
1653302476742,VIS 1,A06,088814,Tonies; Joshua Vanjaymes,6,0,10,4
1653302476742,VIS 1,A07,088815,Tonies; Joshua Vanjaymes,6,0,10,4
1653302476742,VIS 1,A08,088816,Tonies; Joshua Vanjaymes,9,0,10,1
1653302476742,VIS 1,A09,088817,Tonies; Joshua Vanjaymes,8,0,10,2
1653302476742,VIS 1,A10,088818,Tonies; Joshua Vanjaymes,8,0,10,2
1653302476742,VIS 1,A11,088819,Tonies; Joshua Vanjaymes,3,0,10,7
1653302476742,VIS 1,A12,088820,Tonies; Joshua Vanjaymes,6,0,10,4
1653302476742,VIS 1,A13,088821,Tonies; Joshua Vanjaymes,6,0,10,4
1653302476742,VIS 1,A14,088822,Tonies; Joshua Vanjaymes,7,0,10,3
1653302476742,VIS 1,A15,088823,Tonies; Joshua Vanjaymes,7,0,10,3
1653302476742,VIS 1,A16,088824,Tonies; Joshua Vanjaymes,8,0,10,2
1653302477276,VIS 20,A01,088826,Woods; Ann,19,0,20,1
1653302477276,VIS 20,A02,088827,Woods; Ann,20,0,20,0
1653302477276,VIS 20,A03,088828,Woods; Ann,18,0,20,2
1653302477276,VIS 20,A04,088829,Woods; Ann,17,0,20,3
1653302477276,VIS 20,A05,088830,Woods; Ann,20,0,20,0
1653302477276,VIS 20,A06,088831,Woods; Ann,20,0,20,0
1653302477276,VIS 20,A07,088832,Woods; Ann,20,0,20,0
1653302477276,VIS 20,A08,088833,Woods; Ann,20,0,20,0
1653302477276,VIS 20,A09,088834,Woods; Ann,18,0,20,2
1653302477276,VIS 20,A10,088835,Woods; Ann,19,0,20,1
1653302477276,VIS 20,A11,088836,Woods; Ann,20,0,20,0
1653302477276,VIS 20,A12,088837,Woods; Ann,20,0,20,0
1653302477802,VIS 23,A00,088838,Rose; Jordan M,3,0,3,0
1653302478333,VIS 30,A01,088840,Stone; Patricia,11,0,11,0
1653302478333,VIS 30,A02,088841,Stone; Patricia,7,0,11,4
1653302478333,VIS 30,A03,094821,Stone; Patricia,8,0,11,3
1653302478333,VIS 30,A04,094822,Stone; Patricia,11,0,11,0
1653302478858,VIS 41,A01,088844,D'Elena-Tweed; Jessica Erin,9,0,10,1
1653302478858,VIS 41,A02,088845,D'Elena-Tweed; Jessica Erin,9,0,10,1
1653302478858,VIS 41,A03,088846,D'Elena-Tweed; Jessica Erin,9,0,10,1
1653302478858,VIS 41,A04,088847,D'Elena-Tweed; Jessica Erin,9,0,10,1
1653302478858,VIS 41,A05,088848,D'Elena-Tweed; Jessica Erin,10,0,10,0
1653302478858,VIS 41,A06,088849,D'Elena-Tweed; Jessica Erin,10,0,10,0
1653302478858,VIS 41,A07,088850,D'Elena-Tweed; Jessica Erin,10,0,10,0
1653302478858,VIS 41,A08,088851,D'Elena-Tweed; Jessica Erin,10,0,10,0
1653302479391,VIS 60,A01,088853,Sepuya; Paul Mpagi,9,0,10,1
1653302479391,VIS 60,A02,088854,Sepuya; Paul Mpagi,10,0,10,0
1653302479391,VIS 60,A03,088855,Sepuya; Paul Mpagi,10,0,10,0
1653302479391,VIS 60,A04,088856,Sepuya; Paul Mpagi,10,0,10,0
1653302479391,VIS 60,A05,088857,Sepuya; Paul Mpagi,10,0,10,0
1653302479391,VIS 60,A06,088858,Sepuya; Paul Mpagi,10,0,10,0
1653302479391,VIS 60,A07,088859,Sepuya; Paul Mpagi,9,0,10,1
1653302479391,VIS 60,A08,093932,Sepuya; Paul Mpagi,10,0,10,0
1653302479921,VIS 70N,A01,088861,Segade; Alexandro Abraham,8,0,8,0
1653302479921,VIS 70N,A02,088862,Segade; Alexandro Abraham,8,0,8,0
1653302479921,VIS 70N,A03,088863,Segade; Alexandro Abraham,8,0,8,0
1653302479921,VIS 70N,A04,088864,Segade; Alexandro Abraham,8,0,8,0
1653302479921,VIS 70N,A05,088865,Segade; Alexandro Abraham,7,0,8,1
1653302479921,VIS 70N,A06,088866,Segade; Alexandro Abraham,8,0,8,0
1653302480445,VIS 80,A01,088868,Adler; Amy,9,0,10,1
1653302480445,VIS 80,A02,088869,Adler; Amy,8,0,10,2
1653302480445,VIS 80,A03,088870,Adler; Amy,9,0,10,1
1653302480445,VIS 80,A04,088871,Adler; Amy,8,0,10,2
1653302480445,VIS 80,A05,088872,Adler; Amy,10,0,10,0
1653302480445,VIS 80,A06,088873,Adler; Amy,7,0,10,3
1653302480980,VIS 100,A00,088874,Cruz; Edwin Teddy,65,0,75,10
1653302481505,VIS 105A,A00,088875,Tonies; Joshua Vanjaymes,26,0,30,4
1653302482045,VIS 105B,A00,088876,Staff,25,0,30,5
1653302482569,VIS 106A,A00,088877,Tobe; Geoffroy,21,0,25,4
1653302483092,VIS 106B,A00,088878,Staff,21,0,25,4
1653302483616,VIS 106C,A00,088879,Staff,9,0,15,6
1653302484141,VIS 107B,A00,088880,Gallaccio; Anya,24,0,25,1
1653302484664,VIS 108,A00,093894,Gallaccio; Anya,5,0,15,10
1653302485189,VIS 110A,A00,093895,Dean; Danielle Adobi,15,0,15,0
1653302485712,VIS 110B,A00,088881,Adler; Amy,14,0,15,1
1653302486243,VIS 125E,A00,093896,Welchman; John C.,75,0,75,0
1653302486769,VIS 126HN,A00,088882,Newsome; Elizabeth Ann,74,0,75,1
1653302487292,VIS 126P,A00,088883,Wardwell; Mariana Razo,72,0,75,3
1653302487822,VIS 128E,A00,088884,Staff,68,0,75,7
1653302488348,VIS 132,A00,088885,Miller; Nicole L,15,0,15,0
1653302488874,VIS 133,A01,094348,D'Elena-Tweed; Jessica Erin,34,0,34,0
1653302488874,VIS 133,A02,094492,D'Elena-Tweed; Jessica Erin,33,0,34,1
1653302489400,VIS 142,A01,088887,Stalbaum; Brett,14,0,15,1
1653302489400,VIS 142,A02,088888,Stalbaum; Brett,10,0,15,5
1653302489400,VIS 142,A03,088889,Stalbaum; Brett,15,0,15,0
1653302489400,VIS 142,A04,088890,Stalbaum; Brett,8,0,15,7
1653302489400,VIS 142,A05,088891,Stalbaum; Brett,14,0,15,1
1653302489400,VIS 142,A06,094828,Stalbaum; Brett,15,0,15,0
1653302489929,VIS 143,A00,088892,Akten; Mehmet,11,0,22,11
1653302490453,VIS 147A,A01,088894,Stalbaum; Brett,20,0,22,2
1653302490453,VIS 147A,A02,088895,Stalbaum; Brett,17,0,22,5
1653302490975,VIS 149,A00,088896,Akten; Mehmet,11,0,15,4
1653302491500,VIS 150,A00,093893,Tufenkian; Armand Yervant,24,0,30,6
1653302492029,VIS 151A,A00,088897,Williams; Alena J,13,0,15,2
1653302492560,VIS 163,A00,088901,Bratton; Benjamin H.,75,0,75,0
1653302493091,VIS 164,A00,088902,Nakayama; Yue,22,0,22,0
1653302493621,VIS 165A,A00,093892,Cross; Brian R,19,0,22,3
1653302494146,VIS 167,A00,088903,Ortiz-Torres; Ruben,19,0,22,3
1653302494674,VIS 174,A00,088905,Staff,21,0,22,1
1653302494674,VIS 174,B00,088906,Kauffmann; Casey,22,0,22,0
1653302495198,VIS 175,A00,093891,Staff,18,0,22,4
1653302495722,VIS 177,A00,088907,Segade; Alexandro Abraham,20,0,22,2
1653302496244,VIS 178,A00,093890,Staff,17,0,22,5
1653302496769,VIS 179,A00,093889,Kauffmann; Casey,21,0,22,1
1653302497293,VIS 180A,A00,093888,Nakayama; Yue,16,0,22,6
1653302497818,VIS 180B,A00,088908,Miller; Nicole L,21,0,22,1
1653302498345,VIS 183A,A00,088909,Sepuya; Paul Mpagi,20,0,22,2
1653302498876,WCWP 10A,001,086588,Gagnon; Jeffrey C,15,0,15,0
1653302498876,WCWP 10A,002,086589,Gagnon; Jeffrey C,14,0,15,1
1653302498876,WCWP 10A,003,086590,Gagnon; Jeffrey C,15,0,15,0
1653302498876,WCWP 10A,004,086591,Gagnon; Jeffrey C,15,0,15,0
1653302498876,WCWP 10A,005,086592,Gagnon; Jeffrey C,15,0,15,0
1653302498876,WCWP 10A,006,086593,Gagnon; Jeffrey C,15,0,15,0
1653302498876,WCWP 10A,007,086594,Gagnon; Jeffrey C,15,0,15,0
1653302498876,WCWP 10A,008,086595,Gagnon; Jeffrey C,15,0,15,0
1653302498876,WCWP 10A,009,086596,Gagnon; Jeffrey C,15,0,15,0
1653302498876,WCWP 10A,010,086597,Gagnon; Jeffrey C,15,0,15,0
1653302498876,WCWP 10A,011,086598,Gagnon; Jeffrey C,20,0,20,0
1653302498876,WCWP 10A,012,086599,Gagnon; Jeffrey C,20,0,20,0
1653302498876,WCWP 10A,013,086600,Gagnon; Jeffrey C,20,0,20,0
1653302498876,WCWP 10A,014,086601,Gagnon; Jeffrey C,20,0,20,0
1653302498876,WCWP 10A,015,086602,Gagnon; Jeffrey C,20,0,20,0
1653302498876,WCWP 10A,016,086603,Gagnon; Jeffrey C,20,0,20,0
1653302498876,WCWP 10A,017,086604,Gagnon; Jeffrey C,20,0,20,0
1653302498876,WCWP 10A,018,086605,Gagnon; Jeffrey C,19,0,20,1
1653302498876,WCWP 10A,019,086606,Gagnon; Jeffrey C,19,0,20,1
1653302498876,WCWP 10A,020,086607,Gagnon; Jeffrey C,20,0,20,0
1653302498876,WCWP 10A,021,086608,Gagnon; Jeffrey C,20,0,20,0
1653302498876,WCWP 10A,022,086609,Gagnon; Jeffrey C,20,0,20,0
1653302498876,WCWP 10A,023,086610,Gagnon; Jeffrey C,19,0,20,1
1653302498876,WCWP 10A,024,086611,Gagnon; Jeffrey C,20,0,20,0
1653302498876,WCWP 10A,025,086612,Gagnon; Jeffrey C,0,0,0,0
1653302498876,WCWP 10A,026,086613,Gagnon; Jeffrey C,0,0,0,0
1653302498876,WCWP 10A,027,086614,Gagnon; Jeffrey C,0,0,0,0
1653302498876,WCWP 10A,028,086615,Gagnon; Jeffrey C,0,0,0,0
1653302498876,WCWP 10A,029,086616,Gagnon; Jeffrey C,0,0,0,0
1653302498876,WCWP 10A,030,086617,Gagnon; Jeffrey C,15,0,15,0
1653302498876,WCWP 10A,031,086618,Gagnon; Jeffrey C,15,0,15,0
1653302498876,WCWP 10A,032,093687,Gagnon; Jeffrey C,15,0,15,0
1653302498876,WCWP 10A,033,093688,Gagnon; Jeffrey C,15,0,15,0
1653302498876,WCWP 10A,034,093689,Gagnon; Jeffrey C,0,0,0,0
1653302498876,WCWP 10A,035,093690,Gagnon; Jeffrey C,0,0,0,0
1653302499406,WCWP 10B,003,086621,Gagnon; Jeffrey C,0,0,0,0
1653302499406,WCWP 10B,004,086622,Gagnon; Jeffrey C,16,0,20,4
1653302499406,WCWP 10B,005,086623,Gagnon; Jeffrey C,18,0,20,2
1653302499406,WCWP 10B,006,086624,Gagnon; Jeffrey C,20,0,20,0
1653302499406,WCWP 10B,007,086625,Gagnon; Jeffrey C,0,0,0,0
1653302499937,WCWP 100,A00,086626,McCleary; Keith Long,20,0,20,0
1653302499937,WCWP 100,B00,086627,McCleary; Keith Long,20,0,20,0
1653302499937,WCWP 100,C00,086628,McCleary; Keith Long,18,0,20,2
1653302499937,WCWP 100,D00,086629,Twohig; Niall Ivan,17,0,20,3
1653302499937,WCWP 100,E00,086630,Twohig; Niall Ivan,17,0,20,3
1653302499937,WCWP 100,F00,086631,Twohig; Niall Ivan,18,0,20,2
1653302499937,WCWP 100,G00,086632,Young; Mark T,20,0,20,0
1653302499937,WCWP 100,H00,086633,Young; Mark T,20,0,20,0
1653302558188,AAS 10,A01,085689,Butler; Elizabeth Annette,28,0,34,6
1653302558188,AAS 10,A02,085690,Butler; Elizabeth Annette,34,0,34,0
1653302558711,AAS 170,A00,085691,Butler; Elizabeth Annette,30,0,32,2
1653302559233,AIP 197,001,085683,Staff,100,0,100,0
1653302559233,AIP 197,002,085684,Rao; Ramesh R,50,0,50,0
1653302559763,AIP 197DC,001,085696,Anderson; Patrick W.,27,0,27,0
1653302560288,AIP 197T,A00,085685,Anderson; Patrick W.,15,0,15,0
1653302560820,ANAR 100,A00,094326,Fortier; Jana,22,0,25,3
1653302561345,ANAR 104,A01,085846,Staff,13,0,15,2
1653302561868,ANAR 120,A00,085847,Staff,15,0,15,0
1653302562392,ANAR 143,A00,094288,Staff,31,0,32,1
1653302562921,ANBI 100,A00,085849,Marchetto; Maria Carolina,31,0,34,3
1653302563449,ANBI 112,A00,085850,Marchetto; Maria Carolina,21,0,28,7
1653302563973,ANBI 118,A00,085851,Fox; Patrick Keolu Ozer,32,0,32,0
1653302564500,ANBI 136,A00,085852,Semendeferi; Ekaterini,20,0,22,2
1653302565032,ANBI 141,A00,085854,Gagneux; Pascal,186,0,192,6
1653302565558,ANBI 145,A00,085855,Staff,30,0,32,2
1653302566092,ANBI 175,A00,085857,Staff,30,0,32,2
1653302566615,ANSC 104,A00,094290,Yeh; Rihan Wen Xin,40,0,46,6
1653302567144,ANSC 105,A00,085859,Olivas Hernandez; Olga Lid,36,0,37,1
1653302567668,ANSC 120,A00,085860,Jassal; Aftab,51,0,56,5
1653302568193,ANSC 121,A00,085861,Staff,29,0,32,3
1653302569241,ANSC 148,A00,085866,Staff,71,0,73,2
1653302569766,ANSC 169,A00,085869,Fortier; Jana,23,0,25,2
1653302570308,ANSC 175,A00,085871,Pedersen; David,28,0,32,4
1653302570833,ANTH 1,A00,085803,Varma; Saiba,146,0,146,0
1653302571357,ANTH 2,A01,085805,Staff,43,0,44,1
1653302571357,ANTH 2,A02,085806,Staff,42,0,44,2
1653302571357,ANTH 2,A03,085807,Staff,44,0,44,0
1653302571357,ANTH 2,A04,085808,Staff,44,0,44,0
1653302571357,ANTH 2,A05,085809,Staff,40,0,40,0
1653302571885,ANTH 4,A01,085811,Yeh; Rihan Wen Xin,32,0,32,0
1653302571885,ANTH 4,A02,095113,Yeh; Rihan Wen Xin,32,0,32,0
1653302571885,ANTH 4,A03,095114,Yeh; Rihan Wen Xin,32,0,32,0
1653302571885,ANTH 4,A04,095115,Yeh; Rihan Wen Xin,34,0,34,0
1653302572410,ANTH 10,A00,085814,Stewart; Alexander B,215,0,216,1
1653302572936,ANTH 21,A01,085816,Kang; Byung Chu,35,0,35,0
1653302572936,ANTH 21,A02,085817,Kang; Byung Chu,35,0,35,0
1653302572936,ANTH 21,A03,085818,Kang; Byung Chu,35,0,35,0
1653302572936,ANTH 21,A04,085819,Kang; Byung Chu,35,0,35,0
1653302572936,ANTH 21,A05,085820,Kang; Byung Chu,33,0,35,2
1653302572936,ANTH 21,A06,085821,Kang; Byung Chu,33,0,35,2
1653302572936,ANTH 21,A07,085822,Kang; Byung Chu,35,0,35,0
1653302572936,ANTH 21,A08,085823,Kang; Byung Chu,35,0,35,0
1653302572936,ANTH 21,A09,085824,Kang; Byung Chu,0,0,0,0
1653302572936,ANTH 21,A10,085825,Kang; Byung Chu,0,0,0,0
1653302572936,ANTH 21,A11,095111,Kang; Byung Chu,30,0,30,0
1653302572936,ANTH 21,A12,095112,Kang; Byung Chu,30,0,30,0
1653302572936,ANTH 21,B01,085827,Staff,36,0,36,0
1653302572936,ANTH 21,B02,085828,Staff,36,0,36,0
1653302572936,ANTH 21,B03,085829,Staff,36,0,36,0
1653302572936,ANTH 21,B04,085830,Staff,38,0,38,0
1653302573466,ANTH 23,A01,085832,Stewart; Alexander B,31,0,31,0
1653302573466,ANTH 23,A02,085833,Stewart; Alexander B,31,0,31,0
1653302573466,ANTH 23,A03,085834,Stewart; Alexander B,31,0,31,0
1653302573466,ANTH 23,A04,085835,Stewart; Alexander B,31,0,31,0
1653302573466,ANTH 23,A05,085836,Stewart; Alexander B,31,0,31,0
1653302573466,ANTH 23,A06,085837,Stewart; Alexander B,0,0,0,0
1653302573466,ANTH 23,A07,085838,Stewart; Alexander B,0,0,0,0
1653302573991,ANTH 87,A00,085842,Staff,20,0,20,0
1653302573991,ANTH 87,B00,085843,Staff,20,0,20,0
1653302574517,ANTH 101,A01,085873,Goldstein; Paul S,33,0,36,3
1653302574517,ANTH 101,A02,085874,Goldstein; Paul S,33,0,36,3
1653302574517,ANTH 101,A03,085875,Goldstein; Paul S,36,0,36,0
1653302574517,ANTH 101,A04,085876,Goldstein; Paul S,36,0,38,2
1653302575044,ANTH 105,A00,085877,Staff,39,0,40,1
1653302575569,ANTH 108,A00,085878,Staff,31,0,32,1
1653302576099,ANTH 192,A00,094234,Kaiser; Bronwyn Nicole & Non; Amy L,20,0,20,0
1653302576624,ANTH 196A,A00,085879,Varma; Saiba,20,0,20,0
1653302577158,AWP 3,001,085697,Staff,13,0,13,0
1653302577158,AWP 3,002,085698,Staff,13,0,13,0
1653302577158,AWP 3,003,085699,Staff,13,0,13,0
1653302577158,AWP 3,004,085700,Staff,0,0,0,0
1653302577158,AWP 3,005,085701,Staff,0,0,0,0
1653302577158,AWP 3,006,085703,Staff,0,0,0,0
1653302577158,AWP 3,007,085704,Staff,13,0,13,0
1653302577158,AWP 3,008,085707,Staff,0,0,0,0
1653302577158,AWP 3,009,085709,Staff,13,0,13,0
1653302577158,AWP 3,010,085710,Staff,13,0,13,0
1653302577158,AWP 3,011,085711,Staff,0,0,0,0
1653302577158,AWP 3,012,085712,Staff,0,0,0,0
1653302577158,AWP 3,013,085713,Staff,13,0,13,0
1653302577158,AWP 3,014,085715,Staff,13,0,13,0
1653302577158,AWP 3,015,085717,Staff,13,0,13,0
1653302577158,AWP 3,016,085719,Staff,13,0,13,0
1653302577158,AWP 3,017,085720,Staff,13,0,13,0
1653302577158,AWP 3,018,085721,Staff,13,0,13,0
1653302577158,AWP 3,019,085722,Staff,13,0,13,0
1653302577158,AWP 3,020,085723,Staff,13,0,13,0
1653302577158,AWP 3,021,085724,Staff,13,0,13,0
1653302577158,AWP 3,022,085725,Staff,13,0,13,0
1653302577158,AWP 3,023,085726,Staff,13,0,13,0
1653302577158,AWP 3,024,085727,Staff,13,0,13,0
1653302577158,AWP 3,025,085728,Staff,13,0,13,0
1653302577158,AWP 3,026,085729,Staff,13,0,13,0
1653302577158,AWP 3,027,085730,Staff,13,0,13,0
1653302577158,AWP 3,028,085731,Staff,13,0,13,0
1653302577158,AWP 3,029,085732,Staff,13,0,13,0
1653302577158,AWP 3,030,085733,Staff,13,0,13,0
1653302577158,AWP 3,031,085734,Staff,13,0,13,0
1653302577158,AWP 3,032,085735,Staff,13,0,13,0
1653302577158,AWP 3,033,085736,Staff,13,0,13,0
1653302577158,AWP 3,034,085737,Staff,13,0,13,0
1653302577158,AWP 3,035,085738,Staff,13,0,13,0
1653302577158,AWP 3,036,085739,Staff,13,0,13,0
1653302577158,AWP 3,037,085740,Staff,13,0,13,0
1653302577158,AWP 3,038,085741,Staff,13,0,13,0
1653302577158,AWP 3,039,085742,Staff,13,0,13,0
1653302577158,AWP 3,040,085743,Staff,13,0,13,0
1653302577158,AWP 3,041,085744,Staff,13,0,13,0
1653302577158,AWP 3,042,085745,Staff,13,0,13,0
1653302577158,AWP 3,043,085746,Staff,13,0,13,0
1653302577158,AWP 3,044,085747,Staff,13,0,13,0
1653302577158,AWP 3,045,085748,Staff,13,0,13,0
1653302577158,AWP 3,046,085749,Staff,13,0,13,0
1653302577158,AWP 3,047,085750,Staff,13,0,13,0
1653302577158,AWP 3,048,085751,Staff,13,0,13,0
1653302577158,AWP 3,049,085752,Staff,13,0,13,0
1653302577158,AWP 3,050,085753,Staff,13,0,13,0
1653302577158,AWP 3,051,085754,Staff,13,0,13,0
1653302577158,AWP 3,052,085755,Staff,0,0,0,0
1653302577158,AWP 3,053,085756,Staff,13,0,13,0
1653302577158,AWP 3,054,085757,Staff,0,0,0,0
1653302577158,AWP 3,055,085758,Staff,13,0,13,0
1653302577158,AWP 3,056,085759,Staff,13,0,13,0
1653302577158,AWP 3,057,085760,Staff,13,0,13,0
1653302577158,AWP 3,058,085761,Staff,13,0,13,0
1653302577158,AWP 3,059,085762,Staff,13,0,13,0
1653302577158,AWP 3,060,085763,Staff,13,0,13,0
1653302577158,AWP 3,061,085764,Staff,13,0,13,0
1653302577158,AWP 3,062,085765,Staff,13,0,13,0
1653302577158,AWP 3,063,085766,Staff,13,0,13,0
1653302577158,AWP 3,064,085767,Staff,13,0,13,0
1653302577158,AWP 3,065,085768,Staff,13,0,13,0
1653302577158,AWP 3,066,085769,Staff,0,0,0,0
1653302577685,AWP 4A,001,085770,Staff,0,0,0,0
1653302577685,AWP 4A,002,085771,Staff,13,0,13,0
1653302577685,AWP 4A,003,085772,Staff,13,0,13,0
1653302577685,AWP 4A,004,085773,Staff,13,0,13,0
1653302577685,AWP 4A,005,085774,Staff,0,0,0,0
1653302577685,AWP 4A,006,085775,Staff,13,0,13,0
1653302577685,AWP 4A,007,085776,Staff,0,0,0,0
1653302577685,AWP 4A,008,085777,Staff,0,0,0,0
1653302577685,AWP 4A,009,085778,Staff,0,0,0,0
1653302577685,AWP 4A,010,085779,Staff,13,0,13,0
1653302577685,AWP 4A,011,085780,Staff,13,0,13,0
1653302577685,AWP 4A,012,085781,Staff,0,0,0,0
1653302577685,AWP 4A,013,085782,Staff,13,0,13,0
1653302577685,AWP 4A,014,085783,Staff,13,0,13,0
1653302577685,AWP 4A,015,085784,Staff,13,0,13,0
1653302577685,AWP 4A,016,085785,Staff,13,0,13,0
1653302577685,AWP 4A,017,085786,Staff,13,0,13,0
1653302577685,AWP 4A,018,085787,Staff,0,0,0,0
1653302577685,AWP 4A,019,085788,Staff,13,0,13,0
1653302577685,AWP 4A,020,085789,Staff,13,0,13,0
1653302577685,AWP 4A,021,085790,Staff,0,0,0,0
1653302577685,AWP 4A,022,085791,Staff,13,0,13,0
1653302577685,AWP 4A,023,085792,Staff,0,0,0,0
1653302577685,AWP 4A,024,085793,Staff,0,0,0,0
1653302577685,AWP 4A,025,085794,Staff,13,0,13,0
1653302577685,AWP 4A,026,085795,Staff,13,0,13,0
1653302577685,AWP 4A,027,085796,Staff,13,0,13,0
1653302577685,AWP 4A,028,085797,Staff,13,0,13,0
1653302577685,AWP 4A,029,085798,Staff,0,0,0,0
1653302577685,AWP 4A,030,085799,Staff,0,0,0,0
1653302577685,AWP 4A,031,093835,Staff,0,0,0,0
1653302578209,AWP 4B,001,085800,Staff,0,0,0,0
1653302578209,AWP 4B,002,085801,Staff,0,0,0,0
1653302578740,BENG 2,A00,085936,Wheeler; Bruce Christopher,28,0,30,2
1653302579269,BENG 110,A01,085939,Mc Culloch; Andrew Douglas,20,0,30,10
1653302579269,BENG 110,A02,085940,Mc Culloch; Andrew Douglas,18,0,30,12
1653302579269,BENG 110,A03,085941,Mc Culloch; Andrew Douglas,27,0,30,3
1653302579888,BENG 119A,A01,085943,Wheeler; Bruce Christopher,29,0,30,1
1653302580412,BENG 122A,A01,085945,Cauwenberghs; Gert,18,0,25,7
1653302580412,BENG 122A,A02,085946,Cauwenberghs; Gert,22,0,25,3
1653302580412,BENG 122A,A03,085947,Cauwenberghs; Gert,22,0,25,3
1653302580940,BENG 126A,A01,085949,Wheeler; Bruce Christopher,30,0,30,0
1653302581464,BENG 127A,A01,085951,Wheeler; Bruce Christopher,28,0,30,2
1653302581991,BENG 128A,A01,085953,Wheeler; Bruce Christopher,29,0,30,1
1653302582514,BENG 134,A01,085955,Smarr; Benjamin,0,0,0,0
1653302583036,BENG 135,A00,085956,Wheeler; Bruce Christopher,23,0,30,7
1653302583559,BENG 141,A00,085958,Lal; Ratnesh,20,0,30,10
1653302584083,BENG 147A,A01,085963,Wheeler; Bruce Christopher,30,0,30,0
1653302584606,BENG 148A,A01,085967,Wheeler; Bruce Christopher,30,0,30,0
1653302585134,BENG 149A,A01,085969,Wheeler; Bruce Christopher,30,0,30,0
1653302585659,BENG 161A,A01,085971,Fraley; Stephanie I.,20,0,25,5
1653302585659,BENG 161A,A02,085972,Fraley; Stephanie I.,13,0,25,12
1653302585659,BENG 161A,A03,085973,Fraley; Stephanie I.,9,0,25,16
1653302586181,BENG 162,A01,085975,Mali; Prashant Gulab Ram,0,0,35,35
1653302586181,BENG 162,A02,085976,Mali; Prashant Gulab Ram,26,0,35,9
1653302586705,BENG 166A,A00,085977,Sah; Robert Lie-Yuan,0,0,0,0
1653302587229,BENG 169A,A01,085982,Wheeler; Bruce Christopher,28,0,30,2
1653302587752,BENG 179A,A01,085984,Wheeler; Bruce Christopher,30,0,30,0
1653302588285,BENG 183,A01,085986,Zhong; Sheng,13,0,30,17
1653302588285,BENG 183,A02,085987,Zhong; Sheng,15,0,30,15
1653302588285,BENG 183,A03,085988,Zhong; Sheng,20,0,30,10
1653302588812,BENG 187B,A00,085989,Wheeler; Bruce Christopher,105,0,170,65
1653302589335,BENG 196,001,094047,Engler; Adam J.,9999,0,9999,0
1653302589869,BIBC 100,A01,092918,Huffaker; Alisa,0,0,19,19
1653302589869,BIBC 100,A02,092919,Huffaker; Alisa,19,0,19,0
1653302589869,BIBC 100,A03,092920,Huffaker; Alisa,18,0,19,1
1653302589869,BIBC 100,A04,092921,Huffaker; Alisa,18,0,19,1
1653302589869,BIBC 100,A05,092922,Huffaker; Alisa,19,0,19,0
1653302589869,BIBC 100,A06,092923,Huffaker; Alisa,18,0,19,1
1653302589869,BIBC 100,A07,092924,Huffaker; Alisa,10,0,19,9
1653302589869,BIBC 100,A08,092925,Huffaker; Alisa,17,0,19,2
1653302589869,BIBC 100,A09,092926,Huffaker; Alisa,19,0,19,0
1653302589869,BIBC 100,A10,092927,Huffaker; Alisa,11,0,19,8
1653302590406,BIBC 102,A01,092997,Schmelz; Eric Alexander,16,0,19,3
1653302590406,BIBC 102,A02,092998,Schmelz; Eric Alexander,5,0,19,14
1653302590406,BIBC 102,A03,092999,Schmelz; Eric Alexander,1,0,19,18
1653302590406,BIBC 102,A04,093000,Schmelz; Eric Alexander,17,0,19,2
1653302590406,BIBC 102,A05,093001,Schmelz; Eric Alexander,9,0,19,10
1653302590406,BIBC 102,A06,093002,Schmelz; Eric Alexander,16,0,19,3
1653302590406,BIBC 102,A07,093003,Schmelz; Eric Alexander,19,0,19,0
1653302590406,BIBC 102,A08,093004,Schmelz; Eric Alexander,19,0,19,0
1653302590406,BIBC 102,A09,093005,Schmelz; Eric Alexander,14,0,19,5
1653302590406,BIBC 102,B01,093064,Coleman; Aaron B.,19,0,19,0
1653302590406,BIBC 102,B02,093065,Coleman; Aaron B.,17,0,19,2
1653302590406,BIBC 102,B03,093066,Coleman; Aaron B.,16,0,19,3
1653302590406,BIBC 102,B04,093067,Coleman; Aaron B.,11,0,19,8
1653302590406,BIBC 102,B05,093068,Coleman; Aaron B.,18,0,19,1
1653302590406,BIBC 102,B06,093069,Coleman; Aaron B.,16,0,19,3
1653302590406,BIBC 102,B07,093070,Coleman; Aaron B.,19,0,19,0
1653302590406,BIBC 102,B08,093071,Coleman; Aaron B.,15,0,19,4
1653302590406,BIBC 102,B09,093072,Coleman; Aaron B.,17,0,19,2
1653302590938,BIBC 103,A01,089887,Bozinovic; Goran,19,0,24,5
1653302590938,BIBC 103,A02,089888,Bozinovic; Goran,23,0,24,1
1653302590938,BIBC 103,B01,089890,Burg; Michael,1,0,24,23
1653302590938,BIBC 103,B02,089891,Burg; Michael,20,0,24,4
1653302590938,BIBC 103,C01,089893,Beyhan; Sinem,14,0,24,10
1653302590938,BIBC 103,C02,089894,Beyhan; Sinem,22,0,24,2
1653302590938,BIBC 103,D01,089896,Coleman; Aaron B.,10,0,24,14
1653302590938,BIBC 103,D02,089897,Coleman; Aaron B.,22,0,24,2
1653302591465,BIBC 194,A00,089898,Hui; Enfu,16,0,27,11
1653302591993,BICD 100,A01,092396,Smith; Laurie,21,0,22,1
1653302591993,BICD 100,A02,092397,Smith; Laurie,22,0,22,0
1653302591993,BICD 100,A03,092398,Smith; Laurie,21,0,22,1
1653302591993,BICD 100,A04,092399,Smith; Laurie,22,0,22,0
1653302591993,BICD 100,A05,092400,Smith; Laurie,21,0,22,1
1653302591993,BICD 100,A06,092401,Smith; Laurie,22,0,22,0
1653302591993,BICD 100,A07,092402,Smith; Laurie,22,0,22,0
1653302591993,BICD 100,A08,092403,Smith; Laurie,22,0,22,0
1653302591993,BICD 100,B01,093073,Mueller; Liam O'Connor,21,0,22,1
1653302591993,BICD 100,B02,093074,Mueller; Liam O'Connor,22,0,22,0
1653302591993,BICD 100,B03,093075,Mueller; Liam O'Connor,22,0,22,0
1653302591993,BICD 100,B04,093076,Mueller; Liam O'Connor,22,0,22,0
1653302591993,BICD 100,B05,093077,Mueller; Liam O'Connor,22,0,22,0
1653302591993,BICD 100,B06,093078,Mueller; Liam O'Connor,22,0,22,0
1653302591993,BICD 100,B07,093079,Mueller; Liam O'Connor,21,0,22,1
1653302591993,BICD 100,B08,093080,Mueller; Liam O'Connor,22,0,22,0
1653302591993,BICD 100,C01,093021,McDonnell; Lisa Marie,21,0,22,1
1653302591993,BICD 100,C02,093022,McDonnell; Lisa Marie,20,0,22,2
1653302591993,BICD 100,C03,093023,McDonnell; Lisa Marie,22,0,22,0
1653302591993,BICD 100,C04,093024,McDonnell; Lisa Marie,22,0,22,0
1653302591993,BICD 100,C05,093025,McDonnell; Lisa Marie,22,0,22,0
1653302591993,BICD 100,C06,093026,McDonnell; Lisa Marie,22,0,22,0
1653302591993,BICD 100,C07,093027,McDonnell; Lisa Marie,20,0,22,2
1653302591993,BICD 100,C08,093028,McDonnell; Lisa Marie,22,0,22,0
1653302591993,BICD 100,D01,093081,Day; Christopher D,22,0,22,0
1653302591993,BICD 100,D02,093082,Day; Christopher D,17,0,22,5
1653302591993,BICD 100,D03,093083,Day; Christopher D,21,0,22,1
1653302591993,BICD 100,D04,093084,Day; Christopher D,19,0,22,3
1653302591993,BICD 100,D05,093085,Day; Christopher D,22,0,22,0
1653302591993,BICD 100,D06,093086,Day; Christopher D,20,0,22,2
1653302591993,BICD 100,D07,093087,Day; Christopher D,19,0,22,3
1653302591993,BICD 100,D08,093088,Day; Christopher D,20,0,22,2
1653302592526,BICD 110,A01,093089,Kiger; Amy,29,0,32,3
1653302592526,BICD 110,A02,093091,Kiger; Amy,32,0,32,0
1653302592526,BICD 110,A03,093092,Kiger; Amy,31,0,32,1
1653302592526,BICD 110,A04,093093,Kiger; Amy,31,0,32,1
1653302592526,BICD 110,A05,093094,Kiger; Amy,26,0,32,6
1653302592526,BICD 110,A06,093095,Kiger; Amy,31,0,32,1
1653302592526,BICD 110,A07,093096,Kiger; Amy,31,0,32,1
1653302592526,BICD 110,B01,093029,Grossman; Emily N,21,0,32,11
1653302592526,BICD 110,B02,093030,Grossman; Emily N,28,0,32,4
1653302592526,BICD 110,B03,093031,Grossman; Emily N,32,0,32,0
1653302592526,BICD 110,B04,093032,Grossman; Emily N,28,0,32,4
1653302592526,BICD 110,B05,093033,Grossman; Emily N,26,0,32,6
1653302592526,BICD 110,B06,093034,Grossman; Emily N,19,0,32,13
1653302592526,BICD 110,B07,093035,Grossman; Emily N,20,0,32,12
1653302593054,BICD 140,A01,093097,Zuniga; Elina I,19,0,32,13
1653302593054,BICD 140,A02,093098,Zuniga; Elina I,17,0,32,15
1653302593054,BICD 140,A03,093099,Zuniga; Elina I,30,0,32,2
1653302593054,BICD 140,A04,093100,Zuniga; Elina I,32,0,32,0
1653302593054,BICD 140,A05,093101,Zuniga; Elina I,29,0,32,3
1653302593054,BICD 140,A06,093102,Zuniga; Elina I,27,0,32,5
1653302593583,BIEB 102,A01,092528,Butler; Shannon Rhey,22,0,27,5
1653302593583,BIEB 102,A02,092529,Butler; Shannon Rhey,17,0,27,10
1653302593583,BIEB 102,A03,092530,Butler; Shannon Rhey,24,0,27,3
1653302593583,BIEB 102,A04,092531,Butler; Shannon Rhey,26,0,27,1
1653302593583,BIEB 102,A05,092532,Butler; Shannon Rhey,25,0,27,2
1653302593583,BIEB 102,A06,092533,Butler; Shannon Rhey,24,0,27,3
1653302593583,BIEB 102,A07,092534,Butler; Shannon Rhey,23,0,27,4
1653302594110,BIEB 121,A00,089907,Holway; David A.,0,0,32,32
1653302594635,BIEB 126,A01,092974,Kohn; Joshua R,24,0,27,3
1653302594635,BIEB 126,A02,092975,Kohn; Joshua R,26,0,27,1
1653302594635,BIEB 126,A03,092976,Kohn; Joshua R,23,0,27,4
1653302594635,BIEB 126,A04,092977,Kohn; Joshua R,25,0,27,2
1653302594635,BIEB 126,A05,092978,Kohn; Joshua R,27,0,27,0
1653302595162,BIEB 146,A01,093054,Petrie; Katherine Lynn,1,0,27,26
1653302595162,BIEB 146,A02,093055,Petrie; Katherine Lynn,4,0,27,23
1653302595162,BIEB 146,A03,093056,Petrie; Katherine Lynn,0,0,27,27
1653302595162,BIEB 146,A04,093057,Petrie; Katherine Lynn,0,0,27,27
1653302595162,BIEB 146,A05,093058,Petrie; Katherine Lynn,20,0,27,7
1653302595162,BIEB 146,A06,093059,Petrie; Katherine Lynn,26,0,27,1
1653302595162,BIEB 146,A07,093060,Petrie; Katherine Lynn,16,0,27,11
1653302595162,BIEB 146,A08,093061,Petrie; Katherine Lynn,25,0,27,2
1653302595162,BIEB 146,A09,093062,Petrie; Katherine Lynn,17,0,27,10
1653302595687,BIEB 150,A01,093103,Rennison; Diana,16,0,27,11
1653302595687,BIEB 150,A02,093104,Rennison; Diana,21,0,27,6
1653302595687,BIEB 150,A03,093105,Rennison; Diana,26,0,27,1
1653302595687,BIEB 150,A04,093106,Rennison; Diana,24,0,27,3
1653302595687,BIEB 150,A05,093107,Rennison; Diana,25,0,27,2
1653302595687,BIEB 150,A06,093108,Rennison; Diana,27,0,27,0
1653302596223,BIEB 158,A01,094057,Reese; Aspen Taylor & Jackrel; Sara,31,0,32,1
1653302596223,BIEB 158,A02,094058,Reese; Aspen Taylor & Jackrel; Sara,28,0,32,4
1653302596223,BIEB 158,A03,094059,Reese; Aspen Taylor & Jackrel; Sara,31,0,32,1
1653302596223,BIEB 158,A04,094060,Reese; Aspen Taylor & Jackrel; Sara,32,0,32,0
1653302596759,BIEB 174,A01,092465,Cleland; Elsa Eleanor & Barton; Andrew David,27,0,27,0
1653302596759,BIEB 174,A02,092466,Cleland; Elsa Eleanor & Barton; Andrew David,27,0,27,0
1653302596759,BIEB 174,A03,092467,Cleland; Elsa Eleanor & Barton; Andrew David,23,0,27,4
1653302596759,BIEB 174,A04,092468,Cleland; Elsa Eleanor & Barton; Andrew David,20,0,27,7
1653302596759,BIEB 174,A05,092469,Cleland; Elsa Eleanor & Barton; Andrew David,25,0,27,2
1653302596759,BIEB 174,A06,092470,Cleland; Elsa Eleanor & Barton; Andrew David,27,0,27,0
1653302596759,BIEB 174,A07,092471,Cleland; Elsa Eleanor & Barton; Andrew David,25,0,27,2
1653302597292,BILD 1,A01,092884,Pickett; Brooke Elizabeth,16,0,19,3
1653302597292,BILD 1,A02,092885,Pickett; Brooke Elizabeth,19,0,19,0
1653302597292,BILD 1,A03,092886,Pickett; Brooke Elizabeth,19,0,19,0
1653302597292,BILD 1,A04,092887,Pickett; Brooke Elizabeth,18,0,19,1
1653302597292,BILD 1,A05,092888,Pickett; Brooke Elizabeth,19,0,19,0
1653302597292,BILD 1,A06,092889,Pickett; Brooke Elizabeth,19,0,19,0
1653302597292,BILD 1,A07,092890,Pickett; Brooke Elizabeth,17,0,19,2
1653302597292,BILD 1,B01,092891,Pekkurnaz Banghart; Gulcin,19,0,19,0
1653302597292,BILD 1,B02,092892,Pekkurnaz Banghart; Gulcin,16,0,19,3
1653302597292,BILD 1,B03,092893,Pekkurnaz Banghart; Gulcin,19,0,19,0
1653302597292,BILD 1,B04,092894,Pekkurnaz Banghart; Gulcin,19,0,19,0
1653302597292,BILD 1,B05,092895,Pekkurnaz Banghart; Gulcin,17,0,19,2
1653302597292,BILD 1,B06,092896,Pekkurnaz Banghart; Gulcin,19,0,19,0
1653302597292,BILD 1,B07,092897,Pekkurnaz Banghart; Gulcin,19,0,19,0
1653302597292,BILD 1,C01,092421,Meaders; Clara Leigh,18,0,19,1
1653302597292,BILD 1,C02,092422,Meaders; Clara Leigh,18,0,19,1
1653302597292,BILD 1,C03,092423,Meaders; Clara Leigh,17,0,19,2
1653302597292,BILD 1,C04,092424,Meaders; Clara Leigh,16,0,19,3
1653302597292,BILD 1,C05,092425,Meaders; Clara Leigh,19,0,19,0
1653302597292,BILD 1,C06,092426,Meaders; Clara Leigh,19,0,19,0
1653302597292,BILD 1,C07,092427,Meaders; Clara Leigh,19,0,19,0
1653302597292,BILD 1,D01,092428,Meaders; Clara Leigh,14,0,19,5
1653302597292,BILD 1,D02,092429,Meaders; Clara Leigh,19,0,19,0
1653302597292,BILD 1,D03,092430,Meaders; Clara Leigh,19,0,19,0
1653302597292,BILD 1,D04,092431,Meaders; Clara Leigh,19,0,19,0
1653302597292,BILD 1,D05,092432,Meaders; Clara Leigh,19,0,19,0
1653302597292,BILD 1,D06,092433,Meaders; Clara Leigh,19,0,19,0
1653302597292,BILD 1,D07,092434,Meaders; Clara Leigh,19,0,19,0
1653302597292,BILD 1,E01,092445,Cooper; Andrew Michael,19,0,19,0
1653302597292,BILD 1,E02,092446,Cooper; Andrew Michael,19,0,19,0
1653302597292,BILD 1,E03,092447,Cooper; Andrew Michael,19,0,19,0
1653302597292,BILD 1,E04,092448,Cooper; Andrew Michael,19,0,19,0
1653302597292,BILD 1,E05,092449,Cooper; Andrew Michael,17,0,19,2
1653302597292,BILD 1,E06,092450,Cooper; Andrew Michael,19,0,19,0
1653302597292,BILD 1,E07,092451,Cooper; Andrew Michael,19,0,19,0
1653302597821,BILD 2,A01,092822,Glasgow; Stacey Marie,25,0,25,0
1653302597821,BILD 2,A02,092823,Glasgow; Stacey Marie,24,0,25,1
1653302597821,BILD 2,A03,092824,Glasgow; Stacey Marie,24,0,25,1
1653302597821,BILD 2,A04,092825,Glasgow; Stacey Marie,25,0,25,0
1653302597821,BILD 2,A05,092826,Glasgow; Stacey Marie,25,0,25,0
1653302597821,BILD 2,A06,092827,Glasgow; Stacey Marie,25,0,25,0
1653302597821,BILD 2,A07,092828,Glasgow; Stacey Marie,25,0,25,0
1653302597821,BILD 2,B01,092830,Owens; Melinda Tsao-Ying,25,0,25,0
1653302597821,BILD 2,B02,092831,Owens; Melinda Tsao-Ying,21,0,25,4
1653302597821,BILD 2,B03,092832,Owens; Melinda Tsao-Ying,23,0,25,2
1653302597821,BILD 2,B04,092833,Owens; Melinda Tsao-Ying,25,0,25,0
1653302597821,BILD 2,B05,092834,Owens; Melinda Tsao-Ying,24,0,25,1
1653302597821,BILD 2,B06,092835,Owens; Melinda Tsao-Ying,21,0,25,4
1653302597821,BILD 2,B07,092836,Owens; Melinda Tsao-Ying,25,0,25,0
1653302597821,BILD 2,C01,092668,Owens; Melinda Tsao-Ying,24,0,25,1
1653302597821,BILD 2,C02,092669,Owens; Melinda Tsao-Ying,23,0,25,2
1653302597821,BILD 2,C03,092670,Owens; Melinda Tsao-Ying,22,0,25,3
1653302597821,BILD 2,C04,092671,Owens; Melinda Tsao-Ying,25,0,25,0
1653302597821,BILD 2,C05,092672,Owens; Melinda Tsao-Ying,25,0,25,0
1653302597821,BILD 2,C06,092673,Owens; Melinda Tsao-Ying,24,0,25,1
1653302597821,BILD 2,C07,092674,Owens; Melinda Tsao-Ying,25,0,25,0
1653302598352,BILD 3,A01,092454,Stockwell; Sarah R,17,0,19,2
1653302598352,BILD 3,A02,092455,Stockwell; Sarah R,17,0,19,2
1653302598352,BILD 3,A03,092456,Stockwell; Sarah R,18,0,19,1
1653302598352,BILD 3,A04,092457,Stockwell; Sarah R,19,0,19,0
1653302598352,BILD 3,A05,092458,Stockwell; Sarah R,19,0,19,0
1653302598352,BILD 3,A06,092459,Stockwell; Sarah R,18,0,19,1
1653302598352,BILD 3,A07,092460,Stockwell; Sarah R,18,0,19,1
1653302598352,BILD 3,A08,092461,Stockwell; Sarah R,19,0,19,0
1653302598352,BILD 3,A09,092462,Stockwell; Sarah R,19,0,19,0
1653302598352,BILD 3,B01,092479,Stockwell; Sarah R,19,0,19,0
1653302598352,BILD 3,B02,092480,Stockwell; Sarah R,18,0,19,1
1653302598352,BILD 3,B03,092481,Stockwell; Sarah R,18,0,19,1
1653302598352,BILD 3,B04,092482,Stockwell; Sarah R,19,0,19,0
1653302598352,BILD 3,B05,092483,Stockwell; Sarah R,19,0,19,0
1653302598352,BILD 3,B06,092484,Stockwell; Sarah R,19,0,19,0
1653302598352,BILD 3,B07,092485,Stockwell; Sarah R,19,0,19,0
1653302598352,BILD 3,B08,092486,Stockwell; Sarah R,18,0,19,1
1653302598352,BILD 3,B09,092487,Stockwell; Sarah R,18,0,19,1
1653302598352,BILD 3,C01,092412,Butler; Shannon Rhey,18,0,19,1
1653302598352,BILD 3,C02,092413,Butler; Shannon Rhey,15,0,19,4
1653302598352,BILD 3,C03,092414,Butler; Shannon Rhey,19,0,19,0
1653302598352,BILD 3,C04,092415,Butler; Shannon Rhey,19,0,19,0
1653302598352,BILD 3,C05,092416,Butler; Shannon Rhey,19,0,19,0
1653302598352,BILD 3,C06,092417,Butler; Shannon Rhey,19,0,19,0
1653302598352,BILD 3,C07,092418,Butler; Shannon Rhey,19,0,19,0
1653302598352,BILD 3,C08,092419,Butler; Shannon Rhey,19,0,19,0
1653302598352,BILD 3,C09,092420,Butler; Shannon Rhey,19,0,19,0
1653302598352,BILD 3,D01,092898,Reuther; Keefe,18,0,19,1
1653302598352,BILD 3,D02,092899,Reuther; Keefe,19,0,19,0
1653302598352,BILD 3,D03,092900,Reuther; Keefe,19,0,19,0
1653302598352,BILD 3,D04,092901,Reuther; Keefe,19,0,19,0
1653302598352,BILD 3,D05,092902,Reuther; Keefe,19,0,19,0
1653302598352,BILD 3,D06,092903,Reuther; Keefe,19,0,19,0
1653302598352,BILD 3,D07,092904,Reuther; Keefe,18,0,19,1
1653302598352,BILD 3,D08,092905,Reuther; Keefe,19,0,19,0
1653302598352,BILD 3,D09,092906,Reuther; Keefe,19,0,19,0
1653302598882,BILD 4,A01,089840,Mel; Stephanie,0,0,0,0
1653302598882,BILD 4,A02,089841,Mel; Stephanie,0,0,0,0
1653302598882,BILD 4,A03,089842,Mel; Stephanie,0,0,0,0
1653302598882,BILD 4,A04,089843,Mel; Stephanie,0,0,0,0
1653302598882,BILD 4,A05,089844,Mel; Stephanie,0,0,0,0
1653302598882,BILD 4,A06,089845,Mel; Stephanie,0,0,0,0
1653302598882,BILD 4,A07,089846,Mel; Stephanie,0,0,0,0
1653302598882,BILD 4,A08,089847,Mel; Stephanie,0,0,0,0
1653302598882,BILD 4,A09,089848,Mel; Stephanie,0,0,0,0
1653302598882,BILD 4,A10,089849,Mel; Stephanie,0,0,0,0
1653302598882,BILD 4,A11,089850,Mel; Stephanie,0,0,0,0
1653302598882,BILD 4,A12,089851,Mel; Stephanie,0,0,0,0
1653302598882,BILD 4,A13,089852,Mel; Stephanie,0,0,0,0
1653302598882,BILD 4,A14,089853,Mel; Stephanie,0,0,0,0
1653302598882,BILD 4,A15,089854,Mel; Stephanie,0,0,0,0
1653302598882,BILD 4,A16,089855,Mel; Stephanie,0,0,0,0
1653302598882,BILD 4,B01,089857,Lo; Stanley M.,0,0,0,0
1653302598882,BILD 4,B02,089858,Lo; Stanley M.,0,0,0,0
1653302598882,BILD 4,B03,089859,Lo; Stanley M.,0,0,0,0
1653302598882,BILD 4,B04,089860,Lo; Stanley M.,0,0,0,0
1653302598882,BILD 4,B05,089861,Lo; Stanley M.,0,0,0,0
1653302598882,BILD 4,B06,089862,Lo; Stanley M.,0,0,0,0
1653302598882,BILD 4,B07,089863,Lo; Stanley M.,0,0,0,0
1653302598882,BILD 4,B08,089864,Lo; Stanley M.,0,0,0,0
1653302598882,BILD 4,B09,089865,Lo; Stanley M.,0,0,0,0
1653302598882,BILD 4,B10,089866,Lo; Stanley M.,0,0,0,0
1653302598882,BILD 4,B11,089867,Lo; Stanley M.,0,0,0,0
1653302598882,BILD 4,B12,089868,Lo; Stanley M.,0,0,0,0
1653302598882,BILD 4,B13,089869,Lo; Stanley M.,0,0,0,0
1653302598882,BILD 4,B14,089870,Lo; Stanley M.,0,0,0,0
1653302598882,BILD 4,B15,089871,Lo; Stanley M.,0,0,0,0
1653302598882,BILD 4,B16,089872,Lo; Stanley M.,0,0,0,0
1653302599405,BILD 5,A01,092907,Reuther; Keefe,31,0,32,1
1653302599405,BILD 5,A02,092908,Reuther; Keefe,30,0,32,2
1653302599936,BILD 10,A01,092909,Gustafson-Brown; Cindy,27,0,27,0
1653302599936,BILD 10,A02,092910,Gustafson-Brown; Cindy,27,0,27,0
1653302599936,BILD 10,A03,092911,Gustafson-Brown; Cindy,27,0,27,0
1653302599936,BILD 10,A04,092912,Gustafson-Brown; Cindy,27,0,27,0
1653302599936,BILD 10,A05,092913,Gustafson-Brown; Cindy,25,0,27,2
1653302599936,BILD 10,A06,092914,Gustafson-Brown; Cindy,26,0,27,1
1653302599936,BILD 10,A07,092915,Gustafson-Brown; Cindy,27,0,27,0
1653302599936,BILD 10,A08,092916,Gustafson-Brown; Cindy,27,0,27,0
1653302599936,BILD 10,A09,092917,Gustafson-Brown; Cindy,27,0,27,0
1653302600460,BILD 20,A01,092956,Rana; Brinda Kanti,24,0,27,3
1653302600460,BILD 20,A02,092957,Rana; Brinda Kanti,24,0,27,3
1653302600460,BILD 20,A03,092958,Rana; Brinda Kanti,27,0,27,0
1653302600460,BILD 20,A04,092959,Rana; Brinda Kanti,27,0,27,0
1653302600988,BILD 32,A01,092990,Burg; Michael,27,0,27,0
1653302600988,BILD 32,A02,092991,Burg; Michael,26,0,27,1
1653302600988,BILD 32,A03,092992,Burg; Michael,27,0,27,0
1653302600988,BILD 32,A04,092993,Burg; Michael,26,0,27,1
1653302600988,BILD 32,A05,092994,Burg; Michael,27,0,27,0
1653302600988,BILD 32,A06,092995,Burg; Michael,27,0,27,0
1653302600988,BILD 32,A07,092996,Burg; Michael,27,0,27,0
1653302601519,BILD 60,A01,092392,Hammond; LaTisha Marie,24,0,24,0
1653302601519,BILD 60,A02,092393,Hammond; LaTisha Marie,24,0,24,0
1653302601519,BILD 60,B01,092394,Macagno; Eduardo R.,23,0,24,1
1653302601519,BILD 60,B02,092395,Macagno; Eduardo R.,24,0,24,0
1653302602049,BILD 62,A01,092949,Aljadeff; Johnatan,31,0,32,1
1653302602049,BILD 62,A02,092950,Aljadeff; Johnatan,32,0,32,0
1653302602049,BILD 62,A03,092951,Aljadeff; Johnatan,32,0,32,0
1653302602576,BILD 80,A00,089880,Pogliano; Joseph,27,0,30,3
1653302603107,BIMM 100,A01,092435,Pasquinelli; Amy,32,0,32,0
1653302603107,BIMM 100,A02,092436,Pasquinelli; Amy,30,0,32,2
1653302603107,BIMM 100,A03,092437,Pasquinelli; Amy,32,0,32,0
1653302603107,BIMM 100,A04,092438,Pasquinelli; Amy,31,0,32,1
1653302603107,BIMM 100,A05,092439,Pasquinelli; Amy,32,0,32,0
1653302603107,BIMM 100,A06,092440,Pasquinelli; Amy,32,0,32,0
1653302603107,BIMM 100,A07,092441,Pasquinelli; Amy,32,0,32,0
1653302603107,BIMM 100,A08,092442,Pasquinelli; Amy,32,0,32,0
1653302603107,BIMM 100,A09,092443,Pasquinelli; Amy,32,0,32,0
1653302603107,BIMM 100,A10,092444,Pasquinelli; Amy,32,0,32,0
1653302603107,BIMM 100,B01,092518,Pruneda-Paz; Jose L.,26,0,32,6
1653302603107,BIMM 100,B02,092519,Pruneda-Paz; Jose L.,19,0,32,13
1653302603107,BIMM 100,B03,092520,Pruneda-Paz; Jose L.,20,0,32,12
1653302603107,BIMM 100,B04,092521,Pruneda-Paz; Jose L.,24,0,32,8
1653302603107,BIMM 100,B05,092522,Pruneda-Paz; Jose L.,23,0,32,9
1653302603107,BIMM 100,B06,092523,Pruneda-Paz; Jose L.,24,0,32,8
1653302603107,BIMM 100,B07,092524,Pruneda-Paz; Jose L.,28,0,32,4
1653302603107,BIMM 100,B08,092525,Pruneda-Paz; Jose L.,25,0,32,7
1653302603107,BIMM 100,B09,092526,Pruneda-Paz; Jose L.,26,0,32,6
1653302603107,BIMM 100,B10,092527,Pruneda-Paz; Jose L.,24,0,32,8
1653302603662,BIMM 101,A01,089915,Rusert; Jessica Marie,22,0,24,2
1653302603662,BIMM 101,A02,089916,Rusert; Jessica Marie,21,0,24,3
1653302603662,BIMM 101,A03,089917,Rusert; Jessica Marie,21,0,24,3
1653302603662,BIMM 101,A04,089918,Rusert; Jessica Marie,20,0,24,4
1653302603662,BIMM 101,B01,089920,Grossman; Emily N,0,0,24,24
1653302603662,BIMM 101,B02,089921,Grossman; Emily N,1,0,24,23
1653302603662,BIMM 101,C01,089923,Day; Christopher D,0,0,24,24
1653302603662,BIMM 101,C02,089924,Day; Christopher D,0,0,24,24
1653302603662,BIMM 101,D01,089926,Cooper; Andrew Michael,18,0,24,6
1653302603662,BIMM 101,D02,089927,Cooper; Andrew Michael,24,0,24,0
1653302603662,BIMM 101,E01,089929,McDonnell; Lisa Marie,1,0,24,23
1653302603662,BIMM 101,E02,089930,McDonnell; Lisa Marie,12,0,24,12
1653302604195,BIMM 110,A01,092472,Tour; Ella,26,0,32,6
1653302604195,BIMM 110,A02,092473,Tour; Ella,23,0,32,9
1653302604195,BIMM 110,A03,092474,Tour; Ella,29,0,32,3
1653302604195,BIMM 110,A04,092475,Tour; Ella,27,0,32,5
1653302604195,BIMM 110,A05,092476,Tour; Ella,32,0,32,0
1653302604195,BIMM 110,A06,092477,Tour; Ella,30,0,32,2
1653302604195,BIMM 110,A07,092478,Tour; Ella,29,0,32,3
1653302604720,BIMM 120,A01,092979,Allen; Eric,28,0,32,4
1653302604720,BIMM 120,A02,092980,Allen; Eric,1,0,32,31
1653302604720,BIMM 120,A03,092981,Allen; Eric,14,0,32,18
1653302604720,BIMM 120,A04,092982,Allen; Eric,27,0,32,5
1653302604720,BIMM 120,A05,092983,Allen; Eric,30,0,32,2
1653302604720,BIMM 120,A06,092984,Allen; Eric,29,0,32,3
1653302604720,BIMM 120,A07,092985,Allen; Eric,20,0,32,12
1653302604720,BIMM 120,A08,092986,Allen; Eric,30,0,32,2
1653302604720,BIMM 120,A09,092987,Allen; Eric,30,0,32,2
1653302604720,BIMM 120,A10,092988,Allen; Eric,30,0,32,2
1653302604720,BIMM 120,A11,092989,Allen; Eric,32,0,32,0
1653302605253,BIMM 121,A01,089934,Petrie; Katherine Lynn,0,0,24,24
1653302605253,BIMM 121,A02,089935,Petrie; Katherine Lynn,0,0,24,24
1653302605253,BIMM 121,B01,089937,Pickett; Brooke Elizabeth,0,0,24,24
1653302605253,BIMM 121,B02,089938,Pickett; Brooke Elizabeth,0,0,24,24
1653302605253,BIMM 121,C01,089940,Pirino; Giorgia,0,0,24,24
1653302605253,BIMM 121,C02,089941,Pirino; Giorgia,0,0,24,24
1653302605253,BIMM 121,C03,089942,Pirino; Giorgia,0,0,24,24
1653302605253,BIMM 121,C04,089943,Pirino; Giorgia,0,0,24,24
1653302605777,BIMM 122,A01,093006,Russell; Alistair B,18,0,32,14
1653302605777,BIMM 122,A02,093007,Russell; Alistair B,16,0,32,16
1653302605777,BIMM 122,A03,093008,Russell; Alistair B,26,0,32,6
1653302605777,BIMM 122,A04,093009,Russell; Alistair B,32,0,32,0
1653302605777,BIMM 122,A05,093010,Russell; Alistair B,30,0,32,2
1653302606301,BIMM 124,A01,092404,Gustafson-Brown; Cindy,26,0,32,6
1653302606301,BIMM 124,A02,092405,Gustafson-Brown; Cindy,29,0,32,3
1653302606301,BIMM 124,A03,092406,Gustafson-Brown; Cindy,30,0,32,2
1653302606301,BIMM 124,A04,092407,Gustafson-Brown; Cindy,32,0,32,0
1653302606301,BIMM 124,A05,092408,Gustafson-Brown; Cindy,28,0,32,4
1653302606301,BIMM 124,A06,092409,Gustafson-Brown; Cindy,31,0,32,1
1653302606301,BIMM 124,A07,092410,Gustafson-Brown; Cindy,32,0,32,0
1653302606826,BIMM 140,A01,089947,Suel; Gurol Mehmet & Hao; Nan,16,0,27,11
1653302606826,BIMM 140,A02,089948,Suel; Gurol Mehmet & Hao; Nan,24,0,27,3
1653302606826,BIMM 140,A03,089949,Suel; Gurol Mehmet & Hao; Nan,21,0,27,6
1653302606826,BIMM 140,A04,089950,Suel; Gurol Mehmet & Hao; Nan,25,0,27,2
1653302606826,BIMM 140,A05,089951,Suel; Gurol Mehmet & Hao; Nan,24,0,27,3
1653302607353,BIMM 143,A01,089953,Grant; Barry J,0,0,40,40
1653302607353,BIMM 143,B01,089955,Fan; Chun Chieh,39,0,40,1
1653302607353,BIMM 143,C01,089957,Bozinovic; Goran,29,0,40,11
1653302607886,BIMM 194,A00,089958,Hasty; Jeff M,15,0,27,12
1653302607886,BIMM 194,B00,089959,Golden; James W,19,0,27,8
1653302607886,BIMM 194,C00,089960,Lykke-Andersen; Jens,2,0,27,25
1653302607886,BIMM 194,D00,094317,Golden; Susan S.,25,0,27,2
1653302608413,BIPN 100,A01,093011,Cooke; James Edward,7,0,19,12
1653302608413,BIPN 100,A02,093012,Cooke; James Edward,10,0,19,9
1653302608413,BIPN 100,A03,093013,Cooke; James Edward,8,0,19,11
1653302608413,BIPN 100,A04,093014,Cooke; James Edward,12,0,19,7
1653302608413,BIPN 100,A05,093015,Cooke; James Edward,17,0,19,2
1653302608413,BIPN 100,A06,093016,Cooke; James Edward,12,0,19,7
1653302608413,BIPN 100,A07,093017,Cooke; James Edward,12,0,19,7
1653302608413,BIPN 100,A08,093018,Cooke; James Edward,18,0,19,1
1653302608413,BIPN 100,A09,093019,Cooke; James Edward,17,0,19,2
1653302608413,BIPN 100,A10,093020,Cooke; James Edward,18,0,19,1
1653302608413,BIPN 100,B01,093036,Reyes Gonzalez; Catalina,17,0,19,2
1653302608413,BIPN 100,B02,093037,Reyes Gonzalez; Catalina,14,0,19,5
1653302608413,BIPN 100,B03,093038,Reyes Gonzalez; Catalina,16,0,19,3
1653302608413,BIPN 100,B04,093039,Reyes Gonzalez; Catalina,19,0,19,0
1653302608413,BIPN 100,B05,093040,Reyes Gonzalez; Catalina,19,0,19,0
1653302608413,BIPN 100,B06,093041,Reyes Gonzalez; Catalina,19,0,19,0
1653302608413,BIPN 100,B07,093042,Reyes Gonzalez; Catalina,14,0,19,5
1653302608413,BIPN 100,B08,093043,Reyes Gonzalez; Catalina,16,0,19,3
1653302608413,BIPN 100,B09,093044,Reyes Gonzalez; Catalina,19,0,19,0
1653302608413,BIPN 100,B10,093045,Reyes Gonzalez; Catalina,19,0,19,0
1653302608937,BIPN 102,A01,093046,Reyes Gonzalez; Catalina,28,0,32,4
1653302608937,BIPN 102,A02,093047,Reyes Gonzalez; Catalina,17,0,32,15
1653302608937,BIPN 102,A05,093050,Reyes Gonzalez; Catalina,29,0,32,3
1653302608937,BIPN 102,A06,093051,Reyes Gonzalez; Catalina,15,0,32,17
1653302608937,BIPN 102,A07,093052,Reyes Gonzalez; Catalina,29,0,32,3
1653302608937,BIPN 102,A08,093053,Reyes Gonzalez; Catalina,31,0,32,1
1653302609464,BIPN 105,A01,089966,Armour; Jon Christopher,0,0,21,21
1653302609464,BIPN 105,A02,089967,Armour; Jon Christopher,0,0,21,21
1653302609464,BIPN 105,A03,089968,Armour; Jon Christopher,3,0,21,18
1653302609464,BIPN 105,A04,089969,Armour; Jon Christopher,10,0,21,11
1653302609996,BIPN 140,A01,092514,Spitzer; Nicholas & Su; Chih-Ying,9,0,19,10
1653302609996,BIPN 140,A02,092515,Spitzer; Nicholas & Su; Chih-Ying,12,0,19,7
1653302609996,BIPN 140,A03,092516,Spitzer; Nicholas & Su; Chih-Ying,11,0,19,8
1653302609996,BIPN 140,A04,092517,Spitzer; Nicholas & Su; Chih-Ying,15,0,19,4
1653302609996,BIPN 140,B01,092952,Banghart; Matthew Ryan,12,0,19,7
1653302609996,BIPN 140,B02,092953,Banghart; Matthew Ryan,19,0,19,0
1653302609996,BIPN 140,B03,092954,Banghart; Matthew Ryan,19,0,19,0
1653302609996,BIPN 140,B04,092955,Banghart; Matthew Ryan,19,0,19,0
1653302610523,BIPN 145,A01,089973,Marino; Marc J,35,0,42,7
1653302610523,BIPN 145,A02,089974,Marino; Marc J,36,0,42,6
1653302610523,BIPN 145,B01,089976,Juavinett; Ashley Lauren,0,0,42,42
1653302611052,BIPN 148,A01,092960,Leutgeb; Jill K.,31,0,32,1
1653302611052,BIPN 148,A02,092961,Leutgeb; Jill K.,25,0,32,7
1653302611052,BIPN 148,A03,092962,Leutgeb; Jill K.,29,0,31,2
1653302611052,BIPN 148,A04,092963,Leutgeb; Jill K.,31,0,31,0
1653302611052,BIPN 148,A05,092964,Leutgeb; Jill K.,31,0,31,0
1653302611052,BIPN 148,A06,094351,Leutgeb; Jill K.,26,0,31,5
1653302611052,BIPN 148,A07,092966,Leutgeb; Jill K.,26,0,31,5
1653302611052,BIPN 148,A08,092967,Leutgeb; Jill K.,26,0,31,5
1653302611578,BIPN 189,A00,090665,Gentner; Tim,0,0,25,25
1653302612115,BIPN 194,A00,089978,Pekkurnaz Banghart; Gulcin,17,0,27,10
1653302612115,BIPN 194,B00,089979,Leutgeb; Stefan,24,0,27,3
1653302612640,BISP 194,A00,089980,Wertheim; Joel Okrent,8,0,27,19
1653302613168,CAT 1,A01,086671,Bronstein; Phoebe Malan,17,0,17,0
1653302613168,CAT 1,A02,086672,Bronstein; Phoebe Malan,13,0,17,4
1653302613168,CAT 1,A03,086673,Bronstein; Phoebe Malan,17,0,17,0
1653302613168,CAT 1,A04,086674,Bronstein; Phoebe Malan,15,0,17,2
1653302613168,CAT 1,A05,086675,Bronstein; Phoebe Malan,17,0,17,0
1653302613168,CAT 1,A06,086676,Bronstein; Phoebe Malan,17,0,17,0
1653302613168,CAT 1,A07,086677,Bronstein; Phoebe Malan,16,0,17,1
1653302613168,CAT 1,A08,086678,Bronstein; Phoebe Malan,17,0,17,0
1653302613168,CAT 1,A09,086679,Bronstein; Phoebe Malan,16,0,17,1
1653302613168,CAT 1,A10,086680,Bronstein; Phoebe Malan,17,0,17,0
1653302613168,CAT 1,A11,086681,Bronstein; Phoebe Malan,16,0,17,1
1653302613168,CAT 1,A12,086682,Bronstein; Phoebe Malan,17,0,17,0
1653302613168,CAT 1,A13,086683,Bronstein; Phoebe Malan,17,0,17,0
1653302613168,CAT 1,A14,086684,Bronstein; Phoebe Malan,17,0,17,0
1653302613168,CAT 1,A15,086685,Bronstein; Phoebe Malan,17,0,17,0
1653302613168,CAT 1,A16,086686,Bronstein; Phoebe Malan,17,0,17,0
1653302613168,CAT 1,B01,086688,Bigham; David Joseph,17,0,17,0
1653302613168,CAT 1,B02,086689,Bigham; David Joseph,16,0,17,1
1653302613168,CAT 1,B03,086690,Bigham; David Joseph,17,0,17,0
1653302613168,CAT 1,B04,086691,Bigham; David Joseph,17,0,17,0
1653302613168,CAT 1,B05,086692,Bigham; David Joseph,16,0,17,1
1653302613168,CAT 1,B06,086693,Bigham; David Joseph,17,0,17,0
1653302613168,CAT 1,B07,086694,Bigham; David Joseph,17,0,17,0
1653302613168,CAT 1,B08,086695,Bigham; David Joseph,17,0,17,0
1653302613168,CAT 1,B09,086696,Bigham; David Joseph,17,0,17,0
1653302613168,CAT 1,B10,086697,Bigham; David Joseph,17,0,17,0
1653302613168,CAT 1,B11,086698,Bigham; David Joseph,17,0,17,0
1653302613168,CAT 1,B12,086699,Bigham; David Joseph,17,0,17,0
1653302613168,CAT 1,B13,086700,Bigham; David Joseph,15,0,17,2
1653302613168,CAT 1,B14,086701,Bigham; David Joseph,17,0,17,0
1653302613168,CAT 1,C01,086703,Algaze; Guillermo,17,0,17,0
1653302613168,CAT 1,C02,086704,Algaze; Guillermo,17,0,17,0
1653302613168,CAT 1,C03,086705,Algaze; Guillermo,17,0,17,0
1653302613168,CAT 1,C04,086706,Algaze; Guillermo,17,0,17,0
1653302613168,CAT 1,C05,086707,Algaze; Guillermo,17,0,17,0
1653302613168,CAT 1,C06,086708,Algaze; Guillermo,17,0,17,0
1653302613168,CAT 1,C07,086709,Algaze; Guillermo,17,0,17,0
1653302613168,CAT 1,C08,086710,Algaze; Guillermo,17,0,17,0
1653302613168,CAT 1,C09,086711,Algaze; Guillermo,17,0,17,0
1653302613168,CAT 1,C10,086712,Algaze; Guillermo,17,0,17,0
1653302613168,CAT 1,C11,086713,Algaze; Guillermo,17,0,17,0
1653302613168,CAT 1,C12,086714,Algaze; Guillermo,17,0,17,0
1653302613168,CAT 1,C13,086715,Algaze; Guillermo,17,0,17,0
1653302613168,CAT 1,C14,086716,Algaze; Guillermo,16,0,17,1
1653302613168,CAT 1,C15,086717,Algaze; Guillermo,17,0,17,0
1653302613168,CAT 1,C16,086718,Algaze; Guillermo,16,0,17,1
1653302613168,CAT 1,D01,086720,Staff,17,0,17,0
1653302613168,CAT 1,D02,086721,Staff,17,0,17,0
1653302613168,CAT 1,D03,086722,Staff,17,0,17,0
1653302613168,CAT 1,D04,086723,Staff,17,0,17,0
1653302613168,CAT 1,D05,086724,Staff,16,0,17,1
1653302613168,CAT 1,D06,086725,Staff,16,0,17,1
1653302613168,CAT 1,D07,086726,Staff,17,0,17,0
1653302613168,CAT 1,D08,086727,Staff,17,0,17,0
1653302613168,CAT 1,D09,086728,Staff,16,0,17,1
1653302613168,CAT 1,D10,086729,Staff,17,0,17,0
1653302613168,CAT 1,D11,086730,Staff,17,0,17,0
1653302613168,CAT 1,D12,086731,Staff,17,0,17,0
1653302613168,CAT 1,D13,086732,Staff,17,0,17,0
1653302613168,CAT 1,D14,086733,Staff,17,0,17,0
1653302613699,CAT 3,A01,086735,Gumm; Elizabeth Ashley,14,0,15,1
1653302613699,CAT 3,A02,086736,Gumm; Elizabeth Ashley,14,0,15,1
1653302613699,CAT 3,A03,086737,Gumm; Elizabeth Ashley,15,0,15,0
1653302613699,CAT 3,A04,086738,Gumm; Elizabeth Ashley,15,0,15,0
1653302613699,CAT 3,A05,086739,Gumm; Elizabeth Ashley,15,0,15,0
1653302613699,CAT 3,A06,086740,Gumm; Elizabeth Ashley,15,0,15,0
1653302614222,CAT 124,A01,086742,Staff,15,0,15,0
1653302614748,CAT 125R,A01,094882,Staff,14,0,16,2
1653302614748,CAT 125R,A02,086745,Staff,16,0,16,0
1653302614748,CAT 125R,A03,086746,Staff,14,0,16,2
1653302614748,CAT 125R,A04,086747,Staff,13,0,16,3
1653302614748,CAT 125R,A05,086748,Staff,15,0,16,1
1653302614748,CAT 125R,A06,086749,Staff,12,0,16,4
1653302614748,CAT 125R,A07,086750,Staff,14,0,16,2
1653302614748,CAT 125R,A08,094883,Staff,14,0,16,2
1653302614748,CAT 125R,A09,094884,Staff,16,0,16,0
1653302614748,CAT 125R,A10,094885,Staff,15,0,16,1
1653302614748,CAT 125R,A14,086761,Staff,15,0,16,1
1653302614748,CAT 125R,A15,086762,Staff,16,0,16,0
1653302614748,CAT 125R,A16,086763,Staff,13,0,16,3
1653302614748,CAT 125R,A17,086764,Staff,14,0,16,2
1653302614748,CAT 125R,A18,086765,Staff,14,0,16,2
1653302614748,CAT 125R,A19,086766,Staff,14,0,16,2
1653302615272,CCS 101,A00,088353,Staff,29,0,35,6
1653302615805,CENG 4,A01,086204,Bae; Jinhye,30,0,30,0
1653302615805,CENG 4,A02,086205,Bae; Jinhye,30,0,30,0
1653302615805,CENG 4,B01,086207,Drews; Aaron,30,0,30,0
1653302615805,CENG 4,B02,086208,Drews; Aaron,30,0,30,0
1653302616335,CENG 15,A01,086210,Lubarda; Vlado,63,0,65,2
1653302616335,CENG 15,B01,086212,Lubarda; Vlado,65,0,65,0
1653302616864,CENG 100,A00,086213,Chen; Zheng,147,0,150,3
1653302617404,CENG 101A,A00,086214,Bae; Jinhye,142,0,150,8
1653302617928,CENG 120,A00,086215,Opatkiewicz; Justin Paul,125,0,150,25
1653302618452,CENG 122,A00,086216,Opatkiewicz; Justin Paul,137,0,150,13
1653302618984,CGS 2A,A01,086271,Shelby; Karen Lee,12,0,15,3
1653302618984,CGS 2A,A02,086272,Shelby; Karen Lee,13,0,15,2
1653302618984,CGS 2A,A03,086273,Shelby; Karen Lee,14,0,15,1
1653302618984,CGS 2A,A04,086274,Shelby; Karen Lee,15,0,15,0
1653302619512,CGS 100A,A00,086275,Perez; Roy,26,0,32,6
1653302620035,CGS 101,A00,086276,Shelby; Karen Lee,30,0,30,0
1653302620562,CGS 106,A00,086277,Shelby; Karen Lee,24,0,30,6
1653302621085,CGS 119,A00,086279,Nguyen; Hoang Tan,27,0,30,3
1653302621613,CGS 121,A00,086280,Martin Sandino; Amanda Maria Yoland,19,0,20,1
1653302622142,CGS 122,A00,086281,Whitley; Leila Marie,20,0,20,0
1653302622667,CGS 123,A00,086282,Staff,0,0,0,0
1653302623193,CGS 127,A00,086283,Whitley; Leila Marie,15,0,15,0
1653302623717,CGS 130,A00,086284,Martin Sandino; Amanda Maria Yoland,15,0,15,0
1653302624244,CGS 187,A00,086285,Perez; Roy,15,0,16,1
1653302624768,CGS 190,A00,086286,Staff,5,0,5,0
1653302625294,CHEM 4,A01,089669,Bussey; Thomas J,40,0,40,0
1653302625294,CHEM 4,A02,089670,Bussey; Thomas J,42,0,42,0
1653302625294,CHEM 4,A03,089671,Bussey; Thomas J,40,0,42,2
1653302625294,CHEM 4,A04,089672,Bussey; Thomas J,42,0,42,0
1653302625294,CHEM 4,A05,089673,Bussey; Thomas J,40,0,42,2
1653302625294,CHEM 4,A06,089674,Bussey; Thomas J,40,0,42,2
1653302625294,CHEM 4,A07,089675,Bussey; Thomas J,42,0,42,0
1653302625294,CHEM 4,A08,089676,Bussey; Thomas J,42,0,42,0
1653302625294,CHEM 4,A09,089677,Bussey; Thomas J,41,0,41,0
1653302625294,CHEM 4,A10,089678,Bussey; Thomas J,40,0,40,0
1653302625832,CHEM 6A,A01,092734,Pomeroy; Robert S.,4,0,4,0
1653302625832,CHEM 6A,A02,092735,Pomeroy; Robert S.,4,0,4,0
1653302625832,CHEM 6A,A03,092736,Pomeroy; Robert S.,4,0,4,0
1653302625832,CHEM 6A,A04,092737,Pomeroy; Robert S.,4,0,4,0
1653302625832,CHEM 6A,A05,092738,Pomeroy; Robert S.,4,0,4,0
1653302625832,CHEM 6A,A06,092739,Pomeroy; Robert S.,4,0,4,0
1653302625832,CHEM 6A,A07,092740,Pomeroy; Robert S.,4,0,4,0
1653302625832,CHEM 6A,A08,092741,Pomeroy; Robert S.,4,0,4,0
1653302625832,CHEM 6A,A09,092742,Pomeroy; Robert S.,0,0,0,0
1653302625832,CHEM 6A,B01,092744,Schurmeier; Kimberly,4,0,4,0
1653302625832,CHEM 6A,B02,092746,Schurmeier; Kimberly,4,0,4,0
1653302625832,CHEM 6A,B03,092749,Schurmeier; Kimberly,4,0,4,0
1653302625832,CHEM 6A,B04,092751,Schurmeier; Kimberly,4,0,4,0
1653302625832,CHEM 6A,B05,092753,Schurmeier; Kimberly,4,0,4,0
1653302625832,CHEM 6A,B06,092755,Schurmeier; Kimberly,3,0,4,1
1653302625832,CHEM 6A,B07,092756,Schurmeier; Kimberly,4,0,4,0
1653302625832,CHEM 6A,B08,092757,Schurmeier; Kimberly,4,0,4,0
1653302625832,CHEM 6A,B09,092758,Schurmeier; Kimberly,0,0,0,0
1653302625832,CHEM 6A,C01,092805,Schurmeier; Kimberly,4,0,4,0
1653302625832,CHEM 6A,C02,092806,Schurmeier; Kimberly,4,0,4,0
1653302625832,CHEM 6A,C03,092807,Schurmeier; Kimberly,4,0,4,0
1653302625832,CHEM 6A,C04,092808,Schurmeier; Kimberly,4,0,4,0
1653302625832,CHEM 6A,C05,092809,Schurmeier; Kimberly,4,0,4,0
1653302625832,CHEM 6A,C06,092810,Schurmeier; Kimberly,4,0,4,0
1653302625832,CHEM 6A,C07,092811,Schurmeier; Kimberly,4,0,4,0
1653302625832,CHEM 6A,C08,092812,Schurmeier; Kimberly,4,0,4,0
1653302625832,CHEM 6A,C09,092813,Schurmeier; Kimberly,0,0,0,0
1653302625832,CHEM 6A,D01,092837,Stallings; Dontarie M,4,0,4,0
1653302625832,CHEM 6A,D02,092838,Stallings; Dontarie M,4,0,4,0
1653302625832,CHEM 6A,D03,092839,Stallings; Dontarie M,4,0,4,0
1653302625832,CHEM 6A,D04,092840,Stallings; Dontarie M,4,0,4,0
1653302625832,CHEM 6A,D05,092841,Stallings; Dontarie M,4,0,4,0
1653302625832,CHEM 6A,D06,092842,Stallings; Dontarie M,4,0,4,0
1653302625832,CHEM 6A,D07,092843,Stallings; Dontarie M,4,0,4,0
1653302625832,CHEM 6A,D08,092844,Stallings; Dontarie M,4,0,4,0
1653302625832,CHEM 6A,D09,092845,Stallings; Dontarie M,0,0,0,0
1653302625832,CHEM 6A,E01,092796,Brydges; Stacey,4,0,4,0
1653302625832,CHEM 6A,E02,092797,Brydges; Stacey,3,0,4,1
1653302625832,CHEM 6A,E03,092798,Brydges; Stacey,4,0,4,0
1653302625832,CHEM 6A,E04,092799,Brydges; Stacey,3,0,4,1
1653302625832,CHEM 6A,E05,092800,Brydges; Stacey,4,0,4,0
1653302625832,CHEM 6A,E06,092801,Brydges; Stacey,4,0,4,0
1653302625832,CHEM 6A,E07,092802,Brydges; Stacey,4,0,4,0
1653302625832,CHEM 6A,E08,092803,Brydges; Stacey,4,0,4,0
1653302625832,CHEM 6A,E09,092804,Brydges; Stacey,0,0,0,0
1653302625832,CHEM 6A,F01,092759,Brydges; Stacey,4,0,4,0
1653302625832,CHEM 6A,F02,092760,Brydges; Stacey,4,0,4,0
1653302625832,CHEM 6A,F03,092761,Brydges; Stacey,3,0,4,1
1653302625832,CHEM 6A,F04,092762,Brydges; Stacey,4,0,4,0
1653302625832,CHEM 6A,F05,092763,Brydges; Stacey,4,0,4,0
1653302625832,CHEM 6A,F06,092764,Brydges; Stacey,4,0,4,0
1653302625832,CHEM 6A,F07,092765,Brydges; Stacey,4,0,4,0
1653302625832,CHEM 6A,F08,092766,Brydges; Stacey,4,0,4,0
1653302625832,CHEM 6A,F09,092767,Brydges; Stacey,0,0,0,0
1653302625832,CHEM 6A,G01,092774,Zid; Brian M,0,0,4,4
1653302625832,CHEM 6A,G02,092775,Zid; Brian M,2,0,4,2
1653302625832,CHEM 6A,G03,092776,Zid; Brian M,2,0,4,2
1653302625832,CHEM 6A,G04,092777,Zid; Brian M,2,0,4,2
1653302625832,CHEM 6A,G05,092778,Zid; Brian M,4,0,4,0
1653302625832,CHEM 6A,G06,092779,Zid; Brian M,4,0,4,0
1653302625832,CHEM 6A,G07,092780,Zid; Brian M,3,0,4,1
1653302625832,CHEM 6A,G08,092781,Zid; Brian M,3,0,4,1
1653302625832,CHEM 6A,G09,092782,Zid; Brian M,0,0,0,0
1653302625832,CHEM 6A,H01,092846,Stallings; Dontarie M,4,0,4,0
1653302625832,CHEM 6A,H02,092847,Stallings; Dontarie M,3,0,4,1
1653302625832,CHEM 6A,H03,092848,Stallings; Dontarie M,4,0,4,0
1653302625832,CHEM 6A,H04,092849,Stallings; Dontarie M,4,0,4,0
1653302625832,CHEM 6A,H05,092850,Stallings; Dontarie M,4,0,4,0
1653302625832,CHEM 6A,H06,092851,Stallings; Dontarie M,3,0,4,1
1653302625832,CHEM 6A,H07,092852,Stallings; Dontarie M,4,0,4,0
1653302625832,CHEM 6A,H08,092853,Stallings; Dontarie M,3,0,4,1
1653302625832,CHEM 6A,H09,092854,Stallings; Dontarie M,0,0,0,0
1653302625832,CHEM 6A,I01,092814,Staff,0,0,0,0
1653302625832,CHEM 6A,I02,092815,Staff,0,0,0,0
1653302625832,CHEM 6A,I04,092816,Staff,0,0,0,0
1653302625832,CHEM 6A,I05,092817,Staff,0,0,0,0
1653302625832,CHEM 6A,I06,092818,Staff,0,0,0,0
1653302625832,CHEM 6A,I07,092819,Staff,0,0,0,0
1653302625832,CHEM 6A,I08,092820,Staff,0,0,0,0
1653302625832,CHEM 6A,I09,092821,Staff,0,0,0,0
1653302626362,CHEM 6AH,A01,092793,Paesani; Francesco,15,0,16,1
1653302626362,CHEM 6AH,A02,092794,Paesani; Francesco,16,0,16,0
1653302626362,CHEM 6AH,A03,092795,Paesani; Francesco,16,0,16,0
1653302626896,CHEM 6B,A01,092691,Hopkins; Patrycja Anna,21,0,25,4
1653302626896,CHEM 6B,A02,092692,Hopkins; Patrycja Anna,23,0,25,2
1653302626896,CHEM 6B,A03,092693,Hopkins; Patrycja Anna,25,0,25,0
1653302626896,CHEM 6B,A04,092694,Hopkins; Patrycja Anna,0,0,0,0
1653302626896,CHEM 6B,A05,092695,Hopkins; Patrycja Anna,24,0,25,1
1653302626896,CHEM 6B,A06,092696,Hopkins; Patrycja Anna,22,0,25,3
1653302626896,CHEM 6B,A07,092697,Hopkins; Patrycja Anna,24,0,25,1
1653302627422,CHEM 6C,A01,092708,Albizati; Kim F.,31,0,38,7
1653302627422,CHEM 6C,A02,092709,Albizati; Kim F.,32,0,38,6
1653302627422,CHEM 6C,A03,092710,Albizati; Kim F.,37,0,38,1
1653302627422,CHEM 6C,A04,092711,Albizati; Kim F.,36,0,38,2
1653302627422,CHEM 6C,A05,092712,Albizati; Kim F.,0,0,0,0
1653302627422,CHEM 6C,A06,092714,Albizati; Kim F.,33,0,38,5
1653302627422,CHEM 6C,A07,092715,Albizati; Kim F.,32,0,38,6
1653302627422,CHEM 6C,A08,092716,Albizati; Kim F.,37,0,38,1
1653302627422,CHEM 6C,A09,092717,Albizati; Kim F.,38,0,38,0
1653302627965,CHEM 7L,A01,089692,Leigh; Brian,11,0,19,8
1653302627965,CHEM 7L,A02,089693,Leigh; Brian,23,0,24,1
1653302627965,CHEM 7L,A03,089694,Leigh; Brian,24,0,24,0
1653302627965,CHEM 7L,A04,089695,Leigh; Brian,24,0,24,0
1653302627965,CHEM 7L,A05,089696,Leigh; Brian,23,0,24,1
1653302627965,CHEM 7L,A06,089697,Leigh; Brian,22,0,24,2
1653302627965,CHEM 7L,A07,089698,Leigh; Brian,21,0,21,0
1653302627965,CHEM 7L,A08,089699,Leigh; Brian,17,0,24,7
1653302627965,CHEM 7L,A09,089700,Leigh; Brian,23,0,24,1
1653302627965,CHEM 7L,A10,089701,Leigh; Brian,0,0,0,0
1653302627965,CHEM 7L,B01,089703,Leigh; Brian,18,0,24,6
1653302627965,CHEM 7L,B02,089704,Leigh; Brian,18,0,24,6
1653302627965,CHEM 7L,B03,089705,Leigh; Brian,23,0,24,1
1653302627965,CHEM 7L,B04,089706,Leigh; Brian,20,0,21,1
1653302627965,CHEM 7L,B05,089707,Leigh; Brian,17,0,24,7
1653302627965,CHEM 7L,B06,089708,Leigh; Brian,17,0,24,7
1653302627965,CHEM 7L,B07,089709,Leigh; Brian,17,0,24,7
1653302627965,CHEM 7L,B08,089710,Leigh; Brian,21,0,24,3
1653302627965,CHEM 7L,B09,089711,Leigh; Brian,21,0,24,3
1653302627965,CHEM 7L,B10,089712,Leigh; Brian,0,0,0,0
1653302627965,CHEM 7L,C01,089714,Staff,23,0,24,1
1653302627965,CHEM 7L,C02,089715,Staff,22,0,24,2
1653302627965,CHEM 7L,C03,089716,Staff,23,0,24,1
1653302627965,CHEM 7L,C04,089717,Staff,24,0,24,0
1653302627965,CHEM 7L,C05,089718,Staff,21,0,24,3
1653302627965,CHEM 7L,C06,089719,Staff,22,0,24,2
1653302627965,CHEM 7L,C07,089720,Staff,23,0,24,1
1653302627965,CHEM 7L,C08,089721,Staff,24,0,24,0
1653302627965,CHEM 7L,C09,089722,Staff,24,0,24,0
1653302627965,CHEM 7L,C10,089723,Staff,0,0,0,0
1653302628497,CHEM 40A,A01,092871,Schmidt; Valerie A,31,0,31,0
1653302628497,CHEM 40A,A02,092872,Schmidt; Valerie A,31,0,31,0
1653302628497,CHEM 40A,A03,092873,Schmidt; Valerie A,31,0,31,0
1653302628497,CHEM 40A,A04,092874,Schmidt; Valerie A,0,0,0,0
1653302628497,CHEM 40A,A05,092875,Schmidt; Valerie A,31,0,31,0
1653302628497,CHEM 40A,A06,092876,Schmidt; Valerie A,29,0,31,2
1653302628497,CHEM 40A,A07,092877,Schmidt; Valerie A,31,0,31,0
1653302628497,CHEM 40A,A08,092878,Schmidt; Valerie A,28,0,28,0
1653302628497,CHEM 40A,B01,089726,Lam; Tin Yiu,31,0,31,0
1653302628497,CHEM 40A,B02,089727,Lam; Tin Yiu,31,0,31,0
1653302628497,CHEM 40A,B03,089728,Lam; Tin Yiu,31,0,31,0
1653302628497,CHEM 40A,B04,089729,Lam; Tin Yiu,30,0,31,1
1653302628497,CHEM 40A,B05,089730,Lam; Tin Yiu,31,0,31,0
1653302628497,CHEM 40A,B06,089731,Lam; Tin Yiu,30,0,31,1
1653302628497,CHEM 40A,B07,089732,Lam; Tin Yiu,29,0,31,2
1653302628497,CHEM 40A,B08,089733,Lam; Tin Yiu,0,0,0,0
1653302628497,CHEM 40A,C01,092718,Albizati; Kim F.,17,0,31,14
1653302628497,CHEM 40A,C02,092719,Albizati; Kim F.,24,0,31,7
1653302628497,CHEM 40A,C03,092720,Albizati; Kim F.,12,0,31,19
1653302628497,CHEM 40A,C04,092721,Albizati; Kim F.,24,0,31,7
1653302628497,CHEM 40A,C05,092722,Albizati; Kim F.,21,0,31,10
1653302628497,CHEM 40A,C06,092723,Albizati; Kim F.,24,0,31,7
1653302628497,CHEM 40A,C07,092724,Albizati; Kim F.,30,0,31,1
1653302628497,CHEM 40A,C08,092725,Albizati; Kim F.,0,0,0,0
1653302628497,CHEM 40A,D01,092863,Yang; Jerry,28,0,31,3
1653302628497,CHEM 40A,D02,092864,Yang; Jerry,28,0,31,3
1653302628497,CHEM 40A,D03,092865,Yang; Jerry,31,0,31,0
1653302628497,CHEM 40A,D04,092866,Yang; Jerry,31,0,31,0
1653302628497,CHEM 40A,D05,092867,Yang; Jerry,0,0,0,0
1653302628497,CHEM 40A,D06,092868,Yang; Jerry,31,0,31,0
1653302628497,CHEM 40A,D07,092869,Yang; Jerry,31,0,31,0
1653302628497,CHEM 40A,D08,092870,Yang; Jerry,31,0,31,0
1653302629023,CHEM 40B,A01,092698,Oconnor; Joseph M.,24,0,34,10
1653302629023,CHEM 40B,A02,092699,Oconnor; Joseph M.,34,0,34,0
1653302629023,CHEM 40B,A03,092700,Oconnor; Joseph M.,0,0,0,0
1653302629023,CHEM 40B,A04,092701,Oconnor; Joseph M.,30,0,34,4
1653302629023,CHEM 40B,A05,092702,Oconnor; Joseph M.,33,0,34,1
1653302629023,CHEM 40B,A06,092703,Oconnor; Joseph M.,34,0,34,0
1653302629023,CHEM 40B,A07,092704,Oconnor; Joseph M.,32,0,34,2
1653302629023,CHEM 40B,A08,092705,Oconnor; Joseph M.,33,0,34,1
1653302629023,CHEM 40B,A09,092706,Oconnor; Joseph M.,34,0,34,0
1653302629547,CHEM 40C,A01,089739,Lam; Tin Yiu,0,0,0,0
1653302629547,CHEM 40C,A02,089740,Lam; Tin Yiu,0,0,0,0
1653302629547,CHEM 40C,A03,089741,Lam; Tin Yiu,0,0,0,0
1653302629547,CHEM 40C,A04,089742,Lam; Tin Yiu,13,0,34,21
1653302629547,CHEM 40C,A05,089743,Lam; Tin Yiu,32,0,34,2
1653302629547,CHEM 40C,A06,089744,Lam; Tin Yiu,31,0,34,3
1653302630072,CHEM 41A,A01,093840,Ternansky; Robert J.,29,0,33,4
1653302630072,CHEM 41A,A02,093841,Ternansky; Robert J.,32,0,33,1
1653302630072,CHEM 41A,A03,093842,Ternansky; Robert J.,33,0,33,0
1653302630072,CHEM 41A,A04,093843,Ternansky; Robert J.,30,0,33,3
1653302630072,CHEM 41A,A05,093844,Ternansky; Robert J.,31,0,33,2
1653302630072,CHEM 41A,A06,093845,Ternansky; Robert J.,27,0,27,0
1653302630072,CHEM 41A,A07,093846,Ternansky; Robert J.,32,0,33,1
1653302630072,CHEM 41A,A08,093847,Ternansky; Robert J.,33,0,33,0
1653302630625,CHEM 43A,A01,089746,Klosterman; Jeremy K,11,0,24,13
1653302630625,CHEM 43A,A02,089747,Klosterman; Jeremy K,16,0,24,8
1653302630625,CHEM 43A,A03,089748,Klosterman; Jeremy K,21,0,24,3
1653302630625,CHEM 43A,A04,089749,Klosterman; Jeremy K,22,0,24,2
1653302630625,CHEM 43A,A05,089750,Klosterman; Jeremy K,23,0,24,1
1653302630625,CHEM 43A,A06,089751,Klosterman; Jeremy K,8,0,24,16
1653302630625,CHEM 43A,A07,089752,Klosterman; Jeremy K,17,0,24,7
1653302630625,CHEM 43A,A08,089753,Klosterman; Jeremy K,16,0,24,8
1653302630625,CHEM 43A,A09,089754,Klosterman; Jeremy K,21,0,24,3
1653302630625,CHEM 43A,A10,089755,Klosterman; Jeremy K,21,0,24,3
1653302630625,CHEM 43A,A11,089756,Klosterman; Jeremy K,0,0,0,0
1653302630625,CHEM 43A,A12,089757,Klosterman; Jeremy K,0,0,0,0
1653302630625,CHEM 43A,A13,089758,Klosterman; Jeremy K,0,0,0,0
1653302630625,CHEM 43A,B01,089760,Klosterman; Jeremy K,0,0,0,0
1653302630625,CHEM 43A,B02,089761,Klosterman; Jeremy K,0,0,0,0
1653302630625,CHEM 43A,B03,089762,Klosterman; Jeremy K,16,0,24,8
1653302630625,CHEM 43A,B04,089763,Klosterman; Jeremy K,22,0,24,2
1653302630625,CHEM 43A,B05,089764,Klosterman; Jeremy K,23,0,24,1
1653302630625,CHEM 43A,B06,089765,Klosterman; Jeremy K,23,0,24,1
1653302630625,CHEM 43A,B07,089766,Klosterman; Jeremy K,17,0,24,7
1653302630625,CHEM 43A,B08,089767,Klosterman; Jeremy K,23,0,24,1
1653302630625,CHEM 43A,B09,089768,Klosterman; Jeremy K,24,0,24,0
1653302630625,CHEM 43A,B10,089769,Klosterman; Jeremy K,23,0,24,1
1653302630625,CHEM 43A,B11,089770,Klosterman; Jeremy K,22,0,24,2
1653302630625,CHEM 43A,B12,089771,Klosterman; Jeremy K,21,0,24,3
1653302631150,CHEM 87,A00,089772,Bussey; Thomas J,20,0,20,0
1653302631674,CHEM 96,A00,089773,Bussey; Thomas J,20,0,25,5
1653302632199,CHEM 100A,A01,089775,Pomeroy; Robert S.,22,0,24,2
1653302632199,CHEM 100A,A02,089776,Pomeroy; Robert S.,19,0,24,5
1653302632199,CHEM 100A,A03,089777,Pomeroy; Robert S.,13,0,24,11
1653302632199,CHEM 100A,A04,089778,Pomeroy; Robert S.,18,0,24,6
1653302632199,CHEM 100A,A05,089779,Pomeroy; Robert S.,19,0,24,5
1653302632199,CHEM 100A,A06,089780,Pomeroy; Robert S.,24,0,24,0
1653302632199,CHEM 100A,A07,089781,Pomeroy; Robert S.,0,0,0,0
1653302632731,CHEM 105A,A01,089783,Young; Mark,0,0,39,39
1653302632731,CHEM 105A,B01,089785,Young; Mark,26,0,39,13
1653302633330,CHEM 108,A01,089787,Ghosh; Gourisankar,1,0,22,21
1653302633330,CHEM 108,A02,089788,Ghosh; Gourisankar,6,0,22,16
1653302633330,CHEM 108,B01,089790,Ghosh; Gourisankar,13,0,22,9
1653302633330,CHEM 108,B02,089791,Ghosh; Gourisankar,20,0,22,2
1653302633855,CHEM 109,A01,089793,Hamaoka; Brent Y,4,0,22,18
1653302633855,CHEM 109,A02,089794,Hamaoka; Brent Y,10,0,22,12
1653302633855,CHEM 109,B01,089796,Hamaoka; Brent Y,6,0,22,16
1653302633855,CHEM 109,B02,089797,Hamaoka; Brent Y,18,0,22,4
1653302634381,CHEM 114A,A01,092855,Toor; Navtej,21,0,25,4
1653302634381,CHEM 114A,A02,092856,Toor; Navtej,25,0,25,0
1653302634381,CHEM 114A,A03,092857,Toor; Navtej,19,0,25,6
1653302634381,CHEM 114A,A04,092858,Toor; Navtej,24,0,25,1
1653302634381,CHEM 114A,A05,092859,Toor; Navtej,0,0,0,0
1653302634381,CHEM 114A,A06,092860,Toor; Navtej,14,0,25,11
1653302634381,CHEM 114A,A07,092861,Toor; Navtej,24,0,25,1
1653302634381,CHEM 114A,A08,092862,Toor; Navtej,24,0,25,1
1653302634906,CHEM 116,A01,092707,Ferguson; Fleur,6,0,35,29
1653302634906,CHEM 116,A02,094887,Ferguson; Fleur,31,0,35,4
1653302635431,CHEM 120A,A01,092785,Schimpf; Alina M,16,0,28,12
1653302635431,CHEM 120A,A02,092786,Schimpf; Alina M,26,0,28,2
1653302635431,CHEM 120A,A03,092787,Schimpf; Alina M,20,0,28,8
1653302635431,CHEM 120A,A04,092788,Schimpf; Alina M,27,0,28,1
1653302635431,CHEM 120A,A05,092789,Schimpf; Alina M,27,0,28,1
1653302635431,CHEM 120A,A06,092790,Schimpf; Alina M,0,0,0,0
1653302635431,CHEM 120A,A07,092791,Schimpf; Alina M,15,0,28,13
1653302635431,CHEM 120A,A08,092792,Schimpf; Alina M,0,0,0,0
1653302635956,CHEM 126A,A01,092768,Schoeneberg; Johannes,16,0,35,19
1653302635956,CHEM 126A,A02,092769,Schoeneberg; Johannes,35,0,35,0
1653302635956,CHEM 126A,A03,092770,Schoeneberg; Johannes,29,0,35,6
1653302635956,CHEM 126A,A04,092771,Schoeneberg; Johannes,0,0,0,0
1653302635956,CHEM 126A,A05,092772,Schoeneberg; Johannes,30,0,35,5
1653302635956,CHEM 126A,A06,092773,Schoeneberg; Johannes,33,0,35,2
1653302636480,CHEM 130,A01,092685,Sinha; Amitabha,28,0,38,10
1653302636480,CHEM 130,A02,092686,Sinha; Amitabha,31,0,38,7
1653302636480,CHEM 130,A03,092687,Sinha; Amitabha,34,0,38,4
1653302637006,CHEM 142,A00,089803,Esko; Jeffrey D. & Godula; Kamil,9,0,46,37
1653302637531,CHEM 143C,A01,089805,Ternansky; Robert J.,17,0,22,5
1653302637531,CHEM 143C,A02,089806,Ternansky; Robert J.,18,0,22,4
1653302637531,CHEM 143C,A03,089807,Ternansky; Robert J.,19,0,22,3
1653302637531,CHEM 143C,A04,089808,Ternansky; Robert J.,20,0,22,2
1653302638060,CHEM 152,A00,089809,Romero; Nathan A & Schmidt; Valerie A,35,0,40,5
1653302638590,CHEM 171,A01,092688,Slade; Jonathan,35,0,45,10
1653302638590,CHEM 171,A02,092689,Slade; Jonathan,44,0,45,1
1653302638590,CHEM 171,A03,092690,Slade; Jonathan,45,0,45,0
1653302639114,CHEM 186,A00,089811,Paesani; Francesco,9,0,15,6
1653302639638,CHIN 10AD,A01,086223,Staff,13,0,13,0
1653302639638,CHIN 10AD,A02,086224,Staff,12,0,13,1
1653302639638,CHIN 10AD,B01,086227,Staff,14,0,15,1
1653302640170,CHIN 10AM,A01,086230,Chen; Pei-Chia,16,0,16,0
1653302640170,CHIN 10AM,A02,086231,Chen; Pei-Chia,16,0,16,0
1653302640702,CHIN 10AN,A01,086234,Xu; Li,14,0,14,0
1653302640702,CHIN 10AN,A02,086235,Xu; Li,14,0,14,0
1653302640702,CHIN 10AN,B01,086240,Xu; Li,14,0,14,0
1653302640702,CHIN 10AN,B02,086242,Xu; Li,0,0,0,0
1653302640702,CHIN 10AN,C01,086245,Xu; Li,14,0,14,0
1653302640702,CHIN 10AN,C02,086246,Xu; Li,14,0,14,0
1653302641233,CHIN 20AD,A01,086248,Wang; Xiao,14,0,14,0
1653302641233,CHIN 20AD,A02,086249,Wang; Xiao,14,0,14,0
1653302641233,CHIN 20AD,B01,086251,Wang; Xiao,13,0,14,1
1653302641233,CHIN 20AD,B02,086252,Wang; Xiao,14,0,14,0
1653302641763,CHIN 20AM,A01,086254,Wang; Xiao,11,0,14,3
1653302641763,CHIN 20AM,A02,086255,Wang; Xiao,13,0,14,1
1653302641763,CHIN 20AM,B01,086257,Staff,15,0,15,0
1653302642288,CHIN 20AN,A01,086259,Anderson; Qin-Hong,11,0,12,1
1653302642288,CHIN 20AN,A02,086260,Anderson; Qin-Hong,12,0,12,0
1653302642288,CHIN 20AN,A03,086261,Anderson; Qin-Hong,0,0,0,0
1653302642288,CHIN 20AN,B01,086263,Anderson; Qin-Hong,12,0,13,1
1653302642288,CHIN 20AN,B02,086264,Anderson; Qin-Hong,13,0,13,0
1653302642816,CHIN 100AM,A00,086265,Anderson; Qin-Hong,20,0,20,0
1653302643343,CHIN 100AN,A00,086266,Chen; Pei-Chia,17,0,20,3
1653302643869,CHIN 185A,A00,086268,Staff,20,0,20,0
1653302644412,COGS 1,A01,087834,Barrera; Steven James,57,0,60,3
1653302644412,COGS 1,A02,087835,Barrera; Steven James,52,0,60,8
1653302644412,COGS 1,A03,087836,Barrera; Steven James,57,0,60,3
1653302644412,COGS 1,A04,087837,Barrera; Steven James,59,0,60,1
1653302644412,COGS 1,A05,087838,Barrera; Steven James,60,0,60,0
1653302644412,COGS 1,A06,087839,Barrera; Steven James,59,0,60,1
1653302644412,COGS 1,A07,087840,Barrera; Steven James,54,0,57,3
1653302644937,COGS 2,A01,087842,Boyle; Mary E. T.,64,0,64,0
1653302644937,COGS 2,A02,087843,Boyle; Mary E. T.,61,0,64,3
1653302644937,COGS 2,A03,087844,Boyle; Mary E. T.,64,0,64,0
1653302645462,COGS 3,A01,094312,Boyle; Mary E. T.,30,0,35,5
1653302645462,COGS 3,A02,094313,Boyle; Mary E. T.,33,0,35,2
1653302645462,COGS 3,A03,094314,Boyle; Mary E. T.,35,0,35,0
1653302645462,COGS 3,A04,094315,Boyle; Mary E. T.,35,0,35,0
1653302645462,COGS 3,A05,094316,Boyle; Mary E. T.,35,0,35,0
1653302645989,COGS 8,A01,087846,Staff,35,0,35,0
1653302646524,COGS 10,A01,094357,Hollan; James D.,53,0,60,7
1653302646524,COGS 10,A02,094358,Hollan; James D.,58,0,60,2
1653302646524,COGS 10,A03,094359,Hollan; James D.,59,0,60,1
1653302646524,COGS 10,A04,094360,Hollan; James D.,60,0,60,0
1653302646524,COGS 10,A05,094361,Hollan; James D.,60,0,60,0
1653302647052,COGS 11,A01,087848,Boyle; Mary E. T.,46,0,47,1
1653302647052,COGS 11,A02,087849,Boyle; Mary E. T.,44,0,47,3
1653302647052,COGS 11,A03,087850,Boyle; Mary E. T.,46,0,46,0
1653302647593,COGS 13,A01,087852,Davis; Joshua Daniel,56,0,60,4
1653302647593,COGS 13,A02,087853,Davis; Joshua Daniel,55,0,60,5
1653302647593,COGS 13,A03,087854,Davis; Joshua Daniel,57,0,60,3
1653302647593,COGS 13,A04,087855,Davis; Joshua Daniel,58,0,60,2
1653302648122,COGS 14A,A01,087857,Creel; Sarah,58,0,65,7
1653302648122,COGS 14A,A02,087858,Creel; Sarah,62,0,65,3
1653302648122,COGS 14A,A03,087859,Creel; Sarah,63,0,65,2
1653302648122,COGS 14A,A04,087860,Creel; Sarah,63,0,65,2
1653302648650,COGS 14B,A01,087862,Hoffman; Drew Ellen,56,0,60,4
1653302648650,COGS 14B,A02,087863,Hoffman; Drew Ellen,53,0,60,7
1653302648650,COGS 14B,A03,087864,Hoffman; Drew Ellen,60,0,60,0
1653302649176,COGS 15,A01,087866,Bergen; Benjamin,60,0,60,0
1653302649176,COGS 15,A02,087867,Bergen; Benjamin,59,0,60,1
1653302649703,COGS 17,A01,087869,Johnson; Christine M.,55,0,60,5
1653302649703,COGS 17,A02,087870,Johnson; Christine M.,58,0,60,2
1653302649703,COGS 17,A03,087871,Johnson; Christine M.,55,0,60,5
1653302649703,COGS 17,A04,087872,Johnson; Christine M.,60,0,60,0
1653302649703,COGS 17,A05,087873,Johnson; Christine M.,59,0,60,1
1653302649703,COGS 17,A06,087874,Johnson; Christine M.,60,0,60,0
1653302650233,COGS 18,A01,087876,Fleischer; Jason G,22,0,35,13
1653302650233,COGS 18,A02,087877,Fleischer; Jason G,31,0,35,4
1653302650233,COGS 18,A03,087878,Fleischer; Jason G,33,0,35,2
1653302650233,COGS 18,A04,087879,Fleischer; Jason G,33,0,35,2
1653302650233,COGS 18,A05,087880,Fleischer; Jason G,28,0,35,7
1653302650233,COGS 18,A06,087881,Fleischer; Jason G,34,0,35,1
1653302650233,COGS 18,A07,087882,Fleischer; Jason G,33,0,35,2
1653302650233,COGS 18,A08,087883,Fleischer; Jason G,31,0,35,4
1653302650233,COGS 18,A09,087884,Fleischer; Jason G,33,0,35,2
1653302650758,COGS 20,A01,090761,Borgo; David Garcia,5,0,5,0
1653302650758,COGS 20,A02,090762,Borgo; David Garcia,5,0,5,0
1653302650758,COGS 20,A03,090763,Borgo; David Garcia,5,0,5,0
1653302651282,COGS 87,A00,087885,Deak; Gedeon O.,20,0,20,0
1653302651282,COGS 87,B00,087886,Fleischer; Jason G,20,0,20,0
1653302651807,COGS 100,A01,087892,Kirsh; David Joel,56,0,60,4
1653302651807,COGS 100,A02,087893,Kirsh; David Joel,54,0,60,6
1653302651807,COGS 100,A03,087894,Kirsh; David Joel,54,0,60,6
1653302651807,COGS 100,A04,087895,Kirsh; David Joel,51,0,60,9
1653302651807,COGS 100,A05,087896,Kirsh; David Joel,48,0,60,12
1653302652332,COGS 101A,A01,087898,Hoffman; Drew Ellen,48,0,60,12
1653302652332,COGS 101A,A02,087899,Hoffman; Drew Ellen,58,0,60,2
1653302652332,COGS 101A,A03,087900,Hoffman; Drew Ellen,55,0,60,5
1653302652332,COGS 101A,A04,087901,Hoffman; Drew Ellen,58,0,60,2
1653302652332,COGS 101A,A05,087902,Hoffman; Drew Ellen,59,0,60,1
1653302652332,COGS 101A,A06,087903,Hoffman; Drew Ellen,56,0,60,4
1653302652859,COGS 101B,A01,087905,Barrera; Steven James,30,0,60,30
1653302652859,COGS 101B,A02,087906,Barrera; Steven James,52,0,60,8
1653302652859,COGS 101B,A03,087907,Barrera; Steven James,54,0,60,6
1653302653391,COGS 101C,A01,094240,Cooperrider; Kensy A,70,0,75,5
1653302653391,COGS 101C,A02,094241,Cooperrider; Kensy A,73,0,75,2
1653302653915,COGS 102A,A01,087909,Scott; Taylor Jackson,58,0,60,2
1653302653915,COGS 102A,A02,087910,Scott; Taylor Jackson,51,0,60,9
1653302654440,COGS 107A,A01,087912,Rangel; Lara M,51,0,60,9
1653302654440,COGS 107A,A02,087913,Rangel; Lara M,54,0,60,6
1653302654440,COGS 107A,A03,087914,Rangel; Lara M,47,0,60,13
1653302654440,COGS 107A,A04,087915,Rangel; Lara M,53,0,60,7
1653302654440,COGS 107A,A05,087916,Rangel; Lara M,55,0,60,5
1653302654440,COGS 107A,A06,087917,Rangel; Lara M,50,0,60,10
1653302654968,COGS 108,A01,087919,Fleischer; Jason G,14,0,60,46
1653302654968,COGS 108,A02,087920,Fleischer; Jason G,25,0,60,35
1653302654968,COGS 108,A03,087921,Fleischer; Jason G,40,0,60,20
1653302654968,COGS 108,A04,087922,Fleischer; Jason G,40,0,60,20
1653302654968,COGS 108,A05,087923,Fleischer; Jason G,48,0,60,12
1653302654968,COGS 108,A06,087924,Fleischer; Jason G,55,0,60,5
1653302654968,COGS 108,A07,087925,Fleischer; Jason G,42,0,57,15
1653302655496,COGS 110,A01,087927,Deak; Gedeon O.,30,0,35,5
1653302655496,COGS 110,A02,087928,Deak; Gedeon O.,33,0,35,2
1653302656024,COGS 116,A01,094228,Greene; Deanna Jacquelyn,51,0,52,1
1653302656024,COGS 116,A02,094229,Greene; Deanna Jacquelyn,52,0,52,0
1653302656024,COGS 116,A03,094230,Greene; Deanna Jacquelyn,50,0,52,2
1653302656549,COGS 118B,A01,087930,De Sa; Virginia,24,0,35,11
1653302656549,COGS 118B,A02,087931,De Sa; Virginia,28,0,35,7
1653302656549,COGS 118B,A03,087932,De Sa; Virginia,18,0,35,17
1653302656549,COGS 118B,A04,087933,De Sa; Virginia,29,0,35,6
1653302656549,COGS 118B,A05,087934,De Sa; Virginia,27,0,35,8
1653302656549,COGS 118B,A06,087935,De Sa; Virginia,27,0,35,8
1653302657077,COGS 120,A01,087937,Xia; Haijun,38,0,50,12
1653302657077,COGS 120,A02,087938,Xia; Haijun,32,0,50,18
1653302657077,COGS 120,A03,087939,Xia; Haijun,26,0,50,24
1653302657077,COGS 120,A04,087940,Xia; Haijun,1,0,50,49
1653302657604,COGS 128,A01,087944,Scott; Taylor Jackson,11,0,56,45
1653302658131,COGS 143,A01,087947,Johnson; Christine M.,23,0,40,17
1653302658654,COGS 153,A00,087949,Davis; Joshua Daniel,46,0,75,29
1653302659178,COGS 160,A00,087950,Deak; Gedeon O.,20,0,20,0
1653302659178,COGS 160,B00,094232,Saygin; Ayse P,40,0,40,0
1653302659705,COGS 175,A01,094238,Staff,27,0,40,13
1653302660232,COGS 187A,A01,087958,Kirsh; David Joel,22,0,50,28
1653302660232,COGS 187A,A02,087959,Kirsh; David Joel,30,0,50,20
1653302660232,COGS 187A,A03,087960,Kirsh; David Joel,34,0,45,11
1653302660755,COGS 190A,A00,087961,Staff,9999,0,9999,0
1653302661279,COGS 194,A00,087962,Hill; Seth J,9999,0,9999,0
1653302661814,COMM 10,A02,090628,Schmidt; Thomas Rainer,1,0,5,4
1653302661814,COMM 10,A03,090629,Schmidt; Thomas Rainer,3,0,5,2
1653302661814,COMM 10,A04,090630,Schmidt; Thomas Rainer,4,0,5,1
1653302661814,COMM 10,A05,090631,Schmidt; Thomas Rainer,4,0,5,1
1653302661814,COMM 10,A06,090632,Schmidt; Thomas Rainer,5,0,5,0
1653302661814,COMM 10,A07,090633,Schmidt; Thomas Rainer,5,0,5,0
1653302661814,COMM 10,A08,090634,Schmidt; Thomas Rainer,5,0,5,0
1653302661814,COMM 10,A09,090635,Schmidt; Thomas Rainer,5,0,5,0
1653302661814,COMM 10,A10,090636,Schmidt; Thomas Rainer,2,0,5,3
1653302661814,COMM 10,A11,090637,Schmidt; Thomas Rainer,4,0,5,1
1653302661814,COMM 10,A12,094013,Schmidt; Thomas Rainer,2,0,5,3
1653302661814,COMM 10,A13,094014,Schmidt; Thomas Rainer,5,0,5,0
1653302661814,COMM 10,A14,094015,Schmidt; Thomas Rainer,4,0,5,1
1653302661814,COMM 10,A15,094016,Schmidt; Thomas Rainer,5,0,5,0
1653302662347,COMM 100A,A01,090639,Irani; Lilly C,5,0,5,0
1653302662347,COMM 100A,A02,090640,Irani; Lilly C,4,0,5,1
1653302662347,COMM 100A,A03,090641,Irani; Lilly C,5,0,5,0
1653302662347,COMM 100A,A04,090642,Irani; Lilly C,3,0,5,2
1653302662347,COMM 100A,A05,090643,Irani; Lilly C,3,0,5,2
1653302662347,COMM 100A,A06,090644,Irani; Lilly C,4,0,5,1
1653302662347,COMM 100A,A07,090645,Irani; Lilly C,5,0,5,0
1653302662347,COMM 100A,A08,090646,Irani; Lilly C,5,0,5,0
1653302662347,COMM 100A,A09,090647,Irani; Lilly C,5,0,5,0
1653302662347,COMM 100A,A10,090648,Irani; Lilly C,5,0,5,0
1653302662347,COMM 100A,A11,090649,Irani; Lilly C,3,0,5,2
1653302662347,COMM 100A,A12,090650,Irani; Lilly C,5,0,5,0
1653302662873,COMM 101,A01,090652,Halm; Gavin Patrick,14,0,15,1
1653302662873,COMM 101,A02,090653,Halm; Gavin Patrick,14,0,15,1
1653302662873,COMM 101,A03,090654,Halm; Gavin Patrick,12,0,15,3
1653302662873,COMM 101,A04,090655,Halm; Gavin Patrick,13,0,15,2
1653302663398,COMM 101D,A00,090656,Halm; Gavin Patrick,14,0,15,1
1653302663922,COMM 101K,A00,090657,Ahn; Patricia Jeehyun,16,0,20,4
1653302664444,COMM 101T,A00,093701,Staff,20,0,20,0
1653302664969,COMM 102C,A01,090660,Staff,4,0,6,2
1653302664969,COMM 102C,A02,090661,Staff,6,0,6,0
1653302664969,COMM 102C,A03,090662,Staff,4,0,6,2
1653302665493,COMM 103D,A00,090663,Davis; Zeinabu I.,38,0,40,2
1653302666017,COMM 106E,A00,090667,Geiger; Richard Stuart,26,0,30,4
1653302666544,COMM 106G,A00,090668,Cordoba Azcarate; Matilde,25,0,30,5
1653302667067,COMM 108G,A00,090670,Walkover; Lillian B,30,0,30,0
1653302667596,COMM 109I,A00,090671,Tanaka; Stefan A.,30,0,30,0
1653302668124,COMM 109N,A00,094205,Hallin; Daniel C,25,0,30,5
1653302668655,COMM 110G,A00,090672,Whitworth-Smith; Andrew C,45,0,50,5
1653302669179,COMM 111P,A00,090673,Conner; Thomas Hartnell,27,0,30,3
1653302669704,COMM 111T,A00,090674,Iatarola; Briana Marie,27,0,30,3
1653302670227,COMM 124A,A00,090677,Sims; Christopher O,79,0,80,1
1653302670750,COMM 131,A00,090678,Fields; Gary,22,0,25,3
1653302671275,COMM 134,A00,090679,Kidman; Shawna F,16,0,25,9
1653302671804,COMM 146,A00,090680,Staff,22,0,25,3
1653302672329,COMM 166,A00,094493,Staff,24,0,25,1
1653302672860,COMM 172,A00,094066,Staff,23,0,25,2
1653302673385,COMM 182,A00,094063,Staff,25,0,25,0
1653302673917,COMM 190,A00,090686,Kidman; Shawna F,17,0,23,6
1653302673917,COMM 190,B00,090687,Irani; Lilly C,0,0,0,0
1653302673917,COMM 190,C00,090688,Keith; Kerry,21,0,23,2
1653302673917,COMM 190,D00,090689,Zilberg; Elana,23,0,23,0
1653302674441,COMM 194,A00,091600,Hill; Seth J,9999,0,9999,0
1653302674966,COMM 196A,A00,090690,Schmidt; Thomas Rainer,0,0,0,0
1653302675512,COMM 198,001,091397,Ahn; Patricia Jeehyun,9999,0,9999,0
1653302675512,COMM 198,002,091398,Alac; Morana,9999,0,9999,0
1653302675512,COMM 198,003,091399,Anderson; Patrick W.,9999,0,9999,0
1653302675512,COMM 198,004,091400,Boateng; Boatema,9999,0,9999,0
1653302675512,COMM 198,005,091401,Booker; Angela N,9999,0,9999,0
1653302675512,COMM 198,008,091402,Cordoba Azcarate; Matilde,9999,0,9999,0
1653302675512,COMM 198,009,091403,Davis; Zeinabu I.,9999,0,9999,0
1653302675512,COMM 198,010,091404,Dewaard; Andrew Michael,9999,0,9999,0
1653302675512,COMM 198,011,091405,Dominguez Rubio; Fernando,9999,0,9999,0
1653302675512,COMM 198,012,091406,Fattal; Alexander Leor,9999,0,9999,0
1653302675512,COMM 198,013,091407,Fields; Gary,9999,0,9999,0
1653302675512,COMM 198,014,091408,Gates; Kelly,9999,0,9999,0
1653302675512,COMM 198,015,091409,Goldfarb; Brian,9999,0,9999,0
1653302675512,COMM 198,018,091410,Hill; Erin Truesdell,9999,0,9999,0
1653302675512,COMM 198,019,091411,Horwitz; Robert B,9999,0,9999,0
1653302675512,COMM 198,021,091412,Irani; Lilly C,9999,0,9999,0
1653302675512,COMM 198,022,091413,Jack; Caroline Sarah,9999,0,9999,0
1653302675512,COMM 198,023,091414,Kidman; Shawna F,9999,0,9999,0
1653302675512,COMM 198,024,091415,Martinico; Daniel J,9999,0,9999,0
1653302675512,COMM 198,026,091416,Schmidt; Thomas Rainer,9999,0,9999,0
1653302675512,COMM 198,027,091417,Serlin; David,9999,0,9999,0
1653302675512,COMM 198,028,091418,Sims; Christopher O,9999,0,9999,0
1653302675512,COMM 198,029,091419,Tanaka; Stefan A.,9999,0,9999,0
1653302675512,COMM 198,030,091420,Zilberg; Elana,9999,0,9999,0
1653302675512,COMM 198,031,091421,Walkover; Lillian B,9999,0,9999,0
1653302675512,COMM 198,032,091422,Geiger; Richard Stuart,9999,0,9999,0
1653302676045,CSE 8A,A50,089985,Soosai Raj; Adalbert Geral,7,0,10,3
1653302676045,CSE 8A,A51,089986,Soosai Raj; Adalbert Geral,1,0,10,9
1653302676045,CSE 8A,A52,089987,Soosai Raj; Adalbert Geral,5,0,10,5
1653302676045,CSE 8A,A53,089988,Soosai Raj; Adalbert Geral,9,0,10,1
1653302676045,CSE 8A,B50,089990,Soosai Raj; Adalbert Geral,0,0,10,10
1653302676045,CSE 8A,B51,089991,Soosai Raj; Adalbert Geral,5,0,10,5
1653302676045,CSE 8A,B52,089992,Soosai Raj; Adalbert Geral,5,0,10,5
1653302676045,CSE 8A,B53,089993,Soosai Raj; Adalbert Geral,9,0,10,1
1653302676045,CSE 8A,C50,089995,Lerner; Sorin,0,0,10,10
1653302676045,CSE 8A,C51,089996,Lerner; Sorin,6,0,10,4
1653302676045,CSE 8A,C52,089997,Lerner; Sorin,9,0,10,1
1653302676045,CSE 8A,C53,089998,Lerner; Sorin,8,0,10,2
1653302676573,CSE 8B,A01,090000,Ochoa; Benjamin Lawrence,94,0,100,6
1653302677102,CSE 11,A01,090002,Cao; Yingjun,39,0,49,10
1653302677102,CSE 11,B01,090004,Cao; Yingjun,45,0,49,4
1653302677102,CSE 11,C01,090006,Cao; Yingjun,35,0,49,14
1653302677626,CSE 12,A01,090008,Staff,73,0,73,0
1653302677626,CSE 12,B01,090010,Staff,67,0,73,6
1653302677626,CSE 12,C01,090012,Staff,60,0,73,13
1653302678151,CSE 15L,A01,090014,Politz; Joseph Gibbs,4,0,10,6
1653302678151,CSE 15L,A02,090015,Politz; Joseph Gibbs,7,0,10,3
1653302678151,CSE 15L,A03,090016,Politz; Joseph Gibbs,9,0,10,1
1653302678151,CSE 15L,A04,090017,Politz; Joseph Gibbs,9,0,10,1
1653302678151,CSE 15L,A05,090018,Politz; Joseph Gibbs,9,0,10,1
1653302678151,CSE 15L,B01,090020,Politz; Joseph Gibbs,8,0,10,2
1653302678151,CSE 15L,B02,090021,Politz; Joseph Gibbs,6,0,10,4
1653302678151,CSE 15L,B03,090022,Politz; Joseph Gibbs,7,0,10,3
1653302678151,CSE 15L,B04,090023,Politz; Joseph Gibbs,7,0,10,3
1653302678151,CSE 15L,B05,090024,Politz; Joseph Gibbs,7,0,10,3
1653302678674,CSE 20,A01,090026,Staff,204,0,210,6
1653302679199,CSE 21,A01,090028,Impagliazzo; Russell,0,0,0,0
1653302679199,CSE 21,A02,094488,Impagliazzo; Russell,0,0,0,0
1653302679199,CSE 21,A03,094489,Impagliazzo; Russell,0,0,0,0
1653302679735,CSE 30,A01,092463,Muller; P Keith,73,0,100,27
1653302679735,CSE 30,A02,092464,Staff,97,0,100,3
1653302680259,CSE 87,A00,094193,Moshiri; Alexander Niema,20,0,20,0
1653302680783,CSE 95,A00,090030,Minnes Kemp; Mor Mia,35,0,35,0
1653302680783,CSE 95,B00,093883,Minnes Kemp; Mor Mia,35,0,35,0
1653302680783,CSE 95,C00,093885,Minnes Kemp; Mor Mia,35,0,35,0
1653302681307,CSE 100,A01,090033,Moshiri; Alexander Niema,68,0,114,46
1653302681832,CSE 100R,A01,093837,Moshiri; Alexander Niema,334,0,350,16
1653302682366,CSE 101,A01,090035,Saha; Barna,152,0,237,85
1653302682890,CSE 103,A01,090037,Freund; Yoav,60,0,75,15
1653302683414,CSE 105,A01,090039,Lovett; Shachar,201,0,225,24
1653302683938,CSE 106,A50,090042,Paturi; Ramamohan,11,0,30,19
1653302684463,CSE 107,A01,090044,Bellare; Mihir,94,0,120,26
1653302684992,CSE 110,A50,090047,Powell; Thomas Allan,39,0,50,11
1653302684992,CSE 110,A51,090048,Powell; Thomas Allan,39,0,50,11
1653302684992,CSE 110,A52,090049,Powell; Thomas Allan,48,0,50,2
1653302684992,CSE 110,A53,090050,Powell; Thomas Allan,49,0,50,1
1653302684992,CSE 110,A54,090051,Powell; Thomas Allan,45,0,50,5
1653302684992,CSE 110,A55,090052,Powell; Thomas Allan,50,0,50,0
1653302684992,CSE 110,A56,090053,Powell; Thomas Allan,49,0,50,1
1653302684992,CSE 110,A57,090054,Powell; Thomas Allan,41,0,45,4
1653302685515,CSE 118,A00,094897,Weibel; Nadir,0,0,0,0
1653302686043,CSE 120,A01,090056,Voelker; Geoffrey M.,226,0,300,74
1653302686655,CSE 124,A01,090058,Porter; George M,123,0,189,66
1653302687199,CSE 127,A01,090060,Savage; Stefan,46,0,189,143
1653302687723,CSE 130,A01,090062,Polikarpova; Nadezhda,171,0,189,18
1653302688250,CSE 132A,A01,090064,Deutsch; Alin Bernard,46,0,189,143
1653302688778,CSE 140,A01,090068,Eldon; John,169,0,196,27
1653302688778,CSE 140,B01,090070,Orailoglu; Alex,48,0,49,1
1653302689307,CSE 140L,A01,090072,Eldon; John,161,0,192,31
1653302689307,CSE 140L,B01,090075,Orailoglu; Alex,44,0,49,5
1653302689838,CSE 142,A01,090078,Porter; Leonard Emerson,86,0,146,60
1653302689838,CSE 142,B01,090080,Porter; Leonard Emerson,107,0,146,39
1653302690369,CSE 142L,A01,090082,Swanson; Steven James,48,0,146,98
1653302690369,CSE 142L,B01,090084,Swanson; Steven James,120,0,146,26
1653302690894,CSE 151B,A01,090088,Cottrell; Garrison W,258,0,328,70
1653302691419,CSE 152A,A01,090090,Chandraker; Manmohan Krishna,153,0,189,36
1653302691942,CSE 158,A01,090092,McAuley; Julian John,84,0,197,113
1653302692467,CSE 158R,A01,090094,McAuley; Julian John,306,0,353,47
1653302692992,CSE 167,A01,090096,Chern; Albert Ren-Haur,165,0,189,24
1653302693516,CSE 170,A01,090098,Vaccaro; Kristen Marie,20,0,20,0
1653302693516,CSE 170,A02,090099,Vaccaro; Kristen Marie,14,0,20,6
1653302693516,CSE 170,A03,090100,Vaccaro; Kristen Marie,14,0,20,6
1653302693516,CSE 170,A04,090101,Vaccaro; Kristen Marie,14,0,20,6
1653302693516,CSE 170,A05,090102,Vaccaro; Kristen Marie,18,0,20,2
1653302694044,CSE 190,A00,090103,Shalev; Aaron D,40,0,40,0
1653302694044,CSE 190,B00,090104,Vaccaro; Kristen Marie,100,0,100,0
1653302694044,CSE 190,C00,090105,Pannuto; Patrick William,25,0,25,0
1653302694570,CSE 191,A00,093848,Minnes Kemp; Mor Mia,9999,0,9999,0
1653302695098,CSE 193,A01,090107,Elsherif; May Elhussein,49,0,49,0
1653302695623,CSE 194,A01,090109,Munyaka; Imani N. S.,20,0,49,29
1653302696154,CSS 1,A01,086486,Staff,22,0,24,2
1653302696154,CSS 1,A02,086487,Staff,21,0,24,3
1653302696154,CSS 1,A03,086488,Staff,20,0,24,4
1653302696154,CSS 1,A04,086489,Staff,23,0,24,1
1653302696702,DOC 1,A01,086773,Solomon; Amanda Lee Albaniel,0,0,0,0
1653302696702,DOC 1,A02,086774,Solomon; Amanda Lee Albaniel,0,0,0,0
1653302696702,DOC 1,A03,086775,Solomon; Amanda Lee Albaniel,5,0,6,1
1653302696702,DOC 1,A04,086776,Solomon; Amanda Lee Albaniel,6,0,6,0
1653302696702,DOC 1,A05,086777,Solomon; Amanda Lee Albaniel,6,0,6,0
1653302696702,DOC 1,A06,086778,Solomon; Amanda Lee Albaniel,6,0,6,0
1653302696702,DOC 1,A07,086779,Solomon; Amanda Lee Albaniel,5,0,6,1
1653302696702,DOC 1,A08,086849,Solomon; Amanda Lee Albaniel,6,0,6,0
1653302696702,DOC 1,A09,086780,Solomon; Amanda Lee Albaniel,6,0,6,0
1653302696702,DOC 1,A10,086781,Solomon; Amanda Lee Albaniel,6,0,6,0
1653302696702,DOC 1,A11,086782,Solomon; Amanda Lee Albaniel,5,0,6,1
1653302696702,DOC 1,A12,086783,Solomon; Amanda Lee Albaniel,6,0,6,0
1653302696702,DOC 1,A13,086784,Solomon; Amanda Lee Albaniel,6,0,6,0
1653302696702,DOC 1,A14,086785,Solomon; Amanda Lee Albaniel,6,0,6,0
1653302696702,DOC 1,A15,086786,Solomon; Amanda Lee Albaniel,6,0,6,0
1653302696702,DOC 1,A16,086787,Solomon; Amanda Lee Albaniel,6,0,6,0
1653302696702,DOC 1,A17,086788,Solomon; Amanda Lee Albaniel,0,0,0,0
1653302696702,DOC 1,A18,086789,Solomon; Amanda Lee Albaniel,0,0,0,0
1653302696702,DOC 1,B01,086791,Solomon; Amanda Lee Albaniel,6,0,6,0
1653302696702,DOC 1,B02,086792,Solomon; Amanda Lee Albaniel,6,0,6,0
1653302696702,DOC 1,B03,086793,Solomon; Amanda Lee Albaniel,6,0,6,0
1653302696702,DOC 1,B04,086794,Solomon; Amanda Lee Albaniel,6,0,6,0
1653302696702,DOC 1,B05,086795,Solomon; Amanda Lee Albaniel,3,0,6,3
1653302696702,DOC 1,B06,086796,Solomon; Amanda Lee Albaniel,6,0,6,0
1653302696702,DOC 1,B07,086797,Solomon; Amanda Lee Albaniel,6,0,6,0
1653302696702,DOC 1,B08,086798,Solomon; Amanda Lee Albaniel,6,0,6,0
1653302696702,DOC 1,B09,086799,Solomon; Amanda Lee Albaniel,6,0,6,0
1653302696702,DOC 1,B10,086800,Solomon; Amanda Lee Albaniel,6,0,6,0
1653302696702,DOC 1,B11,086801,Solomon; Amanda Lee Albaniel,5,0,6,1
1653302696702,DOC 1,B12,086802,Solomon; Amanda Lee Albaniel,6,0,6,0
1653302696702,DOC 1,B13,086803,Solomon; Amanda Lee Albaniel,6,0,6,0
1653302696702,DOC 1,B14,086804,Solomon; Amanda Lee Albaniel,6,0,6,0
1653302696702,DOC 1,B15,086805,Solomon; Amanda Lee Albaniel,5,0,6,1
1653302696702,DOC 1,B16,086806,Solomon; Amanda Lee Albaniel,6,0,6,0
1653302696702,DOC 1,B17,086807,Solomon; Amanda Lee Albaniel,0,0,0,0
1653302696702,DOC 1,B18,086808,Solomon; Amanda Lee Albaniel,0,0,0,0
1653302696702,DOC 1,C01,086810,Strom; Megan C.,6,0,6,0
1653302696702,DOC 1,C02,086811,Strom; Megan C.,5,0,6,1
1653302696702,DOC 1,C03,086812,Strom; Megan C.,6,0,6,0
1653302696702,DOC 1,C04,086813,Strom; Megan C.,5,0,6,1
1653302696702,DOC 1,C05,086814,Strom; Megan C.,5,0,6,1
1653302696702,DOC 1,C06,086815,Strom; Megan C.,6,0,6,0
1653302696702,DOC 1,C07,086816,Strom; Megan C.,6,0,6,0
1653302696702,DOC 1,C08,086817,Strom; Megan C.,6,0,6,0
1653302696702,DOC 1,C09,086818,Strom; Megan C.,6,0,6,0
1653302696702,DOC 1,C10,086819,Strom; Megan C.,6,0,6,0
1653302696702,DOC 1,C11,086820,Strom; Megan C.,6,0,6,0
1653302696702,DOC 1,C12,086821,Strom; Megan C.,6,0,6,0
1653302696702,DOC 1,C13,086822,Strom; Megan C.,6,0,6,0
1653302696702,DOC 1,C14,086823,Strom; Megan C.,6,0,6,0
1653302696702,DOC 1,C15,086824,Strom; Megan C.,6,0,6,0
1653302696702,DOC 1,C16,086825,Strom; Megan C.,6,0,6,0
1653302696702,DOC 1,C17,086826,Strom; Megan C.,0,0,0,0
1653302696702,DOC 1,C18,086827,Strom; Megan C.,0,0,0,0
1653302696702,DOC 1,D01,086829,Strom; Megan C.,6,0,6,0
1653302696702,DOC 1,D02,086830,Strom; Megan C.,6,0,6,0
1653302696702,DOC 1,D03,086831,Strom; Megan C.,5,0,6,1
1653302696702,DOC 1,D04,086832,Strom; Megan C.,6,0,6,0
1653302696702,DOC 1,D05,086833,Strom; Megan C.,6,0,6,0
1653302696702,DOC 1,D06,086834,Strom; Megan C.,6,0,6,0
1653302696702,DOC 1,D07,086835,Strom; Megan C.,6,0,6,0
1653302696702,DOC 1,D08,086836,Strom; Megan C.,6,0,6,0
1653302696702,DOC 1,D09,086837,Strom; Megan C.,0,0,0,0
1653302696702,DOC 1,D10,086838,Strom; Megan C.,0,0,0,0
1653302696702,DOC 1,D11,086839,Strom; Megan C.,6,0,6,0
1653302696702,DOC 1,D12,086840,Strom; Megan C.,6,0,6,0
1653302696702,DOC 1,D13,086841,Strom; Megan C.,6,0,6,0
1653302696702,DOC 1,D14,086842,Strom; Megan C.,5,0,6,1
1653302696702,DOC 1,D15,086843,Strom; Megan C.,6,0,6,0
1653302696702,DOC 1,D16,086844,Strom; Megan C.,5,0,6,1
1653302697226,DOC 100D,A00,086845,Pass; Natalye Joann,0,0,0,0
1653302697226,DOC 100D,B00,086846,Pass; Natalye Joann,21,0,25,4
1653302697226,DOC 100D,C00,086847,Pass; Natalye Joann,23,0,25,2
1653302697754,DSC 10,A01,088092,Tiefenbruck; Janine LoBue,13,0,15,2
1653302697754,DSC 10,B01,088095,Tiefenbruck; Janine LoBue,9,0,15,6
1653302697754,DSC 10,C01,088098,Rampure; Suraj,0,0,15,15
1653302698282,DSC 20,A01,088101,Langlois; Marina,148,0,150,2
1653302698809,DSC 30,A01,088105,Langlois; Marina,74,0,75,1
1653302699333,DSC 40A,A01,088107,Rampure; Suraj,97,0,100,3
1653302699333,DSC 40A,B01,088109,Rampure; Suraj,99,0,100,1
1653302699858,DSC 40B,A01,088111,Eldridge; Justin Matthew,73,0,75,2
1653302699858,DSC 40B,B01,088113,Wang; Yusu,75,0,75,0
1653302700382,DSC 80,A01,088115,Eldridge; Justin Matthew,95,0,100,5
1653302700906,DSC 95,A01,088117,Langlois; Marina,20,0,20,0
1653302701438,DSC 96,A00,088118,Liao; Soohyun Nam,50,0,50,0
1653302701961,DSC 100,A01,088120,Salimi; Babak,164,0,175,11
1653302702493,DSC 102,A01,094320,Kumar; Arun Kumar,77,0,125,48
1653302703017,DSC 180A,A01,088124,Fraenkel; Aaron Mcmillan,0,0,0,0
1653302703017,DSC 180A,A02,088125,Fraenkel; Aaron Mcmillan,0,0,0,0
1653302703017,DSC 180A,A03,088126,Fraenkel; Aaron Mcmillan,0,0,0,0
1653302703017,DSC 180A,A04,088127,Fraenkel; Aaron Mcmillan,0,0,0,0
1653302703017,DSC 180A,A05,088128,Fraenkel; Aaron Mcmillan,0,0,0,0
1653302703017,DSC 180A,A06,088129,Fraenkel; Aaron Mcmillan,0,0,0,0
1653302703017,DSC 180A,A07,088130,Fraenkel; Aaron Mcmillan,0,0,0,0
1653302703017,DSC 180A,A08,088131,Fraenkel; Aaron Mcmillan,0,0,0,0
1653302703017,DSC 180A,A09,088132,Fraenkel; Aaron Mcmillan,0,0,0,0
1653302703017,DSC 180A,A10,088133,Fraenkel; Aaron Mcmillan,0,0,0,0
1653302703017,DSC 180A,A11,088134,Fraenkel; Aaron Mcmillan,0,0,0,0
1653302703017,DSC 180A,A12,088135,Fraenkel; Aaron Mcmillan,0,0,0,0
1653302703017,DSC 180A,A13,088136,Fraenkel; Aaron Mcmillan,0,0,0,0
1653302703017,DSC 180A,A14,088137,Fraenkel; Aaron Mcmillan,0,0,0,0
1653302703017,DSC 180A,A15,088138,Fraenkel; Aaron Mcmillan,0,0,0,0
1653302703017,DSC 180A,B01,088141,Fraenkel; Aaron Mcmillan,0,0,0,0
1653302703017,DSC 180A,B02,088142,Fraenkel; Aaron Mcmillan,0,0,0,0
1653302703017,DSC 180A,B03,088143,Fraenkel; Aaron Mcmillan,0,0,0,0
1653302703017,DSC 180A,B04,088144,Fraenkel; Aaron Mcmillan,0,0,0,0
1653302703017,DSC 180A,B05,088145,Fraenkel; Aaron Mcmillan,0,0,0,0
1653302703017,DSC 180A,B06,088146,Fraenkel; Aaron Mcmillan,0,0,0,0
1653302703017,DSC 180A,B07,088147,Fraenkel; Aaron Mcmillan,0,0,0,0
1653302703017,DSC 180A,B08,088148,Fraenkel; Aaron Mcmillan,0,0,0,0
1653302703017,DSC 180A,B09,088149,Fraenkel; Aaron Mcmillan,0,0,0,0
1653302703017,DSC 180A,B10,088150,Fraenkel; Aaron Mcmillan,0,0,0,0
1653302703017,DSC 180A,B11,088151,Fraenkel; Aaron Mcmillan,0,0,0,0
1653302703017,DSC 180A,B12,088152,Fraenkel; Aaron Mcmillan,0,0,0,0
1653302703017,DSC 180A,B13,088153,Fraenkel; Aaron Mcmillan,0,0,0,0
1653302703017,DSC 180A,B14,088154,Fraenkel; Aaron Mcmillan,0,0,0,0
1653302703017,DSC 180A,B15,088155,Fraenkel; Aaron Mcmillan,0,0,0,0
1653302703542,DSC 190,A01,088158,Mishne; Gal,48,0,50,2
1653302703542,DSC 190,B01,088160,Silberman; Jack,16,0,21,5
1653302704064,DSC 197,001,088161,Eldridge; Justin Matthew,9999,0,9999,0
1653302704590,DSGN 1,A01,087888,Meyer; Michael Wayne,49,0,53,4
1653302704590,DSGN 1,A02,087889,Meyer; Michael Wayne,47,0,53,6
1653302704590,DSGN 1,A03,087890,Meyer; Michael Wayne,43,0,53,10
1653302705117,DSGN 100,A01,087983,Dow; Steven P,39,0,40,1
1653302705117,DSGN 100,A02,087984,Dow; Steven P,40,0,40,0
1653302705117,DSGN 100,A03,087985,Dow; Steven P,34,0,40,6
1653302705644,DSGN 118,A01,087987,Xia; Haijun,55,0,60,5
1653302705644,DSGN 118,A02,087988,Xia; Haijun,56,0,60,4
1653302706167,DSGN 119,A00,087989,Staff,51,0,70,19
1653302706694,ECE 5,A01,090699,Morris; Karcher William,0,0,0,0
1653302706694,ECE 5,A02,090700,Morris; Karcher William,0,0,0,0
1653302706694,ECE 5,A03,090701,Morris; Karcher William,0,0,0,0
1653302706694,ECE 5,A04,090702,Morris; Karcher William,0,0,0,0
1653302706694,ECE 5,A05,090703,Morris; Karcher William,0,0,0,0
1653302706694,ECE 5,A06,090704,Morris; Karcher William,0,0,0,0
1653302707224,ECE 15,A01,090706,Schurgers; Curt,0,0,0,0
1653302707224,ECE 15,A02,090707,Schurgers; Curt,0,0,0,0
1653302707762,ECE 16,A01,090709,Khoshabeh; Ramsin,24,0,30,6
1653302708290,ECE 17,A01,090711,Gilja; Vikash,55,0,60,5
1653302708814,ECE 25,A50,090714,Liu; Zhaowei,0,0,0,0
1653302708814,ECE 25,A51,090715,Liu; Zhaowei,0,0,0,0
1653302708814,ECE 25,A52,090716,Liu; Zhaowei,0,0,0,0
1653302709344,ECE 30,A50,094300,Mir Arabbaygi; Siavash,25,0,30,5
1653302709344,ECE 30,A51,094301,Mir Arabbaygi; Siavash,29,0,30,1
1653302709344,ECE 30,A52,094302,Mir Arabbaygi; Siavash,27,0,30,3
1653302709344,ECE 30,A53,094303,Mir Arabbaygi; Siavash,29,0,30,1
1653302709344,ECE 30,A54,094304,Mir Arabbaygi; Siavash,25,0,25,0
1653302709876,ECE 35,A50,090720,Schurgers; Curt,0,0,0,0
1653302709876,ECE 35,A51,090721,Schurgers; Curt,0,0,0,0
1653302709876,ECE 35,A52,090722,Schurgers; Curt,0,0,0,0
1653302709876,ECE 35,A53,090723,Schurgers; Curt,0,0,0,0
1653302709876,ECE 35,A54,090724,Schurgers; Curt,0,0,0,0
1653302709876,ECE 35,A55,090725,Schurgers; Curt,0,0,0,0
1653302709876,ECE 35,B50,090729,Schurgers; Curt,0,0,0,0
1653302709876,ECE 35,B51,090730,Schurgers; Curt,0,0,0,0
1653302709876,ECE 35,B52,090731,Schurgers; Curt,0,0,0,0
1653302709876,ECE 35,B53,090732,Schurgers; Curt,0,0,0,0
1653302709876,ECE 35,B54,090733,Schurgers; Curt,0,0,0,0
1653302709876,ECE 35,B55,090734,Schurgers; Curt,0,0,0,0
1653302710400,ECE 45,A01,090736,Franceschetti; Massimo,56,0,57,1
1653302710400,ECE 45,A02,090737,Franceschetti; Massimo,50,0,58,8
1653302710925,ECE 65,A50,090741,Baghdadchi; Saharnaz,13,0,15,2
1653302710925,ECE 65,A51,090742,Baghdadchi; Saharnaz,5,0,10,5
1653302710925,ECE 65,A52,090743,Baghdadchi; Saharnaz,14,0,15,1
1653302710925,ECE 65,A53,090744,Baghdadchi; Saharnaz,8,0,10,2
1653302710925,ECE 65,A54,094865,Baghdadchi; Saharnaz,14,0,15,1
1653302710925,ECE 65,A55,094866,Baghdadchi; Saharnaz,9,0,10,1
1653302710925,ECE 65,A56,094867,Baghdadchi; Saharnaz,14,0,15,1
1653302710925,ECE 65,A57,094868,Baghdadchi; Saharnaz,15,0,15,0
1653302710925,ECE 65,A58,094869,Baghdadchi; Saharnaz,10,0,10,0
1653302711453,ECE 100,A01,090746,Baghdadchi; Saharnaz,16,0,20,4
1653302711453,ECE 100,A02,090747,Baghdadchi; Saharnaz,20,0,20,0
1653302711453,ECE 100,A03,090748,Baghdadchi; Saharnaz,18,0,20,2
1653302711453,ECE 100,A04,090749,Baghdadchi; Saharnaz,20,0,20,0
1653302711453,ECE 100,A05,090750,Baghdadchi; Saharnaz,18,0,20,2
1653302711453,ECE 100,A06,090751,Baghdadchi; Saharnaz,18,0,20,2
1653302711453,ECE 100,A07,090752,Baghdadchi; Saharnaz,20,0,20,0
1653302711982,ECE 101,A01,090754,Siegel; Paul H.,62,0,75,13
1653302711982,ECE 101,A02,090755,Siegel; Paul H.,71,0,75,4
1653302712507,ECE 102,A00,090756,Hsueh; Tzu-Chien,57,0,75,18
1653302713036,ECE 103,A01,090767,Lo; Yu-Hwa,45,0,50,5
1653302713560,ECE 107,A01,090769,Lomakin; Vitaliy,72,0,75,3
1653302714087,ECE 109,A01,090771,Zeger; Kenneth A.,176,0,180,4
1653302714614,ECE 111,A01,090774,Koushanfar; Farinaz,100,0,120,20
1653302715146,ECE 121A,A50,090777,Esmaili; Gholamreza,17,0,24,7
1653302715146,ECE 121A,A51,090778,Esmaili; Gholamreza,9,0,24,15
1653302715146,ECE 121A,A52,090779,Esmaili; Gholamreza,22,0,24,2
1653302715673,ECE 128A,A00,090780,Staff,40,0,70,30
1653302716198,ECE 135A,A00,090781,Kuzum; Duygu,30,0,30,0
1653302716727,ECE 143,A00,090782,Unpingco; Jose H.,0,0,0,2
1653302717251,ECE 148,A01,090784,Staff,32,0,32,0
1653302717776,ECE 155,A01,090786,Milstein; Laurence B.,16,0,20,4
1653302718298,ECE 158A,A01,090788,Franceschetti; Massimo,56,0,65,9
1653302718823,ECE 161A,A01,090790,Rao; Bhaskar D.,103,0,115,12
1653302719350,ECE 164,A00,090791,Hall; Drew A.,87,0,115,28
1653302719876,ECE 166,A50,090796,Rebeiz; Gabriel,6,0,12,6
1653302719876,ECE 166,A51,090797,Rebeiz; Gabriel,9,0,12,3
1653302719876,ECE 166,A52,090799,Rebeiz; Gabriel,1,0,12,11
1653302719876,ECE 166,A53,090800,Rebeiz; Gabriel,6,0,12,6
1653302719876,ECE 166,A54,094335,Rebeiz; Gabriel,11,0,12,1
1653302719876,ECE 166,A55,094336,Rebeiz; Gabriel,12,0,12,0
1653302719876,ECE 166,A56,094349,Rebeiz; Gabriel,13,0,15,2
1653302719876,ECE 166,A57,094350,Rebeiz; Gabriel,14,0,15,1
1653302720400,ECE 171A,A01,090802,Atanasov; Nikolay A.,45,0,60,15
1653302720923,ECE 171B,A01,090804,Shi; Yuanyuan,44,0,50,6
1653302721450,ECE 174,A01,090806,Pal; Piya,125,0,146,21
1653302721975,ECE 182,A01,090808,Lomakin; Vitaliy,23,0,23,0
1653302722499,ECE 187,A00,090809,Liu; Zhaowei,19,0,20,1
1653302723027,ECE 196,A00,090812,Morris; Karcher William,19,0,24,5
1653302723027,ECE 196,B00,094833,Morris; Karcher William,24,0,24,0
1653302723551,ECE 197,001,090813,Sievenpiper; Daniel F.,9999,0,9999,0
1653302724080,ECON 1,A01,092535,Staff,0,0,0,0
1653302724080,ECON 1,A02,092536,Staff,0,0,0,0
1653302724080,ECON 1,A03,092537,Staff,0,0,0,0
1653302724080,ECON 1,A04,092538,Staff,0,0,0,0
1653302724080,ECON 1,A05,092539,Staff,0,0,0,0
1653302724080,ECON 1,B01,092540,Ma; Alyson Chan,42,0,45,3
1653302724080,ECON 1,B02,092541,Ma; Alyson Chan,45,0,45,0
1653302724080,ECON 1,B03,092542,Ma; Alyson Chan,45,0,45,0
1653302724080,ECON 1,B04,092543,Ma; Alyson Chan,40,0,40,0
1653302724080,ECON 1,B05,092544,Ma; Alyson Chan,40,0,40,0
1653302724080,ECON 1,C01,092545,Tocoian; Oana,0,0,0,0
1653302724080,ECON 1,C02,092546,Tocoian; Oana,0,0,0,0
1653302724080,ECON 1,C03,092547,Tocoian; Oana,0,0,0,0
1653302724080,ECON 1,C04,092548,Tocoian; Oana,0,0,0,0
1653302724080,ECON 1,D01,094253,Levkoff; Steven B.,41,0,45,4
1653302724080,ECON 1,D02,094254,Levkoff; Steven B.,44,0,45,1
1653302724080,ECON 1,D03,094255,Levkoff; Steven B.,45,0,45,0
1653302724080,ECON 1,D04,094256,Levkoff; Steven B.,36,0,40,4
1653302724080,ECON 1,D05,094257,Levkoff; Steven B.,40,0,40,0
1653302724608,ECON 2,A01,092549,Staff,0,0,0,0
1653302724608,ECON 2,A02,092550,Staff,0,0,0,0
1653302724608,ECON 2,A03,092551,Staff,0,0,0,0
1653302725133,ECON 4,A01,092554,Levkoff; Steven B.,29,0,30,1
1653302725133,ECON 4,A02,092555,Levkoff; Steven B.,27,0,30,3
1653302725133,ECON 4,A03,092556,Levkoff; Steven B.,30,0,30,0
1653302725658,ECON 100A,A01,092557,Newhouse; Herbert S,23,0,30,7
1653302725658,ECON 100A,A02,092558,Newhouse; Herbert S,28,0,30,2
1653302725658,ECON 100A,A03,092559,Newhouse; Herbert S,29,0,30,1
1653302725658,ECON 100A,A04,092560,Newhouse; Herbert S,35,0,35,0
1653302725658,ECON 100A,B01,092561,Newhouse; Herbert S,20,0,30,10
1653302725658,ECON 100A,B02,092562,Newhouse; Herbert S,28,0,30,2
1653302725658,ECON 100A,B03,092563,Newhouse; Herbert S,15,0,30,15
1653302725658,ECON 100A,B04,092564,Newhouse; Herbert S,35,0,35,0
1653302726186,ECON 100B,A01,092565,Galperti; Simone,27,0,30,3
1653302726186,ECON 100B,A02,092566,Galperti; Simone,18,0,20,2
1653302726186,ECON 100B,A03,094496,Staff,27,0,30,3
1653302726186,ECON 100B,A04,094497,Staff,16,0,20,4
1653302726186,ECON 100B,B01,092567,Galperti; Simone,16,0,25,9
1653302726710,ECON 100C,A01,092569,Du; Songzi,62,0,75,13
1653302726710,ECON 100C,B01,092570,Du; Songzi,70,0,75,5
1653302726710,ECON 100C,B02,094258,Du; Songzi,75,0,75,0
1653302727236,ECON 100CH,A00,088284,Andreoni; James,20,0,20,0
1653302727766,ECON 109,A01,092572,Watson; Joel Christopher,68,0,75,7
1653302727766,ECON 109,B01,092573,Watson; Joel Christopher,68,0,75,7
1653302728294,ECON 110A,A01,092574,Alon; Titan Michael,12,0,25,13
1653302728294,ECON 110A,A02,092575,Alon; Titan Michael,24,0,25,1
1653302728294,ECON 110A,B01,092576,Alon; Titan Michael,24,0,25,1
1653302728294,ECON 110A,B02,092577,Alon; Titan Michael,25,0,25,0
1653302728825,ECON 110B,A01,092578,Trottner; Fabian Gunter We,16,0,25,9
1653302728825,ECON 110B,A02,094054,Trottner; Fabian Gunter We,23,0,25,2
1653302728825,ECON 110B,B01,092579,Trottner; Fabian Gunter We,7,0,25,18
1653302728825,ECON 110B,B02,094055,Trottner; Fabian Gunter We,24,0,25,1
1653302729350,ECON 116,A00,088291,Lowes; Sara Rachel,58,0,70,12
1653302729876,ECON 120A,A01,092580,Elliott; Graham,18,0,25,7
1653302729876,ECON 120A,A02,092581,Elliott; Graham,22,0,25,3
1653302729876,ECON 120A,B01,092582,Elliott; Graham,18,0,25,7
1653302729876,ECON 120A,B02,092583,Elliott; Graham,20,0,25,5
1653302729876,ECON 120A,C01,092584,Tocoian; Oana,27,0,30,3
1653302729876,ECON 120A,C02,092585,Tocoian; Oana,28,0,30,2
1653302729876,ECON 120A,C03,092586,Tocoian; Oana,40,0,40,0
1653302730404,ECON 120B,A01,092587,Candido; Maria Teresa,58,0,70,12
1653302730404,ECON 120B,A02,092588,Candido; Maria Teresa,51,0,60,9
1653302730404,ECON 120B,A03,092589,Candido; Maria Teresa,56,0,60,4
1653302730927,ECON 120C,A01,092590,Candido; Maria Teresa,48,0,60,12
1653302730927,ECON 120C,A02,092591,Candido; Maria Teresa,59,0,60,1
1653302730927,ECON 120C,A03,094310,Candido; Maria Teresa,73,0,75,2
1653302731455,ECON 121,A00,088298,Vogl; Tom Saul,36,0,50,14
1653302731981,ECON 130,A00,088299,Staff,59,0,75,16
1653302732506,ECON 131,A00,088300,Jacobsen; Mark,129,0,150,21
1653302732506,ECON 131,B00,088301,Jacobsen; Mark,15,0,30,15
1653302733032,ECON 152,A00,088302,Fadlon; Yizhak,34,0,50,16
1653302733032,ECON 152,B00,088303,Fadlon; Yizhak,49,0,50,1
1653302733558,ECON 168,A00,088304,Staff,54,0,60,6
1653302734081,ECON 191B,A00,088312,Galperti; Simone,20,0,20,0
1653302734605,EDS 25,A01,087581,Staff,9,0,10,1
1653302734605,EDS 25,A02,087582,Staff,10,0,10,0
1653302734605,EDS 25,A03,087583,Staff,7,0,10,3
1653302734605,EDS 25,A04,087584,Staff,10,0,10,0
1653302735133,EDS 31,A00,087585,Bussey; Thomas J,9,0,10,1
1653302735661,EDS 110R,A01,087597,Cohen; Shana R,43,0,50,7
1653302735661,EDS 110R,B01,093579,Cohen; Shana R,10,0,10,0
1653302736187,EDS 113,A00,087598,Staff,45,0,50,5
1653302736711,EDS 114,A01,088091,Eguchi; Emi,17,0,20,3
1653302736711,EDS 114,A02,087600,Eguchi; Emi,19,0,20,1
1653302737236,EDS 117,A01,087603,Chung; Luz Marina,25,0,35,10
1653302737236,EDS 117,A02,087604,Chung; Luz Marina,34,0,35,1
1653302737771,EDS 124AR,A01,087606,Simon; Elizabeth A,0,0,19,19
1653302737771,EDS 124AR,A02,087607,Simon; Elizabeth A,13,0,19,6
1653302737771,EDS 124AR,A03,087608,Simon; Elizabeth A,15,0,19,4
1653302737771,EDS 124AR,A04,087609,Simon; Elizabeth A,4,0,19,15
1653302737771,EDS 124AR,B01,087611,Simon; Elizabeth A,14,0,19,5
1653302737771,EDS 124AR,B02,087612,Simon; Elizabeth A,18,0,19,1
1653302737771,EDS 124AR,B03,087613,Simon; Elizabeth A,18,0,19,1
1653302737771,EDS 124AR,B04,087614,Simon; Elizabeth A,19,0,19,0
1653302737771,EDS 124AR,C01,094210,Simon; Elizabeth A,6,0,6,0
1653302737771,EDS 124AR,C02,094211,Simon; Elizabeth A,6,0,6,0
1653302737771,EDS 124AR,C03,094212,Simon; Elizabeth A,6,0,6,0
1653302737771,EDS 124AR,C04,094213,Simon; Elizabeth A,6,0,6,0
1653302737771,EDS 124AR,D01,094215,Simon; Elizabeth A,6,0,6,0
1653302737771,EDS 124AR,D02,094216,Simon; Elizabeth A,6,0,6,0
1653302737771,EDS 124AR,D03,094217,Simon; Elizabeth A,6,0,6,0
1653302737771,EDS 124AR,D04,094218,Simon; Elizabeth A,6,0,6,0
1653302738298,EDS 124BR,A00,087615,Eguchi; Emi,65,0,75,10
1653302738298,EDS 124BR,B00,093580,Eguchi; Emi,25,0,25,0
1653302738825,EDS 125,A00,087616,Jones; Gabrielle Anastasia,51,0,60,9
1653302739353,EDS 129A,A01,087618,Heinzman; Erica M.,43,0,50,7
1653302739955,EDS 130,A01,087620,Holtzman; Caren Lynn,17,0,20,3
1653302739955,EDS 130,A02,087621,Holtzman; Caren Lynn,20,0,20,0
1653302739955,EDS 130,A03,087622,Holtzman; Caren Lynn,20,0,20,0
1653302740480,EDS 131,A01,087624,Wishard Guerra; Alison G.,37,0,40,3
1653302741005,EDS 133,A01,087627,Bintliff; Amy S.V.,17,0,20,3
1653302741005,EDS 133,A02,087628,Bintliff; Amy S.V.,19,0,20,1
1653302741532,EDS 139,A00,087629,Holtzman; Caren Lynn,55,0,60,5
1653302741532,EDS 139,B00,087630,Heinzman; Erica M.,51,0,60,9
1653302741532,EDS 139,C00,087631,Bintliff; Amy S.V.,57,0,60,3
1653302741532,EDS 139,D00,087632,Wishard Guerra; Alison G.,58,0,60,2
1653302741532,EDS 139,E00,087633,Holtzman; Caren Lynn,30,0,30,0
1653302741532,EDS 139,F00,094886,Staff,25,0,25,0
1653302742056,EDS 146,A01,094220,Staff,25,0,25,0
1653302742580,EDS 164R,A01,087644,Wishard Guerra; Alison G.,37,0,40,3
1653302742580,EDS 164R,B01,093582,Wishard Guerra; Alison G.,20,0,20,0
1653302743107,EDS 190,A00,087645,Bresser; Bernard George,20,0,20,0
1653302743107,EDS 190,B00,087646,Pappas; Elizabeth,20,0,20,0
1653302743107,EDS 190,C00,087647,Scharton; Susan Michelle,20,0,20,0
1653302743107,EDS 190,E00,087648,Staff,20,0,20,0
1653302743637,ENG 10,A00,086288,Staff,30,0,30,0
1653302743637,ENG 10,B00,086289,Staff,30,0,30,0
1653302744167,ENG 15,A01,086291,Staff,35,0,35,0
1653302744696,ENG 20,A00,086292,Evdokimenko; Ekaterina,33,0,35,2
1653302745236,ENG 100D,A00,086293,Ngo; Anh-Thu T.,45,0,50,5
1653302745236,ENG 100D,B00,094309,Staff,46,0,50,4
1653302745766,ENG 100L,A00,086295,Kleissl; Jan,6,0,6,0
1653302745766,ENG 100L,B00,086296,Bratton; Maryann,8,0,8,0
1653302745766,ENG 100L,C00,086297,Nguyen; Truong Quang,10,0,10,0
1653302745766,ENG 100L,E00,086299,de Oliveira; Mauricio,8,0,8,0
1653302745766,ENG 100L,F00,086300,Goldberg; Charles G.,6,0,6,0
1653302745766,ENG 100L,G00,086301,Bratton; Maryann,6,0,6,0
1653302745766,ENG 100L,H00,086302,Staff,6,0,6,0
1653302746300,ENVR 30,A01,093565,Staff,29,0,30,1
1653302746300,ENVR 30,A02,093567,Staff,28,0,30,2
1653302746300,ENVR 30,A03,093568,Staff,25,0,30,5
1653302746300,ENVR 30,A04,093569,Staff,30,0,30,0
1653302746300,ENVR 30,A05,093570,Staff,29,0,30,1
1653302746300,ENVR 30,A06,093566,Staff,29,0,30,1
1653302746823,ENVR 102,A00,093571,Daly; Heather Marie,25,0,30,5
1653302747892,ERC 1,A01,092328,Herbst; Matthew,20,0,20,0
1653302747892,ERC 1,A02,092330,Herbst; Matthew,20,0,20,0
1653302747892,ERC 1,A03,092331,Herbst; Matthew,20,0,20,0
1653302747892,ERC 1,A04,092332,Herbst; Matthew,20,0,20,0
1653302747892,ERC 1,A05,092333,Herbst; Matthew,20,0,20,0
1653302747892,ERC 1,A06,092334,Herbst; Matthew,20,0,20,0
1653302748420,ERC 2,A01,092336,Rahimi; Babak,20,0,20,0
1653302748420,ERC 2,A02,092337,Rahimi; Babak,20,0,20,0
1653302748420,ERC 2,A03,092338,Rahimi; Babak,20,0,20,0
1653302748420,ERC 2,A04,092339,Rahimi; Babak,20,0,20,0
1653302748945,ERC 20,A00,092340,Evans; Ivan T,30,0,30,0
1653302748945,ERC 20,B00,092341,Evans; Ivan T,30,0,30,0
1653302749467,ERC 87,A00,093850,Herbst; Matthew,20,0,20,0
1653302749992,ERC 92,A00,092342,Staff,1,0,1,0
1653302749992,ERC 92,B00,092343,Staff,1,0,1,0
1653302749992,ERC 92,C00,092344,Staff,1,0,1,0
1653302749992,ERC 92,D00,092345,Staff,1,0,1,0
1653302749992,ERC 92,E00,092346,Staff,1,0,1,0
1653302749992,ERC 92,F00,092347,Staff,1,0,1,0
1653302750520,ESYS 90,A00,086303,Teranes; Jane,12,0,12,0
1653302751051,ESYS 101,A01,086305,Taylor; Jennifer Rebecca & Diaz; Julia Michelle,25,0,27,2
1653302751051,ESYS 101,A02,086306,Taylor; Jennifer Rebecca & Diaz; Julia Michelle,15,0,27,12
1653302751051,ESYS 101,A03,086307,Taylor; Jennifer Rebecca & Diaz; Julia Michelle,21,0,27,6
1653302751051,ESYS 101,A04,086308,Taylor; Jennifer Rebecca & Diaz; Julia Michelle,27,0,27,0
1653302751578,ESYS 187A,A01,086310,Teranes; Jane,38,0,40,2
1653302751578,ESYS 187A,B01,086312,Teranes; Jane,30,0,40,10
1653302752103,ETHN 1,A01,086314,Frank; Ross H.,15,0,15,0
1653302752103,ETHN 1,A02,086315,Frank; Ross H.,15,0,15,0
1653302752103,ETHN 1,A03,086316,Frank; Ross H.,14,0,15,1
1653302752103,ETHN 1,A04,086317,Frank; Ross H.,15,0,15,0
1653302752103,ETHN 1,A05,086318,Frank; Ross H.,15,0,15,0
1653302752103,ETHN 1,A06,086319,Frank; Ross H.,13,0,15,2
1653302752103,ETHN 1,A07,086320,Frank; Ross H.,15,0,15,0
1653302752103,ETHN 1,A08,086321,Frank; Ross H.,14,0,15,1
1653302752103,ETHN 1,A09,086322,Frank; Ross H.,15,0,15,0
1653302752103,ETHN 1,A10,086323,Frank; Ross H.,15,0,15,0
1653302752103,ETHN 1,A11,086324,Frank; Ross H.,15,0,15,0
1653302752103,ETHN 1,A12,086325,Frank; Ross H.,15,0,15,0
1653302752103,ETHN 1,A13,086326,Frank; Ross H.,15,0,15,0
1653302752103,ETHN 1,A14,086327,Frank; Ross H.,15,0,15,0
1653302752103,ETHN 1,A15,086328,Frank; Ross H.,15,0,15,0
1653302752103,ETHN 1,A16,086329,Frank; Ross H.,15,0,15,0
1653302752632,ETHN 100A,A00,086330,Patel; Shaista,41,0,48,7
1653302753160,ETHN 103,A00,086331,Perreira; Christopher Michael,63,0,70,7
1653302753685,ETHN 104,A00,086332,Staff,0,0,0,0
1653302754212,ETHN 106,A00,086333,Staff,0,0,0,0
1653302754741,ETHN 121,A00,086341,Sasaki; Christen T,20,0,28,8
1653302755268,ETHN 139,A00,086342,Ruiz; Ariana,16,0,20,4
1653302755797,ETHN 144M,A00,086343,Jolivette; Andrew J,66,0,70,4
1653302756326,ETHN 159,A00,088427,Graham; Jessica Lynn,0,0,0,0
1653302756855,ETHN 163E,A00,086344,Patel; Shaista,37,0,40,3
1653302757378,ETHN 178R,A00,090798,Borgo; David Garcia,15,0,20,5
1653302757903,ETHN 187,A00,086345,Perez; Roy,14,0,16,2
1653302758426,EXPR 100,A00,085686,Staff,9999,0,9999,0
1653302758958,FMPH 40,A00,086370,Emory; Kristen,70,0,75,5
1653302758958,FMPH 40,B00,086371,Romero; Sally Ann Dominick,71,0,75,4
1653302759486,FMPH 101,A00,086372,Brouwer; Kimberly,43,0,55,12
1653302760014,FMPH 102,A50,094498,Rana; Brinda Kanti,42,0,55,13
1653302760548,FMPH 110,A00,086374,Zoumas-Morse; Christine E.,61,0,65,4
1653302761079,FMPH 120,A00,086375,Nguyen-Grozavu; France T.,45,0,65,20
1653302761079,FMPH 120,B00,086376,Nguyen-Grozavu; France T.,60,0,65,5
1653302761603,FMPH 130,A00,086377,Staff,48,0,65,17
1653302762651,FMPH 161,A00,086379,Zoumas-Morse; Christine E.,58,0,65,7
1653302763232,FMPH 191,A00,086380,Harrell; Maralee Mae,58,0,60,2
1653302763757,FMPH 196A,A00,086381,Binkin; Nancy Jeanne,0,0,0,0
1653302764281,GLBH 20,A00,086407,Walkover; Lillian B,85,0,90,5
1653302764813,GLBH 100,A00,086408,Staff,55,0,56,1
1653302764813,GLBH 100,B00,086409,Wu; Hua,52,0,56,4
1653302764813,GLBH 100,D00,086411,Staff,38,0,40,2
1653302765336,GLBH 103,A00,086412,Hannah; Seth Donal,48,0,50,2
1653302765861,GLBH 105,A00,086413,Olivas Hernandez; Olga Lid,36,0,38,2
1653302766384,GLBH 106,A00,086414,Kayser; Georgia Lyn,40,0,40,0
1653302766908,GLBH 111,A01,094330,Burgos; Jose L.,0,0,0,0
1653302766908,GLBH 111,B01,094332,Burgos; Jose L.,0,0,0,0
1653302767435,GLBH 148,A00,086415,Staff,69,0,73,4
1653302767960,GLBH 181,A00,086417,Burgos; Jose L.,144,0,146,2
1653302768485,GSS 20,A00,094269,Staff,73,0,75,2
1653302769010,HDS 1,A01,086423,Staff,24,0,25,1
1653302769010,HDS 1,A02,086424,Staff,24,0,25,1
1653302769010,HDS 1,A03,086425,Staff,23,0,25,2
1653302769010,HDS 1,A04,086426,Staff,25,0,25,0
1653302769010,HDS 1,A05,086427,Staff,24,0,25,1
1653302769010,HDS 1,A06,086428,Staff,25,0,25,0
1653302769010,HDS 1,A07,086429,Staff,30,0,30,0
1653302769534,HDS 60,A01,086431,Staff,23,0,25,2
1653302770072,HDS 111,A00,086432,Staff,73,0,80,7
1653302770596,HDS 121,A01,086434,Deak; Gedeon O.,11,0,15,4
1653302770596,HDS 121,A02,086435,Deak; Gedeon O.,13,0,15,2
1653302771122,HDS 150,A00,086436,Staff,25,0,25,0
1653302771122,HDS 150,B00,086437,Staff,25,0,25,0
1653302771645,HDS 173,A00,086439,Staff,27,0,30,3
1653302772168,HDS 181,A01,086441,Staff,30,0,30,0
1653302772696,HDS 191,A01,086443,Staff,25,0,25,0
1653302773224,HIEA 129,A00,088057,Schneewind; Sarah,0,0,0,0
1653302773764,HIEA 137,A00,088058,Lu; Weijing,53,0,55,2
1653302774290,HIEA 144,A00,088059,Henry; Todd A.,43,0,45,2
1653302774814,HIEA 171,A00,088060,Lu; Weijing,15,0,15,0
1653302775341,HIEU 102,A00,088061,Watts; Edward J.,0,0,0,0
1653302775869,HIEU 107,A00,088062,Caciola; Nancy A,0,0,0,0
1653302776400,HIEU 108,A00,088063,Balberg; Mira,53,0,60,7
1653302776928,HIEU 128,A00,088064,Neuheiser; Joerg,0,0,0,0
1653302777462,HIEU 144,A00,094327,Staff,48,0,50,2
1653302777987,HIEU 149,A00,088065,Devereux; Andrew W,38,0,45,7
1653302778517,HIEU 154,A00,088066,Biess; Frank Peter,58,0,65,7
1653302779045,HIGL 114,A00,088067,Edington; Claire Ellen,53,0,55,2
1653302779573,HILA 119,A00,088068,Vitz; Matthew,49,0,51,2
1653302780101,HILA 122,A00,088069,Widener; Daniel,61,0,65,4
1653302780628,HILD 2A,A01,088024,Hanna; Mark G.,28,0,28,0
1653302780628,HILD 2A,A02,088025,Hanna; Mark G.,25,0,25,0
1653302780628,HILD 2A,A03,088026,Hanna; Mark G.,27,0,28,1
1653302780628,HILD 2A,A04,088027,Hanna; Mark G.,28,0,28,0
1653302780628,HILD 2A,A05,088028,Hanna; Mark G.,28,0,28,0
1653302780628,HILD 2A,A06,088029,Hanna; Mark G.,28,0,28,0
1653302781152,HILD 7A,A01,088031,Graham; Jessica Lynn,28,0,28,0
1653302781152,HILD 7A,A02,088032,Graham; Jessica Lynn,27,0,28,1
1653302781152,HILD 7A,A03,088033,Graham; Jessica Lynn,27,0,28,1
1653302781152,HILD 7A,A04,088034,Graham; Jessica Lynn,26,0,28,2
1653302781152,HILD 7A,A05,088035,Graham; Jessica Lynn,26,0,28,2
1653302781152,HILD 7A,A06,088037,Graham; Jessica Lynn,22,0,28,6
1653302781152,HILD 7A,A07,088038,Graham; Jessica Lynn,28,0,28,0
1653302781152,HILD 7A,A08,088039,Graham; Jessica Lynn,28,0,28,0
1653302781152,HILD 7A,A09,088040,Graham; Jessica Lynn,27,0,28,1
1653302781152,HILD 7A,A10,088041,Graham; Jessica Lynn,28,0,28,0
1653302781152,HILD 7A,A11,088042,Graham; Jessica Lynn,28,0,28,0
1653302781152,HILD 7A,A12,088043,Graham; Jessica Lynn,28,0,28,0
1653302781677,HILD 10,A01,088045,Muscolino; Micah S,27,0,28,1
1653302781677,HILD 10,A02,088046,Muscolino; Micah S,27,0,28,1
1653302781677,HILD 10,A03,088047,Muscolino; Micah S,28,0,28,0
1653302781677,HILD 10,A04,088048,Muscolino; Micah S,27,0,28,1
1653302781677,HILD 10,A05,088049,Muscolino; Micah S,28,0,28,0
1653302781677,HILD 10,A06,088050,Muscolino; Micah S,27,0,28,1
1653302782200,HILD 30,A01,088052,Edington; Claire Ellen,24,0,28,4
1653302782200,HILD 30,A02,088053,Edington; Claire Ellen,28,0,28,0
1653302782727,HILD 41,A01,088055,Devereux; Andrew W,28,0,28,0
1653302782727,HILD 41,A02,088056,Devereux; Andrew W,28,0,28,0
1653302783254,HINE 116,A00,088070,Kayali; Hasan,47,0,50,3
1653302783798,HINE 144,A00,088071,Provence; Michael,40,0,45,5
1653302784321,HISC 106,A00,088072,Pineda De Avila; Nydia,47,0,50,3
1653302784850,HISC 115,A00,088073,Gere; Catherina M.,103,0,110,7
1653302785382,HITO 87,A00,094352,Patterson; Patrick H.,20,0,20,0
1653302785382,HITO 87,C00,094354,Patterson; Patrick H.,20,0,20,0
1653302785382,HITO 87,B00,094353,Hanna; Mark G.,20,0,20,0
1653302785910,HITO 100,A00,088074,Hanna; Mark G.,8,0,12,4
1653302786433,HITO 193,A00,091603,Hill; Seth J,9999,0,9999,0
1653302786957,HITO 196,A00,088075,Hendrickson; Gerald M.,20,0,20,0
1653302787481,HIUS 108B,A00,088076,Klann; Mary Cameron,48,0,51,3
1653302788004,HIUS 112,A00,088077,Plant; Rebecca Jo,144,0,148,4
1653302788532,HIUS 152A,A00,088078,Vandevelde; Kenneth Joseph,40,0,45,5
1653302789062,HIUS 155,A00,088079,Alvarez; Luis A,37,0,45,8
1653302789591,HIUS 183,A00,088080,Graham; Jessica Lynn,19,0,20,1
1653302790122,HUM 3,A01,087224,West; Geoffrey Scott,27,0,28,1
1653302790122,HUM 3,A02,087225,West; Geoffrey Scott,28,0,28,0
1653302790122,HUM 3,A03,087226,West; Geoffrey Scott,26,0,28,2
1653302790122,HUM 3,A04,087227,West; Geoffrey Scott,27,0,28,1
1653302790122,HUM 3,A05,087228,West; Geoffrey Scott,27,0,28,1
1653302790122,HUM 3,A06,087229,West; Geoffrey Scott,24,0,28,4
1653302790122,HUM 3,A07,087230,West; Geoffrey Scott,27,0,28,1
1653302790122,HUM 3,A08,087231,West; Geoffrey Scott,28,0,28,0
1653302790122,HUM 3,B01,087233,Staff,28,0,28,0
1653302790122,HUM 3,B02,087234,Staff,28,0,28,0
1653302790122,HUM 3,B03,087235,Staff,28,0,28,0
1653302790122,HUM 3,B04,087236,Staff,28,0,28,0
1653302790122,HUM 3,B05,087237,Staff,28,0,28,0
1653302790122,HUM 3,B06,087238,Staff,28,0,28,0
1653302790122,HUM 3,B07,087239,Staff,0,0,0,0
1653302790122,HUM 3,B08,087240,Staff,0,0,0,0
1653302790122,HUM 3,B09,087241,Staff,30,0,30,0
1653302790122,HUM 3,B10,087242,Staff,28,0,30,2
1653302790122,HUM 3,C01,087244,Patterson; Patrick H.,0,0,0,0
1653302790122,HUM 3,C02,087245,Patterson; Patrick H.,0,0,0,0
1653302790122,HUM 3,C03,087246,Patterson; Patrick H.,23,0,28,5
1653302790122,HUM 3,C04,087247,Patterson; Patrick H.,28,0,28,0
1653302790122,HUM 3,C05,087248,Patterson; Patrick H.,27,0,28,1
1653302790122,HUM 3,C06,087249,Patterson; Patrick H.,25,0,28,3
1653302790122,HUM 3,C07,087250,Patterson; Patrick H.,27,0,28,1
1653302790122,HUM 3,C08,087251,Patterson; Patrick H.,28,0,28,0
1653302790122,HUM 3,C09,087252,Patterson; Patrick H.,28,0,28,0
1653302790122,HUM 3,C10,087253,Patterson; Patrick H.,27,0,28,1
1653302790122,HUM 3,D01,087255,Lyon; Antony J.,24,0,28,4
1653302790122,HUM 3,D02,087256,Lyon; Antony J.,28,0,28,0
1653302790122,HUM 3,D03,087257,Lyon; Antony J.,0,0,0,0
1653302790122,HUM 3,D04,087258,Lyon; Antony J.,0,0,0,0
1653302790122,HUM 3,D05,087259,Lyon; Antony J.,27,0,28,1
1653302790122,HUM 3,D06,087260,Lyon; Antony J.,28,0,28,0
1653302790122,HUM 3,D07,087261,Lyon; Antony J.,21,0,28,7
1653302790122,HUM 3,D08,087262,Lyon; Antony J.,20,0,28,8
1653302790122,HUM 3,D09,087263,Lyon; Antony J.,28,0,28,0
1653302790122,HUM 3,D10,087264,Lyon; Antony J.,27,0,28,1
1653302790122,HUM 3,D11,087265,Lyon; Antony J.,30,0,30,0
1653302790122,HUM 3,D12,087266,Lyon; Antony J.,30,0,30,0
1653302790122,HUM 3,D13,087267,Lyon; Antony J.,26,0,28,2
1653302790122,HUM 3,D14,087268,Lyon; Antony J.,25,0,28,3
1653302790653,INTL 101,A01,088176,Day; Joel Keith,19,0,20,1
1653302790653,INTL 101,A02,088177,Day; Joel Keith,20,0,20,0
1653302790653,INTL 101,A03,088178,Day; Joel Keith,17,0,20,3
1653302790653,INTL 101,A04,088179,Day; Joel Keith,19,0,20,1
1653302790653,INTL 101,A05,088180,Day; Joel Keith,19,0,20,1
1653302790653,INTL 101,A06,088181,Day; Joel Keith,18,0,20,2
1653302791179,INTL 102,A01,088183,Walter; Barbara Florence,19,0,20,1
1653302791179,INTL 102,A02,088184,Walter; Barbara Florence,19,0,20,1
1653302791179,INTL 102,A03,088185,Walter; Barbara Florence,18,0,20,2
1653302791179,INTL 102,A04,088186,Walter; Barbara Florence,16,0,20,4
1653302791179,INTL 102,A05,088187,Walter; Barbara Florence,19,0,20,1
1653302791179,INTL 102,A06,088188,Walter; Barbara Florence,19,0,20,1
1653302791708,INTL 190,A00,088189,Auerbach; Bradford C,0,0,0,0
1653302791708,INTL 190,B00,088190,Auerbach; Bradford C,0,0,0,0
1653302791708,INTL 190,C00,088191,Fortier; Jana,0,0,0,0
1653302791708,INTL 190,D00,088192,Kshatriya; Krista C,0,0,0,0
1653302791708,INTL 190,E00,088193,Nadkarni; Vidya,0,0,0,0
1653302791708,INTL 190,F00,088194,Scott; Jeffrey F,0,0,0,0
1653302791708,INTL 190,G00,088195,Segui; Alan S,0,0,0,0
1653302791708,INTL 190,H00,088196,Segui; Alan S,0,0,0,0
1653302792233,INTL 190H,A00,088197,Gibson; Clark C,0,0,0,0
1653302792771,JAPN 10A,A01,086851,Maruyama; Rie,15,0,15,0
1653302792771,JAPN 10A,A02,086852,Maruyama; Rie,15,0,15,0
1653302792771,JAPN 10A,B01,086854,Staff,13,0,13,0
1653302792771,JAPN 10A,B02,086855,Staff,13,0,13,0
1653302792771,JAPN 10A,C01,086857,McKee; Mayumi Mochizuki,13,0,13,0
1653302792771,JAPN 10A,C02,086858,McKee; Mayumi Mochizuki,11,0,13,2
1653302792771,JAPN 10A,D01,086860,Sato; Kyoko,13,0,13,0
1653302792771,JAPN 10A,D02,086861,Sato; Kyoko,13,0,13,0
1653302792771,JAPN 10A,E01,086863,Kamioka; Sachiko,12,0,13,1
1653302792771,JAPN 10A,E02,086864,Kamioka; Sachiko,12,0,13,1
1653302792771,JAPN 10A,F01,086866,Sato; Kyoko,13,0,13,0
1653302792771,JAPN 10A,F02,086867,Sato; Kyoko,13,0,13,0
1653302792771,JAPN 10A,G01,086869,Maruyama; Rie,8,0,13,5
1653302792771,JAPN 10A,G02,086870,Maruyama; Rie,13,0,13,0
1653302792771,JAPN 10A,H01,086872,Kamioka; Sachiko,12,0,13,1
1653302792771,JAPN 10A,H02,086873,Kamioka; Sachiko,11,0,13,2
1653302792771,JAPN 10A,I01,086875,Staff,12,0,13,1
1653302792771,JAPN 10A,I02,086876,Staff,13,0,13,0
1653302792771,JAPN 10A,J01,086878,McKee; Mayumi Mochizuki,12,0,13,1
1653302792771,JAPN 10A,J02,086879,McKee; Mayumi Mochizuki,13,0,13,0
1653302792771,JAPN 10A,K01,086881,Inada; Minori,13,0,13,0
1653302792771,JAPN 10A,K02,086882,Inada; Minori,12,0,13,1
1653302792771,JAPN 10A,L01,086884,Tipton; Yuko,13,0,13,0
1653302792771,JAPN 10A,L02,086885,Tipton; Yuko,13,0,13,0
1653302792771,JAPN 10A,M01,086887,Inada; Minori,12,0,13,1
1653302792771,JAPN 10A,M02,086888,Inada; Minori,13,0,13,0
1653302792771,JAPN 10A,N01,086890,McKee; Mayumi Mochizuki,13,0,13,0
1653302792771,JAPN 10A,N02,086891,McKee; Mayumi Mochizuki,11,0,13,2
1653302792771,JAPN 10A,O01,086893,Staff,13,0,13,0
1653302792771,JAPN 10A,O02,086894,Staff,12,0,13,1
1653302792771,JAPN 10A,P01,086896,Tipton; Yuko,15,0,15,0
1653302792771,JAPN 10A,P02,086897,Tipton; Yuko,15,0,15,0
1653302793388,JAPN 20A,A01,086899,Simpson; Junko Tokuda,11,0,13,2
1653302793388,JAPN 20A,A02,086900,Simpson; Junko Tokuda,12,0,13,1
1653302793388,JAPN 20A,B01,086902,Takeda; Izumi,11,0,13,2
1653302793388,JAPN 20A,B02,086903,Takeda; Izumi,12,0,13,1
1653302793388,JAPN 20A,C01,086905,Ross; Kayoko F,12,0,13,1
1653302793388,JAPN 20A,C02,086906,Ross; Kayoko F,12,0,13,1
1653302793388,JAPN 20A,D01,086908,Takeda; Izumi,10,0,13,3
1653302793388,JAPN 20A,D02,086909,Takeda; Izumi,13,0,13,0
1653302793388,JAPN 20A,E01,086911,Maruyama; Rie,11,0,13,2
1653302793388,JAPN 20A,E02,086912,Maruyama; Rie,11,0,13,2
1653302793388,JAPN 20A,F01,086914,Kamioka; Sachiko,7,0,13,6
1653302793388,JAPN 20A,F02,086915,Kamioka; Sachiko,9,0,13,4
1653302793388,JAPN 20A,G01,086917,Ross; Kayoko F,13,0,13,0
1653302793388,JAPN 20A,G02,086918,Ross; Kayoko F,12,0,13,1
1653302793918,JAPN 130A,A01,086920,Simpson; Junko Tokuda,6,0,10,4
1653302793918,JAPN 130A,A02,086921,Simpson; Junko Tokuda,5,0,10,5
1653302793918,JAPN 130A,B01,086923,Ross; Kayoko F,9,0,10,1
1653302793918,JAPN 130A,B02,086924,Ross; Kayoko F,9,0,10,1
1653302794452,JAPN 135A,A00,086925,Inada; Minori,14,0,15,1
1653302794452,JAPN 135A,B00,086926,Takeda; Izumi,15,0,15,0
1653302794977,JAPN 140A,A00,086927,Sato; Kyoko,19,0,20,1
1653302795502,JWSP 1,A01,086445,Shuster; Alana,15,0,15,0
1653302795502,JWSP 1,A02,086446,Shuster; Alana,15,0,15,0
1653302796026,JWSP 104,A01,086448,Shuster; Alana,15,0,15,0
1653302796553,LATI 10,A01,093588,Kennemore; Amy Michelle,31,0,32,1
1653302796553,LATI 10,A02,093589,Kennemore; Amy Michelle,32,0,32,0
1653302796553,LATI 10,A03,093590,Kennemore; Amy Michelle,32,0,32,0
1653302797086,LATI 50,A01,093592,Kokinis; Troy Andreas,32,0,32,0
1653302797086,LATI 50,A02,093593,Kokinis; Troy Andreas,31,0,32,1
1653302797086,LATI 50,A03,093595,Kokinis; Troy Andreas,32,0,32,0
1653302797610,LATI 122A,A00,093649,Andrews; Abigail Leslie,0,0,0,0
1653302798134,LATI 180,A00,093597,Staff,36,0,40,4
1653302798661,LIAB 1A,A00,087085,Saab; Dima,13,0,14,1
1653302798661,LIAB 1A,B00,087086,Saab; Dima,13,0,14,1
1653302798661,LIAB 1A,C00,087087,Saab; Dima,14,0,14,0
1653302798661,LIAB 1A,D00,087088,El Cheddadi; Youniss,14,0,14,0
1653302799189,LIAB 1AX,A00,087089,Akjeje; Abdelhak,28,0,28,0
1653302799189,LIAB 1AX,B00,087091,Akjeje; Abdelhak,28,0,28,0
1653302799715,LIAB 1D,A00,087093,El Cheddadi; Youniss,13,0,14,1
1653302799715,LIAB 1D,B00,087094,El Cheddadi; Youniss,12,0,14,2
1653302800242,LIAB 1DX,A00,087095,Akjeje; Abdelhak,27,0,28,1
1653302800768,LIDS 19,001,095098,Goodall; Grant Todd,9999,0,9999,0
1653302800768,LIDS 19,002,095099,Goodall; Grant Todd,9999,0,9999,0
1653302800768,LIDS 19,003,095100,Goodall; Grant Todd,9999,0,9999,0
1653302800768,LIDS 19,004,095101,Goodall; Grant Todd,9999,0,9999,0
1653302800768,LIDS 19,005,095102,Goodall; Grant Todd,9999,0,9999,0
1653302800768,LIDS 19,006,095103,Goodall; Grant Todd,9999,0,9999,0
1653302800768,LIDS 19,007,095104,Goodall; Grant Todd,9999,0,9999,0
1653302800768,LIDS 19,008,095105,Goodall; Grant Todd,9999,0,9999,0
1653302800768,LIDS 19,009,095106,Goodall; Grant Todd,9999,0,9999,0
1653302800768,LIDS 19,010,095107,Goodall; Grant Todd,9999,0,9999,0
1653302800768,LIDS 19,011,095108,Goodall; Grant Todd,9999,0,9999,0
1653302800768,LIDS 19,012,095109,Goodall; Grant Todd,9999,0,9999,0
1653302801293,LIFR 1A,A00,087097,Goodall; Grant Todd,13,0,14,1
1653302801293,LIFR 1A,B00,087098,Goodall; Grant Todd,13,0,14,1
1653302801293,LIFR 1A,C00,087099,Goodall; Grant Todd,12,0,14,2
1653302801293,LIFR 1A,D00,087100,Goodall; Grant Todd,12,0,14,2
1653302801293,LIFR 1A,E00,087101,Goodall; Grant Todd,14,0,14,0
1653302801293,LIFR 1A,F00,087102,Goodall; Grant Todd,13,0,14,1
1653302801818,LIFR 1AX,A00,087103,Goodall; Grant Todd,27,0,28,1
1653302801818,LIFR 1AX,B00,087104,Goodall; Grant Todd,27,0,28,1
1653302801818,LIFR 1AX,C00,087105,Goodall; Grant Todd,25,0,28,3
1653302802346,LIFR 1B,A00,087106,Goodall; Grant Todd,14,0,14,0
1653302802346,LIFR 1B,B00,087107,Goodall; Grant Todd,13,0,14,1
1653302802346,LIFR 1B,C00,087108,Goodall; Grant Todd,13,0,14,1
1653302802346,LIFR 1B,D00,087109,Goodall; Grant Todd,13,0,14,1
1653302802874,LIFR 1BX,A00,087110,Goodall; Grant Todd,26,0,28,2
1653302802874,LIFR 1BX,B00,087111,Goodall; Grant Todd,26,0,28,2
1653302803404,LIFR 1D,A00,087112,Goodall; Grant Todd,14,0,14,0
1653302803404,LIFR 1D,B00,087113,Goodall; Grant Todd,12,0,14,2
1653302803404,LIFR 1D,C00,087114,Goodall; Grant Todd,11,0,14,3
1653302803404,LIFR 1D,D00,087115,Goodall; Grant Todd,10,0,14,4
1653302803932,LIFR 1DX,A00,087116,Goodall; Grant Todd,26,0,28,2
1653302803932,LIFR 1DX,B00,087117,Goodall; Grant Todd,23,0,28,5
1653302804455,LIFR 11,A00,087118,Goodall; Grant Todd,10,0,10,0
1653302804979,LIGM 1A,A00,087119,Riebeling; Elke,14,0,14,0
1653302804979,LIGM 1A,B00,087120,Riebeling; Elke,14,0,14,0
1653302804979,LIGM 1A,C00,087121,Riebeling; Elke,12,0,14,2
1653302804979,LIGM 1A,D00,087122,Riebeling; Elke,14,0,14,0
1653302804979,LIGM 1A,E00,087123,Riebeling; Elke,14,0,14,0
1653302805501,LIGM 1AX,A00,087124,Riebeling; Elke,28,0,28,0
1653302805501,LIGM 1AX,B00,087125,Riebeling; Elke,28,0,28,0
1653302805501,LIGM 1AX,C00,087126,Riebeling; Elke,27,0,28,1
1653302806026,LIGM 1D,A00,087127,Riebeling; Elke,14,0,14,0
1653302806026,LIGM 1D,B00,087128,Riebeling; Elke,12,0,14,2
1653302806553,LIGM 1DX,A00,087129,Riebeling; Elke,26,0,28,2
1653302807081,LIGM 11,A00,087130,Goodall; Grant Todd,10,0,10,0
1653302807605,LIGN 5,A00,087005,Goodall; Grant Todd,74,0,75,1
1653302808129,LIGN 7,A00,087006,Mayberry; Rachel,139,0,146,7
1653302808658,LIGN 8,A00,087007,McIntosh; Justin Daniel,244,0,250,6
1653302809184,LIGN 17,A00,087008,Kehler; Andrew Scott,218,0,220,2
1653302809711,LIGN 101,A01,087010,Styler; William Francis,29,0,30,1
1653302809711,LIGN 101,A02,087011,Styler; William Francis,29,0,30,1
1653302809711,LIGN 101,A03,087012,Styler; William Francis,29,0,30,1
1653302809711,LIGN 101,A04,087013,Styler; William Francis,29,0,30,1
1653302810235,LIGN 110,A01,087015,Garellek; Marc,29,0,30,1
1653302810235,LIGN 110,A02,087016,Garellek; Marc,26,0,30,4
1653302810235,LIGN 110,A03,087017,Garellek; Marc,26,0,30,4
1653302810235,LIGN 110,A04,087018,Garellek; Marc,28,0,30,2
1653302810759,LIGN 121,A01,087020,Drake; Emily C,23,0,25,2
1653302810759,LIGN 121,A02,087021,Drake; Emily C,24,0,25,1
1653302811285,LIGN 150,A00,093702,Staff,71,0,75,4
1653302811814,LIGN 152,A00,087023,Caballero; Gabriela Hernandez,16,0,20,4
1653302812342,LIGN 154,A00,087024,Kluender; Robert,70,0,70,0
1653302812872,LIGN 167,A00,087025,Bergen; Leon,70,0,100,30
1653302813399,LIGN 187,A00,087026,McIntosh; Justin Daniel,20,0,20,0
1653302813926,LIHL 112F,A00,086505,Alicio; Atilio,25,0,28,3
1653302814454,LIHL 114F,A00,086506,Staff,21,0,28,7
1653302814984,LIHL 117F,A00,086508,Sadegholvad; Elham,20,0,20,0
1653302815508,LIHL 118,A00,086509,Staff,25,0,28,3
1653302816032,LIHL 119F,A00,086510,Staff,26,0,28,2
1653302816558,LIHL 124F,A00,086511,Staff,27,0,28,1
1653302817084,LIHL 132F,A00,086512,Alicio; Atilio,28,0,28,0
1653302817608,LIIT 1A,A00,087131,Riebeling; Elke,14,0,14,0
1653302817608,LIIT 1A,B00,087132,Riebeling; Elke,14,0,14,0
1653302817608,LIIT 1A,C00,087133,Riebeling; Elke,12,0,14,2
1653302817608,LIIT 1A,D00,087134,Riebeling; Elke,14,0,14,0
1653302818133,LIIT 1AX,A00,087135,Riebeling; Elke,28,0,28,0
1653302818133,LIIT 1AX,B00,087136,Riebeling; Elke,26,0,28,2
1653302818663,LIPO 1A,A00,087137,Paladini; Denise,14,0,14,0
1653302818663,LIPO 1A,B00,087138,Paladini; Denise,10,0,14,4
1653302819194,LIPO 1AX,A00,087139,De Abreu; Cassia,18,0,22,4
1653302819194,LIPO 1AX,B00,087140,De Abreu; Cassia,22,0,22,0
1653302819722,LIPO 1D,A00,087141,Paladini; Denise,10,0,14,4
1653302820245,LIPO 1DX,A00,087143,De Abreu; Cassia,10,0,14,4
1653302820778,LISL 1A,A00,087145,Lott; Margaret S.,10,0,14,4
1653302820778,LISL 1A,B00,087146,Lott; Margaret S.,14,0,14,0
1653302820778,LISL 1A,C00,087147,Lott; Margaret S.,10,0,14,4
1653302820778,LISL 1A,D00,087148,Lott; Margaret S.,11,0,14,3
1653302820778,LISL 1A,E00,087149,Lott; Margaret S.,13,0,14,1
1653302820778,LISL 1A,F00,087150,Lott; Margaret S.,12,0,14,2
1653302820778,LISL 1A,G00,087151,Lott; Margaret S.,13,0,14,1
1653302820778,LISL 1A,H00,087152,Lott; Margaret S.,13,0,14,1
1653302821303,LISL 1AX,A00,087153,Lott; Margaret S.,28,0,28,0
1653302821303,LISL 1AX,B00,087154,Lott; Margaret S.,25,0,28,3
1653302821303,LISL 1AX,C00,087155,Lott; Margaret S.,25,0,28,3
1653302821303,LISL 1AX,D00,087156,Lott; Margaret S.,24,0,28,4
1653302821828,LISL 1B,A00,087157,Lott; Margaret S.,13,0,14,1
1653302821828,LISL 1B,B00,087158,Lott; Margaret S.,12,0,14,2
1653302821828,LISL 1B,C00,087159,Lott; Margaret S.,11,0,14,3
1653302821828,LISL 1B,D00,087160,Lott; Margaret S.,13,0,14,1
1653302821828,LISL 1B,E00,087161,Lott; Margaret S.,13,0,14,1
1653302821828,LISL 1B,F00,087162,Lott; Margaret S.,13,0,14,1
1653302822352,LISL 1BX,A00,087163,Lott; Margaret S.,23,0,28,5
1653302822352,LISL 1BX,B00,087164,Lott; Margaret S.,26,0,28,2
1653302822352,LISL 1BX,C00,087165,Lott; Margaret S.,28,0,28,0
1653302822885,LISL 1D,A00,087166,Lott; Margaret S.,14,0,14,0
1653302822885,LISL 1D,B00,087167,Lott; Margaret S.,14,0,14,0
1653302822885,LISL 1D,C00,087168,Lott; Margaret S.,8,0,14,6
1653302822885,LISL 1D,D00,087169,Lott; Margaret S.,13,0,14,1
1653302823409,LISL 1DX,A00,087170,Lott; Margaret S.,23,0,28,5
1653302823409,LISL 1DX,B00,087171,Lott; Margaret S.,26,0,28,2
1653302823934,LISP 1A,001,087172,Munoz Sanchez; Alicia,13,0,14,1
1653302823934,LISP 1A,002,087173,Munoz Sanchez; Alicia,12,0,14,2
1653302823934,LISP 1A,003,087174,Munoz Sanchez; Alicia,13,0,14,1
1653302823934,LISP 1A,004,087175,Munoz Sanchez; Alicia,12,0,14,2
1653302823934,LISP 1A,005,087176,Munoz Sanchez; Alicia,10,0,14,4
1653302823934,LISP 1A,006,087177,Munoz Sanchez; Alicia,12,0,14,2
1653302823934,LISP 1A,007,087178,Munoz Sanchez; Alicia,12,0,14,2
1653302823934,LISP 1A,008,087179,Munoz Sanchez; Alicia,14,0,14,0
1653302824462,LISP 1AX,A00,087180,Munoz Sanchez; Alicia,27,0,28,1
1653302824462,LISP 1AX,B00,087181,Munoz Sanchez; Alicia,24,0,28,4
1653302824462,LISP 1AX,C00,087182,Munoz Sanchez; Alicia,25,0,28,3
1653302824462,LISP 1AX,D00,087183,Munoz Sanchez; Alicia,25,0,28,3
1653302824987,LISP 1B,001,087184,Munoz Sanchez; Alicia,14,0,14,0
1653302824987,LISP 1B,002,087185,Munoz Sanchez; Alicia,14,0,14,0
1653302824987,LISP 1B,003,087186,Munoz Sanchez; Alicia,11,0,14,3
1653302824987,LISP 1B,004,087187,Munoz Sanchez; Alicia,12,0,14,2
1653302824987,LISP 1B,005,087188,Munoz Sanchez; Alicia,13,0,14,1
1653302824987,LISP 1B,006,087189,Munoz Sanchez; Alicia,13,0,14,1
1653302824987,LISP 1B,007,087190,Munoz Sanchez; Alicia,14,0,14,0
1653302824987,LISP 1B,008,087191,Munoz Sanchez; Alicia,13,0,14,1
1653302824987,LISP 1B,009,087192,Munoz Sanchez; Alicia,14,0,14,0
1653302824987,LISP 1B,010,087193,Munoz Sanchez; Alicia,13,0,14,1
1653302824987,LISP 1B,011,087194,Munoz Sanchez; Alicia,14,0,14,0
1653302825519,LISP 1BX,A00,087195,Munoz Sanchez; Alicia,28,0,28,0
1653302825519,LISP 1BX,B00,087196,Munoz Sanchez; Alicia,26,0,28,2
1653302825519,LISP 1BX,C00,087197,Munoz Sanchez; Alicia,26,0,28,2
1653302825519,LISP 1BX,D00,087198,Munoz Sanchez; Alicia,26,0,28,2
1653302825519,LISP 1BX,E00,087199,Munoz Sanchez; Alicia,28,0,28,0
1653302826050,LISP 1D,001,087200,Munoz Sanchez; Alicia,13,0,14,1
1653302826050,LISP 1D,002,087201,Munoz Sanchez; Alicia,14,0,14,0
1653302826050,LISP 1D,003,087202,Munoz Sanchez; Alicia,8,0,14,6
1653302826050,LISP 1D,004,087203,Munoz Sanchez; Alicia,5,0,14,9
1653302826050,LISP 1D,005,087204,Munoz Sanchez; Alicia,11,0,14,3
1653302826050,LISP 1D,006,087205,Munoz Sanchez; Alicia,13,0,14,1
1653302826050,LISP 1D,007,087206,Munoz Sanchez; Alicia,13,0,14,1
1653302826050,LISP 1D,008,087207,Munoz Sanchez; Alicia,13,0,14,1
1653302826050,LISP 1D,009,087208,Munoz Sanchez; Alicia,14,0,14,0
1653302826050,LISP 1D,010,087209,Munoz Sanchez; Alicia,12,0,14,2
1653302826050,LISP 1D,011,087210,Munoz Sanchez; Alicia,13,0,14,1
1653302826050,LISP 1D,012,087211,Munoz Sanchez; Alicia,14,0,14,0
1653302826050,LISP 1D,013,087212,Munoz Sanchez; Alicia,14,0,14,0
1653302826050,LISP 1D,014,087213,Munoz Sanchez; Alicia,14,0,14,0
1653302826580,LISP 1DX,A00,087214,Munoz Sanchez; Alicia,27,0,28,1
1653302826580,LISP 1DX,B00,087215,Munoz Sanchez; Alicia,23,0,28,5
1653302826580,LISP 1DX,C00,087216,Munoz Sanchez; Alicia,23,0,28,5
1653302826580,LISP 1DX,D00,087217,Munoz Sanchez; Alicia,25,0,28,3
1653302826580,LISP 1DX,E00,087218,Munoz Sanchez; Alicia,27,0,28,1
1653302826580,LISP 1DX,F00,087219,Munoz Sanchez; Alicia,25,0,28,3
1653302826580,LISP 1DX,G00,087220,Munoz Sanchez; Alicia,28,0,28,0
1653302827107,LISP 15,A00,087221,Munoz Sanchez; Alicia,19,0,20,1
1653302827630,LISP 18,A00,087222,Munoz Sanchez; Alicia,15,0,20,5
1653302828154,LTAM 110,A00,087352,Chacon; Gloria Elizabeth,35,0,40,5
1653302828679,LTCS 87,A00,094011,Nguyen; Hoang Tan,19,0,20,1
1653302829207,LTCS 111,A00,087353,Vitkus; Daniel J.,40,0,40,0
1653302829735,LTCS 119,A00,087354,Nguyen; Hoang Tan,29,0,30,1
1653302830260,LTCS 130,A00,087355,Kim; Joo Ok,37,0,40,3
1653302830788,LTCS 165,A00,087356,Kim; Joo Ok,38,0,40,2
1653302831320,LTEA 120A,A00,087357,Fiss; Geraldine Anna,291,0,300,9
1653302831844,LTEA 140,A00,094009,Lee; Jin-Kyung,28,0,32,4
1653302832370,LTEA 142,A00,087358,Lee; Jin-Kyung,102,0,120,18
1653302832894,LTEN 21,A01,087275,Lampert-Weissig; Lisa,25,0,25,0
1653302832894,LTEN 21,A02,087276,Lampert-Weissig; Lisa,25,0,25,0
1653302832894,LTEN 21,A03,087277,Lampert-Weissig; Lisa,25,0,25,0
1653302832894,LTEN 21,A04,087278,Lampert-Weissig; Lisa,25,0,25,0
1653302833420,LTEN 25,A01,087280,Johnson; Sara E.,25,0,25,0
1653302833420,LTEN 25,A02,087281,Johnson; Sara E.,25,0,25,0
1653302833420,LTEN 25,A03,087282,Johnson; Sara E.,23,0,25,2
1653302833420,LTEN 25,A04,087283,Johnson; Sara E.,25,0,25,0
1653302833952,LTEN 29,A01,087285,Ruiz; Ariana,24,0,25,1
1653302833952,LTEN 29,A02,087286,Ruiz; Ariana,25,0,25,0
1653302833952,LTEN 29,A03,087287,Ruiz; Ariana,24,0,25,1
1653302833952,LTEN 29,A04,087288,Ruiz; Ariana,24,0,25,1
1653302834480,LTEN 107,A00,087359,Lampert-Weissig; Lisa,39,0,40,1
1653302835008,LTEN 117,A00,087360,Vitkus; Daniel J.,40,0,40,0
1653302835534,LTEN 127,A00,087361,Loose; Margaret,38,0,40,2
1653302836058,LTEN 142,A00,094010,Loose; Margaret,38,0,40,2
1653302836584,LTEN 148,A00,087363,Walkiewicz; Kathryn A,40,0,40,0
1653302837108,LTEN 152,A00,087364,Walkiewicz; Kathryn A,37,0,40,3
1653302837640,LTEN 180,A00,087365,Ruiz; Ariana,18,0,20,2
1653302838169,LTFR 2A,A01,087290,Ploye; Catherine,23,0,25,2
1653302838697,LTFR 2B,A01,087292,Ploye; Catherine,25,0,25,0
1653302839227,LTFR 104,A00,087366,Ploye; Catherine,25,0,25,0
1653302839752,LTFR 116,A00,087367,Zhiri; Oumelbanine,13,0,15,2
1653302840277,LTGK 1,A00,087293,Myerston Santana; Jacobo,27,0,30,3
1653302840802,LTGK 103,A00,087368,duBois; Page Ann,14,0,15,1
1653302841327,LTGM 2A,A01,087295,Fischer-Grunski; Eva K,24,0,25,1
1653302841860,LTIT 2A,A01,087297,De Marchi Gherini; Adriana,24,0,25,1
1653302842387,LTKO 1A,A01,087299,Staff,24,0,25,1
1653302842387,LTKO 1A,B01,087301,Staff,25,0,25,0
1653302842387,LTKO 1A,C01,087303,Staff,25,0,25,0
1653302842387,LTKO 1A,D01,087305,Staff,25,0,25,0
1653302842387,LTKO 1A,E01,087307,Staff,24,0,25,1
1653302842387,LTKO 1A,F01,087309,Staff,25,0,25,0
1653302842387,LTKO 1A,G01,087311,Staff,25,0,25,0
1653302842387,LTKO 1A,H01,087313,Staff,24,0,25,1
1653302842387,LTKO 1A,I01,087315,Staff,25,0,25,0
1653302842917,LTKO 2A,A01,087317,Staff,24,0,25,1
1653302842917,LTKO 2A,B01,087319,Staff,22,0,25,3
1653302842917,LTKO 2A,C01,087321,Lee; Jeyseon,24,0,25,1
1653302843443,LTKO 130,A00,087369,Lee; Jeyseon,25,0,25,0
1653302843973,LTLA 1,A00,087322,Murray; Kourtney Kristine,38,0,40,2
1653302844497,LTLA 100,A00,087371,Kelting; Edward William,23,0,25,2
1653302845027,LTRU 1A,A01,087324,Wells; Patricia Rebecca,23,0,25,2
1653302845551,LTRU 2A,A01,087326,Wells; Patricia Rebecca,20,0,20,0
1653302846080,LTRU 104B,A01,087373,Wells; Patricia Rebecca,14,0,15,1
1653302846676,LTSP 2A,A01,087328,Staff,25,0,25,0
1653302846676,LTSP 2A,B01,087330,Staff,22,0,25,3
1653302846676,LTSP 2A,C01,087332,Staff,22,0,25,3
1653302847200,LTSP 2B,A01,087334,Staff,22,0,25,3
1653302847200,LTSP 2B,B01,087336,Staff,19,0,25,6
1653302847726,LTSP 2D,A00,087337,Staff,25,0,25,0
1653302847726,LTSP 2D,B00,087338,Staff,25,0,25,0
1653302847726,LTSP 2D,C00,087339,Staff,25,0,25,0
1653302848256,LTSP 100A,A00,087374,Arcos Herrera; Carol,23,0,25,2
1653302848780,LTSP 116,A00,087375,Blanco; John D,29,0,30,1
1653302849304,LTSP 140,A00,087376,Chacon; Gloria Elizabeth,30,0,30,0
1653302849831,LTSP 175,A00,087377,Arcos Herrera; Carol,30,0,30,0
1653302850354,LTTH 150,A00,087379,Cohen; Alain J. J.,40,0,40,0
1653302850877,LTWL 19A,A00,087340,Myerston Santana; Jacobo,39,0,40,1
1653302851400,LTWL 87,A00,094012,Lampert-Weissig; Lisa,20,0,20,0
1653302851926,LTWL 116,A00,087380,Nguyen; Hoang Tan,60,0,60,0
1653302852452,LTWL 120,A00,087381,Fiss; Geraldine Anna,37,0,40,3
1653302852977,LTWL 172,A00,087382,De Marchi Gherini; Adriana,40,0,40,0
1653302853502,LTWL 180,A00,087383,Kontje; Todd Curtis,39,0,40,1
1653302854029,LTWL 194,A00,087384,Suzuki; Erin M.,31,0,32,1
1653302854561,LTWR 8A,A01,087342,Jemc; Jaclyn,24,0,25,1
1653302854561,LTWR 8A,A02,087343,Jemc; Jaclyn,25,0,25,0
1653302854561,LTWR 8A,A03,087344,Jemc; Jaclyn,24,0,25,1
1653302854561,LTWR 8A,A04,087345,Jemc; Jaclyn,24,0,25,1
1653302855091,LTWR 8C,A01,087348,Forbes; Camille,25,0,25,0
1653302855091,LTWR 8C,A02,087349,Forbes; Camille,25,0,25,0
1653302855091,LTWR 8C,A03,087350,Forbes; Camille,25,0,25,0
1653302855091,LTWR 8C,A04,087351,Forbes; Camille,23,0,25,2
1653302855614,LTWR 100,A00,087385,Staff,12,0,15,3
1653302856138,LTWR 102,A00,087386,Staff,14,0,15,1
1653302856662,LTWR 115,A00,087387,Carroll; Amy Sara,24,0,30,6
1653302857185,LTWR 119,A00,087388,Staff,22,0,30,8
1653302857708,LTWR 140,A00,087389,Carroll; Amy Sara,37,0,40,3
1653302858234,LTWR 194,A00,087390,Som; Brandon D,35,0,40,5
1653302858761,MAE 2,A01,090334,Anderson; Mark Ronald,8,0,8,0
1653302858761,MAE 2,A02,090335,Anderson; Mark Ronald,8,0,8,0
1653302858761,MAE 2,A03,090336,Anderson; Mark Ronald,8,0,8,0
1653302858761,MAE 2,A04,090337,Anderson; Mark Ronald,8,0,8,0
1653302858761,MAE 2,A05,090338,Anderson; Mark Ronald,8,0,8,0
1653302858761,MAE 2,A06,090339,Anderson; Mark Ronald,8,0,8,0
1653302858761,MAE 2,A07,090340,Anderson; Mark Ronald,8,0,8,0
1653302858761,MAE 2,A08,090341,Anderson; Mark Ronald,7,0,8,1
1653302858761,MAE 2,A09,090342,Anderson; Mark Ronald,8,0,8,0
1653302859292,MAE 3,A01,090344,Delson; Nathan Joseph,21,0,22,1
1653302859292,MAE 3,A02,090345,Delson; Nathan Joseph,20,0,22,2
1653302859292,MAE 3,A03,090346,Delson; Nathan Joseph,21,0,22,1
1653302859292,MAE 3,A04,090347,Delson; Nathan Joseph,22,0,22,0
1653302859292,MAE 3,B01,090349,Qi; Huihui,18,0,22,4
1653302859292,MAE 3,B02,090350,Qi; Huihui,17,0,22,5
1653302859292,MAE 3,B03,090351,Qi; Huihui,20,0,22,2
1653302859292,MAE 3,B04,090352,Qi; Huihui,19,0,22,3
1653302859821,MAE 8,A01,090354,Pham; Hieu Tan,182,0,185,3
1653302860354,MAE 11,A00,090355,Nomura; Keiko K.,155,0,165,10
1653302860883,MAE 20,A00,090356,Bandaru; Prabhakar,160,0,160,0
1653302860883,MAE 20,B00,090357,Evdokimenko; Ekaterina,145,0,160,15
1653302861416,MAE 21,A01,090359,Cai; Shengqiang,8,0,9,1
1653302861416,MAE 21,A02,090360,Cai; Shengqiang,9,0,9,0
1653302861416,MAE 21,A03,090361,Cai; Shengqiang,6,0,9,3
1653302861416,MAE 21,A04,090362,Cai; Shengqiang,7,0,9,2
1653302861416,MAE 21,A05,090363,Cai; Shengqiang,0,0,0,0
1653302861416,MAE 21,A06,090364,Cai; Shengqiang,9,0,9,0
1653302861416,MAE 21,A07,090365,Cai; Shengqiang,9,0,9,0
1653302861416,MAE 21,A08,090366,Cai; Shengqiang,8,0,9,1
1653302861416,MAE 21,A09,090367,Cai; Shengqiang,8,0,9,1
1653302861416,MAE 21,A10,090368,Cai; Shengqiang,0,0,0,0
1653302861416,MAE 21,A11,090369,Cai; Shengqiang,9,0,9,0
1653302861416,MAE 21,A12,090370,Cai; Shengqiang,8,0,9,1
1653302861940,MAE 30A,A00,090371,Lal; Ratnesh,72,0,75,3
1653302862469,MAE 40,A00,090372,Bitmead; Robert R.,167,0,175,8
1653302863000,MAE 101A,A00,090373,Bahadori; Mohammad Yousef,105,0,115,10
1653302863526,MAE 101C,A00,090374,Poulikakos; Lisa Voula,41,0,110,69
1653302863526,MAE 101C,B00,090375,Chen; Renkun,96,0,110,14
1653302864050,MAE 104,A00,090376,Sanchez; Antonio Luis,78,0,120,42
1653302864581,MAE 105,A00,090377,Saintillan; David,154,0,170,16
1653302865114,MAE 107,A00,090378,Lindsey; Stephanie,104,0,110,6
1653302865114,MAE 107,B00,090379,Tolley; Michael Thomas,85,0,110,25
1653302865643,MAE 118,A00,090380,Krasheninnikov; Sergei,27,0,45,18
1653302866169,MAE 131A,A00,090381,Ghazinejad; Maziar,70,0,75,5
1653302866703,MAE 133,A00,090382,Frazier; Michael,26,0,33,7
1653302867228,MAE 143A,A00,090383,de Oliveira; Mauricio,74,0,100,26
1653302867756,MAE 144,A00,090384,Bewley; Thomas R,50,0,70,20
1653302868282,MAE 148,A01,091597,Staff,32,0,32,0
1653302868809,MAE 150,A00,090385,Friend; James Robert,69,0,90,21
1653302868809,MAE 150,B00,090386,Ghazinejad; Maziar,4,0,90,86
1653302869340,MAE 152,A00,090387,Tynan; George Robert,0,0,16,16
1653302869340,MAE 152,B00,090388,Tynan; George Robert,0,0,16,16
1653302869340,MAE 152,C00,090389,Tynan; George Robert,0,0,16,16
1653302869340,MAE 152,D00,090390,Tynan; George Robert,0,0,16,16
1653302869868,MAE 156A,A01,090392,Delson; Nathan Joseph,2,0,12,10
1653302869868,MAE 156A,A02,090393,Delson; Nathan Joseph,1,0,12,11
1653302869868,MAE 156A,A03,090394,Delson; Nathan Joseph,4,0,12,8
1653302870394,MAE 170,A01,090396,Lubarda; Marko,14,0,30,16
1653302870394,MAE 170,A02,090397,Lubarda; Marko,19,0,30,11
1653302870394,MAE 170,A03,090398,Lubarda; Marko,28,0,30,2
1653302870394,MAE 170,A04,090399,Lubarda; Marko,20,0,30,10
1653302870394,MAE 170,B01,090401,Diagne; Mamadou Lamine,30,0,30,0
1653302870394,MAE 170,B02,090402,Diagne; Mamadou Lamine,27,0,30,3
1653302870394,MAE 170,B03,090403,Diagne; Mamadou Lamine,28,0,30,2
1653302870394,MAE 170,B04,090404,Diagne; Mamadou Lamine,28,0,30,2
1653302870920,MAE 180A,A00,090405,McEneaney; William Michael,110,0,125,15
1653302871444,MAE 181,A00,090406,Bahadori; Mohammad Yousef,46,0,60,14
1653302871974,MAE 190,A00,090407,Anderson; Mark Ronald,27,0,45,18
1653302872498,MAE 191,A01,090409,Qi; Huihui,25,0,32,7
1653302873028,MATH 2,A01,089123,Hammock; Frances H,0,0,0,0
1653302873028,MATH 2,B01,089126,Hammock; Frances H,0,0,0,0
1653302873028,MATH 2,C01,089129,Hammock; Frances H,0,0,0,0
1653302873028,MATH 2,D01,094201,Harel; Guershon,0,0,0,0
1653302873560,MATH 3C,A01,089132,Bowers; Adam R.,0,0,0,0
1653302873560,MATH 3C,A02,089133,Bowers; Adam R.,0,0,0,0
1653302873560,MATH 3C,A03,089134,Bowers; Adam R.,0,0,0,0
1653302873560,MATH 3C,A04,089135,Bowers; Adam R.,0,0,0,0
1653302873560,MATH 3C,A05,089136,Bowers; Adam R.,0,0,0,0
1653302873560,MATH 3C,A06,089137,Bowers; Adam R.,0,0,0,0
1653302873560,MATH 3C,A07,089138,Bowers; Adam R.,0,0,0,0
1653302873560,MATH 3C,A08,089139,Bowers; Adam R.,0,0,0,0
1653302873560,MATH 3C,A09,089140,Bowers; Adam R.,0,0,0,0
1653302873560,MATH 3C,A10,089141,Bowers; Adam R.,0,0,0,0
1653302873560,MATH 3C,A11,089142,Bowers; Adam R.,0,0,0,0
1653302873560,MATH 3C,A12,089143,Bowers; Adam R.,0,0,0,0
1653302873560,MATH 3C,A13,089144,Bowers; Adam R.,0,0,0,0
1653302873560,MATH 3C,A14,089145,Bowers; Adam R.,0,0,0,0
1653302873560,MATH 3C,A15,089146,Bowers; Adam R.,0,0,0,0
1653302873560,MATH 3C,A16,089147,Bowers; Adam R.,0,0,0,0
1653302873560,MATH 3C,A17,089148,Bowers; Adam R.,0,0,0,0
1653302873560,MATH 3C,A18,089149,Bowers; Adam R.,0,0,0,0
1653302873560,MATH 3C,A19,089150,Bowers; Adam R.,0,0,0,0
1653302873560,MATH 3C,A20,089151,Bowers; Adam R.,0,0,0,0
1653302873560,MATH 3C,A21,089152,Bowers; Adam R.,0,0,0,0
1653302873560,MATH 3C,A22,089153,Bowers; Adam R.,0,0,0,0
1653302873560,MATH 3C,A23,089154,Bowers; Adam R.,0,0,0,0
1653302873560,MATH 3C,A24,089155,Bowers; Adam R.,0,0,0,0
1653302873560,MATH 3C,B01,089158,Staff,0,0,0,0
1653302873560,MATH 3C,B02,089159,Staff,0,0,0,0
1653302873560,MATH 3C,B03,089160,Staff,0,0,0,0
1653302873560,MATH 3C,B04,089161,Staff,0,0,0,0
1653302873560,MATH 3C,C01,094244,Staff,0,0,0,0
1653302873560,MATH 3C,C02,094245,Staff,0,0,0,0
1653302873560,MATH 3C,C03,094246,Staff,0,0,0,0
1653302873560,MATH 3C,C04,094247,Staff,0,0,0,0
1653302874086,MATH 4C,A01,089164,Staff,0,0,0,0
1653302874086,MATH 4C,A02,089165,Staff,0,0,0,0
1653302874086,MATH 4C,A03,089166,Staff,0,0,0,0
1653302874086,MATH 4C,B01,089169,Ganzberger; Geoffrey Michael,0,0,0,0
1653302874086,MATH 4C,B02,089170,Ganzberger; Geoffrey Michael,0,0,0,0
1653302874086,MATH 4C,B03,089171,Ganzberger; Geoffrey Michael,0,0,0,0
1653302874086,MATH 4C,C01,089174,Ganzberger; Geoffrey Michael,0,0,0,0
1653302874086,MATH 4C,C02,089175,Ganzberger; Geoffrey Michael,0,0,0,0
1653302874086,MATH 4C,C03,089176,Ganzberger; Geoffrey Michael,0,0,0,0
1653302874086,MATH 4C,D01,094249,Ganzberger; Geoffrey Michael,0,0,0,0
1653302874086,MATH 4C,D02,094250,Ganzberger; Geoffrey Michael,0,0,0,0
1653302874086,MATH 4C,D03,094251,Ganzberger; Geoffrey Michael,0,0,0,0
1653302874621,MATH 10A,A01,089179,Jin; Muzhi,5,0,5,0
1653302874621,MATH 10A,A02,089180,Jin; Muzhi,5,0,5,0
1653302874621,MATH 10A,A03,089181,Jin; Muzhi,4,0,5,1
1653302874621,MATH 10A,A04,089182,Jin; Muzhi,4,0,5,1
1653302874621,MATH 10A,A05,089183,Jin; Muzhi,5,0,5,0
1653302874621,MATH 10A,A06,089184,Jin; Muzhi,5,0,5,0
1653302874621,MATH 10A,A07,089185,Jin; Muzhi,5,0,5,0
1653302874621,MATH 10A,A08,089186,Jin; Muzhi,5,0,5,0
1653302874621,MATH 10A,B01,089188,Stevens; Laura Jeanne,1,0,5,4
1653302874621,MATH 10A,B02,089189,Stevens; Laura Jeanne,4,0,5,1
1653302874621,MATH 10A,B03,089190,Stevens; Laura Jeanne,4,0,5,1
1653302874621,MATH 10A,B04,089191,Stevens; Laura Jeanne,5,0,5,0
1653302874621,MATH 10A,B05,089192,Stevens; Laura Jeanne,4,0,5,1
1653302874621,MATH 10A,B06,089193,Stevens; Laura Jeanne,5,0,5,0
1653302874621,MATH 10A,B07,089194,Stevens; Laura Jeanne,5,0,5,0
1653302874621,MATH 10A,B08,089195,Stevens; Laura Jeanne,4,0,5,1
1653302874621,MATH 10A,C01,089197,Jin; Muzhi,1,0,5,4
1653302874621,MATH 10A,C02,089198,Jin; Muzhi,5,0,5,0
1653302874621,MATH 10A,C03,089199,Jin; Muzhi,5,0,5,0
1653302874621,MATH 10A,C04,089200,Jin; Muzhi,5,0,5,0
1653302874621,MATH 10A,C05,089201,Jin; Muzhi,5,0,5,0
1653302874621,MATH 10A,C06,089202,Jin; Muzhi,5,0,5,0
1653302874621,MATH 10A,D01,089204,Upton; James Thomas,4,0,5,1
1653302874621,MATH 10A,D02,089205,Upton; James Thomas,5,0,5,0
1653302874621,MATH 10A,D03,089206,Upton; James Thomas,5,0,5,0
1653302874621,MATH 10A,D04,089207,Upton; James Thomas,5,0,5,0
1653302874621,MATH 10A,E01,089211,Greenfeld; Be'Eri,5,0,5,0
1653302874621,MATH 10A,E02,089212,Greenfeld; Be'Eri,3,0,5,2
1653302874621,MATH 10A,E03,089213,Greenfeld; Be'Eri,4,0,5,1
1653302874621,MATH 10A,E04,089214,Greenfeld; Be'Eri,5,0,5,0
1653302874621,MATH 10A,E05,089215,Greenfeld; Be'Eri,5,0,5,0
1653302874621,MATH 10A,E06,089216,Greenfeld; Be'Eri,5,0,5,0
1653302875148,MATH 10B,A01,089218,Stevens; Laura Jeanne,7,0,8,1
1653302875148,MATH 10B,A02,089219,Stevens; Laura Jeanne,7,0,8,1
1653302875148,MATH 10B,A03,089220,Stevens; Laura Jeanne,8,0,8,0
1653302875148,MATH 10B,A04,089221,Stevens; Laura Jeanne,6,0,8,2
1653302875148,MATH 10B,A05,089222,Stevens; Laura Jeanne,2,0,8,6
1653302875148,MATH 10B,A06,089223,Stevens; Laura Jeanne,0,0,8,8
1653302875148,MATH 10B,A07,089224,Stevens; Laura Jeanne,6,0,8,2
1653302875148,MATH 10B,A08,089225,Stevens; Laura Jeanne,4,0,8,4
1653302875148,MATH 10B,B01,089227,Staff,8,0,8,0
1653302875148,MATH 10B,B02,089228,Staff,8,0,8,0
1653302875148,MATH 10B,B03,089229,Staff,7,0,8,1
1653302875148,MATH 10B,B04,089230,Staff,8,0,8,0
1653302875148,MATH 10B,B05,089231,Staff,8,0,8,0
1653302875148,MATH 10B,B06,089232,Staff,8,0,8,0
1653302875148,MATH 10B,B07,089233,Staff,8,0,8,0
1653302875148,MATH 10B,B08,089234,Staff,8,0,8,0
1653302875148,MATH 10B,C01,089236,McKinley; Gweneth Anne,4,0,8,4
1653302875148,MATH 10B,C02,089237,McKinley; Gweneth Anne,8,0,8,0
1653302875148,MATH 10B,C03,089238,McKinley; Gweneth Anne,8,0,8,0
1653302875148,MATH 10B,C04,089239,McKinley; Gweneth Anne,8,0,8,0
1653302875148,MATH 10B,C05,089240,McKinley; Gweneth Anne,8,0,8,0
1653302875148,MATH 10B,C06,089241,McKinley; Gweneth Anne,8,0,8,0
1653302875682,MATH 10C,A01,089243,Staff,13,0,20,7
1653302875682,MATH 10C,A02,089244,Staff,20,0,20,0
1653302875682,MATH 10C,A03,089245,Staff,18,0,20,2
1653302875682,MATH 10C,A04,089246,Staff,20,0,20,0
1653302875682,MATH 10C,A05,089247,Staff,19,0,20,1
1653302875682,MATH 10C,A06,089248,Staff,20,0,20,0
1653302875682,MATH 10C,A07,094505,Staff,20,0,20,0
1653302875682,MATH 10C,A08,094506,Staff,20,0,20,0
1653302875682,MATH 10C,B01,089250,Staff,19,0,20,1
1653302875682,MATH 10C,B02,089251,Staff,19,0,20,1
1653302875682,MATH 10C,B03,089252,Staff,14,0,20,6
1653302875682,MATH 10C,B04,089253,Staff,20,0,20,0
1653302875682,MATH 10C,B05,089254,Staff,20,0,20,0
1653302875682,MATH 10C,B06,089255,Staff,18,0,20,2
1653302876209,MATH 11,A01,089258,Rava; Denise,1,0,15,14
1653302876209,MATH 11,A02,089260,Rava; Denise,9,0,15,6
1653302876209,MATH 11,A03,089263,Rava; Denise,10,0,15,5
1653302876209,MATH 11,A04,089265,Rava; Denise,13,0,15,2
1653302876209,MATH 11,A05,089267,Rava; Denise,10,0,15,5
1653302876209,MATH 11,A06,089269,Rava; Denise,14,0,15,1
1653302876209,MATH 11,A07,089271,Rava; Denise,14,0,15,1
1653302876209,MATH 11,A08,089273,Rava; Denise,13,0,15,2
1653302876209,MATH 11,B01,089279,Staff,4,0,15,11
1653302876209,MATH 11,B02,089281,Staff,14,0,15,1
1653302876209,MATH 11,B03,089283,Staff,14,0,15,1
1653302876209,MATH 11,B04,089284,Staff,15,0,15,0
1653302876209,MATH 11,B05,089286,Staff,14,0,15,1
1653302876209,MATH 11,B06,089288,Staff,15,0,15,0
1653302876209,MATH 11,B07,089289,Staff,14,0,15,1
1653302876209,MATH 11,B08,089290,Staff,14,0,15,1
1653302876747,MATH 18,A01,089303,Anzaldo; Leesa B,5,0,10,5
1653302876747,MATH 18,A02,089304,Anzaldo; Leesa B,6,0,10,4
1653302876747,MATH 18,A03,089305,Anzaldo; Leesa B,10,0,10,0
1653302876747,MATH 18,A04,089306,Anzaldo; Leesa B,8,0,10,2
1653302876747,MATH 18,A05,089307,Anzaldo; Leesa B,10,0,10,0
1653302876747,MATH 18,A06,089308,Anzaldo; Leesa B,9,0,10,1
1653302876747,MATH 18,A07,089309,Anzaldo; Leesa B,10,0,10,0
1653302876747,MATH 18,A08,089310,Anzaldo; Leesa B,10,0,10,0
1653302876747,MATH 18,A09,089311,Anzaldo; Leesa B,10,0,10,0
1653302876747,MATH 18,A10,089312,Anzaldo; Leesa B,10,0,10,0
1653302876747,MATH 18,A11,089313,Anzaldo; Leesa B,9,0,10,1
1653302876747,MATH 18,A12,089314,Anzaldo; Leesa B,10,0,10,0
1653302876747,MATH 18,A13,089315,Anzaldo; Leesa B,9,0,10,1
1653302876747,MATH 18,A14,089316,Anzaldo; Leesa B,10,0,10,0
1653302876747,MATH 18,A15,089317,Anzaldo; Leesa B,9,0,10,1
1653302876747,MATH 18,A16,089318,Anzaldo; Leesa B,10,0,10,0
1653302876747,MATH 18,A17,089319,Anzaldo; Leesa B,9,0,10,1
1653302876747,MATH 18,A18,089320,Anzaldo; Leesa B,10,0,10,0
1653302876747,MATH 18,A19,089321,Anzaldo; Leesa B,0,0,0,0
1653302876747,MATH 18,A20,089322,Anzaldo; Leesa B,0,0,0,0
1653302876747,MATH 18,A21,089323,Anzaldo; Leesa B,9,0,10,1
1653302876747,MATH 18,A22,089324,Anzaldo; Leesa B,7,0,10,3
1653302876747,MATH 18,A23,089325,Anzaldo; Leesa B,10,0,10,0
1653302876747,MATH 18,A24,089326,Anzaldo; Leesa B,9,0,10,1
1653302876747,MATH 18,B01,089329,Staff,13,0,13,0
1653302876747,MATH 18,B02,089330,Staff,12,0,13,1
1653302876747,MATH 18,B03,089331,Staff,12,0,13,1
1653302876747,MATH 18,B04,089332,Staff,13,0,13,0
1653302876747,MATH 18,B05,089333,Staff,12,0,13,1
1653302876747,MATH 18,C01,089336,Staff,13,0,13,0
1653302876747,MATH 18,C02,089337,Staff,11,0,13,2
1653302876747,MATH 18,C03,089338,Staff,0,0,0,0
1653302876747,MATH 18,C04,089339,Staff,0,0,0,0
1653302876747,MATH 18,C05,089340,Staff,0,0,0,1
1653302876747,MATH 18,D01,094194,Staff,0,0,0,0
1653302876747,MATH 18,D02,094195,Staff,0,0,0,0
1653302876747,MATH 18,D03,094196,Staff,0,0,0,0
1653302876747,MATH 18,D04,094197,Staff,0,0,0,0
1653302876747,MATH 18,D05,094198,Staff,0,0,0,0
1653302877275,MATH 20A,A01,089343,Staff,5,0,5,0
1653302877275,MATH 20A,A02,089344,Staff,5,0,5,0
1653302877275,MATH 20A,A03,089345,Staff,5,0,5,0
1653302877275,MATH 20A,B01,089347,Suk; Andrew Hoon,2,0,3,1
1653302877275,MATH 20A,B02,089348,Suk; Andrew Hoon,3,0,3,0
1653302877275,MATH 20A,B03,089349,Suk; Andrew Hoon,3,0,3,0
1653302877275,MATH 20A,B04,089350,Suk; Andrew Hoon,3,0,3,0
1653302877275,MATH 20A,B05,089351,Suk; Andrew Hoon,3,0,3,0
1653302877275,MATH 20A,B06,089352,Suk; Andrew Hoon,2,0,3,1
1653302877275,MATH 20A,B07,089353,Suk; Andrew Hoon,3,0,3,0
1653302877275,MATH 20A,B08,089354,Suk; Andrew Hoon,3,0,3,0
1653302877275,MATH 20A,B09,089355,Suk; Andrew Hoon,3,0,3,0
1653302877275,MATH 20A,B10,089356,Suk; Andrew Hoon,3,0,3,0
1653302877275,MATH 20A,B11,089357,Suk; Andrew Hoon,3,0,3,0
1653302877275,MATH 20A,B12,089358,Suk; Andrew Hoon,3,0,3,0
1653302877275,MATH 20A,B13,089359,Suk; Andrew Hoon,2,0,3,1
1653302877275,MATH 20A,B14,089360,Suk; Andrew Hoon,3,0,3,0
1653302877275,MATH 20A,B15,089361,Suk; Andrew Hoon,3,0,3,0
1653302877275,MATH 20A,B16,089362,Suk; Andrew Hoon,3,0,3,0
1653302877275,MATH 20A,B17,089363,Suk; Andrew Hoon,3,0,3,0
1653302877275,MATH 20A,B18,089364,Suk; Andrew Hoon,0,0,0,0
1653302877275,MATH 20A,B19,089365,Suk; Andrew Hoon,3,0,3,0
1653302877275,MATH 20A,B20,089366,Suk; Andrew Hoon,3,0,3,0
1653302877275,MATH 20A,B21,089367,Suk; Andrew Hoon,3,0,3,0
1653302877275,MATH 20A,B22,089368,Suk; Andrew Hoon,3,0,3,0
1653302877275,MATH 20A,B23,089369,Suk; Andrew Hoon,3,0,3,0
1653302877275,MATH 20A,B24,089370,Suk; Andrew Hoon,3,0,3,0
1653302877813,MATH 20B,A01,089372,Quarfoot; David James,8,0,8,0
1653302877813,MATH 20B,A02,089373,Quarfoot; David James,8,0,8,0
1653302877813,MATH 20B,A03,089374,Quarfoot; David James,7,0,8,1
1653302877813,MATH 20B,A04,089375,Quarfoot; David James,7,0,8,1
1653302877813,MATH 20B,A05,089376,Quarfoot; David James,0,0,0,0
1653302877813,MATH 20B,A06,089377,Quarfoot; David James,0,0,0,0
1653302877813,MATH 20B,A07,089378,Quarfoot; David James,0,0,0,0
1653302877813,MATH 20B,A08,089379,Quarfoot; David James,0,0,0,0
1653302877813,MATH 20B,A09,089380,Quarfoot; David James,0,0,0,0
1653302877813,MATH 20B,A10,089381,Quarfoot; David James,0,0,0,0
1653302877813,MATH 20B,A11,089382,Quarfoot; David James,0,0,0,0
1653302877813,MATH 20B,A12,089383,Quarfoot; David James,0,0,0,0
1653302877813,MATH 20B,A13,089384,Quarfoot; David James,0,0,0,0
1653302877813,MATH 20B,A14,089385,Quarfoot; David James,0,0,0,0
1653302877813,MATH 20B,A15,089386,Quarfoot; David James,0,0,0,0
1653302877813,MATH 20B,A16,089387,Quarfoot; David James,0,0,0,0
1653302877813,MATH 20B,A17,089388,Quarfoot; David James,8,0,8,0
1653302877813,MATH 20B,A18,089389,Quarfoot; David James,8,0,8,0
1653302877813,MATH 20B,A19,089390,Quarfoot; David James,8,0,8,0
1653302877813,MATH 20B,A20,089391,Quarfoot; David James,8,0,8,0
1653302877813,MATH 20B,A21,089392,Quarfoot; David James,8,0,8,0
1653302877813,MATH 20B,A22,089393,Quarfoot; David James,7,0,8,1
1653302877813,MATH 20B,A23,089394,Quarfoot; David James,7,0,8,1
1653302877813,MATH 20B,A24,089395,Quarfoot; David James,8,0,8,0
1653302877813,MATH 20B,B01,089397,Lahiri; Aranya,7,0,10,3
1653302877813,MATH 20B,B02,089398,Lahiri; Aranya,10,0,10,0
1653302877813,MATH 20B,B03,089399,Lahiri; Aranya,10,0,10,0
1653302877813,MATH 20B,B04,089400,Lahiri; Aranya,10,0,10,0
1653302877813,MATH 20B,B05,089401,Lahiri; Aranya,10,0,10,0
1653302877813,MATH 20B,C01,089403,Lahiri; Aranya,0,0,0,0
1653302877813,MATH 20B,C02,089404,Lahiri; Aranya,8,0,10,2
1653302877813,MATH 20B,C03,089405,Lahiri; Aranya,10,0,10,0
1653302877813,MATH 20B,C04,089406,Lahiri; Aranya,9,0,10,1
1653302877813,MATH 20B,C05,089407,Lahiri; Aranya,9,0,10,1
1653302878346,MATH 20C,A01,089409,Um; Ko Woon,10,0,10,0
1653302878346,MATH 20C,A02,089410,Um; Ko Woon,10,0,10,0
1653302878346,MATH 20C,A03,089411,Um; Ko Woon,9,0,10,1
1653302878346,MATH 20C,A04,089412,Um; Ko Woon,9,0,10,1
1653302878346,MATH 20C,A05,089413,Um; Ko Woon,10,0,10,0
1653302878346,MATH 20C,A06,089414,Um; Ko Woon,9,0,10,1
1653302878346,MATH 20C,A07,094270,Um; Ko Woon,10,0,10,0
1653302878346,MATH 20C,A08,094271,Um; Ko Woon,10,0,10,0
1653302878346,MATH 20C,A09,094272,Um; Ko Woon,7,0,10,3
1653302878346,MATH 20C,A10,094273,Um; Ko Woon,10,0,10,0
1653302878346,MATH 20C,A11,094274,Um; Ko Woon,10,0,10,0
1653302878346,MATH 20C,A12,094275,Um; Ko Woon,8,0,10,2
1653302878346,MATH 20C,A13,094276,Um; Ko Woon,10,0,10,0
1653302878346,MATH 20C,A14,094277,Um; Ko Woon,10,0,10,0
1653302878346,MATH 20C,A15,094278,Um; Ko Woon,10,0,10,0
1653302878346,MATH 20C,A16,094279,Um; Ko Woon,10,0,10,0
1653302878346,MATH 20C,B03,089418,Zhang; Ming,7,0,15,8
1653302878346,MATH 20C,B04,089419,Zhang; Ming,13,0,15,2
1653302878346,MATH 20C,B05,089420,Zhang; Ming,13,0,15,2
1653302878346,MATH 20C,C01,089423,Staff,15,0,15,0
1653302878346,MATH 20C,C02,089424,Staff,15,0,15,0
1653302878346,MATH 20C,C03,089425,Staff,15,0,15,0
1653302878346,MATH 20C,C04,089426,Staff,15,0,15,0
1653302878346,MATH 20C,C05,089427,Staff,15,0,15,0
1653302878346,MATH 20C,D04,089433,Zhang; Ming,13,0,15,2
1653302878346,MATH 20C,D05,089434,Zhang; Ming,15,0,15,0
1653302878346,MATH 20C,E01,089439,Staff,15,0,15,0
1653302878346,MATH 20C,E02,089440,Staff,15,0,15,0
1653302878346,MATH 20C,E03,089441,Staff,15,0,15,0
1653302878346,MATH 20C,E04,089442,Staff,15,0,15,0
1653302878346,MATH 20C,E05,089443,Staff,15,0,15,0
1653302878346,MATH 20C,E06,089444,Staff,15,0,15,0
1653302878346,MATH 20C,A17,094280,Um; Ko Woon,0,0,0,0
1653302878346,MATH 20C,A18,094281,Um; Ko Woon,0,0,0,0
1653302878346,MATH 20C,A19,094282,Um; Ko Woon,0,0,0,0
1653302878346,MATH 20C,A20,094283,Um; Ko Woon,0,0,0,0
1653302878346,MATH 20C,A21,094284,Um; Ko Woon,0,0,0,0
1653302878346,MATH 20C,A22,094285,Um; Ko Woon,0,0,0,0
1653302878346,MATH 20C,A23,094286,Um; Ko Woon,0,0,0,0
1653302878346,MATH 20C,A24,094287,Um; Ko Woon,0,0,0,0
1653302878346,MATH 20C,B01,089416,Zhang; Ming,0,0,0,0
1653302878346,MATH 20C,B02,089417,Zhang; Ming,0,0,0,0
1653302878346,MATH 20C,D01,089430,Zhang; Ming,0,0,0,0
1653302878346,MATH 20C,D02,089431,Zhang; Ming,0,0,0,0
1653302878346,MATH 20C,D03,089432,Zhang; Ming,0,0,0,0
1653302878872,MATH 20D,A01,089455,Lee; Kisun,11,0,25,14
1653302878872,MATH 20D,A02,089456,Lee; Kisun,24,0,25,1
1653302878872,MATH 20D,A03,089457,Lee; Kisun,24,0,25,1
1653302878872,MATH 20D,A04,089458,Lee; Kisun,25,0,25,0
1653302878872,MATH 20D,A05,089459,Lee; Kisun,25,0,25,0
1653302878872,MATH 20D,A06,089460,Lee; Kisun,25,0,25,0
1653302878872,MATH 20D,B01,089463,Lee; Kisun,20,0,25,5
1653302878872,MATH 20D,B02,089464,Lee; Kisun,25,0,25,0
1653302878872,MATH 20D,B03,089465,Lee; Kisun,24,0,25,1
1653302878872,MATH 20D,B04,089466,Lee; Kisun,25,0,25,0
1653302878872,MATH 20D,B05,089467,Lee; Kisun,23,0,25,2
1653302878872,MATH 20D,B06,089468,Lee; Kisun,24,0,25,1
1653302878872,MATH 20D,C01,089471,Staff,23,0,25,2
1653302878872,MATH 20D,C02,089472,Staff,25,0,25,0
1653302878872,MATH 20D,C03,089473,Staff,25,0,25,0
1653302878872,MATH 20D,C04,089474,Staff,25,0,25,0
1653302878872,MATH 20D,C05,089475,Staff,25,0,25,0
1653302878872,MATH 20D,C06,089476,Staff,25,0,25,0
1653302879400,MATH 20E,A01,089479,Eggers; John Dietrich,17,0,24,7
1653302879400,MATH 20E,A02,089480,Eggers; John Dietrich,24,0,25,1
1653302879400,MATH 20E,A03,089481,Eggers; John Dietrich,25,0,25,0
1653302879400,MATH 20E,A04,089482,Eggers; John Dietrich,25,0,25,0
1653302879400,MATH 20E,A05,089483,Eggers; John Dietrich,19,0,25,6
1653302879400,MATH 20E,A06,089484,Eggers; John Dietrich,25,0,25,0
1653302879400,MATH 20E,A07,089485,Eggers; John Dietrich,24,0,25,1
1653302879400,MATH 20E,A08,089486,Eggers; John Dietrich,24,0,25,1
1653302879400,MATH 20E,B01,089488,Staff,15,0,25,10
1653302879400,MATH 20E,B02,089489,Staff,21,0,25,4
1653302879400,MATH 20E,B03,089490,Staff,25,0,25,0
1653302879400,MATH 20E,B04,089491,Staff,25,0,25,0
1653302879400,MATH 20E,B05,089492,Staff,24,0,25,1
1653302879400,MATH 20E,B06,089493,Staff,24,0,25,1
1653302879400,MATH 20E,B07,089494,Staff,25,0,25,0
1653302879400,MATH 20E,B08,089495,Staff,25,0,25,0
1653302879400,MATH 20E,C01,089497,Staff,23,0,25,2
1653302879400,MATH 20E,C02,089498,Staff,25,0,25,0
1653302879400,MATH 20E,C03,089499,Staff,25,0,25,0
1653302879400,MATH 20E,C04,089500,Staff,25,0,25,0
1653302879400,MATH 20E,C05,089501,Staff,25,0,25,0
1653302879400,MATH 20E,C06,089502,Staff,25,0,25,0
1653302879400,MATH 20E,C07,089503,Staff,25,0,25,0
1653302879400,MATH 20E,C08,089504,Staff,25,0,25,0
1653302879924,MATH 31AH,A01,089506,Rabin; Jeffrey Mark,35,0,35,0
1653302879924,MATH 31AH,A02,089507,Rabin; Jeffrey Mark,35,0,35,0
1653302880454,MATH 87,A00,094827,Meyer; David A.,20,0,20,0
1653302880987,MATH 96,A00,094836,Kane; Daniel Mertz,11,0,30,19
1653302881513,MATH 100A,A01,089509,Kedlaya; Kiran S.,23,0,30,7
1653302881513,MATH 100A,A02,089510,Kedlaya; Kiran S.,28,0,30,2
1653302881513,MATH 100A,B01,089512,Greenfeld; Be'Eri,24,0,30,6
1653302881513,MATH 100A,B02,089513,Greenfeld; Be'Eri,30,0,30,0
1653302882039,MATH 102,A01,089515,Hodges; Reuven Moses,25,0,30,5
1653302882039,MATH 102,A02,089516,Hodges; Reuven Moses,30,0,30,0
1653302882039,MATH 102,A03,089517,Hodges; Reuven Moses,30,0,30,0
1653302882039,MATH 102,A04,089518,Hodges; Reuven Moses,29,0,30,1
1653302882039,MATH 102,B01,089520,Hodges; Reuven Moses,29,0,30,1
1653302882039,MATH 102,B02,089521,Hodges; Reuven Moses,29,0,30,1
1653302882039,MATH 102,B03,089522,Hodges; Reuven Moses,29,0,30,1
1653302882039,MATH 102,B04,089523,Hodges; Reuven Moses,30,0,30,0
1653302882576,MATH 103A,A01,089525,Staff,27,0,30,3
1653302882576,MATH 103A,A02,089526,Staff,30,0,30,0
1653302882576,MATH 103A,B01,089528,Seward; Brandon M.,9,0,30,21
1653302882576,MATH 103A,B02,089529,Seward; Brandon M.,22,0,30,8
1653302882576,MATH 103A,C01,089531,Staff,27,0,30,3
1653302882576,MATH 103A,C02,089532,Staff,28,0,30,2
1653302882576,MATH 103A,D01,089534,Staff,28,0,30,2
1653302882576,MATH 103A,D02,089535,Staff,28,0,30,2
1653302883115,MATH 109,A01,089537,Chung; Kwun,9,0,10,1
1653302883115,MATH 109,A02,089538,Chung; Kwun,10,0,10,0
1653302883115,MATH 109,B01,089540,Belmont; Eva Kinoshita,9,0,10,1
1653302883115,MATH 109,B02,089541,Belmont; Eva Kinoshita,6,0,10,4
1653302883115,MATH 109,C01,089543,Chow; Bennett,8,0,10,2
1653302883115,MATH 109,C02,089544,Chow; Bennett,10,0,10,0
1653302883115,MATH 109,D01,089546,Chung; Kwun,9,0,10,1
1653302883115,MATH 109,D02,089547,Chung; Kwun,9,0,10,1
1653302883115,MATH 109,E01,089549,Schweinsberg; Jason,6,0,10,4
1653302883115,MATH 109,E02,089550,Schweinsberg; Jason,10,0,10,0
1653302883642,MATH 110,A01,089552,Wenzl; Hans G,27,0,35,8
1653302883642,MATH 110,A02,089553,Wenzl; Hans G,33,0,35,2
1653302884172,MATH 111A,A01,089555,Meyer; David A.,0,0,0,1
1653302884697,MATH 120A,A01,089557,Manners; Frederick,30,0,35,5
1653302884697,MATH 120A,A02,089558,Manners; Frederick,33,0,35,2
1653302885226,MATH 140A,A01,089560,Seward; Brandon M.,25,0,30,5
1653302885226,MATH 140A,A02,089561,Seward; Brandon M.,29,0,30,1
1653302885226,MATH 140A,B01,089563,Chan; Pak Yeung,30,0,30,0
1653302885226,MATH 140A,B02,089564,Chan; Pak Yeung,22,0,30,8
1653302885752,MATH 142A,A01,089566,Staff,29,0,30,1
1653302885752,MATH 142A,A02,089567,Staff,29,0,30,1
1653302885752,MATH 142A,B01,089569,Staff,30,0,30,0
1653302885752,MATH 142A,B02,089570,Staff,29,0,30,1
1653302885752,MATH 142A,C01,089572,Staff,26,0,30,4
1653302885752,MATH 142A,C02,089573,Staff,29,0,30,1
1653302885752,MATH 142A,D01,089575,Eggers; John Dietrich,15,0,30,15
1653302885752,MATH 142A,D02,089576,Eggers; John Dietrich,27,0,30,3
1653302886277,MATH 144,A01,089578,Bejenaru; Ioan,29,0,30,1
1653302886800,MATH 150A,A01,089580,Chow; Bennett,29,0,35,6
1653302886800,MATH 150A,A02,089581,Chow; Bennett,34,0,35,1
1653302887849,MATH 153,A01,094204,Harel; Guershon,33,0,35,2
1653302888375,MATH 154,A01,089590,Verstraete; Jacques Allan,3,0,30,27
1653302888375,MATH 154,A02,089591,Verstraete; Jacques Allan,23,0,30,7
1653302888375,MATH 154,A03,089592,Verstraete; Jacques Allan,28,0,30,2
1653302888375,MATH 154,A04,089593,Verstraete; Jacques Allan,26,0,30,4
1653302888898,MATH 155A,A01,089595,Buss; Samuel R,22,0,35,13
1653302888898,MATH 155A,A02,089596,Buss; Samuel R,32,0,35,3
1653302889420,MATH 160A,A01,089598,Manners; Frederick,28,0,35,7
1653302889420,MATH 160A,A02,094207,Manners; Frederick,34,0,35,1
1653302889949,MATH 170A,A01,089600,Liu; Shuang,24,0,25,1
1653302889949,MATH 170A,A02,089601,Liu; Shuang,24,0,25,1
1653302889949,MATH 170A,A03,089602,Liu; Shuang,24,0,25,1
1653302889949,MATH 170A,A04,089603,Liu; Shuang,23,0,25,2
1653302889949,MATH 170A,B01,089605,Dumitriu; Ioana,8,0,25,17
1653302889949,MATH 170A,B02,089606,Dumitriu; Ioana,20,0,25,5
1653302889949,MATH 170A,B03,089607,Dumitriu; Ioana,21,0,25,4
1653302889949,MATH 170A,B04,089608,Dumitriu; Ioana,25,0,25,0
1653302890473,MATH 173A,A01,089610,Cloninger; Alexander,0,0,35,35
1653302890473,MATH 173A,A02,089611,Cloninger; Alexander,2,0,35,33
1653302890473,MATH 173A,A03,089612,Cloninger; Alexander,20,0,35,15
1653302891003,MATH 174,A01,089614,Cheng; Li-Tien,23,0,25,2
1653302891003,MATH 174,A02,089615,Cheng; Li-Tien,25,0,25,0
1653302891529,MATH 180A,A01,089617,Jekel; David Andrew,0,0,25,25
1653302891529,MATH 180A,A02,089618,Jekel; David Andrew,23,0,25,2
1653302891529,MATH 180A,A03,089619,Jekel; David Andrew,22,0,25,3
1653302891529,MATH 180A,A04,089620,Jekel; David Andrew,22,0,25,3
1653302891529,MATH 180A,A05,089621,Jekel; David Andrew,24,0,25,1
1653302891529,MATH 180A,A06,089622,Jekel; David Andrew,23,0,25,2
1653302891529,MATH 180A,B01,089624,Agarwal; Pooja,23,0,25,2
1653302891529,MATH 180A,B02,089625,Agarwal; Pooja,24,0,25,1
1653302891529,MATH 180A,B03,089626,Agarwal; Pooja,22,0,25,3
1653302891529,MATH 180A,B04,089627,Agarwal; Pooja,25,0,25,0
1653302891529,MATH 180A,B05,089628,Agarwal; Pooja,24,0,25,1
1653302891529,MATH 180A,B06,089629,Agarwal; Pooja,25,0,25,0
1653302891529,MATH 180A,C01,089631,Staff,22,0,25,3
1653302891529,MATH 180A,C02,089632,Staff,25,0,25,0
1653302891529,MATH 180A,C03,089633,Staff,25,0,25,0
1653302891529,MATH 180A,C04,089634,Staff,25,0,25,0
1653302892058,MATH 180C,A01,089636,Fitzsimmons; Patrick J,4,0,25,21
1653302892058,MATH 180C,A02,089637,Fitzsimmons; Patrick J,21,0,25,4
1653302892582,MATH 181B,A01,089639,Rava; Denise,31,0,35,4
1653302892582,MATH 181B,A02,089640,Rava; Denise,34,0,35,1
1653302892582,MATH 181B,A03,089641,Rava; Denise,31,0,35,4
1653302892582,MATH 181B,A04,089642,Rava; Denise,35,0,35,0
1653302893107,MATH 183,A01,089644,Staff,10,0,25,15
1653302893107,MATH 183,A02,089645,Staff,23,0,25,2
1653302893107,MATH 183,A03,089646,Staff,23,0,25,2
1653302893107,MATH 183,A04,089647,Staff,25,0,25,0
1653302893107,MATH 183,A05,089648,Staff,19,0,25,6
1653302893107,MATH 183,A06,089649,Staff,22,0,25,3
1653302893107,MATH 183,A07,089650,Staff,25,0,25,0
1653302893107,MATH 183,A08,089651,Staff,25,0,25,0
1653302893635,MATH 184,A01,089653,Kane; Daniel Mertz,24,0,30,6
1653302893635,MATH 184,A02,089654,Kane; Daniel Mertz,30,0,30,0
1653302893635,MATH 184,A03,089655,Kane; Daniel Mertz,30,0,30,0
1653302893635,MATH 184,A04,089656,Kane; Daniel Mertz,30,0,30,0
1653302894169,MATH 187A,A01,089658,Bucur; Alina Ioana,0,0,25,25
1653302894169,MATH 187A,A02,089659,Bucur; Alina Ioana,12,0,25,13
1653302894169,MATH 187A,A03,089660,Bucur; Alina Ioana,0,0,25,25
1653302894169,MATH 187A,A04,089661,Bucur; Alina Ioana,17,0,25,8
1653302894692,MATH 187B,A01,089663,Bucur; Alina Ioana,28,0,35,7
1653302894692,MATH 187B,A02,089664,Bucur; Alina Ioana,34,0,35,1
1653302895220,MATH 188,A01,094817,Sam; Steven V,33,0,35,2
1653302895756,MATH 190A,A01,089666,Sam; Steven V,21,0,35,14
1653302896284,MATH 196,A00,089667,Spolaor; Luca,33,0,45,12
1653302896828,MCWP 40,004,093486,Wastal; Carrie King,0,0,3,3
1653302896828,MCWP 40,005,093487,Wastal; Carrie King,0,0,3,3
1653302896828,MCWP 40,006,093488,Wastal; Carrie King,3,0,3,0
1653302896828,MCWP 40,007,093489,Wastal; Carrie King,3,0,3,0
1653302896828,MCWP 40,008,093490,Wastal; Carrie King,2,0,3,1
1653302896828,MCWP 40,009,093491,Wastal; Carrie King,2,0,3,1
1653302896828,MCWP 40,013,093495,Wastal; Carrie King,3,0,3,0
1653302896828,MCWP 40,014,093496,Wastal; Carrie King,0,0,3,3
1653302896828,MCWP 40,015,093497,Wastal; Carrie King,3,0,3,0
1653302896828,MCWP 40,016,093498,Wastal; Carrie King,3,0,3,0
1653302896828,MCWP 40,017,093499,Wastal; Carrie King,3,0,3,0
1653302896828,MCWP 40,018,093500,Wastal; Carrie King,1,0,3,2
1653302896828,MCWP 40,020,093502,Wastal; Carrie King,0,0,0,0
1653302896828,MCWP 40,021,093503,Wastal; Carrie King,3,0,3,0
1653302896828,MCWP 40,022,093504,Wastal; Carrie King,2,0,3,1
1653302896828,MCWP 40,023,093505,Wastal; Carrie King,2,0,3,1
1653302896828,MCWP 40,024,093506,Wastal; Carrie King,2,0,3,1
1653302896828,MCWP 40,026,093508,Wastal; Carrie King,3,0,3,0
1653302896828,MCWP 40,027,093509,Wastal; Carrie King,3,0,3,0
1653302896828,MCWP 40,028,093510,Wastal; Carrie King,3,0,3,0
1653302896828,MCWP 40,029,093511,Wastal; Carrie King,3,0,3,0
1653302896828,MCWP 40,030,093512,Wastal; Carrie King,2,0,3,1
1653302896828,MCWP 40,032,093514,Wastal; Carrie King,2,0,3,1
1653302896828,MCWP 40,033,093515,Wastal; Carrie King,3,0,3,0
1653302896828,MCWP 40,034,093516,Wastal; Carrie King,3,0,3,0
1653302896828,MCWP 40,035,093517,Wastal; Carrie King,3,0,3,0
1653302896828,MCWP 40,038,093520,Wastal; Carrie King,2,0,3,1
1653302896828,MCWP 40,039,093521,Wastal; Carrie King,3,0,3,0
1653302896828,MCWP 40,041,093523,Wastal; Carrie King,2,0,3,1
1653302896828,MCWP 40,042,093524,Wastal; Carrie King,3,0,3,0
1653302896828,MCWP 40,043,093525,Wastal; Carrie King,0,0,0,0
1653302896828,MCWP 40,049,093531,Wastal; Carrie King,2,0,3,1
1653302896828,MCWP 40,050,093532,Wastal; Carrie King,3,0,3,0
1653302896828,MCWP 40,051,093533,Wastal; Carrie King,3,0,3,0
1653302897369,MCWP 50,001,093534,Wastal; Carrie King,0,0,0,0
1653302897369,MCWP 50,002,093535,Wastal; Carrie King,0,0,3,3
1653302897369,MCWP 50,003,093536,Wastal; Carrie King,0,0,3,3
1653302897369,MCWP 50,004,093537,Wastal; Carrie King,0,0,3,3
1653302897369,MCWP 50,005,093538,Wastal; Carrie King,0,0,3,3
1653302897369,MCWP 50,006,093539,Wastal; Carrie King,2,0,3,1
1653302897369,MCWP 50,007,093540,Wastal; Carrie King,0,0,3,3
1653302897369,MCWP 50,008,093541,Wastal; Carrie King,0,0,3,3
1653302897369,MCWP 50,009,093542,Wastal; Carrie King,0,0,3,3
1653302897369,MCWP 50,010,093543,Wastal; Carrie King,0,0,3,3
1653302897369,MCWP 50,013,093546,Wastal; Carrie King,1,0,3,2
1653302897369,MCWP 50,014,093547,Wastal; Carrie King,0,0,3,3
1653302897369,MCWP 50,015,093548,Wastal; Carrie King,0,0,3,3
1653302897369,MCWP 50,016,093549,Wastal; Carrie King,0,0,0,0
1653302897894,MCWP 125,A00,093550,Wilson; Marion E.,3,0,3,0
1653302897894,MCWP 125,B00,093551,Guillen; Melinda,3,0,3,0
1653302897894,MCWP 125,C00,093552,Guillen; Melinda,3,0,3,0
1653302897894,MCWP 125,D00,093553,Guillen; Melinda,3,0,3,0
1653302897894,MCWP 125,E00,093554,Miller; Elizabeth Deen,3,0,3,0
1653302897894,MCWP 125,F00,093555,Miller; Elizabeth Deen,3,0,3,0
1653302897894,MCWP 125,G00,093556,Miller; Elizabeth Deen,3,0,3,0
1653302898419,MGT 3,A00,087704,Wagner; Timothy Ryan,90,0,90,0
1653302898944,MGT 4,A01,087706,Levkoff; Steven B.,2,0,3,1
1653302898944,MGT 4,A02,087707,Levkoff; Steven B.,3,0,3,0
1653302898944,MGT 4,A03,092659,Levkoff; Steven B.,1,0,4,3
1653302899474,MGT 5,A00,087708,Houskeeper; Robert,194,0,196,2
1653302900093,MGT 12,A00,087709,Pecore; Joseph P.,91,0,100,9
1653302900093,MGT 12,B00,087710,Lindenberger; Wade Douglas,91,0,100,9
1653302900618,MGT 16,A00,087711,Campbell; Robert Harold,108,0,110,2
1653302900618,MGT 16,B00,087712,Campbell; Robert Harold,110,0,110,0
1653302900618,MGT 16,C00,087713,Lindenberger; Wade Douglas,100,0,110,10
1653302900618,MGT 16,D00,087714,Lindenberger; Wade Douglas,107,0,110,3
1653302900618,MGT 16,E00,094819,Buchanan; Harold G,99,0,100,1
1653302901146,MGT 18,A00,087715,McKay; Michael J,88,0,90,2
1653302901146,MGT 18,B00,087716,McKay; Michael J,90,0,90,0
1653302901146,MGT 18,C00,087717,McKay; Michael J,88,0,90,2
1653302901146,MGT 18,D00,087718,McKay; Mary A,90,0,90,0
1653302901146,MGT 18,E00,087719,McKay; Mary A,87,0,90,3
1653302901672,MGT 45,A00,087720,Pecore; Joseph P.,136,0,150,14
1653302901672,MGT 45,B00,087721,Pecore; Joseph P.,140,0,150,10
1653302902194,MGT 52,A00,087722,Deal; Jennifer Jean,83,0,90,7
1653302902721,MGT 71,A00,087723,August; Terrence,60,0,90,30
1653302903778,MGT 103,A00,087726,Ehrich; Kristine R,86,0,90,4
1653302903778,MGT 103,B00,087727,Ehrich; Kristine R,89,0,90,1
1653302903778,MGT 103,C00,087728,Eberhard; Craig A,89,0,90,1
1653302903778,MGT 103,D00,087729,Eberhard; Craig A,88,0,90,2
1653302903778,MGT 103,E00,087730,Demill; Burritt,75,0,90,15
1653302903778,MGT 103,F00,087731,Bates; Kenneth Walter,81,0,90,9
1653302903778,MGT 103,G00,087732,Bates; Kenneth Walter,88,0,90,2
1653302904303,MGT 105,A00,087733,Campbell; Robert Harold,102,0,120,18
1653302904826,MGT 106,A00,087734,Eberhard; Craig A,81,0,90,9
1653302905349,MGT 108R,A00,087735,Amir; On,84,0,90,6
1653302905876,MGT 109,A00,087736,Staff,77,0,90,13
1653302906406,MGT 112,A00,087737,Somasundaram; Tyagarajan,89,0,90,1
1653302906406,MGT 112,B00,087738,Somasundaram; Tyagarajan,86,0,90,4
1653302906406,MGT 112,C00,087739,Ehrich; Kristine R,86,0,90,4
1653302906406,MGT 112,D00,087740,Zimmermann; Carsten,65,0,90,25
1653302906932,MGT 121A,A00,087741,Wang; Helen Shan,65,0,70,5
1653302906932,MGT 121A,B00,087742,Wang; Helen Shan,64,0,70,6
1653302907457,MGT 131A,A00,087743,Houskeeper; Robert,146,0,150,4
1653302907982,MGT 132,A00,087744,Blakley; Bruce,88,0,90,2
1653302908509,MGT 134,A00,087745,Houskeeper; Robert,84,0,90,6
1653302909036,MGT 135,A00,087746,Anderson; John Charles,83,0,90,7
1653302909559,MGT 139,A00,087747,Perols; Johan Lars,88,0,90,2
1653302910088,MGT 153,A00,087748,Perols; Johan Lars,82,0,90,8
1653302910088,MGT 153,B00,087749,Phiroz; Zal Navroze,75,0,90,15
1653302910088,MGT 153,C00,087750,Phiroz; Zal Navroze,87,0,90,3
1653302910613,MGT 162R,A00,087751,Gneezy; Uri,64,0,90,26
1653302911143,MGT 164,A00,087752,McKay; Mary A,90,0,90,0
1653302911143,MGT 164,B00,087753,Meyer; Alison Bloomfield,0,0,0,0
1653302911143,MGT 164,C00,087754,Smith; Pamela Karen,82,0,90,8
1653302911671,MGT 166,A00,087755,Moran; Cathleen L.,89,0,90,1
1653302911671,MGT 166,B00,087756,Moran; Cathleen L.,90,0,90,0
1653302911671,MGT 166,C00,087757,Moran; Cathleen L.,90,0,90,0
1653302911671,MGT 166,D00,087758,Demill; Burritt,56,0,90,34
1653302912210,MGT 167,A00,087759,Klaas; Jeffrey David,88,0,90,2
1653302912210,MGT 167,B00,087760,Jacob; Jo Dee C,83,0,90,7
1653302912741,MGT 171,A00,087761,Phiroz; Zal Navroze,85,0,90,5
1653302913275,MGT 172,A00,087762,Hedges; Kathleen & Royal; Rebecca,96,0,100,4
1653302913275,MGT 172,B00,087763,Hedges; Kathleen,79,0,90,11
1653302913275,MGT 172,C00,087764,Zimmermann; Carsten,90,0,90,0
1653302913810,MGT 172R,A00,094888,Erat; Sanjiv,90,0,90,0
1653302914336,MGT 173,A00,087765,Hayes; Sherry Lorine,80,0,100,20
1653302914862,MGT 175,A00,087766,Gopal; Christopher S.,84,0,90,6
1653302915389,MGT 181,A00,087767,Buchanan; Harold G,114,0,120,6
1653302915389,MGT 181,B00,087768,Buchanan; Harold G,110,0,120,10
1653302915389,MGT 181,C00,087769,Bliss; Barbara Ann,109,0,120,11
1653302916443,MGT 185,A00,087771,Dunn; Louis Jean,83,0,90,7
1653302916968,MGT 187,A00,087772,Dunn; Louis Jean,138,0,146,8
1653302917497,MMW 11,A01,086931,duBois; Page Ann,4,0,4,0
1653302917497,MMW 11,A02,086932,duBois; Page Ann,4,0,4,0
1653302917497,MMW 11,A03,086933,duBois; Page Ann,3,0,4,1
1653302917497,MMW 11,A04,086934,duBois; Page Ann,3,0,4,1
1653302917497,MMW 11,A05,086935,duBois; Page Ann,4,0,4,0
1653302917497,MMW 11,A06,086936,duBois; Page Ann,3,0,4,1
1653302917497,MMW 11,A07,086937,duBois; Page Ann,4,0,4,0
1653302917497,MMW 11,A08,086938,duBois; Page Ann,4,0,4,0
1653302917497,MMW 11,A09,086939,duBois; Page Ann,4,0,4,0
1653302917497,MMW 11,A10,086940,duBois; Page Ann,4,0,4,0
1653302917497,MMW 11,A11,086941,duBois; Page Ann,4,0,4,0
1653302917497,MMW 11,A12,093877,duBois; Page Ann,3,0,4,1
1653302918029,MMW 11R,A01,093852,Herbst; Matthew,4,0,4,0
1653302918029,MMW 11R,A02,093853,Herbst; Matthew,4,0,4,0
1653302918029,MMW 11R,A03,093854,Herbst; Matthew,4,0,4,0
1653302918029,MMW 11R,A04,093855,Herbst; Matthew,4,0,4,0
1653302918029,MMW 11R,A05,093856,Herbst; Matthew,4,0,4,0
1653302918029,MMW 11R,A06,093857,Herbst; Matthew,4,0,4,0
1653302918029,MMW 11R,A07,093858,Herbst; Matthew,4,0,4,0
1653302918029,MMW 11R,A08,093859,Herbst; Matthew,4,0,4,0
1653302918029,MMW 11R,A09,093860,Herbst; Matthew,4,0,4,0
1653302918029,MMW 11R,A10,093861,Herbst; Matthew,4,0,4,0
1653302918029,MMW 11R,A11,093862,Herbst; Matthew,4,0,4,0
1653302918029,MMW 11R,A12,093863,Herbst; Matthew,4,0,4,0
1653302918029,MMW 11R,B01,093865,Herbst; Matthew,4,0,4,0
1653302918029,MMW 11R,B02,093866,Herbst; Matthew,4,0,4,0
1653302918029,MMW 11R,B03,093867,Herbst; Matthew,4,0,4,0
1653302918029,MMW 11R,B04,093868,Herbst; Matthew,4,0,4,0
1653302918029,MMW 11R,B05,093869,Herbst; Matthew,4,0,4,0
1653302918029,MMW 11R,B06,093870,Herbst; Matthew,4,0,4,0
1653302918029,MMW 11R,B07,093871,Herbst; Matthew,4,0,4,0
1653302918029,MMW 11R,B08,093872,Herbst; Matthew,4,0,4,0
1653302918029,MMW 11R,B09,093873,Herbst; Matthew,4,0,4,0
1653302918029,MMW 11R,B10,093874,Herbst; Matthew,4,0,4,0
1653302918029,MMW 11R,B11,093875,Herbst; Matthew,4,0,4,0
1653302918029,MMW 11R,B12,093876,Herbst; Matthew,4,0,4,0
1653302918554,MMW 14,A01,086968,Chang; Edmond Yi-Teh,28,0,28,0
1653302918554,MMW 14,A02,086969,Chang; Edmond Yi-Teh,27,0,28,1
1653302918554,MMW 14,A03,086970,Chang; Edmond Yi-Teh,21,0,28,7
1653302918554,MMW 14,A04,086971,Chang; Edmond Yi-Teh,27,0,28,1
1653302918554,MMW 14,A05,086972,Chang; Edmond Yi-Teh,26,0,28,2
1653302918554,MMW 14,A06,086973,Chang; Edmond Yi-Teh,28,0,28,0
1653302918554,MMW 14,A07,086974,Chang; Edmond Yi-Teh,27,0,28,1
1653302918554,MMW 14,A08,086975,Chang; Edmond Yi-Teh,25,0,28,3
1653302918554,MMW 14,A09,086976,Chang; Edmond Yi-Teh,0,0,0,0
1653302918554,MMW 14,A10,086977,Chang; Edmond Yi-Teh,27,0,28,1
1653302918554,MMW 14,A11,086978,Chang; Edmond Yi-Teh,26,0,28,2
1653302918554,MMW 14,A12,086979,Chang; Edmond Yi-Teh,27,0,28,1
1653302918554,MMW 14,A13,086980,Chang; Edmond Yi-Teh,28,0,28,0
1653302919080,MMW 121,A01,086982,Chang; Edmond Yi-Teh,0,0,0,0
1653302919080,MMW 121,A02,086983,Chang; Edmond Yi-Teh,0,0,0,0
1653302919080,MMW 121,A03,086984,Chang; Edmond Yi-Teh,2,0,4,2
1653302919080,MMW 121,A04,086985,Chang; Edmond Yi-Teh,4,0,4,0
1653302919080,MMW 121,A05,086986,Chang; Edmond Yi-Teh,4,0,4,0
1653302919080,MMW 121,A06,086987,Chang; Edmond Yi-Teh,4,0,4,0
1653302919080,MMW 121,A07,086988,Chang; Edmond Yi-Teh,4,0,4,0
1653302919080,MMW 121,A08,086989,Chang; Edmond Yi-Teh,4,0,4,0
1653302919080,MMW 121,B01,086991,Patterson; Patrick H.,4,0,4,0
1653302919080,MMW 121,B02,086992,Patterson; Patrick H.,4,0,4,0
1653302919080,MMW 121,B03,086993,Patterson; Patrick H.,4,0,4,0
1653302919080,MMW 121,B04,086994,Patterson; Patrick H.,3,0,4,1
1653302919080,MMW 121,B05,086995,Patterson; Patrick H.,4,0,4,0
1653302919080,MMW 121,B06,086996,Patterson; Patrick H.,4,0,4,0
1653302919080,MMW 121,B07,086997,Patterson; Patrick H.,4,0,4,0
1653302919080,MMW 121,B08,086998,Patterson; Patrick H.,4,0,4,0
1653302919080,MMW 121,B09,086999,Patterson; Patrick H.,4,0,4,0
1653302919080,MMW 121,B10,087000,Patterson; Patrick H.,4,0,4,0
1653302919080,MMW 121,B11,087001,Patterson; Patrick H.,0,0,0,0
1653302919080,MMW 121,B12,087002,Patterson; Patrick H.,0,0,0,0
1653302919612,MUS 1A,A01,090497,Staff,19,0,20,1
1653302919612,MUS 1A,A02,090498,Staff,13,0,20,7
1653302919612,MUS 1A,A03,090499,Staff,18,0,20,2
1653302919612,MUS 1A,A04,090500,Staff,19,0,20,1
1653302919612,MUS 1A,A05,090501,Staff,20,0,20,0
1653302919612,MUS 1A,A06,090502,Staff,20,0,20,0
1653302919612,MUS 1A,B01,090504,Staff,18,0,20,2
1653302919612,MUS 1A,B02,090505,Staff,20,0,20,0
1653302919612,MUS 1A,B03,090506,Staff,18,0,20,2
1653302919612,MUS 1A,B04,090507,Staff,18,0,20,2
1653302919612,MUS 1A,B05,090508,Staff,16,0,20,4
1653302919612,MUS 1A,B06,090509,Staff,20,0,20,0
1653302920143,MUS 2A,A01,090511,Carlson; Erik Norman,19,0,20,1
1653302920670,MUS 2AK,A00,090512,Ohnishi; Takae,24,0,25,1
1653302920670,MUS 2AK,B00,090513,Ohnishi; Takae,15,0,15,0
1653302921198,MUS 4,A01,090515,Staff,24,0,25,1
1653302921198,MUS 4,A02,090516,Staff,24,0,25,1
1653302921198,MUS 4,A03,090517,Staff,22,0,25,3
1653302921198,MUS 4,A04,090518,Staff,24,0,25,1
1653302921198,MUS 4,A05,090519,Staff,25,0,25,0
1653302921198,MUS 4,A06,090520,Staff,25,0,25,0
1653302921198,MUS 4,A07,090521,Staff,24,0,25,1
1653302921198,MUS 4,A08,090522,Staff,24,0,25,1
1653302921724,MUS 5,A01,090524,Staff,20,0,20,0
1653302921724,MUS 5,A02,090525,Staff,18,0,20,2
1653302921724,MUS 5,A03,090526,Staff,20,0,20,0
1653302921724,MUS 5,A04,090527,Staff,20,0,20,0
1653302921724,MUS 5,A05,090528,Staff,19,0,20,1
1653302922249,MUS 6,A01,090530,Staff,22,0,25,3
1653302922249,MUS 6,A02,090531,Staff,25,0,25,0
1653302922249,MUS 6,A03,090532,Staff,25,0,25,0
1653302922249,MUS 6,A04,090533,Staff,23,0,25,2
1653302922773,MUS 8,A01,090535,Kenyatta; Kamau,17,0,25,8
1653302922773,MUS 8,A02,090536,Kenyatta; Kamau,19,0,25,6
1653302922773,MUS 8,A03,090537,Kenyatta; Kamau,17,0,25,8
1653302922773,MUS 8,A04,090538,Kenyatta; Kamau,21,0,25,4
1653302923302,MUS 12,A01,090540,Narucki; Susan M,20,0,20,0
1653302923302,MUS 12,A02,090541,Narucki; Susan M,20,0,20,0
1653302923302,MUS 12,A03,090542,Narucki; Susan M,17,0,20,3
1653302923842,MUS 15,A01,090544,Staff,21,0,25,4
1653302923842,MUS 15,A02,090545,Staff,23,0,25,2
1653302923842,MUS 15,A03,090546,Staff,24,0,25,1
1653302923842,MUS 15,A04,090547,Staff,22,0,25,3
1653302923842,MUS 15,A05,090548,Staff,25,0,25,0
1653302923842,MUS 15,A06,090549,Staff,24,0,25,1
1653302924370,MUS 19R,A01,090551,Britt; King James,17,0,20,3
1653302924370,MUS 19R,A02,090552,Britt; King James,19,0,20,1
1653302924370,MUS 19R,A03,090553,Britt; King James,20,0,20,0
1653302924370,MUS 19R,A04,090554,Britt; King James,19,0,20,1
1653302924370,MUS 19R,A05,090555,Britt; King James,20,0,20,0
1653302924370,MUS 19R,A06,090556,Britt; King James,18,0,20,2
1653302924370,MUS 19R,A07,090557,Britt; King James,19,0,20,1
1653302924370,MUS 19R,A08,090558,Britt; King James,19,0,20,1
1653302924370,MUS 19R,A09,090559,Britt; King James,20,0,20,0
1653302924370,MUS 19R,A10,090560,Britt; King James,20,0,20,0
1653302924370,MUS 19R,B01,090562,Britt; King James,10,0,10,0
1653302924370,MUS 19R,B02,090563,Britt; King James,10,0,10,0
1653302924370,MUS 19R,B03,090564,Britt; King James,10,0,10,0
1653302924370,MUS 19R,B04,090565,Britt; King James,10,0,10,0
1653302924370,MUS 19R,B05,090566,Britt; King James,10,0,10,0
1653302924370,MUS 19R,B06,090567,Britt; King James,10,0,10,0
1653302924370,MUS 19R,B07,090568,Britt; King James,10,0,10,0
1653302924370,MUS 19R,B08,090569,Britt; King James,10,0,10,0
1653302924370,MUS 19R,B09,090570,Britt; King James,10,0,10,0
1653302924370,MUS 19R,B10,090571,Britt; King James,10,0,10,0
1653302924893,MUS 20,A01,090573,Borgo; David Garcia,12,0,15,3
1653302924893,MUS 20,A02,090574,Borgo; David Garcia,14,0,15,1
1653302924893,MUS 20,A03,090575,Borgo; David Garcia,13,0,15,2
1653302925429,MUS 32,001,094074,Staff,10,0,10,0
1653302925429,MUS 32,002,094075,Kenyatta; Kamau,10,0,10,0
1653302925429,MUS 32,003,094076,Curtis; Charles Rector,10,0,10,0
1653302925429,MUS 32,005,094078,Terrazas Perez; Wilfrido D,10,0,10,0
1653302925429,MUS 32,006,094079,Ohnishi; Takae,10,0,10,0
1653302925429,MUS 32,007,094080,Burr; Anthony I,10,0,10,0
1653302925429,MUS 32,008,094081,Carlson; Erik Norman,10,0,10,0
1653302925429,MUS 32,009,094082,Dresser; Mark Stuart,10,0,10,0
1653302925429,MUS 32,011,094084,Richards; Stephanie F,10,0,10,0
1653302925429,MUS 32,012,094085,Borgo; David Garcia,10,0,10,0
1653302925429,MUS 32,013,094086,Paganos Koukakis; Dimitrios,10,0,10,0
1653302925429,MUS 32,014,094087,Jones; Michael David,10,0,10,0
1653302925955,MUS 32V,A00,094355,Zazueta Cervera; Miguel Angel,10,0,10,0
1653302925955,MUS 32V,B00,094089,Flores; Mariana,10,0,10,0
1653302926480,MUS 32VM,A00,094090,Zazueta Cervera; Miguel Angel,15,0,15,0
1653302927006,MUS 33A,A00,090576,Liang; Lei,24,0,25,1
1653302927530,MUS 43,A00,090577,Burr; Anthony I,92,0,100,8
1653302928056,MUS 95C,B00,094829,Staff,28,0,30,2
1653302928580,MUS 95D,A00,090579,Staff,30,0,30,0
1653302929103,MUS 95E,A00,090580,Staff,30,0,30,0
1653302929626,MUS 95G,A00,090581,Anderson; Kenneth,384,0,395,11
1653302929626,MUS 95G,B00,090582,Anderson; Kenneth,393,0,395,2
1653302930149,MUS 95JC,A00,090583,Kenyatta; Kamau,35,0,35,0
1653302930672,MUS 95L,A00,090584,Staff,30,0,30,0
1653302931194,MUS 95W,A00,090585,Seshadri; Kartik,60,0,60,0
1653302931194,MUS 95W,B00,090586,Seshadri; Kartik,30,0,30,0
1653302931722,MUS 101A,A01,090588,Staff,29,0,30,1
1653302932248,MUS 103A,A00,090589,Ung; Chinary,15,0,15,0
1653302932774,MUS 107,A00,090590,Terrazas Perez; Wilfrido D,30,0,30,0
1653302933300,MUS 111,A00,090591,Yadegari; Shahrokh D,124,0,130,6
1653302933850,MUS 114,A00,090592,Curtis; Charles Rector,117,0,125,8
1653302934387,MUS 120A,A01,090594,Cimini; Amy Marie,29,0,30,1
1653302934915,MUS 126R,A00,090595,Borgo; David Garcia,106,0,115,9
1653302935442,MUS 130,A00,090596,Ohnishi; Takae,30,0,30,0
1653302935966,MUS 132,001,094091,Nourai; Keyarash,10,0,10,0
1653302935966,MUS 132,002,094093,Kenyatta; Kamau,10,0,10,0
1653302935966,MUS 132,003,094094,Curtis; Charles Rector,10,0,10,0
1653302935966,MUS 132,005,094096,Terrazas Perez; Wilfrido D,10,0,10,0
1653302935966,MUS 132,006,094097,Ohnishi; Takae,10,0,10,0
1653302935966,MUS 132,007,094098,Burr; Anthony I,10,0,10,0
1653302935966,MUS 132,008,094099,Carlson; Erik Norman,10,0,10,0
1653302935966,MUS 132,009,094100,Dresser; Mark Stuart,10,0,10,0
1653302935966,MUS 132,011,094102,Richards; Stephanie F,10,0,10,0
1653302935966,MUS 132,012,094103,Borgo; David Garcia,10,0,10,0
1653302935966,MUS 132,013,094104,Jones; Michael David,10,0,10,0
1653302935966,MUS 132,014,094105,Staff,10,0,10,0
1653302936489,MUS 132V,A00,094106,Narucki; Susan M,15,0,15,0
1653302937012,MUS 134,A00,090597,Staff,30,0,30,0
1653302937539,MUS 137A,A00,090598,Kenyatta; Kamau,30,0,30,0
1653302938065,MUS 143,A00,090599,Staff,26,0,30,4
1653302939124,MUS 173,A00,090600,Britt; King James,19,0,30,11
1653302939647,MUS 174A,A00,090601,Staff,8,0,15,7
1653302940705,NANO 4,A01,088199,Vazquez Mena; Oscar,20,0,20,0
1653302940705,NANO 4,B01,088201,Vazquez Mena; Oscar,20,0,20,0
1653302940705,NANO 4,C01,088203,Vazquez Mena; Oscar,20,0,20,0
1653302941236,NANO 15,A01,088205,Lubarda; Vlado,50,0,50,0
1653302941236,NANO 15,B01,088207,Lubarda; Vlado,50,0,50,0
1653302941765,NANO 20L,A00,088208,Sirbuly; Donald,27,0,30,3
1653302941765,NANO 20L,B00,088209,Sirbuly; Donald,29,0,30,1
1653302942288,NANO 100L,A00,088210,Vecchio; Kenneth S,24,0,30,6
1653302942814,NANO 102,A00,088211,Tao; Andrea Rae,94,0,100,6
1653302943338,NANO 110,A00,088212,Pascal; Tod A,99,0,100,1
1653302943863,NANO 111,A00,088213,Fenning; David,45,0,50,5
1653302944395,NANO 117,A00,088214,Cubukcu; Ertugrul,71,0,75,4
1653302944923,NANO 119,A00,088215,Vazquez Mena; Oscar,50,0,50,0
1653302945446,NANO 159,A00,088216,Wang; Joseph,33,0,40,7
1653302945969,NANO 181,A01,088218,Ong; Shyue Ping,22,0,25,3
1653302946495,PHIL 1,A00,090815,Sher; Gila,57,0,60,3
1653302947019,PHIL 10,A01,090817,Grush; Rick Scott,37,0,40,3
1653302947019,PHIL 10,A02,090818,Grush; Rick Scott,37,0,40,3
1653302947019,PHIL 10,A03,090819,Grush; Rick Scott,38,0,40,2
1653302947019,PHIL 10,A04,090820,Grush; Rick Scott,40,0,40,0
1653302947019,PHIL 10,A05,090821,Grush; Rick Scott,38,0,40,2
1653302947019,PHIL 10,A06,090822,Grush; Rick Scott,39,0,40,1
1653302947548,PHIL 12,A01,090824,Bechtel; William,20,0,25,5
1653302947548,PHIL 12,A02,090825,Bechtel; William,24,0,25,1
1653302947548,PHIL 12,A03,090826,Bechtel; William,25,0,25,0
1653302947548,PHIL 12,A04,090827,Bechtel; William,25,0,25,0
1653302948076,PHIL 13,A01,090829,Wonderly; Monique L.,25,0,25,0
1653302948076,PHIL 13,A02,090830,Wonderly; Monique L.,24,0,25,1
1653302948076,PHIL 13,A03,090831,Wonderly; Monique L.,24,0,25,1
1653302948076,PHIL 13,A04,090832,Wonderly; Monique L.,25,0,25,0
1653302948601,PHIL 27,A01,090834,Harrell; Maralee Mae,23,0,35,12
1653302948601,PHIL 27,A02,090835,Harrell; Maralee Mae,35,0,35,0
1653302948601,PHIL 27,A03,090836,Harrell; Maralee Mae,33,0,35,2
1653302948601,PHIL 27,A04,090837,Harrell; Maralee Mae,33,0,35,2
1653302948601,PHIL 27,A05,090838,Harrell; Maralee Mae,35,0,35,0
1653302948601,PHIL 27,A06,090839,Harrell; Maralee Mae,35,0,35,0
1653302949125,PHIL 28,A01,090841,Bazargan-Forward; Saba,31,0,35,4
1653302949125,PHIL 28,A02,090842,Bazargan-Forward; Saba,31,0,35,4
1653302949125,PHIL 28,A03,090843,Bazargan-Forward; Saba,35,0,35,0
1653302949125,PHIL 28,A04,090844,Bazargan-Forward; Saba,30,0,35,5
1653302949125,PHIL 28,A05,090845,Bazargan-Forward; Saba,33,0,35,2
1653302949125,PHIL 28,A06,090846,Bazargan-Forward; Saba,34,0,35,1
1653302949125,PHIL 28,A07,090847,Bazargan-Forward; Saba,32,0,35,3
1653302949125,PHIL 28,A08,090848,Bazargan-Forward; Saba,33,0,35,2
1653302949657,PHIL 31,A00,090849,Johnson; Monte,59,0,60,1
1653302950185,PHIL 100,A00,090852,Nelkin; Dana Kay,28,0,35,7
1653302950709,PHIL 110,A00,090853,Johnson; Monte,29,0,30,1
1653302951234,PHIL 120,A00,090854,Rickless; Samuel Charles,23,0,35,12
1653302951758,PHIL 123,A00,090855,Sher; Gila,38,0,40,2
1653302952285,PHIL 131,A00,090856,Cohen; Jonathan David,34,0,35,1
1653302952809,PHIL 132,A00,090857,Carr; Jennifer Rose,33,0,35,2
1653302953404,PHIL 138,A00,090858,Brink; David O.,34,0,40,6
1653302953929,PHIL 147,A00,090860,Fulkerson; Matthew Todd,33,0,35,2
1653302954455,PHIL 150,A00,090861,Bechtel; William,36,0,40,4
1653302954978,PHIL 155,A00,090862,Vargas; Manuel Rogelio,38,0,40,2
1653302955500,PHIL 165,A00,090863,Rickless; Samuel Charles,59,0,70,11
1653302956024,PHIL 172,A00,090864,Bazargan-Forward; Saba,37,0,40,3
1653302956547,PHIL 173,A00,090865,Wonderly; Monique L.,33,0,40,7
1653302957083,PHYS 1A,A00,088555,Koslover; Elena F,354,0,362,8
1653302957083,PHYS 1A,B00,088556,Koslover; Elena F,343,0,362,19
1653302957083,PHYS 1A,C00,088557,Shpyrko; Oleg,326,0,362,36
1653302957618,PHYS 1AL,001,088558,Tsai; Philbert S,30,0,30,0
1653302957618,PHYS 1AL,002,088559,Tsai; Philbert S,30,0,30,0
1653302957618,PHYS 1AL,003,088560,Tsai; Philbert S,23,0,30,7
1653302957618,PHYS 1AL,004,088561,Tsai; Philbert S,26,0,30,4
1653302957618,PHYS 1AL,005,088562,Tsai; Philbert S,24,0,30,6
1653302957618,PHYS 1AL,006,088563,Tsai; Philbert S,30,0,30,0
1653302957618,PHYS 1AL,007,088564,Tsai; Philbert S,26,0,30,4
1653302957618,PHYS 1AL,008,088565,Tsai; Philbert S,29,0,30,1
1653302957618,PHYS 1AL,009,088566,Tsai; Philbert S,28,0,30,2
1653302957618,PHYS 1AL,010,088567,Tsai; Philbert S,30,0,30,0
1653302957618,PHYS 1AL,011,088568,Tsai; Philbert S,29,0,30,1
1653302957618,PHYS 1AL,012,088569,Tsai; Philbert S,29,0,30,1
1653302957618,PHYS 1AL,013,088570,Tsai; Philbert S,30,0,30,0
1653302957618,PHYS 1AL,014,088571,Tsai; Philbert S,29,0,30,1
1653302957618,PHYS 1AL,015,088572,Tsai; Philbert S,23,0,30,7
1653302957618,PHYS 1AL,016,088573,Tsai; Philbert S,28,0,30,2
1653302957618,PHYS 1AL,017,088574,Tsai; Philbert S,29,0,30,1
1653302957618,PHYS 1AL,018,088575,Tsai; Philbert S,28,0,30,2
1653302957618,PHYS 1AL,019,088576,Tsai; Philbert S,26,0,30,4
1653302957618,PHYS 1AL,020,088577,Tsai; Philbert S,29,0,30,1
1653302957618,PHYS 1AL,021,088578,Tsai; Philbert S,30,0,30,0
1653302957618,PHYS 1AL,022,088579,Tsai; Philbert S,30,0,30,0
1653302957618,PHYS 1AL,023,088580,Tsai; Philbert S,30,0,30,0
1653302957618,PHYS 1AL,024,088581,Tsai; Philbert S,30,0,30,0
1653302957618,PHYS 1AL,025,088582,Tsai; Philbert S,26,0,30,4
1653302957618,PHYS 1AL,026,088583,Tsai; Philbert S,29,0,30,1
1653302957618,PHYS 1AL,027,088584,Tsai; Philbert S,28,0,30,2
1653302957618,PHYS 1AL,028,088585,Tsai; Philbert S,30,0,30,0
1653302957618,PHYS 1AL,029,088586,Tsai; Philbert S,27,0,30,3
1653302957618,PHYS 1AL,030,088587,Tsai; Philbert S,29,0,30,1
1653302957618,PHYS 1AL,031,088588,Tsai; Philbert S,30,0,30,0
1653302957618,PHYS 1AL,032,088589,Tsai; Philbert S,30,0,30,0
1653302957618,PHYS 1AL,033,088590,Tsai; Philbert S,30,0,30,0
1653302957618,PHYS 1AL,034,088591,Tsai; Philbert S,30,0,30,0
1653302957618,PHYS 1AL,035,088592,Tsai; Philbert S,29,0,30,1
1653302957618,PHYS 1AL,036,088593,Tsai; Philbert S,30,0,30,0
1653302958141,PHYS 1B,A00,088594,Groisman; Alexander,351,0,360,9
1653302958666,PHYS 1BL,001,088595,Tsai; Philbert S,30,0,30,0
1653302958666,PHYS 1BL,002,088596,Tsai; Philbert S,25,0,30,5
1653302958666,PHYS 1BL,003,088597,Tsai; Philbert S,27,0,30,3
1653302958666,PHYS 1BL,004,088598,Tsai; Philbert S,30,0,30,0
1653302958666,PHYS 1BL,005,088599,Tsai; Philbert S,29,0,30,1
1653302958666,PHYS 1BL,006,088600,Tsai; Philbert S,25,0,30,5
1653302958666,PHYS 1BL,007,088601,Tsai; Philbert S,30,0,30,0
1653302958666,PHYS 1BL,008,088602,Tsai; Philbert S,29,0,30,1
1653302958666,PHYS 1BL,009,088603,Tsai; Philbert S,30,0,30,0
1653302958666,PHYS 1BL,010,088604,Tsai; Philbert S,30,0,30,0
1653302958666,PHYS 1BL,011,088605,Tsai; Philbert S,28,0,30,2
1653302958666,PHYS 1BL,012,088606,Tsai; Philbert S,26,0,30,4
1653302959191,PHYS 1C,A00,088607,Tsai; Philbert S,334,0,360,26
1653302959715,PHYS 1CL,001,088608,Tsai; Philbert S,30,0,30,0
1653302959715,PHYS 1CL,002,088609,Tsai; Philbert S,24,0,30,6
1653302959715,PHYS 1CL,003,088610,Tsai; Philbert S,24,0,30,6
1653302959715,PHYS 1CL,004,088611,Tsai; Philbert S,29,0,30,1
1653302959715,PHYS 1CL,005,088612,Tsai; Philbert S,17,0,30,13
1653302959715,PHYS 1CL,006,088613,Tsai; Philbert S,19,0,30,11
1653302959715,PHYS 1CL,007,088614,Tsai; Philbert S,30,0,30,0
1653302959715,PHYS 1CL,008,088615,Tsai; Philbert S,26,0,30,4
1653302959715,PHYS 1CL,009,088616,Tsai; Philbert S,27,0,30,3
1653302959715,PHYS 1CL,010,088617,Tsai; Philbert S,29,0,30,1
1653302959715,PHYS 1CL,011,088618,Tsai; Philbert S,27,0,30,3
1653302959715,PHYS 1CL,012,088619,Tsai; Philbert S,24,0,30,6
1653302960247,PHYS 2A,A01,092602,Meyertholen; Andrew D.,26,0,30,4
1653302960247,PHYS 2A,A02,092603,Meyertholen; Andrew D.,28,0,30,2
1653302960247,PHYS 2A,A03,092604,Meyertholen; Andrew D.,29,0,30,1
1653302960247,PHYS 2A,A04,092605,Meyertholen; Andrew D.,30,0,30,0
1653302960247,PHYS 2A,A05,092606,Meyertholen; Andrew D.,29,0,30,1
1653302960247,PHYS 2A,A06,092607,Meyertholen; Andrew D.,29,0,30,1
1653302960247,PHYS 2A,A07,092608,Meyertholen; Andrew D.,30,0,30,0
1653302960247,PHYS 2A,A08,092609,Meyertholen; Andrew D.,30,0,30,0
1653302960247,PHYS 2A,A09,092610,Meyertholen; Andrew D.,27,0,30,3
1653302960247,PHYS 2A,A10,092611,Meyertholen; Andrew D.,30,0,30,0
1653302960247,PHYS 2A,A11,092612,Meyertholen; Andrew D.,30,0,30,0
1653302960247,PHYS 2A,A12,094499,Meyertholen; Andrew D.,27,0,30,3
1653302960780,PHYS 2B,A01,092613,Branson; James G,28,0,30,2
1653302960780,PHYS 2B,A02,092614,Branson; James G,29,0,30,1
1653302960780,PHYS 2B,A03,092615,Branson; James G,30,0,30,0
1653302960780,PHYS 2B,A04,092616,Branson; James G,30,0,30,0
1653302960780,PHYS 2B,A05,092617,Branson; James G,29,0,30,1
1653302960780,PHYS 2B,A06,092618,Branson; James G,29,0,30,1
1653302960780,PHYS 2B,A07,092619,Branson; James G,29,0,30,1
1653302960780,PHYS 2B,A08,092620,Branson; James G,0,0,0,0
1653302960780,PHYS 2B,A09,092621,Branson; James G,0,0,0,0
1653302960780,PHYS 2B,A10,092622,Branson; James G,0,0,0,0
1653302960780,PHYS 2B,A11,092623,Branson; James G,0,0,0,0
1653302960780,PHYS 2B,A12,092624,Branson; James G,30,0,30,0
1653302961306,PHYS 2C,A01,092625,Barreiro Guerrero; Julio,26,0,30,4
1653302961306,PHYS 2C,A02,092626,Barreiro Guerrero; Julio,28,0,30,2
1653302961306,PHYS 2C,A03,092627,Barreiro Guerrero; Julio,29,0,30,1
1653302961306,PHYS 2C,A04,092628,Barreiro Guerrero; Julio,29,0,30,1
1653302961306,PHYS 2C,A05,092629,Barreiro Guerrero; Julio,30,0,30,0
1653302961306,PHYS 2C,A06,092630,Barreiro Guerrero; Julio,30,0,30,0
1653302961306,PHYS 2C,A07,092631,Barreiro Guerrero; Julio,30,0,30,0
1653302961306,PHYS 2C,A08,092632,Barreiro Guerrero; Julio,30,0,30,0
1653302961306,PHYS 2C,A09,092633,Barreiro Guerrero; Julio,29,0,30,1
1653302961306,PHYS 2C,A10,092634,Barreiro Guerrero; Julio,29,0,30,1
1653302961306,PHYS 2C,A11,092635,Barreiro Guerrero; Julio,27,0,30,3
1653302961306,PHYS 2C,A12,092636,Barreiro Guerrero; Julio,29,0,30,1
1653302961306,PHYS 2C,B01,092637,Barreiro Guerrero; Julio,29,0,30,1
1653302961306,PHYS 2C,B02,092638,Barreiro Guerrero; Julio,30,0,30,0
1653302961306,PHYS 2C,B03,092639,Barreiro Guerrero; Julio,28,0,30,2
1653302961306,PHYS 2C,B04,092640,Barreiro Guerrero; Julio,29,0,30,1
1653302961306,PHYS 2C,B05,092641,Barreiro Guerrero; Julio,26,0,30,4
1653302961306,PHYS 2C,B06,092642,Barreiro Guerrero; Julio,28,0,30,2
1653302961306,PHYS 2C,B07,092643,Barreiro Guerrero; Julio,29,0,30,1
1653302961306,PHYS 2C,B08,092644,Barreiro Guerrero; Julio,30,0,30,0
1653302961306,PHYS 2C,B09,092645,Barreiro Guerrero; Julio,29,0,30,1
1653302961306,PHYS 2C,B10,092646,Barreiro Guerrero; Julio,29,0,30,1
1653302961306,PHYS 2C,B11,092647,Barreiro Guerrero; Julio,30,0,30,0
1653302961306,PHYS 2C,B12,092648,Barreiro Guerrero; Julio,30,0,30,0
1653302961831,PHYS 2CL,A01,088625,Du; Chunhui,26,0,30,4
1653302961831,PHYS 2CL,A02,088626,Du; Chunhui,29,0,30,1
1653302961831,PHYS 2CL,A03,088627,Du; Chunhui,21,0,30,9
1653302961831,PHYS 2CL,A04,088628,Du; Chunhui,30,0,30,0
1653302961831,PHYS 2CL,A05,088629,Du; Chunhui,29,0,30,1
1653302961831,PHYS 2CL,A06,088630,Du; Chunhui,24,0,30,6
1653302961831,PHYS 2CL,A07,088631,Du; Chunhui,28,0,30,2
1653302961831,PHYS 2CL,A08,088632,Du; Chunhui,28,0,30,2
1653302961831,PHYS 2CL,A09,088633,Du; Chunhui,24,0,30,6
1653302961831,PHYS 2CL,A10,088634,Du; Chunhui,29,0,30,1
1653302961831,PHYS 2CL,A11,088635,Du; Chunhui,27,0,30,3
1653302961831,PHYS 2CL,A12,088636,Du; Chunhui,30,0,30,0
1653302962356,PHYS 2D,A01,092649,Hirsch; Jorge Eduardo,30,0,30,0
1653302962356,PHYS 2D,A02,092650,Hirsch; Jorge Eduardo,28,0,30,2
1653302962356,PHYS 2D,A03,092651,Hirsch; Jorge Eduardo,30,0,30,0
1653302962356,PHYS 2D,A04,092652,Hirsch; Jorge Eduardo,30,0,30,0
1653302962356,PHYS 2D,A05,092653,Hirsch; Jorge Eduardo,30,0,30,0
1653302962356,PHYS 2D,A06,092654,Hirsch; Jorge Eduardo,30,0,30,0
1653302962880,PHYS 2DL,A01,088639,Butov; Leonid,7,0,16,9
1653302962880,PHYS 2DL,A02,088640,Butov; Leonid,13,0,16,3
1653302962880,PHYS 2DL,A03,094501,Butov; Leonid,13,0,16,3
1653302962880,PHYS 2DL,A04,094502,Butov; Leonid,16,0,16,0
1653302963404,PHYS 4C,A01,092655,Averitt; Richard Douglas,28,0,30,2
1653302963404,PHYS 4C,A02,092656,Averitt; Richard Douglas,30,0,30,0
1653302963404,PHYS 4C,A03,092657,Averitt; Richard Douglas,30,0,30,0
1653302963404,PHYS 4C,A04,092658,Staff,30,0,30,0
1653302963927,PHYS 5,A01,092662,Konopacky; Quinn Morgan,197,0,200,3
1653302964451,PHYS 10,A01,092663,Tytler; David Robert,191,0,192,1
1653302964978,PHYS 100A,A01,092660,Shpyrko; Oleg,114,0,120,6
1653302965501,PHYS 110A,A01,092664,Arovas; Daniel P,116,0,120,4
1653302966024,PHYS 122,A01,088647,Yang; Liang,30,0,40,10
1653302966551,PHYS 130B,A01,092661,Grover; Tarun,106,0,120,14
1653302967074,PHYS 139,A00,088649,Kuti; Julius,19,0,20,1
1653302967600,PHYS 140A,A01,092665,Shotwell; Brian,105,0,120,15
1653302968125,PHYS 161,A01,092666,Fuller; George Michael,46,0,65,19
1653302968654,PHYS 163,A01,092667,Keres; Dusan,48,0,50,2
1653302969187,PHYS 175,A00,088653,Dudko; Olga,18,0,20,2
1653302969711,PHYS 191,A00,088654,Shpyrko; Oleg,26,0,30,4
1653302970237,POLI 11D,A01,090896,Ferree; Karen E,29,0,30,1
1653302970237,POLI 11D,A02,090897,Ferree; Karen E,28,0,30,2
1653302970237,POLI 11D,A03,090899,Ferree; Karen E,28,0,30,2
1653302970237,POLI 11D,A04,090900,Ferree; Karen E,29,0,30,1
1653302970767,POLI 12D,A01,090902,Roeder; Philip G,26,0,30,4
1653302970767,POLI 12D,A02,090903,Roeder; Philip G,27,0,30,3
1653302970767,POLI 12D,A05,090906,Roeder; Philip G,28,0,30,2
1653302970767,POLI 12D,A06,090907,Roeder; Philip G,30,0,30,0
1653302971291,POLI 13DR,A01,090909,Forman; Fonna,26,0,30,4
1653302971291,POLI 13DR,A02,090910,Forman; Fonna,30,0,30,0
1653302971291,POLI 13DR,A03,090911,Forman; Fonna,28,0,30,2
1653302971291,POLI 13DR,A04,090912,Forman; Fonna,30,0,30,0
1653302971291,POLI 13DR,A05,090913,Forman; Fonna,28,0,30,2
1653302971291,POLI 13DR,A06,090914,Forman; Fonna,34,0,34,0
1653302971820,POLI 27,A01,090916,Elgin; Samuel Zincke,23,0,30,7
1653302971820,POLI 27,A02,090917,Elgin; Samuel Zincke,26,0,30,4
1653302971820,POLI 27,A03,090918,Elgin; Samuel Zincke,30,0,30,0
1653302971820,POLI 27,A04,090919,Elgin; Samuel Zincke,28,0,30,2
1653302971820,POLI 27,A05,090920,Elgin; Samuel Zincke,24,0,30,6
1653302971820,POLI 27,A06,090921,Elgin; Samuel Zincke,29,0,30,1
1653302972346,POLI 28,A01,090923,Elgin; Samuel Zincke,23,0,30,7
1653302972346,POLI 28,A02,090924,Elgin; Samuel Zincke,26,0,30,4
1653302972346,POLI 28,A05,090927,Elgin; Samuel Zincke,23,0,30,7
1653302972346,POLI 28,A06,090928,Elgin; Samuel Zincke,23,0,30,7
1653302972877,POLI 30D,A01,090930,Desposato; Scott,22,0,24,2
1653302972877,POLI 30D,A02,090931,Desposato; Scott,22,0,24,2
1653302972877,POLI 30D,A03,090932,Desposato; Scott,23,0,24,1
1653302972877,POLI 30D,A04,090933,Desposato; Scott,24,0,24,0
1653302972877,POLI 30D,A05,090934,Desposato; Scott,23,0,24,1
1653302972877,POLI 30D,A06,090935,Desposato; Scott,24,0,24,0
1653302973405,POLI 100G,A00,090936,Fletcher; Nathan,199,0,208,9
1653302973929,POLI 100V,A00,090937,Gause; LaGina,111,0,115,4
1653302974454,POLI 100W,A00,090938,Paglayan; Agustina,161,0,165,4
1653302974976,POLI 104A,A00,090940,Smith; Glenn Chatmas,186,0,195,9
1653302975503,POLI 104F,A00,090941,Smith; Glenn Chatmas,11,0,19,8
1653302976033,POLI 104M,A00,090942,Stephens; Mattheus E,156,0,165,9
1653302976561,POLI 110A,A00,090943,Wiens; David,39,0,44,5
1653302977092,POLI 110F,A00,090944,Elgin; Samuel Zincke,50,0,50,0
1653302977615,POLI 113A,A00,090945,Magagna; Victor Valentine,469,0,475,6
1653302977615,POLI 113A,B00,090946,Magagna; Victor Valentine,467,0,475,8
1653302978141,POLI 117R,A00,090947,Forman; Fonna,16,0,40,24
1653302978669,POLI 120E,A00,090948,Strom; Kaare,47,0,50,3
1653302979196,POLI 120G,A00,090949,Fisk; David Lee,110,0,115,5
1653302979723,POLI 120H,A00,090950,Fisk; David Lee,111,0,115,4
1653302980249,POLI 133A,A00,090951,Naoi; Megumi,156,0,165,9
1653302980775,POLI 135,A00,090952,Fisk; David Lee,111,0,115,4
1653302981298,POLI 142J,A00,090953,Slantchev; Branislav,45,0,50,5
1653302981826,POLI 143,A00,090954,Gartzke; Erik,111,0,115,4
1653302982351,POLI 149,A00,090955,Joseph; Michael F,152,0,165,13
1653302982876,POLI 151,A00,090956,Schneider; Christina,92,0,100,8
1653302983399,POLI 165,A00,090957,Warren; Scott,45,0,50,5
1653302983927,POLI 178,A00,090958,Joseph; Michael F,34,0,50,16
1653302984459,POLI 191A,A00,090959,Forman; Fonna & Hoston; Germaine,25,0,25,0
1653302984987,POLI 194,A00,090960,Hill; Seth J,9999,0,9999,0
1653302985515,POLI 194SD,A00,090961,Nichter; Maysa,9999,0,9999,0
1653302986039,POLI 197SD,001,090962,Nichter; Maysa,9999,0,9999,0
1653302986564,PSYC 1,A00,088391,Ferreira; Victor,194,0,200,6
1653302987092,PSYC 2,A00,093916,Moranton; Nirelia Melbina-,192,0,195,3
1653302987621,PSYC 3,A00,088392,Pilegard; Celeste Cristine,221,0,225,4
1653302988144,PSYC 6,A00,088393,McCullough; Michael E,198,0,200,2
1653302988676,PSYC 7,A00,088394,Powell; Lindsey Jane,196,0,200,4
1653302989202,PSYC 60,A01,088397,Lowe; Angela Beth,12,0,25,13
1653302989202,PSYC 60,A02,088398,Lowe; Angela Beth,25,0,25,0
1653302989202,PSYC 60,A03,088399,Lowe; Angela Beth,24,0,25,1
1653302989202,PSYC 60,A04,088400,Lowe; Angela Beth,23,0,25,2
1653302989202,PSYC 60,A05,088401,Lowe; Angela Beth,24,0,25,1
1653302989202,PSYC 60,A06,088402,Lowe; Angela Beth,25,0,25,0
1653302989202,PSYC 60,A07,088403,Lowe; Angela Beth,24,0,25,1
1653302989202,PSYC 60,B01,088405,Rickard; Timothy C.,25,0,25,0
1653302989202,PSYC 60,B02,088406,Rickard; Timothy C.,25,0,25,0
1653302989202,PSYC 60,B03,088407,Rickard; Timothy C.,25,0,25,0
1653302989202,PSYC 60,B04,088408,Rickard; Timothy C.,23,0,25,2
1653302989202,PSYC 60,B05,088410,Rickard; Timothy C.,24,0,25,1
1653302989202,PSYC 60,B06,088411,Rickard; Timothy C.,24,0,25,1
1653302989202,PSYC 60,B07,088412,Rickard; Timothy C.,24,0,25,1
1653302989725,PSYC 70,A01,088414,Pilegard; Celeste Cristine,17,0,25,8
1653302989725,PSYC 70,A02,088415,Pilegard; Celeste Cristine,24,0,25,1
1653302989725,PSYC 70,A03,088416,Pilegard; Celeste Cristine,25,0,25,0
1653302989725,PSYC 70,A04,088417,Pilegard; Celeste Cristine,25,0,25,0
1653302989725,PSYC 70,A05,088418,Pilegard; Celeste Cristine,22,0,25,3
1653302989725,PSYC 70,A06,088419,Pilegard; Celeste Cristine,19,0,25,6
1653302990248,PSYC 71,A01,088421,Lowe; Angela Beth,15,0,25,10
1653302990248,PSYC 71,A02,088422,Lowe; Angela Beth,21,0,25,4
1653302990248,PSYC 71,B01,088424,Steiner; Eric Tomas,20,0,25,5
1653302990248,PSYC 71,B02,088425,Steiner; Eric Tomas,23,0,25,2
1653302990772,PSYC 87,A00,093915,Gorman; Michael R.,20,0,20,0
1653302991302,PSYC 88,A00,088426,Dobkins; Karen R.,61,0,65,4
1653302991827,PSYC 100,A00,088428,Chapman; Eddie Nathaniel,125,0,170,45
1653302992351,PSYC 101,A00,088429,Heyman; Gail D.,148,0,170,22
1653302992879,PSYC 102,A00,093917,Moranton; Nirelia Melbina-,162,0,170,8
1653302993402,PSYC 104,A00,088430,Fine; Rachel,163,0,175,12
1653302993928,PSYC 116A,A01,088433,Lang; Ariel,25,0,25,0
1653302994455,PSYC 122,A00,088434,Miller; Cory T.,103,0,115,12
1653302994979,PSYC 125,A00,088436,Rose; Fred E.,90,0,120,30
1653302995501,PSYC 134,A00,088437,Kaye; Walter H.,235,0,250,15
1653302996026,PSYC 137,A00,088438,Fine; Rachel,210,0,216,6
1653302996549,PSYC 145,A00,093918,Staff,73,0,90,17
1653302997076,PSYC 147,A00,088441,Wong; Lauren Hitomi,120,0,146,26
1653302997602,PSYC 154,A00,093919,Lacefield; Katharine I,270,0,295,25
1653302998127,PSYC 158,A00,088443,Willis; Jarryd Thomas,250,0,295,45
1653302998654,PSYC 162,A00,088444,Wixted; John T,210,0,225,15
1653302999178,PSYC 167,A00,088445,Walker; Caren Michelle,0,0,30,30
1653302999703,PSYC 168,A00,088446,Chapman; Eddie Nathaniel,222,0,250,28
1653303000228,PSYC 171,A00,088447,Mukku; Dhananjaya,66,0,75,9
1653303000757,PSYC 178,A00,088448,Glaser; Dale,105,0,120,15
1653303001281,PSYC 179,A00,088449,Lacefield; Katharine I,193,0,250,57
1653303001805,PSYC 181,A00,088450,Anagnostaras; Stephan,284,0,300,16
1653303002329,PSYC 189,A00,088451,Gentner; Tim,19,0,31,12
1653303002866,PSYC 193,A00,088452,Gremel; Christina M,19,0,20,1
1653303002866,PSYC 193,B00,088453,Staff,19,0,20,1
1653303003402,PSYC 193L,A01,088455,Staff,33,0,35,2
1653303003930,PSYC 194A,A01,088461,Heyman; Gail D.,35,0,35,0
1653303004455,RELI 1,A01,086478,Kalleres; Dayna,20,0,20,0
1653303004455,RELI 1,A02,086479,Kalleres; Dayna,19,0,20,1
1653303004991,RELI 147,A00,088409,Caciola; Nancy A,0,0,0,0
1653303005522,REV 1,A01,092308,Leigh; Brian,24,0,24,0
1653303005522,REV 1,A02,092310,Leigh; Brian,24,0,24,0
1653303005522,REV 1,A03,092312,Leigh; Brian,24,0,24,0
1653303005522,REV 1,A04,092314,Leigh; Brian,24,0,24,0
1653303005522,REV 1,A05,092316,Leigh; Brian,24,0,24,0
1653303006049,REV 2,A01,092318,Staff,28,0,28,0
1653303006049,REV 2,A02,092319,Staff,28,0,28,0
1653303006645,REV 20,A00,092320,Staff,40,0,40,0
1653303007170,REV 87,A00,092321,Lyon; Antony J.,20,0,20,0
1653303007698,SE 1,A01,088674,Van Den Einde; Yael Dahlia,48,0,48,0
1653303007698,SE 1,A02,088675,Van Den Einde; Yael Dahlia,47,0,48,1
1653303007698,SE 1,A03,088676,Van Den Einde; Yael Dahlia,46,0,48,2
1653303008224,SE 101A,A00,088677,Morrison; Machel Leigh,191,0,200,9
1653303008750,SE 101C,A00,088678,Zhu; Qiang,137,0,145,8
1653303009274,SE 125,A00,088679,Conte; Joel P,143,0,145,2
1653303009811,SE 130A,A00,088680,Loh; Kenneth J. H.,110,0,115,5
1653303010335,SE 131B,A00,088681,Krysl; Petr,84,0,115,31
1653303010861,SE 142,A01,088683,Staff,11,0,18,7
1653303010861,SE 142,A02,088684,Staff,13,0,18,5
1653303011384,SE 164,A01,088686,Loh; Kenneth J. H.,14,0,16,2
1653303011908,SE 180,A00,088687,Elgamal; Ahmed,66,0,75,9
1653303012433,SE 181,A01,088689,McCartney; John Scott,25,0,30,5
1653303012433,SE 181,A02,088690,McCartney; John Scott,14,0,30,16
1653303012433,SE 181,A03,088691,McCartney; John Scott,25,0,25,0
1653303012433,SE 181,A04,088692,McCartney; John Scott,25,0,25,0
1653303012959,SIO 12,A00,088342,Staff,141,0,146,5
1653303013483,SIO 15,A00,088343,Laske; Gabi,333,0,340,7
1653303014011,SIO 30,A01,092382,Castillo; Paterno R.,28,0,35,7
1653303014011,SIO 30,A02,092383,Castillo; Paterno R.,32,0,35,3
1653303014011,SIO 30,A03,092384,Castillo; Paterno R.,35,0,35,0
1653303014011,SIO 30,A04,092385,Castillo; Paterno R.,35,0,35,0
1653303014536,SIO 40,A00,088345,Barbeau; Katherine,144,0,146,2
1653303015066,SIO 50,A01,088347,Cook; Geoffrey W,11,0,14,3
1653303015066,SIO 50,A02,088348,Cook; Geoffrey W,11,0,14,3
1653303015594,SIO 87,A00,088350,Cook; Geoffrey W,20,0,20,0
1653303015594,SIO 87,B00,088351,Cook; Geoffrey W,20,0,20,0
1653303015594,SIO 87,C00,094017,Gilbert; Jack Anthony,20,0,20,0
1653303015594,SIO 87,D00,094018,Gerwick; William Henry,20,0,20,0
1653303016121,SIO 90,A00,088352,Staff,56,0,60,4
1653303016654,SIO 100,A00,088354,Norris; Richard D. & Gee; Jeffrey S,10,0,20,10
1653303017181,SIO 101,A01,088356,Aluwihare; Lihini & Decima; Moira R.,1,0,30,29
1653303017181,SIO 101,A02,088357,Aluwihare; Lihini & Decima; Moira R.,15,0,30,15
1653303017706,SIO 103,A01,088359,Parnell-Turner; Ross Ernes,21,0,25,4
1653303018234,SIO 105,A00,088360,Driscoll; Neal W.,18,0,20,2
1653303018762,SIO 108,A01,088363,Teranes; Jane,15,0,20,5
1653303019288,SIO 109R,A00,088364,Forman; Fonna,27,0,40,13
1653303019812,SIO 110,A01,088366,Staff,8,0,29,21
1653303020342,SIO 117,A01,088368,Keeling; Ralph F.,31,0,36,5
1653303020866,SIO 123,A00,088369,Allen; Andrew Ellis,61,0,70,9
1653303021399,SIO 132,A01,092386,Hechinger; Ryan F. & Kacev; David,17,0,28,11
1653303021399,SIO 132,A02,092387,Hechinger; Ryan F. & Kacev; David,26,0,28,2
1653303021399,SIO 132,A03,092388,Hechinger; Ryan F. & Kacev; David,28,0,28,0
1653303021399,SIO 132,A04,092389,Hechinger; Ryan F. & Kacev; David,23,0,28,5
1653303021399,SIO 132,A05,092390,Hechinger; Ryan F. & Kacev; David,27,0,28,1
1653303021399,SIO 132,A06,092391,Hechinger; Ryan F. & Kacev; David,27,0,28,1
1653303021925,SIO 136,A01,088373,Kacev; David & Bowman; Jeff Shovlowsky,0,0,5,7
1653303021925,SIO 136,B01,088376,Kacev; David & Bowman; Jeff Shovlowsky,0,0,5,5
1653303022449,SIO 155,A01,088379,Day; James M.D.,1,0,5,4
1653303022976,SIO 170,A00,088380,Cook; Geoffrey W,29,0,30,1
1653303023509,SIO 171,A01,088382,Rudnick; Daniel Lars,37,0,40,3
1653303024038,SIO 175,A01,088384,Merrifield; Mark A,22,0,25,3
1653303024569,SIO 177,A00,088385,Becker; Janet Maria,15,0,20,5
1653303025094,SIO 179,A01,088387,Martz; Todd R.,7,0,15,8
1653303026145,SIO 189,A00,088390,Hamdoun; Amr,35,0,60,25
1653303026676,SIO 194,A00,091602,Hill; Seth J,9999,0,9999,0
1653303027203,SOCE 194,A00,091601,Hill; Seth J,9999,0,9999,0
1653303027740,SOCI 1,A01,093704,Skrentny; John David,19,0,20,1
1653303027740,SOCI 1,A02,093705,Skrentny; John David,20,0,20,0
1653303027740,SOCI 1,A03,093706,Skrentny; John David,18,0,20,2
1653303027740,SOCI 1,A04,093707,Skrentny; John David,19,0,20,1
1653303027740,SOCI 1,A05,093708,Skrentny; John David,17,0,20,3
1653303027740,SOCI 1,A06,093709,Skrentny; John David,20,0,20,0
1653303027740,SOCI 1,A07,093710,Skrentny; John David,20,0,20,0
1653303027740,SOCI 1,A08,093711,Skrentny; John David,20,0,20,0
1653303027740,SOCI 1,A09,093712,Skrentny; John David,20,0,20,0
1653303027740,SOCI 1,A10,093713,Skrentny; John David,20,0,20,0
1653303027740,SOCI 1,A11,093714,Skrentny; John David,20,0,20,0
1653303028263,SOCI 30,A01,093716,Staff,30,0,30,0
1653303028263,SOCI 30,A02,093717,Staff,30,0,30,0
1653303028789,SOCI 60,A01,093719,Staff,17,0,20,3
1653303028789,SOCI 60,A02,093720,Staff,18,0,20,2
1653303028789,SOCI 60,A03,093721,Staff,20,0,20,0
1653303028789,SOCI 60,A04,093722,Staff,20,0,20,0
1653303029315,SOCI 87,A00,093819,Blair-Loy; Mary,20,0,20,0
1653303029844,SOCI 100,A01,093724,Estefan; Michel,15,0,20,5
1653303029844,SOCI 100,A02,093725,Estefan; Michel,5,0,20,15
1653303030369,SOCI 104,A00,093728,Gong; Neil M,22,0,25,3
1653303030893,SOCI 104Q,A00,093729,Staff,23,0,25,2
1653303031416,SOCI 106,A00,093730,Staff,25,0,25,0
1653303031943,SOCI 109,A00,093731,Staff,21,0,25,4
1653303032467,SOCI 110,A00,093732,Binder; Amy,24,0,25,1
1653303034040,SOCI 117,A01,091568,Chung; Luz Marina,29,0,35,6
1653303034040,SOCI 117,A02,091569,Chung; Luz Marina,35,0,35,0
1653303034562,SOCI 118,A00,093735,Staff,0,0,0,0
1653303035093,SOCI 120T,A00,093736,Lampland; Martha,50,0,50,0
1653303035093,SOCI 120T,B00,094832,Staff,69,0,70,1
1653303035615,SOCI 122,A00,093737,Lewis; Kevin Michael,62,0,70,8
1653303036138,SOCI 123,A00,094831,Staff,57,0,65,8
1653303036662,SOCI 125,A00,093738,Staff,115,0,120,5
1653303037184,SOCI 127,A00,094894,Staff,54,0,56,2
1653303037711,SOCI 132,A00,093739,Blair-Loy; Mary,51,0,60,9
1653303038771,SOCI 136F,A00,094830,Staff,45,0,56,11
1653303039295,SOCI 138,A00,093741,Navon; Daniel,117,0,120,3
1653303039823,SOCI 140A,A00,093743,Gong; Neil M,53,0,60,7
1653303040352,SOCI 141,A00,093744,Summers; Valerie R.,111,0,120,9
1653303041402,SOCI 144,A00,093746,Staff,0,0,0,0
1653303043503,SOCI 159,A00,094902,Staff,49,0,50,1
1653303044026,SOCI 160,A00,093750,Staff,0,0,0,0
1653303044549,SOCI 165,A00,093751,Rona-Tas; Akos,43,0,48,5
1653303045074,SOCI 165A,A00,094206,Hallin; Daniel C,3,0,4,1
1653303045604,SOCI 166,A00,093752,Lampland; Martha,52,0,56,4
1653303046129,SOCI 176,A00,093753,Turner; Christena L.,44,0,48,4
1653303046655,SOCI 180,A00,094901,Staff,56,0,56,0
1653303047180,SOCI 185,A00,094903,Staff,55,0,56,1
1653303047703,SOCI 196A,A00,093754,Shafir; Gershon,20,0,20,0
1653303048234,SXTH 1,A01,092351,Bronstein; Phoebe Malan,18,0,18,0
1653303048234,SXTH 1,A02,092352,Bronstein; Phoebe Malan,18,0,18,0
1653303048234,SXTH 1,A03,092353,Bronstein; Phoebe Malan,18,0,18,0
1653303048758,SXTH 20A,A00,092355,Chilukuri; Lakshmi N,56,0,56,0
1653303049289,SYN 2,001,091487,Gladstein; Jill M,13,0,15,2
1653303049289,SYN 2,002,091488,Gladstein; Jill M,14,0,15,1
1653303049289,SYN 2,003,091490,Gladstein; Jill M,12,0,15,3
1653303049289,SYN 2,004,091491,Gladstein; Jill M,15,0,15,0
1653303049289,SYN 2,005,091493,Gladstein; Jill M,15,0,15,0
1653303049289,SYN 2,006,091495,Gladstein; Jill M,15,0,15,0
1653303049289,SYN 2,007,091496,Gladstein; Jill M,15,0,15,0
1653303049289,SYN 2,008,091497,Gladstein; Jill M,14,0,15,1
1653303049289,SYN 2,009,091499,Gladstein; Jill M,13,0,15,2
1653303049289,SYN 2,010,091501,Gladstein; Jill M,13,0,15,2
1653303049289,SYN 2,011,091502,Gladstein; Jill M,13,0,15,2
1653303049289,SYN 2,012,091503,Gladstein; Jill M,15,0,15,0
1653303049289,SYN 2,013,091505,Gladstein; Jill M,13,0,15,2
1653303049289,SYN 2,014,091506,Gladstein; Jill M,12,0,15,3
1653303049289,SYN 2,015,091508,Gladstein; Jill M,14,0,15,1
1653303049289,SYN 2,016,091509,Gladstein; Jill M,12,0,15,3
1653303049289,SYN 2,017,091510,Gladstein; Jill M,14,0,15,1
1653303049289,SYN 2,018,091512,Gladstein; Jill M,15,0,15,0
1653303049289,SYN 2,019,091513,Gladstein; Jill M,15,0,15,0
1653303049289,SYN 2,020,091514,Gladstein; Jill M,15,0,15,0
1653303049289,SYN 2,021,091516,Gladstein; Jill M,12,0,15,3
1653303049289,SYN 2,022,091517,Gladstein; Jill M,13,0,15,2
1653303049289,SYN 2,023,091518,Gladstein; Jill M,15,0,15,0
1653303049289,SYN 2,024,091519,Gladstein; Jill M,15,0,15,0
1653303049289,SYN 2,025,091520,Gladstein; Jill M,11,0,15,4
1653303049289,SYN 2,026,091521,Gladstein; Jill M,15,0,15,0
1653303049289,SYN 2,027,091522,Gladstein; Jill M,0,0,0,0
1653303049289,SYN 2,028,091523,Gladstein; Jill M,0,0,0,0
1653303049289,SYN 2,029,091524,Gladstein; Jill M,0,0,0,0
1653303049289,SYN 2,030,091525,Gladstein; Jill M,0,0,0,0
1653303049289,SYN 2,031,091526,Gladstein; Jill M,14,0,15,1
1653303049289,SYN 2,032,091527,Gladstein; Jill M,15,0,15,0
1653303049289,SYN 2,033,091528,Gladstein; Jill M,0,0,0,0
1653303049289,SYN 2,034,091529,Gladstein; Jill M,15,0,15,0
1653303049289,SYN 2,035,091530,Gladstein; Jill M,15,0,15,0
1653303049289,SYN 2,036,091531,Gladstein; Jill M,15,0,15,0
1653303049289,SYN 2,037,091532,Gladstein; Jill M,15,0,15,0
1653303049289,SYN 2,038,091533,Gladstein; Jill M,15,0,15,0
1653303049289,SYN 2,039,091534,Gladstein; Jill M,15,0,15,0
1653303049289,SYN 2,040,091535,Gladstein; Jill M,15,0,15,0
1653303049812,SYN 100,A01,091537,Gladstein; Jill M,26,0,30,4
1653303049812,SYN 100,B01,091539,Gladstein; Jill M,26,0,30,4
1653303049812,SYN 100,C01,091541,Gladstein; Jill M,26,0,30,4
1653303049812,SYN 100,D01,091543,Gladstein; Jill M,25,0,30,5
1653303049812,SYN 100,E01,091545,Gladstein; Jill M,28,0,30,2
1653303050343,TDAC 1,A00,088922,Walsh; Kim C.,10,0,10,0
1653303050343,TDAC 1,B00,088923,Walsh; Kim C.,8,0,10,2
1653303050343,TDAC 1,C00,088924,Walsh; Kim C.,0,0,10,10
1653303050343,TDAC 1,D00,088925,Walsh; Kim C.,7,0,10,3
1653303050343,TDAC 1,E00,088926,Walsh; Kim C.,2,0,10,8
1653303050343,TDAC 1,F00,088927,Walsh; Kim C.,9,0,10,1
1653303050870,TDAC 101,A00,088972,Harting; Carla Kelso,9,0,10,1
1653303050870,TDAC 101,B00,088973,Salovey; Todd,8,0,10,2
1653303050870,TDAC 101,C00,088974,Walsh; Kim C.,6,0,10,4
1653303051399,TDAC 102,A00,088975,Basso; Beatrice,9,0,10,1
1653303051399,TDAC 102,B00,088976,Basso; Beatrice,7,0,10,3
1653303051925,TDAC 103A,A00,094044,Castro; Robert Jess,32,0,35,3
1653303052452,TDAC 108,A00,088977,Staff,20,0,20,0
1653303052975,TDAC 109,A00,088978,Blair; Kyle Adam,20,0,20,0
1653303053501,TDAC 115,A00,088979,Newcomb; James,20,0,20,0
1653303054026,TDAC 122,A00,088981,Staff,30,0,30,0
1653303054551,TDAC 123,A00,088982,Staff,30,0,30,0
1653303055075,TDDE 1,A01,088929,Benzoni; Elisa,9,0,11,2
1653303055075,TDDE 1,A02,088930,Benzoni; Elisa,11,0,11,0
1653303055075,TDDE 1,A03,088931,Benzoni; Elisa,11,0,11,0
1653303055075,TDDE 1,A04,088932,Benzoni; Elisa,10,0,11,1
1653303055075,TDDE 1,A05,088933,Benzoni; Elisa,11,0,11,0
1653303055599,TDDE 130,A00,088983,Staff,20,0,20,0
1653303056123,TDDE 132,A00,094263,Staff,20,0,20,0
1653303056648,TDDE 169A,A00,094046,Petrovich; Victoria A.,18,0,20,2
1653303057171,TDDM 1,A00,088934,Snaith; Yolande,6,0,10,4
1653303057701,TDDM 5,A00,088935,Smith; Alison D,30,0,30,0
1653303058223,TDDR 101,A00,088986,Powell; Lora,34,0,35,1
1653303058754,TDDR 111,A00,088987,Stalling; Vanessa,24,0,30,6
1653303058754,TDDR 111,B00,094045,Castro; Robert Jess,14,0,16,2
1653303059282,TDDR 190,A00,088988,Stalling; Vanessa,10,0,10,0
1653303059895,TDGE 1,A01,088937,Salovey; Todd,12,0,12,0
1653303059895,TDGE 1,A02,088938,Salovey; Todd,10,0,12,2
1653303059895,TDGE 1,A03,088939,Salovey; Todd,8,0,12,4
1653303059895,TDGE 1,A04,088940,Salovey; Todd,12,0,12,0
1653303059895,TDGE 1,A05,088941,Salovey; Todd,11,0,12,1
1653303059895,TDGE 1,A06,088942,Salovey; Todd,12,0,12,0
1653303060421,TDGE 10,A00,088943,Havis; Allan,191,0,200,9
1653303060944,TDGE 11,A00,088944,Staff,200,0,200,0
1653303061471,TDGE 25,A00,088945,Harting; Carla Kelso,19,0,20,1
1653303061471,TDGE 25,B00,088946,Harting; Carla Kelso,19,0,20,1
1653303061471,TDGE 25,C00,088947,Harting; Carla Kelso,20,0,20,0
1653303061471,TDGE 25,D00,088948,Harting; Carla Kelso,19,0,20,1
1653303061471,TDGE 25,E00,088949,Harting; Carla Kelso,20,0,20,0
1653303061471,TDGE 25,F00,088950,Harting; Carla Kelso,19,0,20,1
1653303061471,TDGE 25,G00,088951,Harting; Carla Kelso,19,0,20,1
1653303061999,TDGE 127,A00,088990,Havis; Allan,188,0,200,12
1653303062527,TDHD 21,A00,088952,Jun; Grace Shin Hae,20,0,20,0
1653303063051,TDHT 10,A00,088953,Power; Jade Yukana,14,0,14,0
1653303063051,TDHT 10,B00,088954,Power; Jade Yukana,13,0,14,1
1653303063582,TDHT 21,A01,088956,Power; Jade Yukana,17,0,18,1
1653303063582,TDHT 21,A02,088957,Power; Jade Yukana,7,0,11,4
1653303063582,TDHT 21,A03,088958,Power; Jade Yukana,11,0,11,0
1653303064113,TDHT 101,A00,088994,Burelle; Julie Sara Veronique,21,0,25,4
1653303064648,TDHT 114,A00,094208,Williams; Madison Mae,47,0,50,3
1653303065175,TDHT 119,A00,094299,Burelle; Julie Sara Veronique,25,0,25,0
1653303065708,TDMV 1,A00,088959,Weinberg; Sadie,23,0,30,7
1653303066232,TDMV 2,A00,088960,Sammartano; Tonnie,27,0,30,3
1653303066232,TDMV 2,B00,094043,Duran; Marcos Antonio,29,0,30,1
1653303066763,TDMV 3,A00,088961,Arcidiacono; Kristin,27,0,30,3
1653303067287,TDMV 110,A00,088995,Wilson; Terry A.,0,0,0,0
1653303067814,TDMV 120,A00,088996,Smith; Alison D,17,0,20,3
1653303068339,TDMV 122,A00,088997,Chaleff; Rebecca,28,0,30,2
1653303068864,TDMV 130,A00,094042,Rincon; Alicia,30,0,30,0
1653303069392,TDMV 138,A00,088998,Jun; Grace Shin Hae,12,0,40,28
1653303069919,TDMV 142,A00,088999,Caligagan; Tony,28,0,40,12
1653303070443,TDMV 143,A00,094041,Foster-King; Sandra,37,0,40,3
1653303070967,TDMV 146,A00,089000,Caligagan; Tony,39,0,40,1
1653303071492,TDPF 160,A00,094264,Snaith; Yolande,30,0,30,0
1653303071492,TDPF 160,B00,094265,Smith; Alison D,30,0,30,0
1653303071492,TDPF 160,C00,094266,Weinberg; Sadie,30,0,30,0
1653303072019,TDPR 6,A01,088963,Benzoni; Elisa,25,0,25,0
1653303072019,TDPR 6,A02,088964,Benzoni; Elisa,25,0,25,0
1653303072547,TDPR 102,A00,089003,Staff,15,0,15,0
1653303073070,TDPR 104,A00,089004,Powell; Lora,15,0,15,0
1653303073593,TDPW 1,A00,088965,Staff,10,0,10,0
1653303073593,TDPW 1,B00,088966,Staff,10,0,10,0
1653303073593,TDPW 1,C00,088967,Staff,9,0,10,1
1653303073593,TDPW 1,D00,088968,Staff,9,0,10,1
1653303073593,TDPW 1,E00,088969,Staff,10,0,10,0
1653303073593,TDPW 1,F00,088970,Staff,9,0,10,1
1653303074119,TDTR 10,A00,088971,Wilson; Terry A.,22,0,25,3
1653303074653,TMC 2,A01,092358,Carver; Leslie J.,20,0,20,0
1653303074653,TMC 2,A02,092359,Carver; Leslie J.,20,0,20,0
1653303074653,TMC 2,A03,092360,Carver; Leslie J.,20,0,20,0
1653303074653,TMC 2,A04,092361,Carver; Leslie J.,20,0,20,0
1653303074653,TMC 2,A05,092362,Carver; Leslie J.,20,0,20,0
1653303074653,TMC 2,A06,092363,Carver; Leslie J.,20,0,20,0
1653303075181,TMC 15,A00,092364,Atkinson; Arthur Laird,20,0,20,0
1653303075704,TMC 20,A00,092365,Carver; Leslie J.,20,0,20,0
1653303076234,TMC 90,A00,092366,Mell; Loren K.,20,0,20,0
1653303076760,TMC 120,A01,092368,Staff,20,0,20,0
1653303077292,USP 1,A01,087520,Kwak; Nancy,19,0,20,1
1653303077292,USP 1,A02,087521,Kwak; Nancy,17,0,20,3
1653303077292,USP 1,A03,087522,Kwak; Nancy,16,0,20,4
1653303077292,USP 1,A04,087523,Kwak; Nancy,19,0,20,1
1653303077819,USP 2,A01,087525,Lerner; Amy M,29,0,30,1
1653303077819,USP 2,A02,087526,Lerner; Amy M,29,0,30,1
1653303078347,USP 4,A00,094267,Polat; Soydan Alihan,16,0,20,4
1653303078347,USP 4,B00,094268,Staff,20,0,20,0
1653303078880,USP 5,A01,087532,Staff,26,0,30,4
1653303078880,USP 5,A02,087533,Staff,27,0,30,3
1653303079412,USP 6,A01,094322,Shvartzberg Carrio; Manuel,20,0,20,0
1653303079412,USP 6,A02,094323,Shvartzberg Carrio; Manuel,20,0,20,0
1653303079940,USP 15,A01,087535,Anderson; William Raymond,20,0,25,5
1653303079940,USP 15,A02,087536,Anderson; William Raymond,23,0,25,2
1653303080465,USP 25,A00,087537,Staff,0,0,7,7
1653303080992,USP 50,A00,087538,Martin; Isaac,38,0,40,2
1653303081522,USP 124,A00,087539,Bussell; Mirle Rabinowitz,26,0,35,9
1653303082050,USP 125,A00,087540,Staff,17,0,23,6
1653303082576,USP 136,A00,087541,Staff,23,0,25,2
1653303083098,USP 144,A00,087542,Staff,136,0,146,10
1653303083622,USP 151,A00,087543,Boomhower; Matthew Charles,18,0,20,2
1653303084150,USP 152,A01,087545,Moeder; Nathan L,17,0,20,3
1653303084150,USP 152,A02,087546,Moeder; Nathan L,20,0,20,0
1653303084681,USP 153,A00,087547,Moden; Kelly Kjestine,27,0,30,3
1653303085209,USP 161,A00,094854,Wartell; Julie Dara,25,0,25,0
1653303085734,USP 169,A00,087548,Bajaj; Ravi Siddharth,30,0,35,5
1653303086262,USP 170,A00,087549,Hinds; Juli Beth,30,0,35,5
1653303086783,USP 171,A00,087550,Lerner; Amy M,38,0,50,12
1653303087310,USP 176,A00,094853,Staff,24,0,25,1
1653303087839,USP 177A,A00,087551,Peerson; Susan,20,0,22,2
1653303088362,USP 184,A00,094324,Shvartzberg Carrio; Manuel,24,0,25,1
1653303088894,USP 185A,A01,087553,Norr; Alex Vaughn,28,0,30,2
1653303088894,USP 185A,B01,087555,Boomhower; Matthew Charles,26,0,30,4
1653303089424,USP 186,A01,087557,Pezzoli; Keith,22,0,25,3
1653303089424,USP 186,A02,087558,Pezzoli; Keith,20,0,25,5
1653303090474,USP 191A,A00,087561,Rothberg; Scott Jacob,18,0,20,2
1653303090997,USP 194,A00,091599,Hill; Seth J,9999,0,9999,0
1653303091532,VIS 1,A01,088809,Tonies; Joshua Vanjaymes,10,0,10,0
1653303091532,VIS 1,A02,088810,Tonies; Joshua Vanjaymes,10,0,10,0
1653303091532,VIS 1,A03,088811,Tonies; Joshua Vanjaymes,3,0,10,7
1653303091532,VIS 1,A04,088812,Tonies; Joshua Vanjaymes,8,0,10,2
1653303091532,VIS 1,A05,088813,Tonies; Joshua Vanjaymes,4,0,10,6
1653303091532,VIS 1,A06,088814,Tonies; Joshua Vanjaymes,6,0,10,4
1653303091532,VIS 1,A07,088815,Tonies; Joshua Vanjaymes,6,0,10,4
1653303091532,VIS 1,A08,088816,Tonies; Joshua Vanjaymes,9,0,10,1
1653303091532,VIS 1,A09,088817,Tonies; Joshua Vanjaymes,8,0,10,2
1653303091532,VIS 1,A10,088818,Tonies; Joshua Vanjaymes,8,0,10,2
1653303091532,VIS 1,A11,088819,Tonies; Joshua Vanjaymes,3,0,10,7
1653303091532,VIS 1,A12,088820,Tonies; Joshua Vanjaymes,6,0,10,4
1653303091532,VIS 1,A13,088821,Tonies; Joshua Vanjaymes,6,0,10,4
1653303091532,VIS 1,A14,088822,Tonies; Joshua Vanjaymes,7,0,10,3
1653303091532,VIS 1,A15,088823,Tonies; Joshua Vanjaymes,7,0,10,3
1653303091532,VIS 1,A16,088824,Tonies; Joshua Vanjaymes,8,0,10,2
1653303092064,VIS 20,A01,088826,Woods; Ann,19,0,20,1
1653303092064,VIS 20,A02,088827,Woods; Ann,20,0,20,0
1653303092064,VIS 20,A03,088828,Woods; Ann,18,0,20,2
1653303092064,VIS 20,A04,088829,Woods; Ann,17,0,20,3
1653303092064,VIS 20,A05,088830,Woods; Ann,20,0,20,0
1653303092064,VIS 20,A06,088831,Woods; Ann,20,0,20,0
1653303092064,VIS 20,A07,088832,Woods; Ann,20,0,20,0
1653303092064,VIS 20,A08,088833,Woods; Ann,20,0,20,0
1653303092064,VIS 20,A09,088834,Woods; Ann,18,0,20,2
1653303092064,VIS 20,A10,088835,Woods; Ann,19,0,20,1
1653303092064,VIS 20,A11,088836,Woods; Ann,20,0,20,0
1653303092064,VIS 20,A12,088837,Woods; Ann,20,0,20,0
1653303092590,VIS 23,A00,088838,Rose; Jordan M,3,0,3,0
1653303093119,VIS 30,A01,088840,Stone; Patricia,11,0,11,0
1653303093119,VIS 30,A02,088841,Stone; Patricia,7,0,11,4
1653303093119,VIS 30,A03,094821,Stone; Patricia,8,0,11,3
1653303093119,VIS 30,A04,094822,Stone; Patricia,11,0,11,0
1653303093652,VIS 41,A01,088844,D'Elena-Tweed; Jessica Erin,9,0,10,1
1653303093652,VIS 41,A02,088845,D'Elena-Tweed; Jessica Erin,9,0,10,1
1653303093652,VIS 41,A03,088846,D'Elena-Tweed; Jessica Erin,9,0,10,1
1653303093652,VIS 41,A04,088847,D'Elena-Tweed; Jessica Erin,9,0,10,1
1653303093652,VIS 41,A05,088848,D'Elena-Tweed; Jessica Erin,10,0,10,0
1653303093652,VIS 41,A06,088849,D'Elena-Tweed; Jessica Erin,10,0,10,0
1653303093652,VIS 41,A07,088850,D'Elena-Tweed; Jessica Erin,10,0,10,0
1653303093652,VIS 41,A08,088851,D'Elena-Tweed; Jessica Erin,10,0,10,0
1653303094183,VIS 60,A01,088853,Sepuya; Paul Mpagi,9,0,10,1
1653303094183,VIS 60,A02,088854,Sepuya; Paul Mpagi,10,0,10,0
1653303094183,VIS 60,A03,088855,Sepuya; Paul Mpagi,10,0,10,0
1653303094183,VIS 60,A04,088856,Sepuya; Paul Mpagi,10,0,10,0
1653303094183,VIS 60,A05,088857,Sepuya; Paul Mpagi,10,0,10,0
1653303094183,VIS 60,A06,088858,Sepuya; Paul Mpagi,10,0,10,0
1653303094183,VIS 60,A07,088859,Sepuya; Paul Mpagi,9,0,10,1
1653303094183,VIS 60,A08,093932,Sepuya; Paul Mpagi,10,0,10,0
1653303094712,VIS 70N,A01,088861,Segade; Alexandro Abraham,8,0,8,0
1653303094712,VIS 70N,A02,088862,Segade; Alexandro Abraham,8,0,8,0
1653303094712,VIS 70N,A03,088863,Segade; Alexandro Abraham,8,0,8,0
1653303094712,VIS 70N,A04,088864,Segade; Alexandro Abraham,8,0,8,0
1653303094712,VIS 70N,A05,088865,Segade; Alexandro Abraham,7,0,8,1
1653303094712,VIS 70N,A06,088866,Segade; Alexandro Abraham,8,0,8,0
1653303095242,VIS 80,A01,088868,Adler; Amy,9,0,10,1
1653303095242,VIS 80,A02,088869,Adler; Amy,8,0,10,2
1653303095242,VIS 80,A03,088870,Adler; Amy,9,0,10,1
1653303095242,VIS 80,A04,088871,Adler; Amy,8,0,10,2
1653303095242,VIS 80,A05,088872,Adler; Amy,10,0,10,0
1653303095242,VIS 80,A06,088873,Adler; Amy,7,0,10,3
1653303095766,VIS 100,A00,088874,Cruz; Edwin Teddy,65,0,75,10
1653303096287,VIS 105A,A00,088875,Tonies; Joshua Vanjaymes,26,0,30,4
1653303096810,VIS 105B,A00,088876,Staff,25,0,30,5
1653303097338,VIS 106A,A00,088877,Tobe; Geoffroy,21,0,25,4
1653303097860,VIS 106B,A00,088878,Staff,21,0,25,4
1653303098384,VIS 106C,A00,088879,Staff,9,0,15,6
1653303098909,VIS 107B,A00,088880,Gallaccio; Anya,24,0,25,1
1653303099431,VIS 108,A00,093894,Gallaccio; Anya,5,0,15,10
1653303099957,VIS 110A,A00,093895,Dean; Danielle Adobi,15,0,15,0
1653303100482,VIS 110B,A00,088881,Adler; Amy,14,0,15,1
1653303101012,VIS 125E,A00,093896,Welchman; John C.,75,0,75,0
1653303101536,VIS 126HN,A00,088882,Newsome; Elizabeth Ann,74,0,75,1
1653303102059,VIS 126P,A00,088883,Wardwell; Mariana Razo,72,0,75,3
1653303102587,VIS 128E,A00,088884,Staff,68,0,75,7
1653303103110,VIS 132,A00,088885,Miller; Nicole L,15,0,15,0
1653303103635,VIS 133,A01,094348,D'Elena-Tweed; Jessica Erin,34,0,34,0
1653303103635,VIS 133,A02,094492,D'Elena-Tweed; Jessica Erin,33,0,34,1
1653303104170,VIS 142,A01,088887,Stalbaum; Brett,14,0,15,1
1653303104170,VIS 142,A02,088888,Stalbaum; Brett,10,0,15,5
1653303104170,VIS 142,A03,088889,Stalbaum; Brett,15,0,15,0
1653303104170,VIS 142,A04,088890,Stalbaum; Brett,8,0,15,7
1653303104170,VIS 142,A05,088891,Stalbaum; Brett,14,0,15,1
1653303104170,VIS 142,A06,094828,Stalbaum; Brett,15,0,15,0
1653303104699,VIS 143,A00,088892,Akten; Mehmet,11,0,22,11
1653303105229,VIS 147A,A01,088894,Stalbaum; Brett,20,0,22,2
1653303105229,VIS 147A,A02,088895,Stalbaum; Brett,17,0,22,5
1653303105757,VIS 149,A00,088896,Akten; Mehmet,11,0,15,4
1653303106281,VIS 150,A00,093893,Tufenkian; Armand Yervant,24,0,30,6
1653303106804,VIS 151A,A00,088897,Williams; Alena J,13,0,15,2
1653303107335,VIS 163,A00,088901,Bratton; Benjamin H.,75,0,75,0
1653303107865,VIS 164,A00,088902,Nakayama; Yue,22,0,22,0
1653303108389,VIS 165A,A00,093892,Cross; Brian R,19,0,22,3
1653303108915,VIS 167,A00,088903,Ortiz-Torres; Ruben,19,0,22,3
1653303109445,VIS 174,A00,088905,Staff,21,0,22,1
1653303109445,VIS 174,B00,088906,Kauffmann; Casey,22,0,22,0
1653303109970,VIS 175,A00,093891,Staff,18,0,22,4
1653303110495,VIS 177,A00,088907,Segade; Alexandro Abraham,20,0,22,2
1653303111022,VIS 178,A00,093890,Staff,17,0,22,5
1653303111545,VIS 179,A00,093889,Kauffmann; Casey,21,0,22,1
1653303112070,VIS 180A,A00,093888,Nakayama; Yue,16,0,22,6
1653303112598,VIS 180B,A00,088908,Miller; Nicole L,21,0,22,1
1653303113197,VIS 183A,A00,088909,Sepuya; Paul Mpagi,20,0,22,2
1653303113742,WCWP 10A,001,086588,Gagnon; Jeffrey C,15,0,15,0
1653303113742,WCWP 10A,002,086589,Gagnon; Jeffrey C,14,0,15,1
1653303113742,WCWP 10A,003,086590,Gagnon; Jeffrey C,15,0,15,0
1653303113742,WCWP 10A,004,086591,Gagnon; Jeffrey C,15,0,15,0
1653303113742,WCWP 10A,005,086592,Gagnon; Jeffrey C,15,0,15,0
1653303113742,WCWP 10A,006,086593,Gagnon; Jeffrey C,15,0,15,0
1653303113742,WCWP 10A,007,086594,Gagnon; Jeffrey C,15,0,15,0
1653303113742,WCWP 10A,008,086595,Gagnon; Jeffrey C,15,0,15,0
1653303113742,WCWP 10A,009,086596,Gagnon; Jeffrey C,15,0,15,0
1653303113742,WCWP 10A,010,086597,Gagnon; Jeffrey C,15,0,15,0
1653303113742,WCWP 10A,011,086598,Gagnon; Jeffrey C,20,0,20,0
1653303113742,WCWP 10A,012,086599,Gagnon; Jeffrey C,20,0,20,0
1653303113742,WCWP 10A,013,086600,Gagnon; Jeffrey C,20,0,20,0
1653303113742,WCWP 10A,014,086601,Gagnon; Jeffrey C,20,0,20,0
1653303113742,WCWP 10A,015,086602,Gagnon; Jeffrey C,20,0,20,0
1653303113742,WCWP 10A,016,086603,Gagnon; Jeffrey C,20,0,20,0
1653303113742,WCWP 10A,017,086604,Gagnon; Jeffrey C,20,0,20,0
1653303113742,WCWP 10A,018,086605,Gagnon; Jeffrey C,19,0,20,1
1653303113742,WCWP 10A,019,086606,Gagnon; Jeffrey C,19,0,20,1
1653303113742,WCWP 10A,020,086607,Gagnon; Jeffrey C,20,0,20,0
1653303113742,WCWP 10A,021,086608,Gagnon; Jeffrey C,20,0,20,0
1653303113742,WCWP 10A,022,086609,Gagnon; Jeffrey C,20,0,20,0
1653303113742,WCWP 10A,023,086610,Gagnon; Jeffrey C,19,0,20,1
1653303113742,WCWP 10A,024,086611,Gagnon; Jeffrey C,20,0,20,0
1653303113742,WCWP 10A,025,086612,Gagnon; Jeffrey C,0,0,0,0
1653303113742,WCWP 10A,026,086613,Gagnon; Jeffrey C,0,0,0,0
1653303113742,WCWP 10A,027,086614,Gagnon; Jeffrey C,0,0,0,0
1653303113742,WCWP 10A,028,086615,Gagnon; Jeffrey C,0,0,0,0
1653303113742,WCWP 10A,029,086616,Gagnon; Jeffrey C,0,0,0,0
1653303113742,WCWP 10A,030,086617,Gagnon; Jeffrey C,15,0,15,0
1653303113742,WCWP 10A,031,086618,Gagnon; Jeffrey C,15,0,15,0
1653303113742,WCWP 10A,032,093687,Gagnon; Jeffrey C,15,0,15,0
1653303113742,WCWP 10A,033,093688,Gagnon; Jeffrey C,15,0,15,0
1653303113742,WCWP 10A,034,093689,Gagnon; Jeffrey C,0,0,0,0
1653303113742,WCWP 10A,035,093690,Gagnon; Jeffrey C,0,0,0,0
1653303114268,WCWP 10B,003,086621,Gagnon; Jeffrey C,0,0,0,0
1653303114268,WCWP 10B,004,086622,Gagnon; Jeffrey C,16,0,20,4
1653303114268,WCWP 10B,005,086623,Gagnon; Jeffrey C,18,0,20,2
1653303114268,WCWP 10B,006,086624,Gagnon; Jeffrey C,20,0,20,0
1653303114268,WCWP 10B,007,086625,Gagnon; Jeffrey C,0,0,0,0
1653303114796,WCWP 100,A00,086626,McCleary; Keith Long,20,0,20,0
1653303114796,WCWP 100,B00,086627,McCleary; Keith Long,20,0,20,0
1653303114796,WCWP 100,C00,086628,McCleary; Keith Long,18,0,20,2
1653303114796,WCWP 100,D00,086629,Twohig; Niall Ivan,17,0,20,3
1653303114796,WCWP 100,E00,086630,Twohig; Niall Ivan,17,0,20,3
1653303114796,WCWP 100,F00,086631,Twohig; Niall Ivan,18,0,20,2
1653303114796,WCWP 100,G00,086632,Young; Mark T,20,0,20,0
1653303114796,WCWP 100,H00,086633,Young; Mark T,20,0,20,0
1653303172916,AAS 10,A01,085689,Butler; Elizabeth Annette,28,0,34,6
1653303172916,AAS 10,A02,085690,Butler; Elizabeth Annette,34,0,34,0
1653303173449,AAS 170,A00,085691,Butler; Elizabeth Annette,30,0,32,2
1653303173972,AIP 197,001,085683,Staff,100,0,100,0
1653303173972,AIP 197,002,085684,Rao; Ramesh R,50,0,50,0
1653303174497,AIP 197DC,001,085696,Anderson; Patrick W.,27,0,27,0
1653303175021,AIP 197T,A00,085685,Anderson; Patrick W.,15,0,15,0
1653303175552,ANAR 100,A00,094326,Fortier; Jana,22,0,25,3
1653303176076,ANAR 104,A01,085846,Staff,13,0,15,2
1653303176599,ANAR 120,A00,085847,Staff,15,0,15,0
1653303177123,ANAR 143,A00,094288,Staff,31,0,32,1
1653303177651,ANBI 100,A00,085849,Marchetto; Maria Carolina,31,0,34,3
1653303178175,ANBI 112,A00,085850,Marchetto; Maria Carolina,21,0,28,7
1653303178701,ANBI 118,A00,085851,Fox; Patrick Keolu Ozer,32,0,32,0
1653303179232,ANBI 136,A00,085852,Semendeferi; Ekaterini,20,0,22,2
1653303179761,ANBI 141,A00,085854,Gagneux; Pascal,186,0,192,6
1653303180288,ANBI 145,A00,085855,Staff,30,0,32,2
1653303180821,ANBI 175,A00,085857,Staff,30,0,32,2
1653303181362,ANSC 104,A00,094290,Yeh; Rihan Wen Xin,40,0,46,6
1653303181886,ANSC 105,A00,085859,Olivas Hernandez; Olga Lid,36,0,37,1
1653303182411,ANSC 120,A00,085860,Jassal; Aftab,51,0,56,5
1653303182936,ANSC 121,A00,085861,Staff,29,0,32,3
1653303183985,ANSC 148,A00,085866,Staff,71,0,73,2
1653303184515,ANSC 169,A00,085869,Fortier; Jana,23,0,25,2
1653303185046,ANSC 175,A00,085871,Pedersen; David,28,0,32,4
1653303185577,ANTH 1,A00,085803,Varma; Saiba,146,0,146,0
1653303186102,ANTH 2,A01,085805,Staff,43,0,44,1
1653303186102,ANTH 2,A02,085806,Staff,42,0,44,2
1653303186102,ANTH 2,A03,085807,Staff,44,0,44,0
1653303186102,ANTH 2,A04,085808,Staff,44,0,44,0
1653303186102,ANTH 2,A05,085809,Staff,40,0,40,0
1653303186627,ANTH 4,A01,085811,Yeh; Rihan Wen Xin,32,0,32,0
1653303186627,ANTH 4,A02,095113,Yeh; Rihan Wen Xin,32,0,32,0
1653303186627,ANTH 4,A03,095114,Yeh; Rihan Wen Xin,32,0,32,0
1653303186627,ANTH 4,A04,095115,Yeh; Rihan Wen Xin,34,0,34,0
1653303187157,ANTH 10,A00,085814,Stewart; Alexander B,215,0,216,1
1653303187684,ANTH 21,A01,085816,Kang; Byung Chu,35,0,35,0
1653303187684,ANTH 21,A02,085817,Kang; Byung Chu,35,0,35,0
1653303187684,ANTH 21,A03,085818,Kang; Byung Chu,35,0,35,0
1653303187684,ANTH 21,A04,085819,Kang; Byung Chu,35,0,35,0
1653303187684,ANTH 21,A05,085820,Kang; Byung Chu,33,0,35,2
1653303187684,ANTH 21,A06,085821,Kang; Byung Chu,33,0,35,2
1653303187684,ANTH 21,A07,085822,Kang; Byung Chu,35,0,35,0
1653303187684,ANTH 21,A08,085823,Kang; Byung Chu,35,0,35,0
1653303187684,ANTH 21,A09,085824,Kang; Byung Chu,0,0,0,0
1653303187684,ANTH 21,A10,085825,Kang; Byung Chu,0,0,0,0
1653303187684,ANTH 21,A11,095111,Kang; Byung Chu,30,0,30,0
1653303187684,ANTH 21,A12,095112,Kang; Byung Chu,30,0,30,0
1653303187684,ANTH 21,B01,085827,Staff,36,0,36,0
1653303187684,ANTH 21,B02,085828,Staff,36,0,36,0
1653303187684,ANTH 21,B03,085829,Staff,36,0,36,0
1653303187684,ANTH 21,B04,085830,Staff,38,0,38,0
1653303188212,ANTH 23,A01,085832,Stewart; Alexander B,31,0,31,0
1653303188212,ANTH 23,A02,085833,Stewart; Alexander B,31,0,31,0
1653303188212,ANTH 23,A03,085834,Stewart; Alexander B,31,0,31,0
1653303188212,ANTH 23,A04,085835,Stewart; Alexander B,31,0,31,0
1653303188212,ANTH 23,A05,085836,Stewart; Alexander B,31,0,31,0
1653303188212,ANTH 23,A06,085837,Stewart; Alexander B,0,0,0,0
1653303188212,ANTH 23,A07,085838,Stewart; Alexander B,0,0,0,0
1653303188742,ANTH 87,A00,085842,Staff,20,0,20,0
1653303188742,ANTH 87,B00,085843,Staff,20,0,20,0
1653303189270,ANTH 101,A01,085873,Goldstein; Paul S,33,0,36,3
1653303189270,ANTH 101,A02,085874,Goldstein; Paul S,33,0,36,3
1653303189270,ANTH 101,A03,085875,Goldstein; Paul S,36,0,36,0
1653303189270,ANTH 101,A04,085876,Goldstein; Paul S,36,0,38,2
1653303189795,ANTH 105,A00,085877,Staff,39,0,40,1
1653303190324,ANTH 108,A00,085878,Staff,31,0,32,1
1653303190856,ANTH 192,A00,094234,Kaiser; Bronwyn Nicole & Non; Amy L,20,0,20,0
1653303191381,ANTH 196A,A00,085879,Varma; Saiba,20,0,20,0
1653303191937,AWP 3,001,085697,Staff,13,0,13,0
1653303191937,AWP 3,002,085698,Staff,13,0,13,0
1653303191937,AWP 3,003,085699,Staff,13,0,13,0
1653303191937,AWP 3,004,085700,Staff,0,0,0,0
1653303191937,AWP 3,005,085701,Staff,0,0,0,0
1653303191937,AWP 3,006,085703,Staff,0,0,0,0
1653303191937,AWP 3,007,085704,Staff,13,0,13,0
1653303191937,AWP 3,008,085707,Staff,0,0,0,0
1653303191937,AWP 3,009,085709,Staff,13,0,13,0
1653303191937,AWP 3,010,085710,Staff,13,0,13,0
1653303191937,AWP 3,011,085711,Staff,0,0,0,0
1653303191937,AWP 3,012,085712,Staff,0,0,0,0
1653303191937,AWP 3,013,085713,Staff,13,0,13,0
1653303191937,AWP 3,014,085715,Staff,13,0,13,0
1653303191937,AWP 3,015,085717,Staff,13,0,13,0
1653303191937,AWP 3,016,085719,Staff,13,0,13,0
1653303191937,AWP 3,017,085720,Staff,13,0,13,0
1653303191937,AWP 3,018,085721,Staff,13,0,13,0
1653303191937,AWP 3,019,085722,Staff,13,0,13,0
1653303191937,AWP 3,020,085723,Staff,13,0,13,0
1653303191937,AWP 3,021,085724,Staff,13,0,13,0
1653303191937,AWP 3,022,085725,Staff,13,0,13,0
1653303191937,AWP 3,023,085726,Staff,13,0,13,0
1653303191937,AWP 3,024,085727,Staff,13,0,13,0
1653303191937,AWP 3,025,085728,Staff,13,0,13,0
1653303191937,AWP 3,026,085729,Staff,13,0,13,0
1653303191937,AWP 3,027,085730,Staff,13,0,13,0
1653303191937,AWP 3,028,085731,Staff,13,0,13,0
1653303191937,AWP 3,029,085732,Staff,13,0,13,0
1653303191937,AWP 3,030,085733,Staff,13,0,13,0
1653303191937,AWP 3,031,085734,Staff,13,0,13,0
1653303191937,AWP 3,032,085735,Staff,13,0,13,0
1653303191937,AWP 3,033,085736,Staff,13,0,13,0
1653303191937,AWP 3,034,085737,Staff,13,0,13,0
1653303191937,AWP 3,035,085738,Staff,13,0,13,0
1653303191937,AWP 3,036,085739,Staff,13,0,13,0
1653303191937,AWP 3,037,085740,Staff,13,0,13,0
1653303191937,AWP 3,038,085741,Staff,13,0,13,0
1653303191937,AWP 3,039,085742,Staff,13,0,13,0
1653303191937,AWP 3,040,085743,Staff,13,0,13,0
1653303191937,AWP 3,041,085744,Staff,13,0,13,0
1653303191937,AWP 3,042,085745,Staff,13,0,13,0
1653303191937,AWP 3,043,085746,Staff,13,0,13,0
1653303191937,AWP 3,044,085747,Staff,13,0,13,0
1653303191937,AWP 3,045,085748,Staff,13,0,13,0
1653303191937,AWP 3,046,085749,Staff,13,0,13,0
1653303191937,AWP 3,047,085750,Staff,13,0,13,0
1653303191937,AWP 3,048,085751,Staff,13,0,13,0
1653303191937,AWP 3,049,085752,Staff,13,0,13,0
1653303191937,AWP 3,050,085753,Staff,13,0,13,0
1653303191937,AWP 3,051,085754,Staff,13,0,13,0
1653303191937,AWP 3,052,085755,Staff,0,0,0,0
1653303191937,AWP 3,053,085756,Staff,13,0,13,0
1653303191937,AWP 3,054,085757,Staff,0,0,0,0
1653303191937,AWP 3,055,085758,Staff,13,0,13,0
1653303191937,AWP 3,056,085759,Staff,13,0,13,0
1653303191937,AWP 3,057,085760,Staff,13,0,13,0
1653303191937,AWP 3,058,085761,Staff,13,0,13,0
1653303191937,AWP 3,059,085762,Staff,13,0,13,0
1653303191937,AWP 3,060,085763,Staff,13,0,13,0
1653303191937,AWP 3,061,085764,Staff,13,0,13,0
1653303191937,AWP 3,062,085765,Staff,13,0,13,0
1653303191937,AWP 3,063,085766,Staff,13,0,13,0
1653303191937,AWP 3,064,085767,Staff,13,0,13,0
1653303191937,AWP 3,065,085768,Staff,13,0,13,0
1653303191937,AWP 3,066,085769,Staff,0,0,0,0
1653303192464,AWP 4A,001,085770,Staff,0,0,0,0
1653303192464,AWP 4A,002,085771,Staff,13,0,13,0
1653303192464,AWP 4A,003,085772,Staff,13,0,13,0
1653303192464,AWP 4A,004,085773,Staff,13,0,13,0
1653303192464,AWP 4A,005,085774,Staff,0,0,0,0
1653303192464,AWP 4A,006,085775,Staff,13,0,13,0
1653303192464,AWP 4A,007,085776,Staff,0,0,0,0
1653303192464,AWP 4A,008,085777,Staff,0,0,0,0
1653303192464,AWP 4A,009,085778,Staff,0,0,0,0
1653303192464,AWP 4A,010,085779,Staff,13,0,13,0
1653303192464,AWP 4A,011,085780,Staff,13,0,13,0
1653303192464,AWP 4A,012,085781,Staff,0,0,0,0
1653303192464,AWP 4A,013,085782,Staff,13,0,13,0
1653303192464,AWP 4A,014,085783,Staff,13,0,13,0
1653303192464,AWP 4A,015,085784,Staff,13,0,13,0
1653303192464,AWP 4A,016,085785,Staff,13,0,13,0
1653303192464,AWP 4A,017,085786,Staff,13,0,13,0
1653303192464,AWP 4A,018,085787,Staff,0,0,0,0
1653303192464,AWP 4A,019,085788,Staff,13,0,13,0
1653303192464,AWP 4A,020,085789,Staff,13,0,13,0
1653303192464,AWP 4A,021,085790,Staff,0,0,0,0
1653303192464,AWP 4A,022,085791,Staff,13,0,13,0
1653303192464,AWP 4A,023,085792,Staff,0,0,0,0
1653303192464,AWP 4A,024,085793,Staff,0,0,0,0
1653303192464,AWP 4A,025,085794,Staff,13,0,13,0
1653303192464,AWP 4A,026,085795,Staff,13,0,13,0
1653303192464,AWP 4A,027,085796,Staff,13,0,13,0
1653303192464,AWP 4A,028,085797,Staff,13,0,13,0
1653303192464,AWP 4A,029,085798,Staff,0,0,0,0
1653303192464,AWP 4A,030,085799,Staff,0,0,0,0
1653303192464,AWP 4A,031,093835,Staff,0,0,0,0
1653303192988,AWP 4B,001,085800,Staff,0,0,0,0
1653303192988,AWP 4B,002,085801,Staff,0,0,0,0
1653303193519,BENG 2,A00,085936,Wheeler; Bruce Christopher,28,0,30,2
1653303194045,BENG 110,A01,085939,Mc Culloch; Andrew Douglas,20,0,30,10
1653303194045,BENG 110,A02,085940,Mc Culloch; Andrew Douglas,18,0,30,12
1653303194045,BENG 110,A03,085941,Mc Culloch; Andrew Douglas,27,0,30,3
1653303194573,BENG 119A,A01,085943,Wheeler; Bruce Christopher,29,0,30,1
1653303195098,BENG 122A,A01,085945,Cauwenberghs; Gert,18,0,25,7
1653303195098,BENG 122A,A02,085946,Cauwenberghs; Gert,22,0,25,3
1653303195098,BENG 122A,A03,085947,Cauwenberghs; Gert,22,0,25,3
1653303195625,BENG 126A,A01,085949,Wheeler; Bruce Christopher,30,0,30,0
1653303196148,BENG 127A,A01,085951,Wheeler; Bruce Christopher,28,0,30,2
1653303196672,BENG 128A,A01,085953,Wheeler; Bruce Christopher,29,0,30,1
1653303197197,BENG 134,A01,085955,Smarr; Benjamin,0,0,0,0
1653303197721,BENG 135,A00,085956,Wheeler; Bruce Christopher,23,0,30,7
1653303198260,BENG 141,A00,085958,Lal; Ratnesh,20,0,30,10
1653303198787,BENG 147A,A01,085963,Wheeler; Bruce Christopher,30,0,30,0
1653303199311,BENG 148A,A01,085967,Wheeler; Bruce Christopher,30,0,30,0
1653303199842,BENG 149A,A01,085969,Wheeler; Bruce Christopher,30,0,30,0
1653303200366,BENG 161A,A01,085971,Fraley; Stephanie I.,20,0,25,5
1653303200366,BENG 161A,A02,085972,Fraley; Stephanie I.,13,0,25,12
1653303200366,BENG 161A,A03,085973,Fraley; Stephanie I.,9,0,25,16
1653303200891,BENG 162,A01,085975,Mali; Prashant Gulab Ram,0,0,35,35
1653303200891,BENG 162,A02,085976,Mali; Prashant Gulab Ram,26,0,35,9
1653303201415,BENG 166A,A00,085977,Sah; Robert Lie-Yuan,0,0,0,0
1653303201939,BENG 169A,A01,085982,Wheeler; Bruce Christopher,28,0,30,2
1653303202465,BENG 179A,A01,085984,Wheeler; Bruce Christopher,30,0,30,0
1653303202996,BENG 183,A01,085986,Zhong; Sheng,13,0,30,17
1653303202996,BENG 183,A02,085987,Zhong; Sheng,15,0,30,15
1653303202996,BENG 183,A03,085988,Zhong; Sheng,20,0,30,10
1653303203521,BENG 187B,A00,085989,Wheeler; Bruce Christopher,105,0,170,65
1653303204085,BENG 196,001,094047,Engler; Adam J.,9999,0,9999,0
1653303204620,BIBC 100,A01,092918,Huffaker; Alisa,0,0,19,19
1653303204620,BIBC 100,A02,092919,Huffaker; Alisa,19,0,19,0
1653303204620,BIBC 100,A03,092920,Huffaker; Alisa,18,0,19,1
1653303204620,BIBC 100,A04,092921,Huffaker; Alisa,18,0,19,1
1653303204620,BIBC 100,A05,092922,Huffaker; Alisa,19,0,19,0
1653303204620,BIBC 100,A06,092923,Huffaker; Alisa,18,0,19,1
1653303204620,BIBC 100,A07,092924,Huffaker; Alisa,10,0,19,9
1653303204620,BIBC 100,A08,092925,Huffaker; Alisa,17,0,19,2
1653303204620,BIBC 100,A09,092926,Huffaker; Alisa,19,0,19,0
1653303204620,BIBC 100,A10,092927,Huffaker; Alisa,11,0,19,8
1653303205157,BIBC 102,A01,092997,Schmelz; Eric Alexander,16,0,19,3
1653303205157,BIBC 102,A02,092998,Schmelz; Eric Alexander,5,0,19,14
1653303205157,BIBC 102,A03,092999,Schmelz; Eric Alexander,1,0,19,18
1653303205157,BIBC 102,A04,093000,Schmelz; Eric Alexander,17,0,19,2
1653303205157,BIBC 102,A05,093001,Schmelz; Eric Alexander,9,0,19,10
1653303205157,BIBC 102,A06,093002,Schmelz; Eric Alexander,16,0,19,3
1653303205157,BIBC 102,A07,093003,Schmelz; Eric Alexander,19,0,19,0
1653303205157,BIBC 102,A08,093004,Schmelz; Eric Alexander,19,0,19,0
1653303205157,BIBC 102,A09,093005,Schmelz; Eric Alexander,14,0,19,5
1653303205157,BIBC 102,B01,093064,Coleman; Aaron B.,19,0,19,0
1653303205157,BIBC 102,B02,093065,Coleman; Aaron B.,17,0,19,2
1653303205157,BIBC 102,B03,093066,Coleman; Aaron B.,16,0,19,3
1653303205157,BIBC 102,B04,093067,Coleman; Aaron B.,11,0,19,8
1653303205157,BIBC 102,B05,093068,Coleman; Aaron B.,18,0,19,1
1653303205157,BIBC 102,B06,093069,Coleman; Aaron B.,16,0,19,3
1653303205157,BIBC 102,B07,093070,Coleman; Aaron B.,19,0,19,0
1653303205157,BIBC 102,B08,093071,Coleman; Aaron B.,15,0,19,4
1653303205157,BIBC 102,B09,093072,Coleman; Aaron B.,17,0,19,2
1653303205687,BIBC 103,A01,089887,Bozinovic; Goran,19,0,24,5
1653303205687,BIBC 103,A02,089888,Bozinovic; Goran,23,0,24,1
1653303205687,BIBC 103,B01,089890,Burg; Michael,1,0,24,23
1653303205687,BIBC 103,B02,089891,Burg; Michael,20,0,24,4
1653303205687,BIBC 103,C01,089893,Beyhan; Sinem,14,0,24,10
1653303205687,BIBC 103,C02,089894,Beyhan; Sinem,22,0,24,2
1653303205687,BIBC 103,D01,089896,Coleman; Aaron B.,10,0,24,14
1653303205687,BIBC 103,D02,089897,Coleman; Aaron B.,22,0,24,2
1653303206217,BIBC 194,A00,089898,Hui; Enfu,16,0,27,11
1653303206750,BICD 100,A01,092396,Smith; Laurie,21,0,22,1
1653303206750,BICD 100,A02,092397,Smith; Laurie,22,0,22,0
1653303206750,BICD 100,A03,092398,Smith; Laurie,21,0,22,1
1653303206750,BICD 100,A04,092399,Smith; Laurie,22,0,22,0
1653303206750,BICD 100,A05,092400,Smith; Laurie,21,0,22,1
1653303206750,BICD 100,A06,092401,Smith; Laurie,22,0,22,0
1653303206750,BICD 100,A07,092402,Smith; Laurie,22,0,22,0
1653303206750,BICD 100,A08,092403,Smith; Laurie,22,0,22,0
1653303206750,BICD 100,B01,093073,Mueller; Liam O'Connor,21,0,22,1
1653303206750,BICD 100,B02,093074,Mueller; Liam O'Connor,22,0,22,0
1653303206750,BICD 100,B03,093075,Mueller; Liam O'Connor,22,0,22,0
1653303206750,BICD 100,B04,093076,Mueller; Liam O'Connor,22,0,22,0
1653303206750,BICD 100,B05,093077,Mueller; Liam O'Connor,22,0,22,0
1653303206750,BICD 100,B06,093078,Mueller; Liam O'Connor,22,0,22,0
1653303206750,BICD 100,B07,093079,Mueller; Liam O'Connor,21,0,22,1
1653303206750,BICD 100,B08,093080,Mueller; Liam O'Connor,22,0,22,0
1653303206750,BICD 100,C01,093021,McDonnell; Lisa Marie,21,0,22,1
1653303206750,BICD 100,C02,093022,McDonnell; Lisa Marie,20,0,22,2
1653303206750,BICD 100,C03,093023,McDonnell; Lisa Marie,22,0,22,0
1653303206750,BICD 100,C04,093024,McDonnell; Lisa Marie,22,0,22,0
1653303206750,BICD 100,C05,093025,McDonnell; Lisa Marie,22,0,22,0
1653303206750,BICD 100,C06,093026,McDonnell; Lisa Marie,22,0,22,0
1653303206750,BICD 100,C07,093027,McDonnell; Lisa Marie,20,0,22,2
1653303206750,BICD 100,C08,093028,McDonnell; Lisa Marie,22,0,22,0
1653303206750,BICD 100,D01,093081,Day; Christopher D,22,0,22,0
1653303206750,BICD 100,D02,093082,Day; Christopher D,17,0,22,5
1653303206750,BICD 100,D03,093083,Day; Christopher D,21,0,22,1
1653303206750,BICD 100,D04,093084,Day; Christopher D,19,0,22,3
1653303206750,BICD 100,D05,093085,Day; Christopher D,22,0,22,0
1653303206750,BICD 100,D06,093086,Day; Christopher D,20,0,22,2
1653303206750,BICD 100,D07,093087,Day; Christopher D,19,0,22,3
1653303206750,BICD 100,D08,093088,Day; Christopher D,20,0,22,2
1653303207278,BICD 110,A01,093089,Kiger; Amy,29,0,32,3
1653303207278,BICD 110,A02,093091,Kiger; Amy,32,0,32,0
1653303207278,BICD 110,A03,093092,Kiger; Amy,31,0,32,1
1653303207278,BICD 110,A04,093093,Kiger; Amy,31,0,32,1
1653303207278,BICD 110,A05,093094,Kiger; Amy,26,0,32,6
1653303207278,BICD 110,A06,093095,Kiger; Amy,31,0,32,1
1653303207278,BICD 110,A07,093096,Kiger; Amy,31,0,32,1
1653303207278,BICD 110,B01,093029,Grossman; Emily N,21,0,32,11
1653303207278,BICD 110,B02,093030,Grossman; Emily N,28,0,32,4
1653303207278,BICD 110,B03,093031,Grossman; Emily N,32,0,32,0
1653303207278,BICD 110,B04,093032,Grossman; Emily N,28,0,32,4
1653303207278,BICD 110,B05,093033,Grossman; Emily N,26,0,32,6
1653303207278,BICD 110,B06,093034,Grossman; Emily N,19,0,32,13
1653303207278,BICD 110,B07,093035,Grossman; Emily N,20,0,32,12
1653303207814,BICD 140,A01,093097,Zuniga; Elina I,19,0,32,13
1653303207814,BICD 140,A02,093098,Zuniga; Elina I,17,0,32,15
1653303207814,BICD 140,A03,093099,Zuniga; Elina I,30,0,32,2
1653303207814,BICD 140,A04,093100,Zuniga; Elina I,32,0,32,0
1653303207814,BICD 140,A05,093101,Zuniga; Elina I,29,0,32,3
1653303207814,BICD 140,A06,093102,Zuniga; Elina I,27,0,32,5
1653303208345,BIEB 102,A01,092528,Butler; Shannon Rhey,22,0,27,5
1653303208345,BIEB 102,A02,092529,Butler; Shannon Rhey,17,0,27,10
1653303208345,BIEB 102,A03,092530,Butler; Shannon Rhey,24,0,27,3
1653303208345,BIEB 102,A04,092531,Butler; Shannon Rhey,26,0,27,1
1653303208345,BIEB 102,A05,092532,Butler; Shannon Rhey,25,0,27,2
1653303208345,BIEB 102,A06,092533,Butler; Shannon Rhey,24,0,27,3
1653303208345,BIEB 102,A07,092534,Butler; Shannon Rhey,23,0,27,4
1653303208869,BIEB 121,A00,089907,Holway; David A.,0,0,32,32
1653303209399,BIEB 126,A01,092974,Kohn; Joshua R,24,0,27,3
1653303209399,BIEB 126,A02,092975,Kohn; Joshua R,26,0,27,1
1653303209399,BIEB 126,A03,092976,Kohn; Joshua R,23,0,27,4
1653303209399,BIEB 126,A04,092977,Kohn; Joshua R,25,0,27,2
1653303209399,BIEB 126,A05,092978,Kohn; Joshua R,27,0,27,0
1653303209931,BIEB 146,A01,093054,Petrie; Katherine Lynn,1,0,27,26
1653303209931,BIEB 146,A02,093055,Petrie; Katherine Lynn,4,0,27,23
1653303209931,BIEB 146,A03,093056,Petrie; Katherine Lynn,0,0,27,27
1653303209931,BIEB 146,A04,093057,Petrie; Katherine Lynn,0,0,27,27
1653303209931,BIEB 146,A05,093058,Petrie; Katherine Lynn,20,0,27,7
1653303209931,BIEB 146,A06,093059,Petrie; Katherine Lynn,26,0,27,1
1653303209931,BIEB 146,A07,093060,Petrie; Katherine Lynn,16,0,27,11
1653303209931,BIEB 146,A08,093061,Petrie; Katherine Lynn,25,0,27,2
1653303209931,BIEB 146,A09,093062,Petrie; Katherine Lynn,17,0,27,10
1653303210456,BIEB 150,A01,093103,Rennison; Diana,16,0,27,11
1653303210456,BIEB 150,A02,093104,Rennison; Diana,21,0,27,6
1653303210456,BIEB 150,A03,093105,Rennison; Diana,26,0,27,1
1653303210456,BIEB 150,A04,093106,Rennison; Diana,24,0,27,3
1653303210456,BIEB 150,A05,093107,Rennison; Diana,25,0,27,2
1653303210456,BIEB 150,A06,093108,Rennison; Diana,27,0,27,0
1653303210980,BIEB 158,A01,094057,Reese; Aspen Taylor & Jackrel; Sara,31,0,32,1
1653303210980,BIEB 158,A02,094058,Reese; Aspen Taylor & Jackrel; Sara,28,0,32,4
1653303210980,BIEB 158,A03,094059,Reese; Aspen Taylor & Jackrel; Sara,31,0,32,1
1653303210980,BIEB 158,A04,094060,Reese; Aspen Taylor & Jackrel; Sara,32,0,32,0
1653303211505,BIEB 174,A01,092465,Cleland; Elsa Eleanor & Barton; Andrew David,27,0,27,0
1653303211505,BIEB 174,A02,092466,Cleland; Elsa Eleanor & Barton; Andrew David,27,0,27,0
1653303211505,BIEB 174,A03,092467,Cleland; Elsa Eleanor & Barton; Andrew David,23,0,27,4
1653303211505,BIEB 174,A04,092468,Cleland; Elsa Eleanor & Barton; Andrew David,20,0,27,7
1653303211505,BIEB 174,A05,092469,Cleland; Elsa Eleanor & Barton; Andrew David,25,0,27,2
1653303211505,BIEB 174,A06,092470,Cleland; Elsa Eleanor & Barton; Andrew David,27,0,27,0
1653303211505,BIEB 174,A07,092471,Cleland; Elsa Eleanor & Barton; Andrew David,25,0,27,2
1653303212059,BILD 1,A01,092884,Pickett; Brooke Elizabeth,16,0,19,3
1653303212059,BILD 1,A02,092885,Pickett; Brooke Elizabeth,19,0,19,0
1653303212059,BILD 1,A03,092886,Pickett; Brooke Elizabeth,19,0,19,0
1653303212059,BILD 1,A04,092887,Pickett; Brooke Elizabeth,18,0,19,1
1653303212059,BILD 1,A05,092888,Pickett; Brooke Elizabeth,19,0,19,0
1653303212059,BILD 1,A06,092889,Pickett; Brooke Elizabeth,19,0,19,0
1653303212059,BILD 1,A07,092890,Pickett; Brooke Elizabeth,17,0,19,2
1653303212059,BILD 1,B01,092891,Pekkurnaz Banghart; Gulcin,19,0,19,0
1653303212059,BILD 1,B02,092892,Pekkurnaz Banghart; Gulcin,16,0,19,3
1653303212059,BILD 1,B03,092893,Pekkurnaz Banghart; Gulcin,19,0,19,0
1653303212059,BILD 1,B04,092894,Pekkurnaz Banghart; Gulcin,19,0,19,0
1653303212059,BILD 1,B05,092895,Pekkurnaz Banghart; Gulcin,17,0,19,2
1653303212059,BILD 1,B06,092896,Pekkurnaz Banghart; Gulcin,19,0,19,0
1653303212059,BILD 1,B07,092897,Pekkurnaz Banghart; Gulcin,19,0,19,0
1653303212059,BILD 1,C01,092421,Meaders; Clara Leigh,18,0,19,1
1653303212059,BILD 1,C02,092422,Meaders; Clara Leigh,18,0,19,1
1653303212059,BILD 1,C03,092423,Meaders; Clara Leigh,17,0,19,2
1653303212059,BILD 1,C04,092424,Meaders; Clara Leigh,16,0,19,3
1653303212059,BILD 1,C05,092425,Meaders; Clara Leigh,19,0,19,0
1653303212059,BILD 1,C06,092426,Meaders; Clara Leigh,19,0,19,0
1653303212059,BILD 1,C07,092427,Meaders; Clara Leigh,19,0,19,0
1653303212059,BILD 1,D01,092428,Meaders; Clara Leigh,14,0,19,5
1653303212059,BILD 1,D02,092429,Meaders; Clara Leigh,19,0,19,0
1653303212059,BILD 1,D03,092430,Meaders; Clara Leigh,19,0,19,0
1653303212059,BILD 1,D04,092431,Meaders; Clara Leigh,19,0,19,0
1653303212059,BILD 1,D05,092432,Meaders; Clara Leigh,19,0,19,0
1653303212059,BILD 1,D06,092433,Meaders; Clara Leigh,19,0,19,0
1653303212059,BILD 1,D07,092434,Meaders; Clara Leigh,19,0,19,0
1653303212059,BILD 1,E01,092445,Cooper; Andrew Michael,19,0,19,0
1653303212059,BILD 1,E02,092446,Cooper; Andrew Michael,19,0,19,0
1653303212059,BILD 1,E03,092447,Cooper; Andrew Michael,19,0,19,0
1653303212059,BILD 1,E04,092448,Cooper; Andrew Michael,19,0,19,0
1653303212059,BILD 1,E05,092449,Cooper; Andrew Michael,17,0,19,2
1653303212059,BILD 1,E06,092450,Cooper; Andrew Michael,19,0,19,0
1653303212059,BILD 1,E07,092451,Cooper; Andrew Michael,19,0,19,0
1653303212586,BILD 2,A01,092822,Glasgow; Stacey Marie,25,0,25,0
1653303212586,BILD 2,A02,092823,Glasgow; Stacey Marie,24,0,25,1
1653303212586,BILD 2,A03,092824,Glasgow; Stacey Marie,24,0,25,1
1653303212586,BILD 2,A04,092825,Glasgow; Stacey Marie,25,0,25,0
1653303212586,BILD 2,A05,092826,Glasgow; Stacey Marie,25,0,25,0
1653303212586,BILD 2,A06,092827,Glasgow; Stacey Marie,25,0,25,0
1653303212586,BILD 2,A07,092828,Glasgow; Stacey Marie,25,0,25,0
1653303212586,BILD 2,B01,092830,Owens; Melinda Tsao-Ying,25,0,25,0
1653303212586,BILD 2,B02,092831,Owens; Melinda Tsao-Ying,21,0,25,4
1653303212586,BILD 2,B03,092832,Owens; Melinda Tsao-Ying,23,0,25,2
1653303212586,BILD 2,B04,092833,Owens; Melinda Tsao-Ying,25,0,25,0
1653303212586,BILD 2,B05,092834,Owens; Melinda Tsao-Ying,24,0,25,1
1653303212586,BILD 2,B06,092835,Owens; Melinda Tsao-Ying,21,0,25,4
1653303212586,BILD 2,B07,092836,Owens; Melinda Tsao-Ying,25,0,25,0
1653303212586,BILD 2,C01,092668,Owens; Melinda Tsao-Ying,24,0,25,1
1653303212586,BILD 2,C02,092669,Owens; Melinda Tsao-Ying,23,0,25,2
1653303212586,BILD 2,C03,092670,Owens; Melinda Tsao-Ying,22,0,25,3
1653303212586,BILD 2,C04,092671,Owens; Melinda Tsao-Ying,25,0,25,0
1653303212586,BILD 2,C05,092672,Owens; Melinda Tsao-Ying,25,0,25,0
1653303212586,BILD 2,C06,092673,Owens; Melinda Tsao-Ying,24,0,25,1
1653303212586,BILD 2,C07,092674,Owens; Melinda Tsao-Ying,25,0,25,0
1653303213130,BILD 3,A01,092454,Stockwell; Sarah R,17,0,19,2
1653303213130,BILD 3,A02,092455,Stockwell; Sarah R,17,0,19,2
1653303213130,BILD 3,A03,092456,Stockwell; Sarah R,18,0,19,1
1653303213130,BILD 3,A04,092457,Stockwell; Sarah R,19,0,19,0
1653303213130,BILD 3,A05,092458,Stockwell; Sarah R,19,0,19,0
1653303213130,BILD 3,A06,092459,Stockwell; Sarah R,18,0,19,1
1653303213130,BILD 3,A07,092460,Stockwell; Sarah R,18,0,19,1
1653303213130,BILD 3,A08,092461,Stockwell; Sarah R,19,0,19,0
1653303213130,BILD 3,A09,092462,Stockwell; Sarah R,19,0,19,0
1653303213130,BILD 3,B01,092479,Stockwell; Sarah R,19,0,19,0
1653303213130,BILD 3,B02,092480,Stockwell; Sarah R,18,0,19,1
1653303213130,BILD 3,B03,092481,Stockwell; Sarah R,18,0,19,1
1653303213130,BILD 3,B04,092482,Stockwell; Sarah R,19,0,19,0
1653303213130,BILD 3,B05,092483,Stockwell; Sarah R,19,0,19,0
1653303213130,BILD 3,B06,092484,Stockwell; Sarah R,19,0,19,0
1653303213130,BILD 3,B07,092485,Stockwell; Sarah R,19,0,19,0
1653303213130,BILD 3,B08,092486,Stockwell; Sarah R,18,0,19,1
1653303213130,BILD 3,B09,092487,Stockwell; Sarah R,18,0,19,1
1653303213130,BILD 3,C01,092412,Butler; Shannon Rhey,18,0,19,1
1653303213130,BILD 3,C02,092413,Butler; Shannon Rhey,15,0,19,4
1653303213130,BILD 3,C03,092414,Butler; Shannon Rhey,19,0,19,0
1653303213130,BILD 3,C04,092415,Butler; Shannon Rhey,19,0,19,0
1653303213130,BILD 3,C05,092416,Butler; Shannon Rhey,19,0,19,0
1653303213130,BILD 3,C06,092417,Butler; Shannon Rhey,19,0,19,0
1653303213130,BILD 3,C07,092418,Butler; Shannon Rhey,19,0,19,0
1653303213130,BILD 3,C08,092419,Butler; Shannon Rhey,19,0,19,0
1653303213130,BILD 3,C09,092420,Butler; Shannon Rhey,19,0,19,0
1653303213130,BILD 3,D01,092898,Reuther; Keefe,18,0,19,1
1653303213130,BILD 3,D02,092899,Reuther; Keefe,19,0,19,0
1653303213130,BILD 3,D03,092900,Reuther; Keefe,19,0,19,0
1653303213130,BILD 3,D04,092901,Reuther; Keefe,19,0,19,0
1653303213130,BILD 3,D05,092902,Reuther; Keefe,19,0,19,0
1653303213130,BILD 3,D06,092903,Reuther; Keefe,19,0,19,0
1653303213130,BILD 3,D07,092904,Reuther; Keefe,18,0,19,1
1653303213130,BILD 3,D08,092905,Reuther; Keefe,19,0,19,0
1653303213130,BILD 3,D09,092906,Reuther; Keefe,19,0,19,0
1653303213659,BILD 4,A01,089840,Mel; Stephanie,0,0,0,0
1653303213659,BILD 4,A02,089841,Mel; Stephanie,0,0,0,0
1653303213659,BILD 4,A03,089842,Mel; Stephanie,0,0,0,0
1653303213659,BILD 4,A04,089843,Mel; Stephanie,0,0,0,0
1653303213659,BILD 4,A05,089844,Mel; Stephanie,0,0,0,0
1653303213659,BILD 4,A06,089845,Mel; Stephanie,0,0,0,0
1653303213659,BILD 4,A07,089846,Mel; Stephanie,0,0,0,0
1653303213659,BILD 4,A08,089847,Mel; Stephanie,0,0,0,0
1653303213659,BILD 4,A09,089848,Mel; Stephanie,0,0,0,0
1653303213659,BILD 4,A10,089849,Mel; Stephanie,0,0,0,0
1653303213659,BILD 4,A11,089850,Mel; Stephanie,0,0,0,0
1653303213659,BILD 4,A12,089851,Mel; Stephanie,0,0,0,0
1653303213659,BILD 4,A13,089852,Mel; Stephanie,0,0,0,0
1653303213659,BILD 4,A14,089853,Mel; Stephanie,0,0,0,0
1653303213659,BILD 4,A15,089854,Mel; Stephanie,0,0,0,0
1653303213659,BILD 4,A16,089855,Mel; Stephanie,0,0,0,0
1653303213659,BILD 4,B01,089857,Lo; Stanley M.,0,0,0,0
1653303213659,BILD 4,B02,089858,Lo; Stanley M.,0,0,0,0
1653303213659,BILD 4,B03,089859,Lo; Stanley M.,0,0,0,0
1653303213659,BILD 4,B04,089860,Lo; Stanley M.,0,0,0,0
1653303213659,BILD 4,B05,089861,Lo; Stanley M.,0,0,0,0
1653303213659,BILD 4,B06,089862,Lo; Stanley M.,0,0,0,0
1653303213659,BILD 4,B07,089863,Lo; Stanley M.,0,0,0,0
1653303213659,BILD 4,B08,089864,Lo; Stanley M.,0,0,0,0
1653303213659,BILD 4,B09,089865,Lo; Stanley M.,0,0,0,0
1653303213659,BILD 4,B10,089866,Lo; Stanley M.,0,0,0,0
1653303213659,BILD 4,B11,089867,Lo; Stanley M.,0,0,0,0
1653303213659,BILD 4,B12,089868,Lo; Stanley M.,0,0,0,0
1653303213659,BILD 4,B13,089869,Lo; Stanley M.,0,0,0,0
1653303213659,BILD 4,B14,089870,Lo; Stanley M.,0,0,0,0
1653303213659,BILD 4,B15,089871,Lo; Stanley M.,0,0,0,0
1653303213659,BILD 4,B16,089872,Lo; Stanley M.,0,0,0,0
1653303214188,BILD 5,A01,092907,Reuther; Keefe,31,0,32,1
1653303214188,BILD 5,A02,092908,Reuther; Keefe,30,0,32,2
1653303214721,BILD 10,A01,092909,Gustafson-Brown; Cindy,27,0,27,0
1653303214721,BILD 10,A02,092910,Gustafson-Brown; Cindy,27,0,27,0
1653303214721,BILD 10,A03,092911,Gustafson-Brown; Cindy,27,0,27,0
1653303214721,BILD 10,A04,092912,Gustafson-Brown; Cindy,27,0,27,0
1653303214721,BILD 10,A05,092913,Gustafson-Brown; Cindy,25,0,27,2
1653303214721,BILD 10,A06,092914,Gustafson-Brown; Cindy,26,0,27,1
1653303214721,BILD 10,A07,092915,Gustafson-Brown; Cindy,27,0,27,0
1653303214721,BILD 10,A08,092916,Gustafson-Brown; Cindy,27,0,27,0
1653303214721,BILD 10,A09,092917,Gustafson-Brown; Cindy,27,0,27,0
1653303215256,BILD 20,A01,092956,Rana; Brinda Kanti,24,0,27,3
1653303215256,BILD 20,A02,092957,Rana; Brinda Kanti,24,0,27,3
1653303215256,BILD 20,A03,092958,Rana; Brinda Kanti,27,0,27,0
1653303215256,BILD 20,A04,092959,Rana; Brinda Kanti,27,0,27,0
1653303215780,BILD 32,A01,092990,Burg; Michael,27,0,27,0
1653303215780,BILD 32,A02,092991,Burg; Michael,26,0,27,1
1653303215780,BILD 32,A03,092992,Burg; Michael,27,0,27,0
1653303215780,BILD 32,A04,092993,Burg; Michael,26,0,27,1
1653303215780,BILD 32,A05,092994,Burg; Michael,27,0,27,0
1653303215780,BILD 32,A06,092995,Burg; Michael,27,0,27,0
1653303215780,BILD 32,A07,092996,Burg; Michael,27,0,27,0
1653303216307,BILD 60,A01,092392,Hammond; LaTisha Marie,24,0,24,0
1653303216307,BILD 60,A02,092393,Hammond; LaTisha Marie,24,0,24,0
1653303216307,BILD 60,B01,092394,Macagno; Eduardo R.,23,0,24,1
1653303216307,BILD 60,B02,092395,Macagno; Eduardo R.,24,0,24,0
1653303216831,BILD 62,A01,092949,Aljadeff; Johnatan,31,0,32,1
1653303216831,BILD 62,A02,092950,Aljadeff; Johnatan,32,0,32,0
1653303216831,BILD 62,A03,092951,Aljadeff; Johnatan,32,0,32,0
1653303217358,BILD 80,A00,089880,Pogliano; Joseph,27,0,30,3
1653303217885,BIMM 100,A01,092435,Pasquinelli; Amy,32,0,32,0
1653303217885,BIMM 100,A02,092436,Pasquinelli; Amy,30,0,32,2
1653303217885,BIMM 100,A03,092437,Pasquinelli; Amy,32,0,32,0
1653303217885,BIMM 100,A04,092438,Pasquinelli; Amy,31,0,32,1
1653303217885,BIMM 100,A05,092439,Pasquinelli; Amy,32,0,32,0
1653303217885,BIMM 100,A06,092440,Pasquinelli; Amy,32,0,32,0
1653303217885,BIMM 100,A07,092441,Pasquinelli; Amy,32,0,32,0
1653303217885,BIMM 100,A08,092442,Pasquinelli; Amy,32,0,32,0
1653303217885,BIMM 100,A09,092443,Pasquinelli; Amy,32,0,32,0
1653303217885,BIMM 100,A10,092444,Pasquinelli; Amy,32,0,32,0
1653303217885,BIMM 100,B01,092518,Pruneda-Paz; Jose L.,26,0,32,6
1653303217885,BIMM 100,B02,092519,Pruneda-Paz; Jose L.,19,0,32,13
1653303217885,BIMM 100,B03,092520,Pruneda-Paz; Jose L.,20,0,32,12
1653303217885,BIMM 100,B04,092521,Pruneda-Paz; Jose L.,24,0,32,8
1653303217885,BIMM 100,B05,092522,Pruneda-Paz; Jose L.,23,0,32,9
1653303217885,BIMM 100,B06,092523,Pruneda-Paz; Jose L.,24,0,32,8
1653303217885,BIMM 100,B07,092524,Pruneda-Paz; Jose L.,28,0,32,4
1653303217885,BIMM 100,B08,092525,Pruneda-Paz; Jose L.,25,0,32,7
1653303217885,BIMM 100,B09,092526,Pruneda-Paz; Jose L.,26,0,32,6
1653303217885,BIMM 100,B10,092527,Pruneda-Paz; Jose L.,24,0,32,8
1653303218421,BIMM 101,A01,089915,Rusert; Jessica Marie,22,0,24,2
1653303218421,BIMM 101,A02,089916,Rusert; Jessica Marie,21,0,24,3
1653303218421,BIMM 101,A03,089917,Rusert; Jessica Marie,21,0,24,3
1653303218421,BIMM 101,A04,089918,Rusert; Jessica Marie,20,0,24,4
1653303218421,BIMM 101,B01,089920,Grossman; Emily N,0,0,24,24
1653303218421,BIMM 101,B02,089921,Grossman; Emily N,1,0,24,23
1653303218421,BIMM 101,C01,089923,Day; Christopher D,0,0,24,24
1653303218421,BIMM 101,C02,089924,Day; Christopher D,0,0,24,24
1653303218421,BIMM 101,D01,089926,Cooper; Andrew Michael,18,0,24,6
1653303218421,BIMM 101,D02,089927,Cooper; Andrew Michael,24,0,24,0
1653303218421,BIMM 101,E01,089929,McDonnell; Lisa Marie,1,0,24,23
1653303218421,BIMM 101,E02,089930,McDonnell; Lisa Marie,12,0,24,12
1653303218946,BIMM 110,A01,092472,Tour; Ella,26,0,32,6
1653303218946,BIMM 110,A02,092473,Tour; Ella,23,0,32,9
1653303218946,BIMM 110,A03,092474,Tour; Ella,29,0,32,3
1653303218946,BIMM 110,A04,092475,Tour; Ella,27,0,32,5
1653303218946,BIMM 110,A05,092476,Tour; Ella,32,0,32,0
1653303218946,BIMM 110,A06,092477,Tour; Ella,30,0,32,2
1653303218946,BIMM 110,A07,092478,Tour; Ella,29,0,32,3
1653303219471,BIMM 120,A01,092979,Allen; Eric,28,0,32,4
1653303219471,BIMM 120,A02,092980,Allen; Eric,1,0,32,31
1653303219471,BIMM 120,A03,092981,Allen; Eric,14,0,32,18
1653303219471,BIMM 120,A04,092982,Allen; Eric,27,0,32,5
1653303219471,BIMM 120,A05,092983,Allen; Eric,30,0,32,2
1653303219471,BIMM 120,A06,092984,Allen; Eric,29,0,32,3
1653303219471,BIMM 120,A07,092985,Allen; Eric,20,0,32,12
1653303219471,BIMM 120,A08,092986,Allen; Eric,30,0,32,2
1653303219471,BIMM 120,A09,092987,Allen; Eric,30,0,32,2
1653303219471,BIMM 120,A10,092988,Allen; Eric,30,0,32,2
1653303219471,BIMM 120,A11,092989,Allen; Eric,32,0,32,0
1653303219996,BIMM 121,A01,089934,Petrie; Katherine Lynn,0,0,24,24
1653303219996,BIMM 121,A02,089935,Petrie; Katherine Lynn,0,0,24,24
1653303219996,BIMM 121,B01,089937,Pickett; Brooke Elizabeth,0,0,24,24
1653303219996,BIMM 121,B02,089938,Pickett; Brooke Elizabeth,0,0,24,24
1653303219996,BIMM 121,C01,089940,Pirino; Giorgia,0,0,24,24
1653303219996,BIMM 121,C02,089941,Pirino; Giorgia,0,0,24,24
1653303219996,BIMM 121,C03,089942,Pirino; Giorgia,0,0,24,24
1653303219996,BIMM 121,C04,089943,Pirino; Giorgia,0,0,24,24
1653303220522,BIMM 122,A01,093006,Russell; Alistair B,18,0,32,14
1653303220522,BIMM 122,A02,093007,Russell; Alistair B,16,0,32,16
1653303220522,BIMM 122,A03,093008,Russell; Alistair B,26,0,32,6
1653303220522,BIMM 122,A04,093009,Russell; Alistair B,32,0,32,0
1653303220522,BIMM 122,A05,093010,Russell; Alistair B,30,0,32,2
1653303221119,BIMM 124,A01,092404,Gustafson-Brown; Cindy,26,0,32,6
1653303221119,BIMM 124,A02,092405,Gustafson-Brown; Cindy,29,0,32,3
1653303221119,BIMM 124,A03,092406,Gustafson-Brown; Cindy,30,0,32,2
1653303221119,BIMM 124,A04,092407,Gustafson-Brown; Cindy,32,0,32,0
1653303221119,BIMM 124,A05,092408,Gustafson-Brown; Cindy,28,0,32,4
1653303221119,BIMM 124,A06,092409,Gustafson-Brown; Cindy,31,0,32,1
1653303221119,BIMM 124,A07,092410,Gustafson-Brown; Cindy,32,0,32,0
1653303221656,BIMM 140,A01,089947,Suel; Gurol Mehmet & Hao; Nan,16,0,27,11
1653303221656,BIMM 140,A02,089948,Suel; Gurol Mehmet & Hao; Nan,24,0,27,3
1653303221656,BIMM 140,A03,089949,Suel; Gurol Mehmet & Hao; Nan,21,0,27,6
1653303221656,BIMM 140,A04,089950,Suel; Gurol Mehmet & Hao; Nan,25,0,27,2
1653303221656,BIMM 140,A05,089951,Suel; Gurol Mehmet & Hao; Nan,24,0,27,3
1653303222180,BIMM 143,A01,089953,Grant; Barry J,0,0,40,40
1653303222180,BIMM 143,B01,089955,Fan; Chun Chieh,39,0,40,1
1653303222180,BIMM 143,C01,089957,Bozinovic; Goran,29,0,40,11
1653303222708,BIMM 194,A00,089958,Hasty; Jeff M,15,0,27,12
1653303222708,BIMM 194,B00,089959,Golden; James W,19,0,27,8
1653303222708,BIMM 194,C00,089960,Lykke-Andersen; Jens,2,0,27,25
1653303222708,BIMM 194,D00,094317,Golden; Susan S.,25,0,27,2
1653303223235,BIPN 100,A01,093011,Cooke; James Edward,7,0,19,12
1653303223235,BIPN 100,A02,093012,Cooke; James Edward,10,0,19,9
1653303223235,BIPN 100,A03,093013,Cooke; James Edward,8,0,19,11
1653303223235,BIPN 100,A04,093014,Cooke; James Edward,12,0,19,7
1653303223235,BIPN 100,A05,093015,Cooke; James Edward,17,0,19,2
1653303223235,BIPN 100,A06,093016,Cooke; James Edward,12,0,19,7
1653303223235,BIPN 100,A07,093017,Cooke; James Edward,12,0,19,7
1653303223235,BIPN 100,A08,093018,Cooke; James Edward,18,0,19,1
1653303223235,BIPN 100,A09,093019,Cooke; James Edward,17,0,19,2
1653303223235,BIPN 100,A10,093020,Cooke; James Edward,18,0,19,1
1653303223235,BIPN 100,B01,093036,Reyes Gonzalez; Catalina,17,0,19,2
1653303223235,BIPN 100,B02,093037,Reyes Gonzalez; Catalina,14,0,19,5
1653303223235,BIPN 100,B03,093038,Reyes Gonzalez; Catalina,16,0,19,3
1653303223235,BIPN 100,B04,093039,Reyes Gonzalez; Catalina,19,0,19,0
1653303223235,BIPN 100,B05,093040,Reyes Gonzalez; Catalina,19,0,19,0
1653303223235,BIPN 100,B06,093041,Reyes Gonzalez; Catalina,19,0,19,0
1653303223235,BIPN 100,B07,093042,Reyes Gonzalez; Catalina,14,0,19,5
1653303223235,BIPN 100,B08,093043,Reyes Gonzalez; Catalina,16,0,19,3
1653303223235,BIPN 100,B09,093044,Reyes Gonzalez; Catalina,19,0,19,0
1653303223235,BIPN 100,B10,093045,Reyes Gonzalez; Catalina,19,0,19,0
1653303223767,BIPN 102,A01,093046,Reyes Gonzalez; Catalina,28,0,32,4
1653303223767,BIPN 102,A02,093047,Reyes Gonzalez; Catalina,17,0,32,15
1653303223767,BIPN 102,A05,093050,Reyes Gonzalez; Catalina,29,0,32,3
1653303223767,BIPN 102,A06,093051,Reyes Gonzalez; Catalina,15,0,32,17
1653303223767,BIPN 102,A07,093052,Reyes Gonzalez; Catalina,29,0,32,3
1653303223767,BIPN 102,A08,093053,Reyes Gonzalez; Catalina,31,0,32,1
1653303224292,BIPN 105,A01,089966,Armour; Jon Christopher,0,0,21,21
1653303224292,BIPN 105,A02,089967,Armour; Jon Christopher,0,0,21,21
1653303224292,BIPN 105,A03,089968,Armour; Jon Christopher,3,0,21,18
1653303224292,BIPN 105,A04,089969,Armour; Jon Christopher,10,0,21,11
1653303224818,BIPN 140,A01,092514,Spitzer; Nicholas & Su; Chih-Ying,9,0,19,10
1653303224818,BIPN 140,A02,092515,Spitzer; Nicholas & Su; Chih-Ying,12,0,19,7
1653303224818,BIPN 140,A03,092516,Spitzer; Nicholas & Su; Chih-Ying,11,0,19,8
1653303224818,BIPN 140,A04,092517,Spitzer; Nicholas & Su; Chih-Ying,15,0,19,4
1653303224818,BIPN 140,B01,092952,Banghart; Matthew Ryan,12,0,19,7
1653303224818,BIPN 140,B02,092953,Banghart; Matthew Ryan,19,0,19,0
1653303224818,BIPN 140,B03,092954,Banghart; Matthew Ryan,19,0,19,0
1653303224818,BIPN 140,B04,092955,Banghart; Matthew Ryan,19,0,19,0
1653303225342,BIPN 145,A01,089973,Marino; Marc J,35,0,42,7
1653303225342,BIPN 145,A02,089974,Marino; Marc J,36,0,42,6
1653303225342,BIPN 145,B01,089976,Juavinett; Ashley Lauren,0,0,42,42
1653303225879,BIPN 148,A01,092960,Leutgeb; Jill K.,31,0,32,1
1653303225879,BIPN 148,A02,092961,Leutgeb; Jill K.,25,0,32,7
1653303225879,BIPN 148,A03,092962,Leutgeb; Jill K.,29,0,31,2
1653303225879,BIPN 148,A04,092963,Leutgeb; Jill K.,31,0,31,0
1653303225879,BIPN 148,A05,092964,Leutgeb; Jill K.,31,0,31,0
1653303225879,BIPN 148,A06,094351,Leutgeb; Jill K.,26,0,31,5
1653303225879,BIPN 148,A07,092966,Leutgeb; Jill K.,26,0,31,5
1653303225879,BIPN 148,A08,092967,Leutgeb; Jill K.,26,0,31,5
1653303226405,BIPN 189,A00,090665,Gentner; Tim,0,0,25,25
1653303226930,BIPN 194,A00,089978,Pekkurnaz Banghart; Gulcin,17,0,27,10
1653303226930,BIPN 194,B00,089979,Leutgeb; Stefan,24,0,27,3
1653303227453,BISP 194,A00,089980,Wertheim; Joel Okrent,8,0,27,19
1653303227987,CAT 1,A01,086671,Bronstein; Phoebe Malan,17,0,17,0
1653303227987,CAT 1,A02,086672,Bronstein; Phoebe Malan,13,0,17,4
1653303227987,CAT 1,A03,086673,Bronstein; Phoebe Malan,17,0,17,0
1653303227987,CAT 1,A04,086674,Bronstein; Phoebe Malan,15,0,17,2
1653303227987,CAT 1,A05,086675,Bronstein; Phoebe Malan,17,0,17,0
1653303227987,CAT 1,A06,086676,Bronstein; Phoebe Malan,17,0,17,0
1653303227987,CAT 1,A07,086677,Bronstein; Phoebe Malan,16,0,17,1
1653303227987,CAT 1,A08,086678,Bronstein; Phoebe Malan,17,0,17,0
1653303227987,CAT 1,A09,086679,Bronstein; Phoebe Malan,16,0,17,1
1653303227987,CAT 1,A10,086680,Bronstein; Phoebe Malan,17,0,17,0
1653303227987,CAT 1,A11,086681,Bronstein; Phoebe Malan,16,0,17,1
1653303227987,CAT 1,A12,086682,Bronstein; Phoebe Malan,17,0,17,0
1653303227987,CAT 1,A13,086683,Bronstein; Phoebe Malan,17,0,17,0
1653303227987,CAT 1,A14,086684,Bronstein; Phoebe Malan,17,0,17,0
1653303227987,CAT 1,A15,086685,Bronstein; Phoebe Malan,17,0,17,0
1653303227987,CAT 1,A16,086686,Bronstein; Phoebe Malan,17,0,17,0
1653303227987,CAT 1,B01,086688,Bigham; David Joseph,17,0,17,0
1653303227987,CAT 1,B02,086689,Bigham; David Joseph,16,0,17,1
1653303227987,CAT 1,B03,086690,Bigham; David Joseph,17,0,17,0
1653303227987,CAT 1,B04,086691,Bigham; David Joseph,17,0,17,0
1653303227987,CAT 1,B05,086692,Bigham; David Joseph,16,0,17,1
1653303227987,CAT 1,B06,086693,Bigham; David Joseph,17,0,17,0
1653303227987,CAT 1,B07,086694,Bigham; David Joseph,17,0,17,0
1653303227987,CAT 1,B08,086695,Bigham; David Joseph,17,0,17,0
1653303227987,CAT 1,B09,086696,Bigham; David Joseph,17,0,17,0
1653303227987,CAT 1,B10,086697,Bigham; David Joseph,17,0,17,0
1653303227987,CAT 1,B11,086698,Bigham; David Joseph,17,0,17,0
1653303227987,CAT 1,B12,086699,Bigham; David Joseph,17,0,17,0
1653303227987,CAT 1,B13,086700,Bigham; David Joseph,15,0,17,2
1653303227987,CAT 1,B14,086701,Bigham; David Joseph,17,0,17,0
1653303227987,CAT 1,C01,086703,Algaze; Guillermo,17,0,17,0
1653303227987,CAT 1,C02,086704,Algaze; Guillermo,17,0,17,0
1653303227987,CAT 1,C03,086705,Algaze; Guillermo,17,0,17,0
1653303227987,CAT 1,C04,086706,Algaze; Guillermo,17,0,17,0
1653303227987,CAT 1,C05,086707,Algaze; Guillermo,17,0,17,0
1653303227987,CAT 1,C06,086708,Algaze; Guillermo,17,0,17,0
1653303227987,CAT 1,C07,086709,Algaze; Guillermo,17,0,17,0
1653303227987,CAT 1,C08,086710,Algaze; Guillermo,17,0,17,0
1653303227987,CAT 1,C09,086711,Algaze; Guillermo,17,0,17,0
1653303227987,CAT 1,C10,086712,Algaze; Guillermo,17,0,17,0
1653303227987,CAT 1,C11,086713,Algaze; Guillermo,17,0,17,0
1653303227987,CAT 1,C12,086714,Algaze; Guillermo,17,0,17,0
1653303227987,CAT 1,C13,086715,Algaze; Guillermo,17,0,17,0
1653303227987,CAT 1,C14,086716,Algaze; Guillermo,16,0,17,1
1653303227987,CAT 1,C15,086717,Algaze; Guillermo,17,0,17,0
1653303227987,CAT 1,C16,086718,Algaze; Guillermo,16,0,17,1
1653303227987,CAT 1,D01,086720,Staff,17,0,17,0
1653303227987,CAT 1,D02,086721,Staff,17,0,17,0
1653303227987,CAT 1,D03,086722,Staff,17,0,17,0
1653303227987,CAT 1,D04,086723,Staff,17,0,17,0
1653303227987,CAT 1,D05,086724,Staff,16,0,17,1
1653303227987,CAT 1,D06,086725,Staff,16,0,17,1
1653303227987,CAT 1,D07,086726,Staff,17,0,17,0
1653303227987,CAT 1,D08,086727,Staff,17,0,17,0
1653303227987,CAT 1,D09,086728,Staff,16,0,17,1
1653303227987,CAT 1,D10,086729,Staff,17,0,17,0
1653303227987,CAT 1,D11,086730,Staff,17,0,17,0
1653303227987,CAT 1,D12,086731,Staff,17,0,17,0
1653303227987,CAT 1,D13,086732,Staff,17,0,17,0
1653303227987,CAT 1,D14,086733,Staff,17,0,17,0
1653303228515,CAT 3,A01,086735,Gumm; Elizabeth Ashley,14,0,15,1
1653303228515,CAT 3,A02,086736,Gumm; Elizabeth Ashley,14,0,15,1
1653303228515,CAT 3,A03,086737,Gumm; Elizabeth Ashley,15,0,15,0
1653303228515,CAT 3,A04,086738,Gumm; Elizabeth Ashley,15,0,15,0
1653303228515,CAT 3,A05,086739,Gumm; Elizabeth Ashley,15,0,15,0
1653303228515,CAT 3,A06,086740,Gumm; Elizabeth Ashley,15,0,15,0
1653303229043,CAT 124,A01,086742,Staff,15,0,15,0
1653303229570,CAT 125R,A01,094882,Staff,14,0,16,2
1653303229570,CAT 125R,A02,086745,Staff,16,0,16,0
1653303229570,CAT 125R,A03,086746,Staff,14,0,16,2
1653303229570,CAT 125R,A04,086747,Staff,13,0,16,3
1653303229570,CAT 125R,A05,086748,Staff,15,0,16,1
1653303229570,CAT 125R,A06,086749,Staff,12,0,16,4
1653303229570,CAT 125R,A07,086750,Staff,14,0,16,2
1653303229570,CAT 125R,A08,094883,Staff,14,0,16,2
1653303229570,CAT 125R,A09,094884,Staff,16,0,16,0
1653303229570,CAT 125R,A10,094885,Staff,15,0,16,1
1653303229570,CAT 125R,A14,086761,Staff,15,0,16,1
1653303229570,CAT 125R,A15,086762,Staff,16,0,16,0
1653303229570,CAT 125R,A16,086763,Staff,13,0,16,3
1653303229570,CAT 125R,A17,086764,Staff,14,0,16,2
1653303229570,CAT 125R,A18,086765,Staff,14,0,16,2
1653303229570,CAT 125R,A19,086766,Staff,14,0,16,2
1653303230093,CCS 101,A00,088353,Staff,29,0,35,6
1653303230629,CENG 4,A01,086204,Bae; Jinhye,30,0,30,0
1653303230629,CENG 4,A02,086205,Bae; Jinhye,30,0,30,0
1653303230629,CENG 4,B01,086207,Drews; Aaron,30,0,30,0
1653303230629,CENG 4,B02,086208,Drews; Aaron,30,0,30,0
1653303231152,CENG 15,A01,086210,Lubarda; Vlado,63,0,65,2
1653303231152,CENG 15,B01,086212,Lubarda; Vlado,65,0,65,0
1653303231679,CENG 100,A00,086213,Chen; Zheng,147,0,150,3
1653303232204,CENG 101A,A00,086214,Bae; Jinhye,142,0,150,8
1653303232727,CENG 120,A00,086215,Opatkiewicz; Justin Paul,125,0,150,25
1653303233252,CENG 122,A00,086216,Opatkiewicz; Justin Paul,137,0,150,13
1653303233778,CGS 2A,A01,086271,Shelby; Karen Lee,12,0,15,3
1653303233778,CGS 2A,A02,086272,Shelby; Karen Lee,13,0,15,2
1653303233778,CGS 2A,A03,086273,Shelby; Karen Lee,14,0,15,1
1653303233778,CGS 2A,A04,086274,Shelby; Karen Lee,15,0,15,0
1653303234304,CGS 100A,A00,086275,Perez; Roy,26,0,32,6
1653303234828,CGS 101,A00,086276,Shelby; Karen Lee,30,0,30,0
1653303235354,CGS 106,A00,086277,Shelby; Karen Lee,24,0,30,6
1653303235885,CGS 119,A00,086279,Nguyen; Hoang Tan,27,0,30,3
1653303236410,CGS 121,A00,086280,Martin Sandino; Amanda Maria Yoland,19,0,20,1
1653303236945,CGS 122,A00,086281,Whitley; Leila Marie,20,0,20,0
1653303237474,CGS 123,A00,086282,Staff,0,0,0,0
1653303238001,CGS 127,A00,086283,Whitley; Leila Marie,15,0,15,0
1653303238525,CGS 130,A00,086284,Martin Sandino; Amanda Maria Yoland,15,0,15,0
1653303239050,CGS 187,A00,086285,Perez; Roy,15,0,16,1
1653303239573,CGS 190,A00,086286,Staff,5,0,5,0
1653303240101,CHEM 4,A01,089669,Bussey; Thomas J,40,0,40,0
1653303240101,CHEM 4,A02,089670,Bussey; Thomas J,42,0,42,0
1653303240101,CHEM 4,A03,089671,Bussey; Thomas J,40,0,42,2
1653303240101,CHEM 4,A04,089672,Bussey; Thomas J,42,0,42,0
1653303240101,CHEM 4,A05,089673,Bussey; Thomas J,40,0,42,2
1653303240101,CHEM 4,A06,089674,Bussey; Thomas J,40,0,42,2
1653303240101,CHEM 4,A07,089675,Bussey; Thomas J,42,0,42,0
1653303240101,CHEM 4,A08,089676,Bussey; Thomas J,42,0,42,0
1653303240101,CHEM 4,A09,089677,Bussey; Thomas J,41,0,41,0
1653303240101,CHEM 4,A10,089678,Bussey; Thomas J,40,0,40,0
1653303240642,CHEM 6A,A01,092734,Pomeroy; Robert S.,4,0,4,0
1653303240642,CHEM 6A,A02,092735,Pomeroy; Robert S.,4,0,4,0
1653303240642,CHEM 6A,A03,092736,Pomeroy; Robert S.,4,0,4,0
1653303240642,CHEM 6A,A04,092737,Pomeroy; Robert S.,4,0,4,0
1653303240642,CHEM 6A,A05,092738,Pomeroy; Robert S.,4,0,4,0
1653303240642,CHEM 6A,A06,092739,Pomeroy; Robert S.,4,0,4,0
1653303240642,CHEM 6A,A07,092740,Pomeroy; Robert S.,4,0,4,0
1653303240642,CHEM 6A,A08,092741,Pomeroy; Robert S.,4,0,4,0
1653303240642,CHEM 6A,A09,092742,Pomeroy; Robert S.,0,0,0,0
1653303240642,CHEM 6A,B01,092744,Schurmeier; Kimberly,4,0,4,0
1653303240642,CHEM 6A,B02,092746,Schurmeier; Kimberly,4,0,4,0
1653303240642,CHEM 6A,B03,092749,Schurmeier; Kimberly,4,0,4,0
1653303240642,CHEM 6A,B04,092751,Schurmeier; Kimberly,4,0,4,0
1653303240642,CHEM 6A,B05,092753,Schurmeier; Kimberly,4,0,4,0
1653303240642,CHEM 6A,B06,092755,Schurmeier; Kimberly,3,0,4,1
1653303240642,CHEM 6A,B07,092756,Schurmeier; Kimberly,4,0,4,0
1653303240642,CHEM 6A,B08,092757,Schurmeier; Kimberly,4,0,4,0
1653303240642,CHEM 6A,B09,092758,Schurmeier; Kimberly,0,0,0,0
1653303240642,CHEM 6A,C01,092805,Schurmeier; Kimberly,4,0,4,0
1653303240642,CHEM 6A,C02,092806,Schurmeier; Kimberly,4,0,4,0
1653303240642,CHEM 6A,C03,092807,Schurmeier; Kimberly,4,0,4,0
1653303240642,CHEM 6A,C04,092808,Schurmeier; Kimberly,4,0,4,0
1653303240642,CHEM 6A,C05,092809,Schurmeier; Kimberly,4,0,4,0
1653303240642,CHEM 6A,C06,092810,Schurmeier; Kimberly,4,0,4,0
1653303240642,CHEM 6A,C07,092811,Schurmeier; Kimberly,4,0,4,0
1653303240642,CHEM 6A,C08,092812,Schurmeier; Kimberly,4,0,4,0
1653303240642,CHEM 6A,C09,092813,Schurmeier; Kimberly,0,0,0,0
1653303240642,CHEM 6A,D01,092837,Stallings; Dontarie M,4,0,4,0
1653303240642,CHEM 6A,D02,092838,Stallings; Dontarie M,4,0,4,0
1653303240642,CHEM 6A,D03,092839,Stallings; Dontarie M,4,0,4,0
1653303240642,CHEM 6A,D04,092840,Stallings; Dontarie M,4,0,4,0
1653303240642,CHEM 6A,D05,092841,Stallings; Dontarie M,4,0,4,0
1653303240642,CHEM 6A,D06,092842,Stallings; Dontarie M,4,0,4,0
1653303240642,CHEM 6A,D07,092843,Stallings; Dontarie M,4,0,4,0
1653303240642,CHEM 6A,D08,092844,Stallings; Dontarie M,4,0,4,0
1653303240642,CHEM 6A,D09,092845,Stallings; Dontarie M,0,0,0,0
1653303240642,CHEM 6A,E01,092796,Brydges; Stacey,4,0,4,0
1653303240642,CHEM 6A,E02,092797,Brydges; Stacey,3,0,4,1
1653303240642,CHEM 6A,E03,092798,Brydges; Stacey,4,0,4,0
1653303240642,CHEM 6A,E04,092799,Brydges; Stacey,3,0,4,1
1653303240642,CHEM 6A,E05,092800,Brydges; Stacey,4,0,4,0
1653303240642,CHEM 6A,E06,092801,Brydges; Stacey,4,0,4,0
1653303240642,CHEM 6A,E07,092802,Brydges; Stacey,4,0,4,0
1653303240642,CHEM 6A,E08,092803,Brydges; Stacey,4,0,4,0
1653303240642,CHEM 6A,E09,092804,Brydges; Stacey,0,0,0,0
1653303240642,CHEM 6A,F01,092759,Brydges; Stacey,4,0,4,0
1653303240642,CHEM 6A,F02,092760,Brydges; Stacey,4,0,4,0
1653303240642,CHEM 6A,F03,092761,Brydges; Stacey,3,0,4,1
1653303240642,CHEM 6A,F04,092762,Brydges; Stacey,4,0,4,0
1653303240642,CHEM 6A,F05,092763,Brydges; Stacey,4,0,4,0
1653303240642,CHEM 6A,F06,092764,Brydges; Stacey,4,0,4,0
1653303240642,CHEM 6A,F07,092765,Brydges; Stacey,4,0,4,0
1653303240642,CHEM 6A,F08,092766,Brydges; Stacey,4,0,4,0
1653303240642,CHEM 6A,F09,092767,Brydges; Stacey,0,0,0,0
1653303240642,CHEM 6A,G01,092774,Zid; Brian M,0,0,4,4
1653303240642,CHEM 6A,G02,092775,Zid; Brian M,2,0,4,2
1653303240642,CHEM 6A,G03,092776,Zid; Brian M,2,0,4,2
1653303240642,CHEM 6A,G04,092777,Zid; Brian M,2,0,4,2
1653303240642,CHEM 6A,G05,092778,Zid; Brian M,4,0,4,0
1653303240642,CHEM 6A,G06,092779,Zid; Brian M,4,0,4,0
1653303240642,CHEM 6A,G07,092780,Zid; Brian M,3,0,4,1
1653303240642,CHEM 6A,G08,092781,Zid; Brian M,3,0,4,1
1653303240642,CHEM 6A,G09,092782,Zid; Brian M,0,0,0,0
1653303240642,CHEM 6A,H01,092846,Stallings; Dontarie M,4,0,4,0
1653303240642,CHEM 6A,H02,092847,Stallings; Dontarie M,3,0,4,1
1653303240642,CHEM 6A,H03,092848,Stallings; Dontarie M,4,0,4,0
1653303240642,CHEM 6A,H04,092849,Stallings; Dontarie M,4,0,4,0
1653303240642,CHEM 6A,H05,092850,Stallings; Dontarie M,4,0,4,0
1653303240642,CHEM 6A,H06,092851,Stallings; Dontarie M,3,0,4,1
1653303240642,CHEM 6A,H07,092852,Stallings; Dontarie M,4,0,4,0
1653303240642,CHEM 6A,H08,092853,Stallings; Dontarie M,3,0,4,1
1653303240642,CHEM 6A,H09,092854,Stallings; Dontarie M,0,0,0,0
1653303240642,CHEM 6A,I01,092814,Staff,0,0,0,0
1653303240642,CHEM 6A,I02,092815,Staff,0,0,0,0
1653303240642,CHEM 6A,I04,092816,Staff,0,0,0,0
1653303240642,CHEM 6A,I05,092817,Staff,0,0,0,0
1653303240642,CHEM 6A,I06,092818,Staff,0,0,0,0
1653303240642,CHEM 6A,I07,092819,Staff,0,0,0,0
1653303240642,CHEM 6A,I08,092820,Staff,0,0,0,0
1653303240642,CHEM 6A,I09,092821,Staff,0,0,0,0
1653303241166,CHEM 6AH,A01,092793,Paesani; Francesco,15,0,16,1
1653303241166,CHEM 6AH,A02,092794,Paesani; Francesco,16,0,16,0
1653303241166,CHEM 6AH,A03,092795,Paesani; Francesco,16,0,16,0
1653303241692,CHEM 6B,A01,092691,Hopkins; Patrycja Anna,21,0,25,4
1653303241692,CHEM 6B,A02,092692,Hopkins; Patrycja Anna,23,0,25,2
1653303241692,CHEM 6B,A03,092693,Hopkins; Patrycja Anna,25,0,25,0
1653303241692,CHEM 6B,A04,092694,Hopkins; Patrycja Anna,0,0,0,0
1653303241692,CHEM 6B,A05,092695,Hopkins; Patrycja Anna,24,0,25,1
1653303241692,CHEM 6B,A06,092696,Hopkins; Patrycja Anna,22,0,25,3
1653303241692,CHEM 6B,A07,092697,Hopkins; Patrycja Anna,24,0,25,1
1653303242218,CHEM 6C,A01,092708,Albizati; Kim F.,31,0,38,7
1653303242218,CHEM 6C,A02,092709,Albizati; Kim F.,32,0,38,6
1653303242218,CHEM 6C,A03,092710,Albizati; Kim F.,37,0,38,1
1653303242218,CHEM 6C,A04,092711,Albizati; Kim F.,36,0,38,2
1653303242218,CHEM 6C,A05,092712,Albizati; Kim F.,0,0,0,0
1653303242218,CHEM 6C,A06,092714,Albizati; Kim F.,33,0,38,5
1653303242218,CHEM 6C,A07,092715,Albizati; Kim F.,32,0,38,6
1653303242218,CHEM 6C,A08,092716,Albizati; Kim F.,37,0,38,1
1653303242218,CHEM 6C,A09,092717,Albizati; Kim F.,38,0,38,0
1653303242766,CHEM 7L,A01,089692,Leigh; Brian,11,0,19,8
1653303242766,CHEM 7L,A02,089693,Leigh; Brian,23,0,24,1
1653303242766,CHEM 7L,A03,089694,Leigh; Brian,24,0,24,0
1653303242766,CHEM 7L,A04,089695,Leigh; Brian,24,0,24,0
1653303242766,CHEM 7L,A05,089696,Leigh; Brian,23,0,24,1
1653303242766,CHEM 7L,A06,089697,Leigh; Brian,22,0,24,2
1653303242766,CHEM 7L,A07,089698,Leigh; Brian,21,0,21,0
1653303242766,CHEM 7L,A08,089699,Leigh; Brian,17,0,24,7
1653303242766,CHEM 7L,A09,089700,Leigh; Brian,23,0,24,1
1653303242766,CHEM 7L,A10,089701,Leigh; Brian,0,0,0,0
1653303242766,CHEM 7L,B01,089703,Leigh; Brian,18,0,24,6
1653303242766,CHEM 7L,B02,089704,Leigh; Brian,18,0,24,6
1653303242766,CHEM 7L,B03,089705,Leigh; Brian,23,0,24,1
1653303242766,CHEM 7L,B04,089706,Leigh; Brian,20,0,21,1
1653303242766,CHEM 7L,B05,089707,Leigh; Brian,17,0,24,7
1653303242766,CHEM 7L,B06,089708,Leigh; Brian,17,0,24,7
1653303242766,CHEM 7L,B07,089709,Leigh; Brian,17,0,24,7
1653303242766,CHEM 7L,B08,089710,Leigh; Brian,21,0,24,3
1653303242766,CHEM 7L,B09,089711,Leigh; Brian,21,0,24,3
1653303242766,CHEM 7L,B10,089712,Leigh; Brian,0,0,0,0
1653303242766,CHEM 7L,C01,089714,Staff,23,0,24,1
1653303242766,CHEM 7L,C02,089715,Staff,22,0,24,2
1653303242766,CHEM 7L,C03,089716,Staff,23,0,24,1
1653303242766,CHEM 7L,C04,089717,Staff,24,0,24,0
1653303242766,CHEM 7L,C05,089718,Staff,21,0,24,3
1653303242766,CHEM 7L,C06,089719,Staff,22,0,24,2
1653303242766,CHEM 7L,C07,089720,Staff,23,0,24,1
1653303242766,CHEM 7L,C08,089721,Staff,24,0,24,0
1653303242766,CHEM 7L,C09,089722,Staff,24,0,24,0
1653303242766,CHEM 7L,C10,089723,Staff,0,0,0,0
1653303243295,CHEM 40A,A01,092871,Schmidt; Valerie A,31,0,31,0
1653303243295,CHEM 40A,A02,092872,Schmidt; Valerie A,31,0,31,0
1653303243295,CHEM 40A,A03,092873,Schmidt; Valerie A,31,0,31,0
1653303243295,CHEM 40A,A04,092874,Schmidt; Valerie A,0,0,0,0
1653303243295,CHEM 40A,A05,092875,Schmidt; Valerie A,31,0,31,0
1653303243295,CHEM 40A,A06,092876,Schmidt; Valerie A,29,0,31,2
1653303243295,CHEM 40A,A07,092877,Schmidt; Valerie A,31,0,31,0
1653303243295,CHEM 40A,A08,092878,Schmidt; Valerie A,28,0,28,0
1653303243295,CHEM 40A,B01,089726,Lam; Tin Yiu,31,0,31,0
1653303243295,CHEM 40A,B02,089727,Lam; Tin Yiu,31,0,31,0
1653303243295,CHEM 40A,B03,089728,Lam; Tin Yiu,31,0,31,0
1653303243295,CHEM 40A,B04,089729,Lam; Tin Yiu,30,0,31,1
1653303243295,CHEM 40A,B05,089730,Lam; Tin Yiu,31,0,31,0
1653303243295,CHEM 40A,B06,089731,Lam; Tin Yiu,30,0,31,1
1653303243295,CHEM 40A,B07,089732,Lam; Tin Yiu,29,0,31,2
1653303243295,CHEM 40A,B08,089733,Lam; Tin Yiu,0,0,0,0
1653303243295,CHEM 40A,C01,092718,Albizati; Kim F.,17,0,31,14
1653303243295,CHEM 40A,C02,092719,Albizati; Kim F.,24,0,31,7
1653303243295,CHEM 40A,C03,092720,Albizati; Kim F.,12,0,31,19
1653303243295,CHEM 40A,C04,092721,Albizati; Kim F.,24,0,31,7
1653303243295,CHEM 40A,C05,092722,Albizati; Kim F.,21,0,31,10
1653303243295,CHEM 40A,C06,092723,Albizati; Kim F.,24,0,31,7
1653303243295,CHEM 40A,C07,092724,Albizati; Kim F.,30,0,31,1
1653303243295,CHEM 40A,C08,092725,Albizati; Kim F.,0,0,0,0
1653303243295,CHEM 40A,D01,092863,Yang; Jerry,28,0,31,3
1653303243295,CHEM 40A,D02,092864,Yang; Jerry,28,0,31,3
1653303243295,CHEM 40A,D03,092865,Yang; Jerry,31,0,31,0
1653303243295,CHEM 40A,D04,092866,Yang; Jerry,31,0,31,0
1653303243295,CHEM 40A,D05,092867,Yang; Jerry,0,0,0,0
1653303243295,CHEM 40A,D06,092868,Yang; Jerry,31,0,31,0
1653303243295,CHEM 40A,D07,092869,Yang; Jerry,31,0,31,0
1653303243295,CHEM 40A,D08,092870,Yang; Jerry,31,0,31,0
1653303243820,CHEM 40B,A01,092698,Oconnor; Joseph M.,24,0,34,10
1653303243820,CHEM 40B,A02,092699,Oconnor; Joseph M.,34,0,34,0
1653303243820,CHEM 40B,A03,092700,Oconnor; Joseph M.,0,0,0,0
1653303243820,CHEM 40B,A04,092701,Oconnor; Joseph M.,30,0,34,4
1653303243820,CHEM 40B,A05,092702,Oconnor; Joseph M.,33,0,34,1
1653303243820,CHEM 40B,A06,092703,Oconnor; Joseph M.,34,0,34,0
1653303243820,CHEM 40B,A07,092704,Oconnor; Joseph M.,32,0,34,2
1653303243820,CHEM 40B,A08,092705,Oconnor; Joseph M.,33,0,34,1
1653303243820,CHEM 40B,A09,092706,Oconnor; Joseph M.,34,0,34,0
1653303244353,CHEM 40C,A01,089739,Lam; Tin Yiu,0,0,0,0
1653303244353,CHEM 40C,A02,089740,Lam; Tin Yiu,0,0,0,0
1653303244353,CHEM 40C,A03,089741,Lam; Tin Yiu,0,0,0,0
1653303244353,CHEM 40C,A04,089742,Lam; Tin Yiu,13,0,34,21
1653303244353,CHEM 40C,A05,089743,Lam; Tin Yiu,32,0,34,2
1653303244353,CHEM 40C,A06,089744,Lam; Tin Yiu,31,0,34,3
1653303244878,CHEM 41A,A01,093840,Ternansky; Robert J.,29,0,33,4
1653303244878,CHEM 41A,A02,093841,Ternansky; Robert J.,32,0,33,1
1653303244878,CHEM 41A,A03,093842,Ternansky; Robert J.,33,0,33,0
1653303244878,CHEM 41A,A04,093843,Ternansky; Robert J.,30,0,33,3
1653303244878,CHEM 41A,A05,093844,Ternansky; Robert J.,31,0,33,2
1653303244878,CHEM 41A,A06,093845,Ternansky; Robert J.,27,0,27,0
1653303244878,CHEM 41A,A07,093846,Ternansky; Robert J.,32,0,33,1
1653303244878,CHEM 41A,A08,093847,Ternansky; Robert J.,33,0,33,0
1653303245407,CHEM 43A,A01,089746,Klosterman; Jeremy K,11,0,24,13
1653303245407,CHEM 43A,A02,089747,Klosterman; Jeremy K,16,0,24,8
1653303245407,CHEM 43A,A03,089748,Klosterman; Jeremy K,21,0,24,3
1653303245407,CHEM 43A,A04,089749,Klosterman; Jeremy K,22,0,24,2
1653303245407,CHEM 43A,A05,089750,Klosterman; Jeremy K,23,0,24,1
1653303245407,CHEM 43A,A06,089751,Klosterman; Jeremy K,8,0,24,16
1653303245407,CHEM 43A,A07,089752,Klosterman; Jeremy K,17,0,24,7
1653303245407,CHEM 43A,A08,089753,Klosterman; Jeremy K,16,0,24,8
1653303245407,CHEM 43A,A09,089754,Klosterman; Jeremy K,21,0,24,3
1653303245407,CHEM 43A,A10,089755,Klosterman; Jeremy K,21,0,24,3
1653303245407,CHEM 43A,A11,089756,Klosterman; Jeremy K,0,0,0,0
1653303245407,CHEM 43A,A12,089757,Klosterman; Jeremy K,0,0,0,0
1653303245407,CHEM 43A,A13,089758,Klosterman; Jeremy K,0,0,0,0
1653303245407,CHEM 43A,B01,089760,Klosterman; Jeremy K,0,0,0,0
1653303245407,CHEM 43A,B02,089761,Klosterman; Jeremy K,0,0,0,0
1653303245407,CHEM 43A,B03,089762,Klosterman; Jeremy K,16,0,24,8
1653303245407,CHEM 43A,B04,089763,Klosterman; Jeremy K,22,0,24,2
1653303245407,CHEM 43A,B05,089764,Klosterman; Jeremy K,23,0,24,1
1653303245407,CHEM 43A,B06,089765,Klosterman; Jeremy K,23,0,24,1
1653303245407,CHEM 43A,B07,089766,Klosterman; Jeremy K,17,0,24,7
1653303245407,CHEM 43A,B08,089767,Klosterman; Jeremy K,23,0,24,1
1653303245407,CHEM 43A,B09,089768,Klosterman; Jeremy K,24,0,24,0
1653303245407,CHEM 43A,B10,089769,Klosterman; Jeremy K,23,0,24,1
1653303245407,CHEM 43A,B11,089770,Klosterman; Jeremy K,22,0,24,2
1653303245407,CHEM 43A,B12,089771,Klosterman; Jeremy K,21,0,24,3
1653303245936,CHEM 87,A00,089772,Bussey; Thomas J,20,0,20,0
1653303246459,CHEM 96,A00,089773,Bussey; Thomas J,20,0,25,5
1653303246985,CHEM 100A,A01,089775,Pomeroy; Robert S.,22,0,24,2
1653303246985,CHEM 100A,A02,089776,Pomeroy; Robert S.,19,0,24,5
1653303246985,CHEM 100A,A03,089777,Pomeroy; Robert S.,13,0,24,11
1653303246985,CHEM 100A,A04,089778,Pomeroy; Robert S.,18,0,24,6
1653303246985,CHEM 100A,A05,089779,Pomeroy; Robert S.,19,0,24,5
1653303246985,CHEM 100A,A06,089780,Pomeroy; Robert S.,24,0,24,0
1653303246985,CHEM 100A,A07,089781,Pomeroy; Robert S.,0,0,0,0
1653303247510,CHEM 105A,A01,089783,Young; Mark,0,0,39,39
1653303247510,CHEM 105A,B01,089785,Young; Mark,26,0,39,13
1653303248033,CHEM 108,A01,089787,Ghosh; Gourisankar,1,0,22,21
1653303248033,CHEM 108,A02,089788,Ghosh; Gourisankar,6,0,22,16
1653303248033,CHEM 108,B01,089790,Ghosh; Gourisankar,13,0,22,9
1653303248033,CHEM 108,B02,089791,Ghosh; Gourisankar,20,0,22,2
1653303248570,CHEM 109,A01,089793,Hamaoka; Brent Y,4,0,22,18
1653303248570,CHEM 109,A02,089794,Hamaoka; Brent Y,10,0,22,12
1653303248570,CHEM 109,B01,089796,Hamaoka; Brent Y,6,0,22,16
1653303248570,CHEM 109,B02,089797,Hamaoka; Brent Y,18,0,22,4
1653303249106,CHEM 114A,A01,092855,Toor; Navtej,21,0,25,4
1653303249106,CHEM 114A,A02,092856,Toor; Navtej,25,0,25,0
1653303249106,CHEM 114A,A03,092857,Toor; Navtej,19,0,25,6
1653303249106,CHEM 114A,A04,092858,Toor; Navtej,24,0,25,1
1653303249106,CHEM 114A,A05,092859,Toor; Navtej,0,0,0,0
1653303249106,CHEM 114A,A06,092860,Toor; Navtej,14,0,25,11
1653303249106,CHEM 114A,A07,092861,Toor; Navtej,24,0,25,1
1653303249106,CHEM 114A,A08,092862,Toor; Navtej,24,0,25,1
1653303249643,CHEM 116,A01,092707,Ferguson; Fleur,6,0,35,29
1653303249643,CHEM 116,A02,094887,Ferguson; Fleur,31,0,35,4
1653303250168,CHEM 120A,A01,092785,Schimpf; Alina M,16,0,28,12
1653303250168,CHEM 120A,A02,092786,Schimpf; Alina M,26,0,28,2
1653303250168,CHEM 120A,A03,092787,Schimpf; Alina M,20,0,28,8
1653303250168,CHEM 120A,A04,092788,Schimpf; Alina M,27,0,28,1
1653303250168,CHEM 120A,A05,092789,Schimpf; Alina M,27,0,28,1
1653303250168,CHEM 120A,A06,092790,Schimpf; Alina M,0,0,0,0
1653303250168,CHEM 120A,A07,092791,Schimpf; Alina M,15,0,28,13
1653303250168,CHEM 120A,A08,092792,Schimpf; Alina M,0,0,0,0
1653303250697,CHEM 126A,A01,092768,Schoeneberg; Johannes,16,0,35,19
1653303250697,CHEM 126A,A02,092769,Schoeneberg; Johannes,35,0,35,0
1653303250697,CHEM 126A,A03,092770,Schoeneberg; Johannes,29,0,35,6
1653303250697,CHEM 126A,A04,092771,Schoeneberg; Johannes,0,0,0,0
1653303250697,CHEM 126A,A05,092772,Schoeneberg; Johannes,30,0,35,5
1653303250697,CHEM 126A,A06,092773,Schoeneberg; Johannes,33,0,35,2
1653303251221,CHEM 130,A01,092685,Sinha; Amitabha,28,0,38,10
1653303251221,CHEM 130,A02,092686,Sinha; Amitabha,31,0,38,7
1653303251221,CHEM 130,A03,092687,Sinha; Amitabha,34,0,38,4
1653303251749,CHEM 142,A00,089803,Esko; Jeffrey D. & Godula; Kamil,9,0,46,37
1653303252274,CHEM 143C,A01,089805,Ternansky; Robert J.,17,0,22,5
1653303252274,CHEM 143C,A02,089806,Ternansky; Robert J.,18,0,22,4
1653303252274,CHEM 143C,A03,089807,Ternansky; Robert J.,19,0,22,3
1653303252274,CHEM 143C,A04,089808,Ternansky; Robert J.,20,0,22,2
1653303252806,CHEM 152,A00,089809,Romero; Nathan A & Schmidt; Valerie A,35,0,40,5
1653303253336,CHEM 171,A01,092688,Slade; Jonathan,35,0,45,10
1653303253336,CHEM 171,A02,092689,Slade; Jonathan,44,0,45,1
1653303253336,CHEM 171,A03,092690,Slade; Jonathan,45,0,45,0
1653303253860,CHEM 186,A00,089811,Paesani; Francesco,9,0,15,6
1653303254393,CHIN 10AD,A01,086223,Staff,13,0,13,0
1653303254393,CHIN 10AD,A02,086224,Staff,12,0,13,1
1653303254393,CHIN 10AD,B01,086227,Staff,14,0,15,1
1653303254917,CHIN 10AM,A01,086230,Chen; Pei-Chia,16,0,16,0
1653303254917,CHIN 10AM,A02,086231,Chen; Pei-Chia,16,0,16,0
1653303255445,CHIN 10AN,A01,086234,Xu; Li,14,0,14,0
1653303255445,CHIN 10AN,A02,086235,Xu; Li,14,0,14,0
1653303255445,CHIN 10AN,B01,086240,Xu; Li,14,0,14,0
1653303255445,CHIN 10AN,B02,086242,Xu; Li,0,0,0,0
1653303255445,CHIN 10AN,C01,086245,Xu; Li,14,0,14,0
1653303255445,CHIN 10AN,C02,086246,Xu; Li,14,0,14,0
1653303255970,CHIN 20AD,A01,086248,Wang; Xiao,14,0,14,0
1653303255970,CHIN 20AD,A02,086249,Wang; Xiao,14,0,14,0
1653303255970,CHIN 20AD,B01,086251,Wang; Xiao,13,0,14,1
1653303255970,CHIN 20AD,B02,086252,Wang; Xiao,14,0,14,0
1653303256500,CHIN 20AM,A01,086254,Wang; Xiao,11,0,14,3
1653303256500,CHIN 20AM,A02,086255,Wang; Xiao,13,0,14,1
1653303256500,CHIN 20AM,B01,086257,Staff,15,0,15,0
1653303257030,CHIN 20AN,A01,086259,Anderson; Qin-Hong,11,0,12,1
1653303257030,CHIN 20AN,A02,086260,Anderson; Qin-Hong,12,0,12,0
1653303257030,CHIN 20AN,A03,086261,Anderson; Qin-Hong,0,0,0,0
1653303257030,CHIN 20AN,B01,086263,Anderson; Qin-Hong,12,0,13,1
1653303257030,CHIN 20AN,B02,086264,Anderson; Qin-Hong,13,0,13,0
1653303257555,CHIN 100AM,A00,086265,Anderson; Qin-Hong,20,0,20,0
1653303258079,CHIN 100AN,A00,086266,Chen; Pei-Chia,17,0,20,3
1653303258604,CHIN 185A,A00,086268,Staff,20,0,20,0
1653303259130,COGS 1,A01,087834,Barrera; Steven James,57,0,60,3
1653303259130,COGS 1,A02,087835,Barrera; Steven James,52,0,60,8
1653303259130,COGS 1,A03,087836,Barrera; Steven James,57,0,60,3
1653303259130,COGS 1,A04,087837,Barrera; Steven James,59,0,60,1
1653303259130,COGS 1,A05,087838,Barrera; Steven James,60,0,60,0
1653303259130,COGS 1,A06,087839,Barrera; Steven James,59,0,60,1
1653303259130,COGS 1,A07,087840,Barrera; Steven James,54,0,57,3
1653303259655,COGS 2,A01,087842,Boyle; Mary E. T.,64,0,64,0
1653303259655,COGS 2,A02,087843,Boyle; Mary E. T.,61,0,64,3
1653303259655,COGS 2,A03,087844,Boyle; Mary E. T.,64,0,64,0
1653303260183,COGS 3,A01,094312,Boyle; Mary E. T.,30,0,35,5
1653303260183,COGS 3,A02,094313,Boyle; Mary E. T.,33,0,35,2
1653303260183,COGS 3,A03,094314,Boyle; Mary E. T.,35,0,35,0
1653303260183,COGS 3,A04,094315,Boyle; Mary E. T.,35,0,35,0
1653303260183,COGS 3,A05,094316,Boyle; Mary E. T.,35,0,35,0
1653303260713,COGS 8,A01,087846,Staff,35,0,35,0
1653303261244,COGS 10,A01,094357,Hollan; James D.,53,0,60,7
1653303261244,COGS 10,A02,094358,Hollan; James D.,58,0,60,2
1653303261244,COGS 10,A03,094359,Hollan; James D.,59,0,60,1
1653303261244,COGS 10,A04,094360,Hollan; James D.,60,0,60,0
1653303261244,COGS 10,A05,094361,Hollan; James D.,60,0,60,0
1653303261768,COGS 11,A01,087848,Boyle; Mary E. T.,46,0,47,1
1653303261768,COGS 11,A02,087849,Boyle; Mary E. T.,44,0,47,3
1653303261768,COGS 11,A03,087850,Boyle; Mary E. T.,46,0,46,0
1653303262292,COGS 13,A01,087852,Davis; Joshua Daniel,56,0,60,4
1653303262292,COGS 13,A02,087853,Davis; Joshua Daniel,55,0,60,5
1653303262292,COGS 13,A03,087854,Davis; Joshua Daniel,57,0,60,3
1653303262292,COGS 13,A04,087855,Davis; Joshua Daniel,58,0,60,2
1653303262820,COGS 14A,A01,087857,Creel; Sarah,58,0,65,7
1653303262820,COGS 14A,A02,087858,Creel; Sarah,62,0,65,3
1653303262820,COGS 14A,A03,087859,Creel; Sarah,63,0,65,2
1653303262820,COGS 14A,A04,087860,Creel; Sarah,63,0,65,2
1653303263349,COGS 14B,A01,087862,Hoffman; Drew Ellen,56,0,60,4
1653303263349,COGS 14B,A02,087863,Hoffman; Drew Ellen,53,0,60,7
1653303263349,COGS 14B,A03,087864,Hoffman; Drew Ellen,60,0,60,0
1653303263873,COGS 15,A01,087866,Bergen; Benjamin,60,0,60,0
1653303263873,COGS 15,A02,087867,Bergen; Benjamin,59,0,60,1
1653303264401,COGS 17,A01,087869,Johnson; Christine M.,55,0,60,5
1653303264401,COGS 17,A02,087870,Johnson; Christine M.,58,0,60,2
1653303264401,COGS 17,A03,087871,Johnson; Christine M.,55,0,60,5
1653303264401,COGS 17,A04,087872,Johnson; Christine M.,60,0,60,0
1653303264401,COGS 17,A05,087873,Johnson; Christine M.,59,0,60,1
1653303264401,COGS 17,A06,087874,Johnson; Christine M.,60,0,60,0
1653303264927,COGS 18,A01,087876,Fleischer; Jason G,22,0,35,13
1653303264927,COGS 18,A02,087877,Fleischer; Jason G,31,0,35,4
1653303264927,COGS 18,A03,087878,Fleischer; Jason G,33,0,35,2
1653303264927,COGS 18,A04,087879,Fleischer; Jason G,33,0,35,2
1653303264927,COGS 18,A05,087880,Fleischer; Jason G,28,0,35,7
1653303264927,COGS 18,A06,087881,Fleischer; Jason G,34,0,35,1
1653303264927,COGS 18,A07,087882,Fleischer; Jason G,33,0,35,2
1653303264927,COGS 18,A08,087883,Fleischer; Jason G,31,0,35,4
1653303264927,COGS 18,A09,087884,Fleischer; Jason G,33,0,35,2
1653303265462,COGS 20,A01,090761,Borgo; David Garcia,5,0,5,0
1653303265462,COGS 20,A02,090762,Borgo; David Garcia,5,0,5,0
1653303265462,COGS 20,A03,090763,Borgo; David Garcia,5,0,5,0
1653303265986,COGS 87,A00,087885,Deak; Gedeon O.,20,0,20,0
1653303265986,COGS 87,B00,087886,Fleischer; Jason G,20,0,20,0
1653303266519,COGS 100,A01,087892,Kirsh; David Joel,56,0,60,4
1653303266519,COGS 100,A02,087893,Kirsh; David Joel,54,0,60,6
1653303266519,COGS 100,A03,087894,Kirsh; David Joel,54,0,60,6
1653303266519,COGS 100,A04,087895,Kirsh; David Joel,51,0,60,9
1653303266519,COGS 100,A05,087896,Kirsh; David Joel,48,0,60,12
1653303267042,COGS 101A,A01,087898,Hoffman; Drew Ellen,48,0,60,12
1653303267042,COGS 101A,A02,087899,Hoffman; Drew Ellen,58,0,60,2
1653303267042,COGS 101A,A03,087900,Hoffman; Drew Ellen,55,0,60,5
1653303267042,COGS 101A,A04,087901,Hoffman; Drew Ellen,58,0,60,2
1653303267042,COGS 101A,A05,087902,Hoffman; Drew Ellen,59,0,60,1
1653303267042,COGS 101A,A06,087903,Hoffman; Drew Ellen,56,0,60,4
1653303267567,COGS 101B,A01,087905,Barrera; Steven James,30,0,60,30
1653303267567,COGS 101B,A02,087906,Barrera; Steven James,52,0,60,8
1653303267567,COGS 101B,A03,087907,Barrera; Steven James,54,0,60,6
1653303268092,COGS 101C,A01,094240,Cooperrider; Kensy A,70,0,75,5
1653303268092,COGS 101C,A02,094241,Cooperrider; Kensy A,73,0,75,2
1653303268616,COGS 102A,A01,087909,Scott; Taylor Jackson,58,0,60,2
1653303268616,COGS 102A,A02,087910,Scott; Taylor Jackson,51,0,60,9
1653303269141,COGS 107A,A01,087912,Rangel; Lara M,51,0,60,9
1653303269141,COGS 107A,A02,087913,Rangel; Lara M,54,0,60,6
1653303269141,COGS 107A,A03,087914,Rangel; Lara M,47,0,60,13
1653303269141,COGS 107A,A04,087915,Rangel; Lara M,53,0,60,7
1653303269141,COGS 107A,A05,087916,Rangel; Lara M,55,0,60,5
1653303269141,COGS 107A,A06,087917,Rangel; Lara M,50,0,60,10
1653303269669,COGS 108,A01,087919,Fleischer; Jason G,14,0,60,46
1653303269669,COGS 108,A02,087920,Fleischer; Jason G,25,0,60,35
1653303269669,COGS 108,A03,087921,Fleischer; Jason G,40,0,60,20
1653303269669,COGS 108,A04,087922,Fleischer; Jason G,40,0,60,20
1653303269669,COGS 108,A05,087923,Fleischer; Jason G,48,0,60,12
1653303269669,COGS 108,A06,087924,Fleischer; Jason G,55,0,60,5
1653303269669,COGS 108,A07,087925,Fleischer; Jason G,42,0,57,15
1653303270196,COGS 110,A01,087927,Deak; Gedeon O.,30,0,35,5
1653303270196,COGS 110,A02,087928,Deak; Gedeon O.,33,0,35,2
1653303270728,COGS 116,A01,094228,Greene; Deanna Jacquelyn,51,0,52,1
1653303270728,COGS 116,A02,094229,Greene; Deanna Jacquelyn,52,0,52,0
1653303270728,COGS 116,A03,094230,Greene; Deanna Jacquelyn,50,0,52,2
1653303271256,COGS 118B,A01,087930,De Sa; Virginia,24,0,35,11
1653303271256,COGS 118B,A02,087931,De Sa; Virginia,28,0,35,7
1653303271256,COGS 118B,A03,087932,De Sa; Virginia,18,0,35,17
1653303271256,COGS 118B,A04,087933,De Sa; Virginia,29,0,35,6
1653303271256,COGS 118B,A05,087934,De Sa; Virginia,27,0,35,8
1653303271256,COGS 118B,A06,087935,De Sa; Virginia,27,0,35,8
1653303271780,COGS 120,A01,087937,Xia; Haijun,38,0,50,12
1653303271780,COGS 120,A02,087938,Xia; Haijun,32,0,50,18
1653303271780,COGS 120,A03,087939,Xia; Haijun,26,0,50,24
1653303271780,COGS 120,A04,087940,Xia; Haijun,1,0,50,49
1653303272304,COGS 128,A01,087944,Scott; Taylor Jackson,11,0,56,45
1653303272828,COGS 143,A01,087947,Johnson; Christine M.,23,0,40,17
1653303273350,COGS 153,A00,087949,Davis; Joshua Daniel,46,0,75,29
1653303273875,COGS 160,A00,087950,Deak; Gedeon O.,20,0,20,0
1653303273875,COGS 160,B00,094232,Saygin; Ayse P,40,0,40,0
1653303274494,COGS 175,A01,094238,Staff,27,0,40,13
1653303275021,COGS 187A,A01,087958,Kirsh; David Joel,22,0,50,28
1653303275021,COGS 187A,A02,087959,Kirsh; David Joel,30,0,50,20
1653303275021,COGS 187A,A03,087960,Kirsh; David Joel,34,0,45,11
1653303275544,COGS 190A,A00,087961,Staff,9999,0,9999,0
1653303276068,COGS 194,A00,087962,Hill; Seth J,9999,0,9999,0
1653303276601,COMM 10,A02,090628,Schmidt; Thomas Rainer,1,0,5,4
1653303276601,COMM 10,A03,090629,Schmidt; Thomas Rainer,3,0,5,2
1653303276601,COMM 10,A04,090630,Schmidt; Thomas Rainer,4,0,5,1
1653303276601,COMM 10,A05,090631,Schmidt; Thomas Rainer,4,0,5,1
1653303276601,COMM 10,A06,090632,Schmidt; Thomas Rainer,5,0,5,0
1653303276601,COMM 10,A07,090633,Schmidt; Thomas Rainer,5,0,5,0
1653303276601,COMM 10,A08,090634,Schmidt; Thomas Rainer,5,0,5,0
1653303276601,COMM 10,A09,090635,Schmidt; Thomas Rainer,5,0,5,0
1653303276601,COMM 10,A10,090636,Schmidt; Thomas Rainer,2,0,5,3
1653303276601,COMM 10,A11,090637,Schmidt; Thomas Rainer,4,0,5,1
1653303276601,COMM 10,A12,094013,Schmidt; Thomas Rainer,2,0,5,3
1653303276601,COMM 10,A13,094014,Schmidt; Thomas Rainer,5,0,5,0
1653303276601,COMM 10,A14,094015,Schmidt; Thomas Rainer,4,0,5,1
1653303276601,COMM 10,A15,094016,Schmidt; Thomas Rainer,5,0,5,0
1653303277128,COMM 100A,A01,090639,Irani; Lilly C,5,0,5,0
1653303277128,COMM 100A,A02,090640,Irani; Lilly C,4,0,5,1
1653303277128,COMM 100A,A03,090641,Irani; Lilly C,5,0,5,0
1653303277128,COMM 100A,A04,090642,Irani; Lilly C,3,0,5,2
1653303277128,COMM 100A,A05,090643,Irani; Lilly C,3,0,5,2
1653303277128,COMM 100A,A06,090644,Irani; Lilly C,4,0,5,1
1653303277128,COMM 100A,A07,090645,Irani; Lilly C,5,0,5,0
1653303277128,COMM 100A,A08,090646,Irani; Lilly C,5,0,5,0
1653303277128,COMM 100A,A09,090647,Irani; Lilly C,5,0,5,0
1653303277128,COMM 100A,A10,090648,Irani; Lilly C,5,0,5,0
1653303277128,COMM 100A,A11,090649,Irani; Lilly C,3,0,5,2
1653303277128,COMM 100A,A12,090650,Irani; Lilly C,5,0,5,0
1653303277654,COMM 101,A01,090652,Halm; Gavin Patrick,14,0,15,1
1653303277654,COMM 101,A02,090653,Halm; Gavin Patrick,14,0,15,1
1653303277654,COMM 101,A03,090654,Halm; Gavin Patrick,12,0,15,3
1653303277654,COMM 101,A04,090655,Halm; Gavin Patrick,13,0,15,2
1653303278179,COMM 101D,A00,090656,Halm; Gavin Patrick,14,0,15,1
1653303278703,COMM 101K,A00,090657,Ahn; Patricia Jeehyun,16,0,20,4
1653303279226,COMM 101T,A00,093701,Staff,20,0,20,0
1653303279756,COMM 102C,A01,090660,Staff,4,0,6,2
1653303279756,COMM 102C,A02,090661,Staff,6,0,6,0
1653303279756,COMM 102C,A03,090662,Staff,4,0,6,2
1653303280284,COMM 103D,A00,090663,Davis; Zeinabu I.,38,0,40,2
1653303280809,COMM 106E,A00,090667,Geiger; Richard Stuart,26,0,30,4
1653303281332,COMM 106G,A00,090668,Cordoba Azcarate; Matilde,25,0,30,5
1653303281864,COMM 108G,A00,090670,Walkover; Lillian B,30,0,30,0
1653303282388,COMM 109I,A00,090671,Tanaka; Stefan A.,30,0,30,0
1653303282912,COMM 109N,A00,094205,Hallin; Daniel C,25,0,30,5
1653303283441,COMM 110G,A00,090672,Whitworth-Smith; Andrew C,45,0,50,5
1653303283968,COMM 111P,A00,090673,Conner; Thomas Hartnell,27,0,30,3
1653303284492,COMM 111T,A00,090674,Iatarola; Briana Marie,27,0,30,3
1653303285016,COMM 124A,A00,090677,Sims; Christopher O,79,0,80,1
1653303285544,COMM 131,A00,090678,Fields; Gary,22,0,25,3
1653303286070,COMM 134,A00,090679,Kidman; Shawna F,16,0,25,9
1653303286596,COMM 146,A00,090680,Staff,22,0,25,3
1653303287119,COMM 166,A00,094493,Staff,24,0,25,1
1653303287643,COMM 172,A00,094066,Staff,23,0,25,2
1653303288169,COMM 182,A00,094063,Staff,25,0,25,0
1653303288699,COMM 190,A00,090686,Kidman; Shawna F,17,0,23,6
1653303288699,COMM 190,B00,090687,Irani; Lilly C,0,0,0,0
1653303288699,COMM 190,C00,090688,Keith; Kerry,21,0,23,2
1653303288699,COMM 190,D00,090689,Zilberg; Elana,23,0,23,0
1653303289226,COMM 194,A00,091600,Hill; Seth J,9999,0,9999,0
1653303289754,COMM 196A,A00,090690,Schmidt; Thomas Rainer,0,0,0,0
1653303290303,COMM 198,001,091397,Ahn; Patricia Jeehyun,9999,0,9999,0
1653303290303,COMM 198,002,091398,Alac; Morana,9999,0,9999,0
1653303290303,COMM 198,003,091399,Anderson; Patrick W.,9999,0,9999,0
1653303290303,COMM 198,004,091400,Boateng; Boatema,9999,0,9999,0
1653303290303,COMM 198,005,091401,Booker; Angela N,9999,0,9999,0
1653303290303,COMM 198,008,091402,Cordoba Azcarate; Matilde,9999,0,9999,0
1653303290303,COMM 198,009,091403,Davis; Zeinabu I.,9999,0,9999,0
1653303290303,COMM 198,010,091404,Dewaard; Andrew Michael,9999,0,9999,0
1653303290303,COMM 198,011,091405,Dominguez Rubio; Fernando,9999,0,9999,0
1653303290303,COMM 198,012,091406,Fattal; Alexander Leor,9999,0,9999,0
1653303290303,COMM 198,013,091407,Fields; Gary,9999,0,9999,0
1653303290303,COMM 198,014,091408,Gates; Kelly,9999,0,9999,0
1653303290303,COMM 198,015,091409,Goldfarb; Brian,9999,0,9999,0
1653303290303,COMM 198,018,091410,Hill; Erin Truesdell,9999,0,9999,0
1653303290303,COMM 198,019,091411,Horwitz; Robert B,9999,0,9999,0
1653303290303,COMM 198,021,091412,Irani; Lilly C,9999,0,9999,0
1653303290303,COMM 198,022,091413,Jack; Caroline Sarah,9999,0,9999,0
1653303290303,COMM 198,023,091414,Kidman; Shawna F,9999,0,9999,0
1653303290303,COMM 198,024,091415,Martinico; Daniel J,9999,0,9999,0
1653303290303,COMM 198,026,091416,Schmidt; Thomas Rainer,9999,0,9999,0
1653303290303,COMM 198,027,091417,Serlin; David,9999,0,9999,0
1653303290303,COMM 198,028,091418,Sims; Christopher O,9999,0,9999,0
1653303290303,COMM 198,029,091419,Tanaka; Stefan A.,9999,0,9999,0
1653303290303,COMM 198,030,091420,Zilberg; Elana,9999,0,9999,0
1653303290303,COMM 198,031,091421,Walkover; Lillian B,9999,0,9999,0
1653303290303,COMM 198,032,091422,Geiger; Richard Stuart,9999,0,9999,0
1653303290840,CSE 8A,A50,089985,Soosai Raj; Adalbert Geral,7,0,10,3
1653303290840,CSE 8A,A51,089986,Soosai Raj; Adalbert Geral,1,0,10,9
1653303290840,CSE 8A,A52,089987,Soosai Raj; Adalbert Geral,5,0,10,5
1653303290840,CSE 8A,A53,089988,Soosai Raj; Adalbert Geral,9,0,10,1
1653303290840,CSE 8A,B50,089990,Soosai Raj; Adalbert Geral,0,0,10,10
1653303290840,CSE 8A,B51,089991,Soosai Raj; Adalbert Geral,5,0,10,5
1653303290840,CSE 8A,B52,089992,Soosai Raj; Adalbert Geral,5,0,10,5
1653303290840,CSE 8A,B53,089993,Soosai Raj; Adalbert Geral,9,0,10,1
1653303290840,CSE 8A,C50,089995,Lerner; Sorin,0,0,10,10
1653303290840,CSE 8A,C51,089996,Lerner; Sorin,6,0,10,4
1653303290840,CSE 8A,C52,089997,Lerner; Sorin,9,0,10,1
1653303290840,CSE 8A,C53,089998,Lerner; Sorin,8,0,10,2
1653303291362,CSE 8B,A01,090000,Ochoa; Benjamin Lawrence,94,0,100,6
1653303291886,CSE 11,A01,090002,Cao; Yingjun,39,0,49,10
1653303291886,CSE 11,B01,090004,Cao; Yingjun,45,0,49,4
1653303291886,CSE 11,C01,090006,Cao; Yingjun,35,0,49,14
1653303292411,CSE 12,A01,090008,Staff,73,0,73,0
1653303292411,CSE 12,B01,090010,Staff,67,0,73,6
1653303292411,CSE 12,C01,090012,Staff,60,0,73,13
1653303292937,CSE 15L,A01,090014,Politz; Joseph Gibbs,4,0,10,6
1653303292937,CSE 15L,A02,090015,Politz; Joseph Gibbs,7,0,10,3
1653303292937,CSE 15L,A03,090016,Politz; Joseph Gibbs,9,0,10,1
1653303292937,CSE 15L,A04,090017,Politz; Joseph Gibbs,9,0,10,1
1653303292937,CSE 15L,A05,090018,Politz; Joseph Gibbs,9,0,10,1
1653303292937,CSE 15L,B01,090020,Politz; Joseph Gibbs,8,0,10,2
1653303292937,CSE 15L,B02,090021,Politz; Joseph Gibbs,6,0,10,4
1653303292937,CSE 15L,B03,090022,Politz; Joseph Gibbs,7,0,10,3
1653303292937,CSE 15L,B04,090023,Politz; Joseph Gibbs,7,0,10,3
1653303292937,CSE 15L,B05,090024,Politz; Joseph Gibbs,7,0,10,3
1653303293465,CSE 20,A01,090026,Staff,204,0,210,6
1653303293991,CSE 21,A01,090028,Impagliazzo; Russell,0,0,0,0
1653303293991,CSE 21,A02,094488,Impagliazzo; Russell,0,0,0,0
1653303293991,CSE 21,A03,094489,Impagliazzo; Russell,0,0,0,0
1653303294515,CSE 30,A01,092463,Muller; P Keith,73,0,100,27
1653303294515,CSE 30,A02,092464,Staff,97,0,100,3
1653303295041,CSE 87,A00,094193,Moshiri; Alexander Niema,20,0,20,0
1653303295572,CSE 95,A00,090030,Minnes Kemp; Mor Mia,35,0,35,0
1653303295572,CSE 95,B00,093883,Minnes Kemp; Mor Mia,35,0,35,0
1653303295572,CSE 95,C00,093885,Minnes Kemp; Mor Mia,35,0,35,0
1653303296096,CSE 100,A01,090033,Moshiri; Alexander Niema,68,0,114,46
1653303296621,CSE 100R,A01,093837,Moshiri; Alexander Niema,334,0,350,16
1653303297146,CSE 101,A01,090035,Saha; Barna,152,0,237,85
1653303297674,CSE 103,A01,090037,Freund; Yoav,60,0,75,15
1653303298211,CSE 105,A01,090039,Lovett; Shachar,201,0,225,24
1653303298741,CSE 106,A50,090042,Paturi; Ramamohan,11,0,30,19
1653303299266,CSE 107,A01,090044,Bellare; Mihir,94,0,120,26
1653303299792,CSE 110,A50,090047,Powell; Thomas Allan,39,0,50,11
1653303299792,CSE 110,A51,090048,Powell; Thomas Allan,39,0,50,11
1653303299792,CSE 110,A52,090049,Powell; Thomas Allan,48,0,50,2
1653303299792,CSE 110,A53,090050,Powell; Thomas Allan,49,0,50,1
1653303299792,CSE 110,A54,090051,Powell; Thomas Allan,45,0,50,5
1653303299792,CSE 110,A55,090052,Powell; Thomas Allan,50,0,50,0
1653303299792,CSE 110,A56,090053,Powell; Thomas Allan,49,0,50,1
1653303299792,CSE 110,A57,090054,Powell; Thomas Allan,41,0,45,4
1653303300323,CSE 118,A00,094897,Weibel; Nadir,0,0,0,0
1653303300848,CSE 120,A01,090056,Voelker; Geoffrey M.,226,0,300,74
1653303301373,CSE 124,A01,090058,Porter; George M,123,0,189,66
1653303301897,CSE 127,A01,090060,Savage; Stefan,46,0,189,143
1653303302427,CSE 130,A01,090062,Polikarpova; Nadezhda,171,0,189,18
1653303302950,CSE 132A,A01,090064,Deutsch; Alin Bernard,46,0,189,143
1653303303480,CSE 140,A01,090068,Eldon; John,169,0,196,27
1653303303480,CSE 140,B01,090070,Orailoglu; Alex,48,0,49,1
1653303304007,CSE 140L,A01,090072,Eldon; John,161,0,192,31
1653303304007,CSE 140L,B01,090075,Orailoglu; Alex,44,0,49,5
1653303304535,CSE 142,A01,090078,Porter; Leonard Emerson,86,0,146,60
1653303304535,CSE 142,B01,090080,Porter; Leonard Emerson,107,0,146,39
1653303305066,CSE 142L,A01,090082,Swanson; Steven James,48,0,146,98
1653303305066,CSE 142L,B01,090084,Swanson; Steven James,120,0,146,26
1653303305590,CSE 151B,A01,090088,Cottrell; Garrison W,258,0,328,70
1653303306117,CSE 152A,A01,090090,Chandraker; Manmohan Krishna,153,0,189,36
1653303306643,CSE 158,A01,090092,McAuley; Julian John,84,0,197,113
1653303307168,CSE 158R,A01,090094,McAuley; Julian John,306,0,353,47
1653303307697,CSE 167,A01,090096,Chern; Albert Ren-Haur,165,0,189,24
1653303308222,CSE 170,A01,090098,Vaccaro; Kristen Marie,20,0,20,0
1653303308222,CSE 170,A02,090099,Vaccaro; Kristen Marie,14,0,20,6
1653303308222,CSE 170,A03,090100,Vaccaro; Kristen Marie,14,0,20,6
1653303308222,CSE 170,A04,090101,Vaccaro; Kristen Marie,14,0,20,6
1653303308222,CSE 170,A05,090102,Vaccaro; Kristen Marie,18,0,20,2
1653303308754,CSE 190,A00,090103,Shalev; Aaron D,40,0,40,0
1653303308754,CSE 190,B00,090104,Vaccaro; Kristen Marie,100,0,100,0
1653303308754,CSE 190,C00,090105,Pannuto; Patrick William,25,0,25,0
1653303309280,CSE 191,A00,093848,Minnes Kemp; Mor Mia,9999,0,9999,0
1653303309802,CSE 193,A01,090107,Elsherif; May Elhussein,49,0,49,0
1653303310326,CSE 194,A01,090109,Munyaka; Imani N. S.,20,0,49,29
1653303310859,CSS 1,A01,086486,Staff,22,0,24,2
1653303310859,CSS 1,A02,086487,Staff,21,0,24,3
1653303310859,CSS 1,A03,086488,Staff,20,0,24,4
1653303310859,CSS 1,A04,086489,Staff,23,0,24,1
1653303311392,DOC 1,A01,086773,Solomon; Amanda Lee Albaniel,0,0,0,0
1653303311392,DOC 1,A02,086774,Solomon; Amanda Lee Albaniel,0,0,0,0
1653303311392,DOC 1,A03,086775,Solomon; Amanda Lee Albaniel,5,0,6,1
1653303311392,DOC 1,A04,086776,Solomon; Amanda Lee Albaniel,6,0,6,0
1653303311392,DOC 1,A05,086777,Solomon; Amanda Lee Albaniel,6,0,6,0
1653303311392,DOC 1,A06,086778,Solomon; Amanda Lee Albaniel,6,0,6,0
1653303311392,DOC 1,A07,086779,Solomon; Amanda Lee Albaniel,5,0,6,1
1653303311392,DOC 1,A08,086849,Solomon; Amanda Lee Albaniel,6,0,6,0
1653303311392,DOC 1,A09,086780,Solomon; Amanda Lee Albaniel,6,0,6,0
1653303311392,DOC 1,A10,086781,Solomon; Amanda Lee Albaniel,6,0,6,0
1653303311392,DOC 1,A11,086782,Solomon; Amanda Lee Albaniel,5,0,6,1
1653303311392,DOC 1,A12,086783,Solomon; Amanda Lee Albaniel,6,0,6,0
1653303311392,DOC 1,A13,086784,Solomon; Amanda Lee Albaniel,6,0,6,0
1653303311392,DOC 1,A14,086785,Solomon; Amanda Lee Albaniel,6,0,6,0
1653303311392,DOC 1,A15,086786,Solomon; Amanda Lee Albaniel,6,0,6,0
1653303311392,DOC 1,A16,086787,Solomon; Amanda Lee Albaniel,6,0,6,0
1653303311392,DOC 1,A17,086788,Solomon; Amanda Lee Albaniel,0,0,0,0
1653303311392,DOC 1,A18,086789,Solomon; Amanda Lee Albaniel,0,0,0,0
1653303311392,DOC 1,B01,086791,Solomon; Amanda Lee Albaniel,6,0,6,0
1653303311392,DOC 1,B02,086792,Solomon; Amanda Lee Albaniel,6,0,6,0
1653303311392,DOC 1,B03,086793,Solomon; Amanda Lee Albaniel,6,0,6,0
1653303311392,DOC 1,B04,086794,Solomon; Amanda Lee Albaniel,6,0,6,0
1653303311392,DOC 1,B05,086795,Solomon; Amanda Lee Albaniel,3,0,6,3
1653303311392,DOC 1,B06,086796,Solomon; Amanda Lee Albaniel,6,0,6,0
1653303311392,DOC 1,B07,086797,Solomon; Amanda Lee Albaniel,6,0,6,0
1653303311392,DOC 1,B08,086798,Solomon; Amanda Lee Albaniel,6,0,6,0
1653303311392,DOC 1,B09,086799,Solomon; Amanda Lee Albaniel,6,0,6,0
1653303311392,DOC 1,B10,086800,Solomon; Amanda Lee Albaniel,6,0,6,0
1653303311392,DOC 1,B11,086801,Solomon; Amanda Lee Albaniel,5,0,6,1
1653303311392,DOC 1,B12,086802,Solomon; Amanda Lee Albaniel,6,0,6,0
1653303311392,DOC 1,B13,086803,Solomon; Amanda Lee Albaniel,6,0,6,0
1653303311392,DOC 1,B14,086804,Solomon; Amanda Lee Albaniel,6,0,6,0
1653303311392,DOC 1,B15,086805,Solomon; Amanda Lee Albaniel,5,0,6,1
1653303311392,DOC 1,B16,086806,Solomon; Amanda Lee Albaniel,6,0,6,0
1653303311392,DOC 1,B17,086807,Solomon; Amanda Lee Albaniel,0,0,0,0
1653303311392,DOC 1,B18,086808,Solomon; Amanda Lee Albaniel,0,0,0,0
1653303311392,DOC 1,C01,086810,Strom; Megan C.,6,0,6,0
1653303311392,DOC 1,C02,086811,Strom; Megan C.,5,0,6,1
1653303311392,DOC 1,C03,086812,Strom; Megan C.,6,0,6,0
1653303311392,DOC 1,C04,086813,Strom; Megan C.,5,0,6,1
1653303311392,DOC 1,C05,086814,Strom; Megan C.,5,0,6,1
1653303311392,DOC 1,C06,086815,Strom; Megan C.,6,0,6,0
1653303311392,DOC 1,C07,086816,Strom; Megan C.,6,0,6,0
1653303311392,DOC 1,C08,086817,Strom; Megan C.,6,0,6,0
1653303311392,DOC 1,C09,086818,Strom; Megan C.,6,0,6,0
1653303311392,DOC 1,C10,086819,Strom; Megan C.,6,0,6,0
1653303311392,DOC 1,C11,086820,Strom; Megan C.,6,0,6,0
1653303311392,DOC 1,C12,086821,Strom; Megan C.,6,0,6,0
1653303311392,DOC 1,C13,086822,Strom; Megan C.,6,0,6,0
1653303311392,DOC 1,C14,086823,Strom; Megan C.,6,0,6,0
1653303311392,DOC 1,C15,086824,Strom; Megan C.,6,0,6,0
1653303311392,DOC 1,C16,086825,Strom; Megan C.,6,0,6,0
1653303311392,DOC 1,C17,086826,Strom; Megan C.,0,0,0,0
1653303311392,DOC 1,C18,086827,Strom; Megan C.,0,0,0,0
1653303311392,DOC 1,D01,086829,Strom; Megan C.,6,0,6,0
1653303311392,DOC 1,D02,086830,Strom; Megan C.,6,0,6,0
1653303311392,DOC 1,D03,086831,Strom; Megan C.,5,0,6,1
1653303311392,DOC 1,D04,086832,Strom; Megan C.,6,0,6,0
1653303311392,DOC 1,D05,086833,Strom; Megan C.,6,0,6,0
1653303311392,DOC 1,D06,086834,Strom; Megan C.,6,0,6,0
1653303311392,DOC 1,D07,086835,Strom; Megan C.,6,0,6,0
1653303311392,DOC 1,D08,086836,Strom; Megan C.,6,0,6,0
1653303311392,DOC 1,D09,086837,Strom; Megan C.,0,0,0,0
1653303311392,DOC 1,D10,086838,Strom; Megan C.,0,0,0,0
1653303311392,DOC 1,D11,086839,Strom; Megan C.,6,0,6,0
1653303311392,DOC 1,D12,086840,Strom; Megan C.,6,0,6,0
1653303311392,DOC 1,D13,086841,Strom; Megan C.,6,0,6,0
1653303311392,DOC 1,D14,086842,Strom; Megan C.,5,0,6,1
1653303311392,DOC 1,D15,086843,Strom; Megan C.,6,0,6,0
1653303311392,DOC 1,D16,086844,Strom; Megan C.,5,0,6,1
1653303311918,DOC 100D,A00,086845,Pass; Natalye Joann,0,0,0,0
1653303311918,DOC 100D,B00,086846,Pass; Natalye Joann,21,0,25,4
1653303311918,DOC 100D,C00,086847,Pass; Natalye Joann,23,0,25,2
1653303312447,DSC 10,A01,088092,Tiefenbruck; Janine LoBue,13,0,15,2
1653303312447,DSC 10,B01,088095,Tiefenbruck; Janine LoBue,9,0,15,6
1653303312447,DSC 10,C01,088098,Rampure; Suraj,0,0,15,15
1653303312973,DSC 20,A01,088101,Langlois; Marina,148,0,150,2
1653303313496,DSC 30,A01,088105,Langlois; Marina,74,0,75,1
1653303314024,DSC 40A,A01,088107,Rampure; Suraj,97,0,100,3
1653303314024,DSC 40A,B01,088109,Rampure; Suraj,99,0,100,1
1653303314554,DSC 40B,A01,088111,Eldridge; Justin Matthew,73,0,75,2
1653303314554,DSC 40B,B01,088113,Wang; Yusu,75,0,75,0
1653303315080,DSC 80,A01,088115,Eldridge; Justin Matthew,95,0,100,5
1653303315609,DSC 95,A01,088117,Langlois; Marina,20,0,20,0
1653303316134,DSC 96,A00,088118,Liao; Soohyun Nam,50,0,50,0
1653303316657,DSC 100,A01,088120,Salimi; Babak,164,0,175,11
1653303317188,DSC 102,A01,094320,Kumar; Arun Kumar,77,0,125,48
1653303317720,DSC 180A,A01,088124,Fraenkel; Aaron Mcmillan,0,0,0,0
1653303317720,DSC 180A,A02,088125,Fraenkel; Aaron Mcmillan,0,0,0,0
1653303317720,DSC 180A,A03,088126,Fraenkel; Aaron Mcmillan,0,0,0,0
1653303317720,DSC 180A,A04,088127,Fraenkel; Aaron Mcmillan,0,0,0,0
1653303317720,DSC 180A,A05,088128,Fraenkel; Aaron Mcmillan,0,0,0,0
1653303317720,DSC 180A,A06,088129,Fraenkel; Aaron Mcmillan,0,0,0,0
1653303317720,DSC 180A,A07,088130,Fraenkel; Aaron Mcmillan,0,0,0,0
1653303317720,DSC 180A,A08,088131,Fraenkel; Aaron Mcmillan,0,0,0,0
1653303317720,DSC 180A,A09,088132,Fraenkel; Aaron Mcmillan,0,0,0,0
1653303317720,DSC 180A,A10,088133,Fraenkel; Aaron Mcmillan,0,0,0,0
1653303317720,DSC 180A,A11,088134,Fraenkel; Aaron Mcmillan,0,0,0,0
1653303317720,DSC 180A,A12,088135,Fraenkel; Aaron Mcmillan,0,0,0,0
1653303317720,DSC 180A,A13,088136,Fraenkel; Aaron Mcmillan,0,0,0,0
1653303317720,DSC 180A,A14,088137,Fraenkel; Aaron Mcmillan,0,0,0,0
1653303317720,DSC 180A,A15,088138,Fraenkel; Aaron Mcmillan,0,0,0,0
1653303317720,DSC 180A,B01,088141,Fraenkel; Aaron Mcmillan,0,0,0,0
1653303317720,DSC 180A,B02,088142,Fraenkel; Aaron Mcmillan,0,0,0,0
1653303317720,DSC 180A,B03,088143,Fraenkel; Aaron Mcmillan,0,0,0,0
1653303317720,DSC 180A,B04,088144,Fraenkel; Aaron Mcmillan,0,0,0,0
1653303317720,DSC 180A,B05,088145,Fraenkel; Aaron Mcmillan,0,0,0,0
1653303317720,DSC 180A,B06,088146,Fraenkel; Aaron Mcmillan,0,0,0,0
1653303317720,DSC 180A,B07,088147,Fraenkel; Aaron Mcmillan,0,0,0,0
1653303317720,DSC 180A,B08,088148,Fraenkel; Aaron Mcmillan,0,0,0,0
1653303317720,DSC 180A,B09,088149,Fraenkel; Aaron Mcmillan,0,0,0,0
1653303317720,DSC 180A,B10,088150,Fraenkel; Aaron Mcmillan,0,0,0,0
1653303317720,DSC 180A,B11,088151,Fraenkel; Aaron Mcmillan,0,0,0,0
1653303317720,DSC 180A,B12,088152,Fraenkel; Aaron Mcmillan,0,0,0,0
1653303317720,DSC 180A,B13,088153,Fraenkel; Aaron Mcmillan,0,0,0,0
1653303317720,DSC 180A,B14,088154,Fraenkel; Aaron Mcmillan,0,0,0,0
1653303317720,DSC 180A,B15,088155,Fraenkel; Aaron Mcmillan,0,0,0,0
1653303318252,DSC 190,A01,088158,Mishne; Gal,48,0,50,2
1653303318252,DSC 190,B01,088160,Silberman; Jack,16,0,21,5
1653303318777,DSC 197,001,088161,Eldridge; Justin Matthew,9999,0,9999,0
1653303319307,DSGN 1,A01,087888,Meyer; Michael Wayne,49,0,53,4
1653303319307,DSGN 1,A02,087889,Meyer; Michael Wayne,47,0,53,6
1653303319307,DSGN 1,A03,087890,Meyer; Michael Wayne,43,0,53,10
1653303319831,DSGN 100,A01,087983,Dow; Steven P,39,0,40,1
1653303319831,DSGN 100,A02,087984,Dow; Steven P,40,0,40,0
1653303319831,DSGN 100,A03,087985,Dow; Steven P,34,0,40,6
1653303320354,DSGN 118,A01,087987,Xia; Haijun,55,0,60,5
1653303320354,DSGN 118,A02,087988,Xia; Haijun,56,0,60,4
1653303320877,DSGN 119,A00,087989,Staff,51,0,70,19
1653303321403,ECE 5,A01,090699,Morris; Karcher William,0,0,0,0
1653303321403,ECE 5,A02,090700,Morris; Karcher William,0,0,0,0
1653303321403,ECE 5,A03,090701,Morris; Karcher William,0,0,0,0
1653303321403,ECE 5,A04,090702,Morris; Karcher William,0,0,0,0
1653303321403,ECE 5,A05,090703,Morris; Karcher William,0,0,0,0
1653303321403,ECE 5,A06,090704,Morris; Karcher William,0,0,0,0
1653303321934,ECE 15,A01,090706,Schurgers; Curt,0,0,0,0
1653303321934,ECE 15,A02,090707,Schurgers; Curt,0,0,0,0
1653303322467,ECE 16,A01,090709,Khoshabeh; Ramsin,24,0,30,6
1653303322995,ECE 17,A01,090711,Gilja; Vikash,55,0,60,5
1653303323525,ECE 25,A50,090714,Liu; Zhaowei,0,0,0,0
1653303323525,ECE 25,A51,090715,Liu; Zhaowei,0,0,0,0
1653303323525,ECE 25,A52,090716,Liu; Zhaowei,0,0,0,0
1653303324051,ECE 30,A50,094300,Mir Arabbaygi; Siavash,25,0,30,5
1653303324051,ECE 30,A51,094301,Mir Arabbaygi; Siavash,29,0,30,1
1653303324051,ECE 30,A52,094302,Mir Arabbaygi; Siavash,27,0,30,3
1653303324051,ECE 30,A53,094303,Mir Arabbaygi; Siavash,29,0,30,1
1653303324051,ECE 30,A54,094304,Mir Arabbaygi; Siavash,25,0,25,0
1653303324577,ECE 35,A50,090720,Schurgers; Curt,0,0,0,0
1653303324577,ECE 35,A51,090721,Schurgers; Curt,0,0,0,0
1653303324577,ECE 35,A52,090722,Schurgers; Curt,0,0,0,0
1653303324577,ECE 35,A53,090723,Schurgers; Curt,0,0,0,0
1653303324577,ECE 35,A54,090724,Schurgers; Curt,0,0,0,0
1653303324577,ECE 35,A55,090725,Schurgers; Curt,0,0,0,0
1653303324577,ECE 35,B50,090729,Schurgers; Curt,0,0,0,0
1653303324577,ECE 35,B51,090730,Schurgers; Curt,0,0,0,0
1653303324577,ECE 35,B52,090731,Schurgers; Curt,0,0,0,0
1653303324577,ECE 35,B53,090732,Schurgers; Curt,0,0,0,0
1653303324577,ECE 35,B54,090733,Schurgers; Curt,0,0,0,0
1653303324577,ECE 35,B55,090734,Schurgers; Curt,0,0,0,0
1653303325107,ECE 45,A01,090736,Franceschetti; Massimo,56,0,57,1
1653303325107,ECE 45,A02,090737,Franceschetti; Massimo,50,0,58,8
1653303325638,ECE 65,A50,090741,Baghdadchi; Saharnaz,13,0,15,2
1653303325638,ECE 65,A51,090742,Baghdadchi; Saharnaz,5,0,10,5
1653303325638,ECE 65,A52,090743,Baghdadchi; Saharnaz,14,0,15,1
1653303325638,ECE 65,A53,090744,Baghdadchi; Saharnaz,8,0,10,2
1653303325638,ECE 65,A54,094865,Baghdadchi; Saharnaz,14,0,15,1
1653303325638,ECE 65,A55,094866,Baghdadchi; Saharnaz,9,0,10,1
1653303325638,ECE 65,A56,094867,Baghdadchi; Saharnaz,14,0,15,1
1653303325638,ECE 65,A57,094868,Baghdadchi; Saharnaz,15,0,15,0
1653303325638,ECE 65,A58,094869,Baghdadchi; Saharnaz,10,0,10,0
1653303326162,ECE 100,A01,090746,Baghdadchi; Saharnaz,16,0,20,4
1653303326162,ECE 100,A02,090747,Baghdadchi; Saharnaz,20,0,20,0
1653303326162,ECE 100,A03,090748,Baghdadchi; Saharnaz,18,0,20,2
1653303326162,ECE 100,A04,090749,Baghdadchi; Saharnaz,20,0,20,0
1653303326162,ECE 100,A05,090750,Baghdadchi; Saharnaz,18,0,20,2
1653303326162,ECE 100,A06,090751,Baghdadchi; Saharnaz,18,0,20,2
1653303326162,ECE 100,A07,090752,Baghdadchi; Saharnaz,20,0,20,0
1653303326685,ECE 101,A01,090754,Siegel; Paul H.,62,0,75,13
1653303326685,ECE 101,A02,090755,Siegel; Paul H.,71,0,75,4
1653303327209,ECE 102,A00,090756,Hsueh; Tzu-Chien,57,0,75,18
1653303327808,ECE 103,A01,090767,Lo; Yu-Hwa,45,0,50,5
1653303328332,ECE 107,A01,090769,Lomakin; Vitaliy,72,0,75,3
1653303328858,ECE 109,A01,090771,Zeger; Kenneth A.,176,0,180,4
1653303329381,ECE 111,A01,090774,Koushanfar; Farinaz,100,0,120,20
1653303329908,ECE 121A,A50,090777,Esmaili; Gholamreza,17,0,24,7
1653303329908,ECE 121A,A51,090778,Esmaili; Gholamreza,9,0,24,15
1653303329908,ECE 121A,A52,090779,Esmaili; Gholamreza,22,0,24,2
1653303330432,ECE 128A,A00,090780,Staff,40,0,70,30
1653303330962,ECE 135A,A00,090781,Kuzum; Duygu,30,0,30,0
1653303331489,ECE 143,A00,090782,Unpingco; Jose H.,0,0,0,2
1653303332026,ECE 148,A01,090784,Staff,32,0,32,0
1653303332556,ECE 155,A01,090786,Milstein; Laurence B.,16,0,20,4
1653303333081,ECE 158A,A01,090788,Franceschetti; Massimo,56,0,65,9
1653303333611,ECE 161A,A01,090790,Rao; Bhaskar D.,103,0,115,12
1653303334137,ECE 164,A00,090791,Hall; Drew A.,87,0,115,28
1653303334664,ECE 166,A50,090796,Rebeiz; Gabriel,6,0,12,6
1653303334664,ECE 166,A51,090797,Rebeiz; Gabriel,9,0,12,3
1653303334664,ECE 166,A52,090799,Rebeiz; Gabriel,1,0,12,11
1653303334664,ECE 166,A53,090800,Rebeiz; Gabriel,6,0,12,6
1653303334664,ECE 166,A54,094335,Rebeiz; Gabriel,11,0,12,1
1653303334664,ECE 166,A55,094336,Rebeiz; Gabriel,12,0,12,0
1653303334664,ECE 166,A56,094349,Rebeiz; Gabriel,13,0,15,2
1653303334664,ECE 166,A57,094350,Rebeiz; Gabriel,14,0,15,1
1653303335190,ECE 171A,A01,090802,Atanasov; Nikolay A.,45,0,60,15
1653303335713,ECE 171B,A01,090804,Shi; Yuanyuan,44,0,50,6
1653303336242,ECE 174,A01,090806,Pal; Piya,125,0,146,21
1653303336771,ECE 182,A01,090808,Lomakin; Vitaliy,23,0,23,0
1653303337299,ECE 187,A00,090809,Liu; Zhaowei,19,0,20,1
1653303337826,ECE 196,A00,090812,Morris; Karcher William,19,0,24,5
1653303337826,ECE 196,B00,094833,Morris; Karcher William,24,0,24,0
1653303338357,ECE 197,001,090813,Sievenpiper; Daniel F.,9999,0,9999,0
1653303338896,ECON 1,A01,092535,Staff,0,0,0,0
1653303338896,ECON 1,A02,092536,Staff,0,0,0,0
1653303338896,ECON 1,A03,092537,Staff,0,0,0,0
1653303338896,ECON 1,A04,092538,Staff,0,0,0,0
1653303338896,ECON 1,A05,092539,Staff,0,0,0,0
1653303338896,ECON 1,B01,092540,Ma; Alyson Chan,42,0,45,3
1653303338896,ECON 1,B02,092541,Ma; Alyson Chan,45,0,45,0
1653303338896,ECON 1,B03,092542,Ma; Alyson Chan,45,0,45,0
1653303338896,ECON 1,B04,092543,Ma; Alyson Chan,40,0,40,0
1653303338896,ECON 1,B05,092544,Ma; Alyson Chan,40,0,40,0
1653303338896,ECON 1,C01,092545,Tocoian; Oana,0,0,0,0
1653303338896,ECON 1,C02,092546,Tocoian; Oana,0,0,0,0
1653303338896,ECON 1,C03,092547,Tocoian; Oana,0,0,0,0
1653303338896,ECON 1,C04,092548,Tocoian; Oana,0,0,0,0
1653303338896,ECON 1,D01,094253,Levkoff; Steven B.,41,0,45,4
1653303338896,ECON 1,D02,094254,Levkoff; Steven B.,44,0,45,1
1653303338896,ECON 1,D03,094255,Levkoff; Steven B.,45,0,45,0
1653303338896,ECON 1,D04,094256,Levkoff; Steven B.,36,0,40,4
1653303338896,ECON 1,D05,094257,Levkoff; Steven B.,40,0,40,0
1653303339426,ECON 2,A01,092549,Staff,0,0,0,0
1653303339426,ECON 2,A02,092550,Staff,0,0,0,0
1653303339426,ECON 2,A03,092551,Staff,0,0,0,0
1653303339953,ECON 4,A01,092554,Levkoff; Steven B.,29,0,30,1
1653303339953,ECON 4,A02,092555,Levkoff; Steven B.,27,0,30,3
1653303339953,ECON 4,A03,092556,Levkoff; Steven B.,30,0,30,0
1653303340491,ECON 100A,A01,092557,Newhouse; Herbert S,23,0,30,7
1653303340491,ECON 100A,A02,092558,Newhouse; Herbert S,28,0,30,2
1653303340491,ECON 100A,A03,092559,Newhouse; Herbert S,29,0,30,1
1653303340491,ECON 100A,A04,092560,Newhouse; Herbert S,35,0,35,0
1653303340491,ECON 100A,B01,092561,Newhouse; Herbert S,20,0,30,10
1653303340491,ECON 100A,B02,092562,Newhouse; Herbert S,28,0,30,2
1653303340491,ECON 100A,B03,092563,Newhouse; Herbert S,15,0,30,15
1653303340491,ECON 100A,B04,092564,Newhouse; Herbert S,35,0,35,0
1653303341035,ECON 100B,A01,092565,Galperti; Simone,27,0,30,3
1653303341035,ECON 100B,A02,092566,Galperti; Simone,18,0,20,2
1653303341035,ECON 100B,A03,094496,Staff,27,0,30,3
1653303341035,ECON 100B,A04,094497,Staff,16,0,20,4
1653303341035,ECON 100B,B01,092567,Galperti; Simone,16,0,25,9
1653303341562,ECON 100C,A01,092569,Du; Songzi,62,0,75,13
1653303341562,ECON 100C,B01,092570,Du; Songzi,70,0,75,5
1653303341562,ECON 100C,B02,094258,Du; Songzi,75,0,75,0
1653303342090,ECON 100CH,A00,088284,Andreoni; James,20,0,20,0
1653303342631,ECON 109,A01,092572,Watson; Joel Christopher,68,0,75,7
1653303342631,ECON 109,B01,092573,Watson; Joel Christopher,68,0,75,7
1653303343156,ECON 110A,A01,092574,Alon; Titan Michael,12,0,25,13
1653303343156,ECON 110A,A02,092575,Alon; Titan Michael,24,0,25,1
1653303343156,ECON 110A,B01,092576,Alon; Titan Michael,24,0,25,1
1653303343156,ECON 110A,B02,092577,Alon; Titan Michael,25,0,25,0
1653303343688,ECON 110B,A01,092578,Trottner; Fabian Gunter We,16,0,25,9
1653303343688,ECON 110B,A02,094054,Trottner; Fabian Gunter We,23,0,25,2
1653303343688,ECON 110B,B01,092579,Trottner; Fabian Gunter We,7,0,25,18
1653303343688,ECON 110B,B02,094055,Trottner; Fabian Gunter We,24,0,25,1
1653303344211,ECON 116,A00,088291,Lowes; Sara Rachel,58,0,70,12
1653303344738,ECON 120A,A01,092580,Elliott; Graham,18,0,25,7
1653303344738,ECON 120A,A02,092581,Elliott; Graham,22,0,25,3
1653303344738,ECON 120A,B01,092582,Elliott; Graham,18,0,25,7
1653303344738,ECON 120A,B02,092583,Elliott; Graham,20,0,25,5
1653303344738,ECON 120A,C01,092584,Tocoian; Oana,27,0,30,3
1653303344738,ECON 120A,C02,092585,Tocoian; Oana,28,0,30,2
1653303344738,ECON 120A,C03,092586,Tocoian; Oana,40,0,40,0
1653303345266,ECON 120B,A01,092587,Candido; Maria Teresa,58,0,70,12
1653303345266,ECON 120B,A02,092588,Candido; Maria Teresa,51,0,60,9
1653303345266,ECON 120B,A03,092589,Candido; Maria Teresa,56,0,60,4
1653303345790,ECON 120C,A01,092590,Candido; Maria Teresa,48,0,60,12
1653303345790,ECON 120C,A02,092591,Candido; Maria Teresa,59,0,60,1
1653303345790,ECON 120C,A03,094310,Candido; Maria Teresa,73,0,75,2
1653303346318,ECON 121,A00,088298,Vogl; Tom Saul,36,0,50,14
1653303346845,ECON 130,A00,088299,Staff,59,0,75,16
1653303347369,ECON 131,A00,088300,Jacobsen; Mark,129,0,150,21
1653303347369,ECON 131,B00,088301,Jacobsen; Mark,15,0,30,15
1653303347898,ECON 152,A00,088302,Fadlon; Yizhak,34,0,50,16
1653303347898,ECON 152,B00,088303,Fadlon; Yizhak,49,0,50,1
1653303348424,ECON 168,A00,088304,Staff,54,0,60,6
1653303348947,ECON 191B,A00,088312,Galperti; Simone,20,0,20,0
1653303349471,EDS 25,A01,087581,Staff,9,0,10,1
1653303349471,EDS 25,A02,087582,Staff,10,0,10,0
1653303349471,EDS 25,A03,087583,Staff,7,0,10,3
1653303349471,EDS 25,A04,087584,Staff,10,0,10,0
1653303349995,EDS 31,A00,087585,Bussey; Thomas J,9,0,10,1
1653303350519,EDS 110R,A01,087597,Cohen; Shana R,43,0,50,7
1653303350519,EDS 110R,B01,093579,Cohen; Shana R,10,0,10,0
1653303351042,EDS 113,A00,087598,Staff,45,0,50,5
1653303351565,EDS 114,A01,088091,Eguchi; Emi,17,0,20,3
1653303351565,EDS 114,A02,087600,Eguchi; Emi,19,0,20,1
1653303352094,EDS 117,A01,087603,Chung; Luz Marina,25,0,35,10
1653303352094,EDS 117,A02,087604,Chung; Luz Marina,34,0,35,1
1653303352631,EDS 124AR,A01,087606,Simon; Elizabeth A,0,0,19,19
1653303352631,EDS 124AR,A02,087607,Simon; Elizabeth A,13,0,19,6
1653303352631,EDS 124AR,A03,087608,Simon; Elizabeth A,15,0,19,4
1653303352631,EDS 124AR,A04,087609,Simon; Elizabeth A,4,0,19,15
1653303352631,EDS 124AR,B01,087611,Simon; Elizabeth A,14,0,19,5
1653303352631,EDS 124AR,B02,087612,Simon; Elizabeth A,18,0,19,1
1653303352631,EDS 124AR,B03,087613,Simon; Elizabeth A,18,0,19,1
1653303352631,EDS 124AR,B04,087614,Simon; Elizabeth A,19,0,19,0
1653303352631,EDS 124AR,C01,094210,Simon; Elizabeth A,6,0,6,0
1653303352631,EDS 124AR,C02,094211,Simon; Elizabeth A,6,0,6,0
1653303352631,EDS 124AR,C03,094212,Simon; Elizabeth A,6,0,6,0
1653303352631,EDS 124AR,C04,094213,Simon; Elizabeth A,6,0,6,0
1653303352631,EDS 124AR,D01,094215,Simon; Elizabeth A,6,0,6,0
1653303352631,EDS 124AR,D02,094216,Simon; Elizabeth A,6,0,6,0
1653303352631,EDS 124AR,D03,094217,Simon; Elizabeth A,6,0,6,0
1653303352631,EDS 124AR,D04,094218,Simon; Elizabeth A,6,0,6,0
1653303353154,EDS 124BR,A00,087615,Eguchi; Emi,65,0,75,10
1653303353154,EDS 124BR,B00,093580,Eguchi; Emi,25,0,25,0
1653303353682,EDS 125,A00,087616,Jones; Gabrielle Anastasia,51,0,60,9
1653303354211,EDS 129A,A01,087618,Heinzman; Erica M.,43,0,50,7
1653303354736,EDS 130,A01,087620,Holtzman; Caren Lynn,17,0,20,3
1653303354736,EDS 130,A02,087621,Holtzman; Caren Lynn,20,0,20,0
1653303354736,EDS 130,A03,087622,Holtzman; Caren Lynn,20,0,20,0
1653303355261,EDS 131,A01,087624,Wishard Guerra; Alison G.,37,0,40,3
1653303355794,EDS 133,A01,087627,Bintliff; Amy S.V.,17,0,20,3
1653303355794,EDS 133,A02,087628,Bintliff; Amy S.V.,19,0,20,1
1653303356317,EDS 139,A00,087629,Holtzman; Caren Lynn,55,0,60,5
1653303356317,EDS 139,B00,087630,Heinzman; Erica M.,51,0,60,9
1653303356317,EDS 139,C00,087631,Bintliff; Amy S.V.,57,0,60,3
1653303356317,EDS 139,D00,087632,Wishard Guerra; Alison G.,58,0,60,2
1653303356317,EDS 139,E00,087633,Holtzman; Caren Lynn,30,0,30,0
1653303356317,EDS 139,F00,094886,Staff,25,0,25,0
1653303356840,EDS 146,A01,094220,Staff,25,0,25,0
1653303357363,EDS 164R,A01,087644,Wishard Guerra; Alison G.,37,0,40,3
1653303357363,EDS 164R,B01,093582,Wishard Guerra; Alison G.,20,0,20,0
1653303357891,EDS 190,A00,087645,Bresser; Bernard George,20,0,20,0
1653303357891,EDS 190,B00,087646,Pappas; Elizabeth,20,0,20,0
1653303357891,EDS 190,C00,087647,Scharton; Susan Michelle,20,0,20,0
1653303357891,EDS 190,E00,087648,Staff,20,0,20,0
1653303358414,ENG 10,A00,086288,Staff,30,0,30,0
1653303358414,ENG 10,B00,086289,Staff,30,0,30,0
1653303358938,ENG 15,A01,086291,Staff,35,0,35,0
1653303359468,ENG 20,A00,086292,Evdokimenko; Ekaterina,33,0,35,2
1653303359999,ENG 100D,A00,086293,Ngo; Anh-Thu T.,45,0,50,5
1653303359999,ENG 100D,B00,094309,Staff,46,0,50,4
1653303360537,ENG 100L,A00,086295,Kleissl; Jan,6,0,6,0
1653303360537,ENG 100L,B00,086296,Bratton; Maryann,8,0,8,0
1653303360537,ENG 100L,C00,086297,Nguyen; Truong Quang,10,0,10,0
1653303360537,ENG 100L,E00,086299,de Oliveira; Mauricio,8,0,8,0
1653303360537,ENG 100L,F00,086300,Goldberg; Charles G.,6,0,6,0
1653303360537,ENG 100L,G00,086301,Bratton; Maryann,6,0,6,0
1653303360537,ENG 100L,H00,086302,Staff,6,0,6,0
1653303361061,ENVR 30,A01,093565,Staff,29,0,30,1
1653303361061,ENVR 30,A02,093567,Staff,28,0,30,2
1653303361061,ENVR 30,A03,093568,Staff,25,0,30,5
1653303361061,ENVR 30,A04,093569,Staff,30,0,30,0
1653303361061,ENVR 30,A05,093570,Staff,29,0,30,1
1653303361061,ENVR 30,A06,093566,Staff,29,0,30,1
1653303361585,ENVR 102,A00,093571,Daly; Heather Marie,25,0,30,5
1653303362649,ERC 1,A01,092328,Herbst; Matthew,20,0,20,0
1653303362649,ERC 1,A02,092330,Herbst; Matthew,20,0,20,0
1653303362649,ERC 1,A03,092331,Herbst; Matthew,20,0,20,0
1653303362649,ERC 1,A04,092332,Herbst; Matthew,20,0,20,0
1653303362649,ERC 1,A05,092333,Herbst; Matthew,20,0,20,0
1653303362649,ERC 1,A06,092334,Herbst; Matthew,20,0,20,0
1653303363183,ERC 2,A01,092336,Rahimi; Babak,20,0,20,0
1653303363183,ERC 2,A02,092337,Rahimi; Babak,20,0,20,0
1653303363183,ERC 2,A03,092338,Rahimi; Babak,20,0,20,0
1653303363183,ERC 2,A04,092339,Rahimi; Babak,20,0,20,0
1653303363713,ERC 20,A00,092340,Evans; Ivan T,30,0,30,0
1653303363713,ERC 20,B00,092341,Evans; Ivan T,30,0,30,0
1653303364237,ERC 87,A00,093850,Herbst; Matthew,20,0,20,0
1653303364762,ERC 92,A00,092342,Staff,1,0,1,0
1653303364762,ERC 92,B00,092343,Staff,1,0,1,0
1653303364762,ERC 92,C00,092344,Staff,1,0,1,0
1653303364762,ERC 92,D00,092345,Staff,1,0,1,0
1653303364762,ERC 92,E00,092346,Staff,1,0,1,0
1653303364762,ERC 92,F00,092347,Staff,1,0,1,0
1653303365290,ESYS 90,A00,086303,Teranes; Jane,12,0,12,0
1653303365829,ESYS 101,A01,086305,Taylor; Jennifer Rebecca & Diaz; Julia Michelle,25,0,27,2
1653303365829,ESYS 101,A02,086306,Taylor; Jennifer Rebecca & Diaz; Julia Michelle,15,0,27,12
1653303365829,ESYS 101,A03,086307,Taylor; Jennifer Rebecca & Diaz; Julia Michelle,21,0,27,6
1653303365829,ESYS 101,A04,086308,Taylor; Jennifer Rebecca & Diaz; Julia Michelle,27,0,27,0
1653303366357,ESYS 187A,A01,086310,Teranes; Jane,38,0,40,2
1653303366357,ESYS 187A,B01,086312,Teranes; Jane,30,0,40,10
1653303366894,ETHN 1,A01,086314,Frank; Ross H.,15,0,15,0
1653303366894,ETHN 1,A02,086315,Frank; Ross H.,15,0,15,0
1653303366894,ETHN 1,A03,086316,Frank; Ross H.,14,0,15,1
1653303366894,ETHN 1,A04,086317,Frank; Ross H.,15,0,15,0
1653303366894,ETHN 1,A05,086318,Frank; Ross H.,15,0,15,0
1653303366894,ETHN 1,A06,086319,Frank; Ross H.,13,0,15,2
1653303366894,ETHN 1,A07,086320,Frank; Ross H.,15,0,15,0
1653303366894,ETHN 1,A08,086321,Frank; Ross H.,14,0,15,1
1653303366894,ETHN 1,A09,086322,Frank; Ross H.,15,0,15,0
1653303366894,ETHN 1,A10,086323,Frank; Ross H.,15,0,15,0
1653303366894,ETHN 1,A11,086324,Frank; Ross H.,15,0,15,0
1653303366894,ETHN 1,A12,086325,Frank; Ross H.,15,0,15,0
1653303366894,ETHN 1,A13,086326,Frank; Ross H.,15,0,15,0
1653303366894,ETHN 1,A14,086327,Frank; Ross H.,15,0,15,0
1653303366894,ETHN 1,A15,086328,Frank; Ross H.,15,0,15,0
1653303366894,ETHN 1,A16,086329,Frank; Ross H.,15,0,15,0
1653303367431,ETHN 100A,A00,086330,Patel; Shaista,41,0,48,7
1653303367956,ETHN 103,A00,086331,Perreira; Christopher Michael,63,0,70,7
1653303368480,ETHN 104,A00,086332,Staff,0,0,0,0
1653303369006,ETHN 106,A00,086333,Staff,0,0,0,0
1653303369530,ETHN 121,A00,086341,Sasaki; Christen T,20,0,28,8
1653303370062,ETHN 139,A00,086342,Ruiz; Ariana,16,0,20,4
1653303370587,ETHN 144M,A00,086343,Jolivette; Andrew J,66,0,70,4
1653303371113,ETHN 159,A00,088427,Graham; Jessica Lynn,0,0,0,0
1653303371635,ETHN 163E,A00,086344,Patel; Shaista,37,0,40,3
1653303372166,ETHN 178R,A00,090798,Borgo; David Garcia,15,0,20,5
1653303372695,ETHN 187,A00,086345,Perez; Roy,14,0,16,2
1653303373223,EXPR 100,A00,085686,Staff,9999,0,9999,0
1653303373755,FMPH 40,A00,086370,Emory; Kristen,70,0,75,5
1653303373755,FMPH 40,B00,086371,Romero; Sally Ann Dominick,71,0,75,4
1653303374285,FMPH 101,A00,086372,Brouwer; Kimberly,43,0,55,12
1653303374815,FMPH 102,A50,094498,Rana; Brinda Kanti,42,0,55,13
1653303375340,FMPH 110,A00,086374,Zoumas-Morse; Christine E.,61,0,65,4
1653303375864,FMPH 120,A00,086375,Nguyen-Grozavu; France T.,45,0,65,20
1653303375864,FMPH 120,B00,086376,Nguyen-Grozavu; France T.,60,0,65,5
1653303376390,FMPH 130,A00,086377,Staff,48,0,65,17
1653303377446,FMPH 161,A00,086379,Zoumas-Morse; Christine E.,58,0,65,7
1653303377987,FMPH 191,A00,086380,Harrell; Maralee Mae,58,0,60,2
1653303378513,FMPH 196A,A00,086381,Binkin; Nancy Jeanne,0,0,0,0
1653303379042,GLBH 20,A00,086407,Walkover; Lillian B,85,0,90,5
1653303379567,GLBH 100,A00,086408,Staff,55,0,56,1
1653303379567,GLBH 100,B00,086409,Wu; Hua,52,0,56,4
1653303379567,GLBH 100,D00,086411,Staff,38,0,40,2
1653303380093,GLBH 103,A00,086412,Hannah; Seth Donal,48,0,50,2
1653303380617,GLBH 105,A00,086413,Olivas Hernandez; Olga Lid,36,0,38,2
1653303381228,GLBH 106,A00,086414,Kayser; Georgia Lyn,40,0,40,0
1653303381759,GLBH 111,A01,094330,Burgos; Jose L.,0,0,0,0
1653303381759,GLBH 111,B01,094332,Burgos; Jose L.,0,0,0,0
1653303382283,GLBH 148,A00,086415,Staff,69,0,73,4
1653303382810,GLBH 181,A00,086417,Burgos; Jose L.,144,0,146,2
1653303383333,GSS 20,A00,094269,Staff,73,0,75,2
1653303383858,HDS 1,A01,086423,Staff,24,0,25,1
1653303383858,HDS 1,A02,086424,Staff,24,0,25,1
1653303383858,HDS 1,A03,086425,Staff,23,0,25,2
1653303383858,HDS 1,A04,086426,Staff,25,0,25,0
1653303383858,HDS 1,A05,086427,Staff,24,0,25,1
1653303383858,HDS 1,A06,086428,Staff,25,0,25,0
1653303383858,HDS 1,A07,086429,Staff,30,0,30,0
1653303384383,HDS 60,A01,086431,Staff,23,0,25,2
1653303384916,HDS 111,A00,086432,Staff,73,0,80,7
1653303385440,HDS 121,A01,086434,Deak; Gedeon O.,11,0,15,4
1653303385440,HDS 121,A02,086435,Deak; Gedeon O.,13,0,15,2
1653303385963,HDS 150,A00,086436,Staff,25,0,25,0
1653303385963,HDS 150,B00,086437,Staff,25,0,25,0
1653303386486,HDS 173,A00,086439,Staff,27,0,30,3
1653303387009,HDS 181,A01,086441,Staff,30,0,30,0
1653303387536,HDS 191,A01,086443,Staff,25,0,25,0
1653303388062,HIEA 129,A00,088057,Schneewind; Sarah,0,0,0,0
1653303388586,HIEA 137,A00,088058,Lu; Weijing,53,0,55,2
1653303389110,HIEA 144,A00,088059,Henry; Todd A.,43,0,45,2
1653303389633,HIEA 171,A00,088060,Lu; Weijing,15,0,15,0
1653303390164,HIEU 102,A00,088061,Watts; Edward J.,0,0,0,0
1653303390690,HIEU 107,A00,088062,Caciola; Nancy A,0,0,0,0
1653303391218,HIEU 108,A00,088063,Balberg; Mira,53,0,60,7
1653303391746,HIEU 128,A00,088064,Neuheiser; Joerg,0,0,0,0
1653303392281,HIEU 144,A00,094327,Staff,48,0,50,2
1653303392806,HIEU 149,A00,088065,Devereux; Andrew W,38,0,45,7
1653303393337,HIEU 154,A00,088066,Biess; Frank Peter,58,0,65,7
1653303393861,HIGL 114,A00,088067,Edington; Claire Ellen,53,0,55,2
1653303394388,HILA 119,A00,088068,Vitz; Matthew,49,0,51,2
1653303394911,HILA 122,A00,088069,Widener; Daniel,61,0,65,4
1653303395439,HILD 2A,A01,088024,Hanna; Mark G.,28,0,28,0
1653303395439,HILD 2A,A02,088025,Hanna; Mark G.,25,0,25,0
1653303395439,HILD 2A,A03,088026,Hanna; Mark G.,27,0,28,1
1653303395439,HILD 2A,A04,088027,Hanna; Mark G.,28,0,28,0
1653303395439,HILD 2A,A05,088028,Hanna; Mark G.,28,0,28,0
1653303395439,HILD 2A,A06,088029,Hanna; Mark G.,28,0,28,0
1653303395970,HILD 7A,A01,088031,Graham; Jessica Lynn,28,0,28,0
1653303395970,HILD 7A,A02,088032,Graham; Jessica Lynn,27,0,28,1
1653303395970,HILD 7A,A03,088033,Graham; Jessica Lynn,27,0,28,1
1653303395970,HILD 7A,A04,088034,Graham; Jessica Lynn,26,0,28,2
1653303395970,HILD 7A,A05,088035,Graham; Jessica Lynn,26,0,28,2
1653303395970,HILD 7A,A06,088037,Graham; Jessica Lynn,22,0,28,6
1653303395970,HILD 7A,A07,088038,Graham; Jessica Lynn,28,0,28,0
1653303395970,HILD 7A,A08,088039,Graham; Jessica Lynn,28,0,28,0
1653303395970,HILD 7A,A09,088040,Graham; Jessica Lynn,27,0,28,1
1653303395970,HILD 7A,A10,088041,Graham; Jessica Lynn,28,0,28,0
1653303395970,HILD 7A,A11,088042,Graham; Jessica Lynn,28,0,28,0
1653303395970,HILD 7A,A12,088043,Graham; Jessica Lynn,28,0,28,0
1653303396501,HILD 10,A01,088045,Muscolino; Micah S,27,0,28,1
1653303396501,HILD 10,A02,088046,Muscolino; Micah S,27,0,28,1
1653303396501,HILD 10,A03,088047,Muscolino; Micah S,28,0,28,0
1653303396501,HILD 10,A04,088048,Muscolino; Micah S,27,0,28,1
1653303396501,HILD 10,A05,088049,Muscolino; Micah S,28,0,28,0
1653303396501,HILD 10,A06,088050,Muscolino; Micah S,27,0,28,1
1653303397026,HILD 30,A01,088052,Edington; Claire Ellen,24,0,28,4
1653303397026,HILD 30,A02,088053,Edington; Claire Ellen,28,0,28,0
1653303397548,HILD 41,A01,088055,Devereux; Andrew W,28,0,28,0
1653303397548,HILD 41,A02,088056,Devereux; Andrew W,28,0,28,0
1653303398080,HINE 116,A00,088070,Kayali; Hasan,47,0,50,3
1653303398609,HINE 144,A00,088071,Provence; Michael,40,0,45,5
1653303399138,HISC 106,A00,088072,Pineda De Avila; Nydia,47,0,50,3
1653303399662,HISC 115,A00,088073,Gere; Catherina M.,103,0,110,7
1653303400190,HITO 87,A00,094352,Patterson; Patrick H.,20,0,20,0
1653303400190,HITO 87,C00,094354,Patterson; Patrick H.,20,0,20,0
1653303400190,HITO 87,B00,094353,Hanna; Mark G.,20,0,20,0
1653303400714,HITO 100,A00,088074,Hanna; Mark G.,8,0,12,4
1653303401243,HITO 193,A00,091603,Hill; Seth J,9999,0,9999,0
1653303401771,HITO 196,A00,088075,Hendrickson; Gerald M.,20,0,20,0
1653303402295,HIUS 108B,A00,088076,Klann; Mary Cameron,48,0,51,3
1653303402819,HIUS 112,A00,088077,Plant; Rebecca Jo,144,0,148,4
1653303403343,HIUS 152A,A00,088078,Vandevelde; Kenneth Joseph,40,0,45,5
1653303403876,HIUS 155,A00,088079,Alvarez; Luis A,37,0,45,8
1653303404402,HIUS 183,A00,088080,Graham; Jessica Lynn,19,0,20,1
1653303404935,HUM 3,A01,087224,West; Geoffrey Scott,27,0,28,1
1653303404935,HUM 3,A02,087225,West; Geoffrey Scott,28,0,28,0
1653303404935,HUM 3,A03,087226,West; Geoffrey Scott,26,0,28,2
1653303404935,HUM 3,A04,087227,West; Geoffrey Scott,27,0,28,1
1653303404935,HUM 3,A05,087228,West; Geoffrey Scott,27,0,28,1
1653303404935,HUM 3,A06,087229,West; Geoffrey Scott,24,0,28,4
1653303404935,HUM 3,A07,087230,West; Geoffrey Scott,27,0,28,1
1653303404935,HUM 3,A08,087231,West; Geoffrey Scott,28,0,28,0
1653303404935,HUM 3,B01,087233,Staff,28,0,28,0
1653303404935,HUM 3,B02,087234,Staff,28,0,28,0
1653303404935,HUM 3,B03,087235,Staff,28,0,28,0
1653303404935,HUM 3,B04,087236,Staff,28,0,28,0
1653303404935,HUM 3,B05,087237,Staff,28,0,28,0
1653303404935,HUM 3,B06,087238,Staff,28,0,28,0
1653303404935,HUM 3,B07,087239,Staff,0,0,0,0
1653303404935,HUM 3,B08,087240,Staff,0,0,0,0
1653303404935,HUM 3,B09,087241,Staff,30,0,30,0
1653303404935,HUM 3,B10,087242,Staff,28,0,30,2
1653303404935,HUM 3,C01,087244,Patterson; Patrick H.,0,0,0,0
1653303404935,HUM 3,C02,087245,Patterson; Patrick H.,0,0,0,0
1653303404935,HUM 3,C03,087246,Patterson; Patrick H.,23,0,28,5
1653303404935,HUM 3,C04,087247,Patterson; Patrick H.,28,0,28,0
1653303404935,HUM 3,C05,087248,Patterson; Patrick H.,27,0,28,1
1653303404935,HUM 3,C06,087249,Patterson; Patrick H.,25,0,28,3
1653303404935,HUM 3,C07,087250,Patterson; Patrick H.,27,0,28,1
1653303404935,HUM 3,C08,087251,Patterson; Patrick H.,28,0,28,0
1653303404935,HUM 3,C09,087252,Patterson; Patrick H.,28,0,28,0
1653303404935,HUM 3,C10,087253,Patterson; Patrick H.,27,0,28,1
1653303404935,HUM 3,D01,087255,Lyon; Antony J.,24,0,28,4
1653303404935,HUM 3,D02,087256,Lyon; Antony J.,28,0,28,0
1653303404935,HUM 3,D03,087257,Lyon; Antony J.,0,0,0,0
1653303404935,HUM 3,D04,087258,Lyon; Antony J.,0,0,0,0
1653303404935,HUM 3,D05,087259,Lyon; Antony J.,27,0,28,1
1653303404935,HUM 3,D06,087260,Lyon; Antony J.,28,0,28,0
1653303404935,HUM 3,D07,087261,Lyon; Antony J.,21,0,28,7
1653303404935,HUM 3,D08,087262,Lyon; Antony J.,20,0,28,8
1653303404935,HUM 3,D09,087263,Lyon; Antony J.,28,0,28,0
1653303404935,HUM 3,D10,087264,Lyon; Antony J.,27,0,28,1
1653303404935,HUM 3,D11,087265,Lyon; Antony J.,30,0,30,0
1653303404935,HUM 3,D12,087266,Lyon; Antony J.,30,0,30,0
1653303404935,HUM 3,D13,087267,Lyon; Antony J.,26,0,28,2
1653303404935,HUM 3,D14,087268,Lyon; Antony J.,25,0,28,3
1653303405466,INTL 101,A01,088176,Day; Joel Keith,19,0,20,1
1653303405466,INTL 101,A02,088177,Day; Joel Keith,20,0,20,0
1653303405466,INTL 101,A03,088178,Day; Joel Keith,17,0,20,3
1653303405466,INTL 101,A04,088179,Day; Joel Keith,19,0,20,1
1653303405466,INTL 101,A05,088180,Day; Joel Keith,19,0,20,1
1653303405466,INTL 101,A06,088181,Day; Joel Keith,18,0,20,2
1653303405992,INTL 102,A01,088183,Walter; Barbara Florence,19,0,20,1
1653303405992,INTL 102,A02,088184,Walter; Barbara Florence,19,0,20,1
1653303405992,INTL 102,A03,088185,Walter; Barbara Florence,18,0,20,2
1653303405992,INTL 102,A04,088186,Walter; Barbara Florence,16,0,20,4
1653303405992,INTL 102,A05,088187,Walter; Barbara Florence,19,0,20,1
1653303405992,INTL 102,A06,088188,Walter; Barbara Florence,19,0,20,1
1653303406520,INTL 190,A00,088189,Auerbach; Bradford C,0,0,0,0
1653303406520,INTL 190,B00,088190,Auerbach; Bradford C,0,0,0,0
1653303406520,INTL 190,C00,088191,Fortier; Jana,0,0,0,0
1653303406520,INTL 190,D00,088192,Kshatriya; Krista C,0,0,0,0
1653303406520,INTL 190,E00,088193,Nadkarni; Vidya,0,0,0,0
1653303406520,INTL 190,F00,088194,Scott; Jeffrey F,0,0,0,0
1653303406520,INTL 190,G00,088195,Segui; Alan S,0,0,0,0
1653303406520,INTL 190,H00,088196,Segui; Alan S,0,0,0,0
1653303407045,INTL 190H,A00,088197,Gibson; Clark C,0,0,0,0
1653303407588,JAPN 10A,A01,086851,Maruyama; Rie,15,0,15,0
1653303407588,JAPN 10A,A02,086852,Maruyama; Rie,15,0,15,0
1653303407588,JAPN 10A,B01,086854,Staff,13,0,13,0
1653303407588,JAPN 10A,B02,086855,Staff,13,0,13,0
1653303407588,JAPN 10A,C01,086857,McKee; Mayumi Mochizuki,13,0,13,0
1653303407588,JAPN 10A,C02,086858,McKee; Mayumi Mochizuki,11,0,13,2
1653303407588,JAPN 10A,D01,086860,Sato; Kyoko,13,0,13,0
1653303407588,JAPN 10A,D02,086861,Sato; Kyoko,13,0,13,0
1653303407588,JAPN 10A,E01,086863,Kamioka; Sachiko,12,0,13,1
1653303407588,JAPN 10A,E02,086864,Kamioka; Sachiko,12,0,13,1
1653303407588,JAPN 10A,F01,086866,Sato; Kyoko,13,0,13,0
1653303407588,JAPN 10A,F02,086867,Sato; Kyoko,13,0,13,0
1653303407588,JAPN 10A,G01,086869,Maruyama; Rie,8,0,13,5
1653303407588,JAPN 10A,G02,086870,Maruyama; Rie,13,0,13,0
1653303407588,JAPN 10A,H01,086872,Kamioka; Sachiko,12,0,13,1
1653303407588,JAPN 10A,H02,086873,Kamioka; Sachiko,11,0,13,2
1653303407588,JAPN 10A,I01,086875,Staff,12,0,13,1
1653303407588,JAPN 10A,I02,086876,Staff,13,0,13,0
1653303407588,JAPN 10A,J01,086878,McKee; Mayumi Mochizuki,12,0,13,1
1653303407588,JAPN 10A,J02,086879,McKee; Mayumi Mochizuki,13,0,13,0
1653303407588,JAPN 10A,K01,086881,Inada; Minori,13,0,13,0
1653303407588,JAPN 10A,K02,086882,Inada; Minori,12,0,13,1
1653303407588,JAPN 10A,L01,086884,Tipton; Yuko,13,0,13,0
1653303407588,JAPN 10A,L02,086885,Tipton; Yuko,13,0,13,0
1653303407588,JAPN 10A,M01,086887,Inada; Minori,12,0,13,1
1653303407588,JAPN 10A,M02,086888,Inada; Minori,13,0,13,0
1653303407588,JAPN 10A,N01,086890,McKee; Mayumi Mochizuki,13,0,13,0
1653303407588,JAPN 10A,N02,086891,McKee; Mayumi Mochizuki,11,0,13,2
1653303407588,JAPN 10A,O01,086893,Staff,13,0,13,0
1653303407588,JAPN 10A,O02,086894,Staff,12,0,13,1
1653303407588,JAPN 10A,P01,086896,Tipton; Yuko,15,0,15,0
1653303407588,JAPN 10A,P02,086897,Tipton; Yuko,15,0,15,0
1653303408114,JAPN 20A,A01,086899,Simpson; Junko Tokuda,11,0,13,2
1653303408114,JAPN 20A,A02,086900,Simpson; Junko Tokuda,12,0,13,1
1653303408114,JAPN 20A,B01,086902,Takeda; Izumi,11,0,13,2
1653303408114,JAPN 20A,B02,086903,Takeda; Izumi,12,0,13,1
1653303408114,JAPN 20A,C01,086905,Ross; Kayoko F,12,0,13,1
1653303408114,JAPN 20A,C02,086906,Ross; Kayoko F,12,0,13,1
1653303408114,JAPN 20A,D01,086908,Takeda; Izumi,10,0,13,3
1653303408114,JAPN 20A,D02,086909,Takeda; Izumi,13,0,13,0
1653303408114,JAPN 20A,E01,086911,Maruyama; Rie,11,0,13,2
1653303408114,JAPN 20A,E02,086912,Maruyama; Rie,11,0,13,2
1653303408114,JAPN 20A,F01,086914,Kamioka; Sachiko,7,0,13,6
1653303408114,JAPN 20A,F02,086915,Kamioka; Sachiko,9,0,13,4
1653303408114,JAPN 20A,G01,086917,Ross; Kayoko F,13,0,13,0
1653303408114,JAPN 20A,G02,086918,Ross; Kayoko F,12,0,13,1
1653303408645,JAPN 130A,A01,086920,Simpson; Junko Tokuda,6,0,10,4
1653303408645,JAPN 130A,A02,086921,Simpson; Junko Tokuda,5,0,10,5
1653303408645,JAPN 130A,B01,086923,Ross; Kayoko F,9,0,10,1
1653303408645,JAPN 130A,B02,086924,Ross; Kayoko F,9,0,10,1
1653303409176,JAPN 135A,A00,086925,Inada; Minori,14,0,15,1
1653303409176,JAPN 135A,B00,086926,Takeda; Izumi,15,0,15,0
1653303409699,JAPN 140A,A00,086927,Sato; Kyoko,19,0,20,1
1653303410224,JWSP 1,A01,086445,Shuster; Alana,15,0,15,0
1653303410224,JWSP 1,A02,086446,Shuster; Alana,15,0,15,0
1653303410747,JWSP 104,A01,086448,Shuster; Alana,15,0,15,0
1653303411276,LATI 10,A01,093588,Kennemore; Amy Michelle,31,0,32,1
1653303411276,LATI 10,A02,093589,Kennemore; Amy Michelle,32,0,32,0
1653303411276,LATI 10,A03,093590,Kennemore; Amy Michelle,32,0,32,0
1653303411807,LATI 50,A01,093592,Kokinis; Troy Andreas,32,0,32,0
1653303411807,LATI 50,A02,093593,Kokinis; Troy Andreas,31,0,32,1
1653303411807,LATI 50,A03,093595,Kokinis; Troy Andreas,32,0,32,0
1653303412338,LATI 122A,A00,093649,Andrews; Abigail Leslie,0,0,0,0
1653303412859,LATI 180,A00,093597,Staff,36,0,40,4
1653303413387,LIAB 1A,A00,087085,Saab; Dima,13,0,14,1
1653303413387,LIAB 1A,B00,087086,Saab; Dima,13,0,14,1
1653303413387,LIAB 1A,C00,087087,Saab; Dima,14,0,14,0
1653303413387,LIAB 1A,D00,087088,El Cheddadi; Youniss,14,0,14,0
1653303413917,LIAB 1AX,A00,087089,Akjeje; Abdelhak,28,0,28,0
1653303413917,LIAB 1AX,B00,087091,Akjeje; Abdelhak,28,0,28,0
1653303414444,LIAB 1D,A00,087093,El Cheddadi; Youniss,13,0,14,1
1653303414444,LIAB 1D,B00,087094,El Cheddadi; Youniss,12,0,14,2
1653303414973,LIAB 1DX,A00,087095,Akjeje; Abdelhak,27,0,28,1
1653303415500,LIDS 19,001,095098,Goodall; Grant Todd,9999,0,9999,0
1653303415500,LIDS 19,002,095099,Goodall; Grant Todd,9999,0,9999,0
1653303415500,LIDS 19,003,095100,Goodall; Grant Todd,9999,0,9999,0
1653303415500,LIDS 19,004,095101,Goodall; Grant Todd,9999,0,9999,0
1653303415500,LIDS 19,005,095102,Goodall; Grant Todd,9999,0,9999,0
1653303415500,LIDS 19,006,095103,Goodall; Grant Todd,9999,0,9999,0
1653303415500,LIDS 19,007,095104,Goodall; Grant Todd,9999,0,9999,0
1653303415500,LIDS 19,008,095105,Goodall; Grant Todd,9999,0,9999,0
1653303415500,LIDS 19,009,095106,Goodall; Grant Todd,9999,0,9999,0
1653303415500,LIDS 19,010,095107,Goodall; Grant Todd,9999,0,9999,0
1653303415500,LIDS 19,011,095108,Goodall; Grant Todd,9999,0,9999,0
1653303415500,LIDS 19,012,095109,Goodall; Grant Todd,9999,0,9999,0
1653303416034,LIFR 1A,A00,087097,Goodall; Grant Todd,13,0,14,1
1653303416034,LIFR 1A,B00,087098,Goodall; Grant Todd,13,0,14,1
1653303416034,LIFR 1A,C00,087099,Goodall; Grant Todd,12,0,14,2
1653303416034,LIFR 1A,D00,087100,Goodall; Grant Todd,12,0,14,2
1653303416034,LIFR 1A,E00,087101,Goodall; Grant Todd,14,0,14,0
1653303416034,LIFR 1A,F00,087102,Goodall; Grant Todd,13,0,14,1
1653303416564,LIFR 1AX,A00,087103,Goodall; Grant Todd,27,0,28,1
1653303416564,LIFR 1AX,B00,087104,Goodall; Grant Todd,27,0,28,1
1653303416564,LIFR 1AX,C00,087105,Goodall; Grant Todd,25,0,28,3
1653303417086,LIFR 1B,A00,087106,Goodall; Grant Todd,14,0,14,0
1653303417086,LIFR 1B,B00,087107,Goodall; Grant Todd,13,0,14,1
1653303417086,LIFR 1B,C00,087108,Goodall; Grant Todd,13,0,14,1
1653303417086,LIFR 1B,D00,087109,Goodall; Grant Todd,13,0,14,1
1653303417613,LIFR 1BX,A00,087110,Goodall; Grant Todd,26,0,28,2
1653303417613,LIFR 1BX,B00,087111,Goodall; Grant Todd,26,0,28,2
1653303418138,LIFR 1D,A00,087112,Goodall; Grant Todd,14,0,14,0
1653303418138,LIFR 1D,B00,087113,Goodall; Grant Todd,12,0,14,2
1653303418138,LIFR 1D,C00,087114,Goodall; Grant Todd,11,0,14,3
1653303418138,LIFR 1D,D00,087115,Goodall; Grant Todd,10,0,14,4
1653303418666,LIFR 1DX,A00,087116,Goodall; Grant Todd,26,0,28,2
1653303418666,LIFR 1DX,B00,087117,Goodall; Grant Todd,23,0,28,5
1653303419191,LIFR 11,A00,087118,Goodall; Grant Todd,10,0,10,0
1653303419719,LIGM 1A,A00,087119,Riebeling; Elke,14,0,14,0
1653303419719,LIGM 1A,B00,087120,Riebeling; Elke,14,0,14,0
1653303419719,LIGM 1A,C00,087121,Riebeling; Elke,12,0,14,2
1653303419719,LIGM 1A,D00,087122,Riebeling; Elke,14,0,14,0
1653303419719,LIGM 1A,E00,087123,Riebeling; Elke,14,0,14,0
1653303420242,LIGM 1AX,A00,087124,Riebeling; Elke,28,0,28,0
1653303420242,LIGM 1AX,B00,087125,Riebeling; Elke,28,0,28,0
1653303420242,LIGM 1AX,C00,087126,Riebeling; Elke,27,0,28,1
1653303420767,LIGM 1D,A00,087127,Riebeling; Elke,14,0,14,0
1653303420767,LIGM 1D,B00,087128,Riebeling; Elke,12,0,14,2
1653303421289,LIGM 1DX,A00,087129,Riebeling; Elke,26,0,28,2
1653303421817,LIGM 11,A00,087130,Goodall; Grant Todd,10,0,10,0
1653303422342,LIGN 5,A00,087005,Goodall; Grant Todd,74,0,75,1
1653303422867,LIGN 7,A00,087006,Mayberry; Rachel,139,0,146,7
1653303423393,LIGN 8,A00,087007,McIntosh; Justin Daniel,244,0,250,6
1653303423923,LIGN 17,A00,087008,Kehler; Andrew Scott,218,0,220,2
1653303424448,LIGN 101,A01,087010,Styler; William Francis,29,0,30,1
1653303424448,LIGN 101,A02,087011,Styler; William Francis,29,0,30,1
1653303424448,LIGN 101,A03,087012,Styler; William Francis,29,0,30,1
1653303424448,LIGN 101,A04,087013,Styler; William Francis,29,0,30,1
1653303424973,LIGN 110,A01,087015,Garellek; Marc,29,0,30,1
1653303424973,LIGN 110,A02,087016,Garellek; Marc,26,0,30,4
1653303424973,LIGN 110,A03,087017,Garellek; Marc,26,0,30,4
1653303424973,LIGN 110,A04,087018,Garellek; Marc,28,0,30,2
1653303425497,LIGN 121,A01,087020,Drake; Emily C,23,0,25,2
1653303425497,LIGN 121,A02,087021,Drake; Emily C,24,0,25,1
1653303426022,LIGN 150,A00,093702,Staff,71,0,75,4
1653303426552,LIGN 152,A00,087023,Caballero; Gabriela Hernandez,16,0,20,4
1653303427085,LIGN 154,A00,087024,Kluender; Robert,70,0,70,0
1653303427609,LIGN 167,A00,087025,Bergen; Leon,70,0,100,30
1653303428136,LIGN 187,A00,087026,McIntosh; Justin Daniel,20,0,20,0
1653303428665,LIHL 112F,A00,086505,Alicio; Atilio,25,0,28,3
1653303429186,LIHL 114F,A00,086506,Staff,21,0,28,7
1653303429712,LIHL 117F,A00,086508,Sadegholvad; Elham,20,0,20,0
1653303430237,LIHL 118,A00,086509,Staff,25,0,28,3
1653303430760,LIHL 119F,A00,086510,Staff,26,0,28,2
1653303431291,LIHL 124F,A00,086511,Staff,27,0,28,1
1653303431818,LIHL 132F,A00,086512,Alicio; Atilio,28,0,28,0
1653303432348,LIIT 1A,A00,087131,Riebeling; Elke,14,0,14,0
1653303432348,LIIT 1A,B00,087132,Riebeling; Elke,14,0,14,0
1653303432348,LIIT 1A,C00,087133,Riebeling; Elke,12,0,14,2
1653303432348,LIIT 1A,D00,087134,Riebeling; Elke,14,0,14,0
1653303432878,LIIT 1AX,A00,087135,Riebeling; Elke,28,0,28,0
1653303432878,LIIT 1AX,B00,087136,Riebeling; Elke,26,0,28,2
1653303433402,LIPO 1A,A00,087137,Paladini; Denise,14,0,14,0
1653303433402,LIPO 1A,B00,087138,Paladini; Denise,10,0,14,4
1653303433925,LIPO 1AX,A00,087139,De Abreu; Cassia,18,0,22,4
1653303433925,LIPO 1AX,B00,087140,De Abreu; Cassia,22,0,22,0
1653303434522,LIPO 1D,A00,087141,Paladini; Denise,10,0,14,4
1653303435049,LIPO 1DX,A00,087143,De Abreu; Cassia,10,0,14,4
1653303435575,LISL 1A,A00,087145,Lott; Margaret S.,10,0,14,4
1653303435575,LISL 1A,B00,087146,Lott; Margaret S.,14,0,14,0
1653303435575,LISL 1A,C00,087147,Lott; Margaret S.,10,0,14,4
1653303435575,LISL 1A,D00,087148,Lott; Margaret S.,11,0,14,3
1653303435575,LISL 1A,E00,087149,Lott; Margaret S.,13,0,14,1
1653303435575,LISL 1A,F00,087150,Lott; Margaret S.,12,0,14,2
1653303435575,LISL 1A,G00,087151,Lott; Margaret S.,13,0,14,1
1653303435575,LISL 1A,H00,087152,Lott; Margaret S.,13,0,14,1
1653303436101,LISL 1AX,A00,087153,Lott; Margaret S.,28,0,28,0
1653303436101,LISL 1AX,B00,087154,Lott; Margaret S.,25,0,28,3
1653303436101,LISL 1AX,C00,087155,Lott; Margaret S.,25,0,28,3
1653303436101,LISL 1AX,D00,087156,Lott; Margaret S.,24,0,28,4
1653303436630,LISL 1B,A00,087157,Lott; Margaret S.,13,0,14,1
1653303436630,LISL 1B,B00,087158,Lott; Margaret S.,12,0,14,2
1653303436630,LISL 1B,C00,087159,Lott; Margaret S.,11,0,14,3
1653303436630,LISL 1B,D00,087160,Lott; Margaret S.,13,0,14,1
1653303436630,LISL 1B,E00,087161,Lott; Margaret S.,13,0,14,1
1653303436630,LISL 1B,F00,087162,Lott; Margaret S.,13,0,14,1
1653303437156,LISL 1BX,A00,087163,Lott; Margaret S.,23,0,28,5
1653303437156,LISL 1BX,B00,087164,Lott; Margaret S.,26,0,28,2
1653303437156,LISL 1BX,C00,087165,Lott; Margaret S.,28,0,28,0
1653303437686,LISL 1D,A00,087166,Lott; Margaret S.,14,0,14,0
1653303437686,LISL 1D,B00,087167,Lott; Margaret S.,14,0,14,0
1653303437686,LISL 1D,C00,087168,Lott; Margaret S.,8,0,14,6
1653303437686,LISL 1D,D00,087169,Lott; Margaret S.,13,0,14,1
1653303438212,LISL 1DX,A00,087170,Lott; Margaret S.,23,0,28,5
1653303438212,LISL 1DX,B00,087171,Lott; Margaret S.,26,0,28,2
1653303438743,LISP 1A,001,087172,Munoz Sanchez; Alicia,13,0,14,1
1653303438743,LISP 1A,002,087173,Munoz Sanchez; Alicia,12,0,14,2
1653303438743,LISP 1A,003,087174,Munoz Sanchez; Alicia,13,0,14,1
1653303438743,LISP 1A,004,087175,Munoz Sanchez; Alicia,12,0,14,2
1653303438743,LISP 1A,005,087176,Munoz Sanchez; Alicia,10,0,14,4
1653303438743,LISP 1A,006,087177,Munoz Sanchez; Alicia,12,0,14,2
1653303438743,LISP 1A,007,087178,Munoz Sanchez; Alicia,12,0,14,2
1653303438743,LISP 1A,008,087179,Munoz Sanchez; Alicia,14,0,14,0
1653303439276,LISP 1AX,A00,087180,Munoz Sanchez; Alicia,27,0,28,1
1653303439276,LISP 1AX,B00,087181,Munoz Sanchez; Alicia,24,0,28,4
1653303439276,LISP 1AX,C00,087182,Munoz Sanchez; Alicia,25,0,28,3
1653303439276,LISP 1AX,D00,087183,Munoz Sanchez; Alicia,25,0,28,3
1653303439806,LISP 1B,001,087184,Munoz Sanchez; Alicia,14,0,14,0
1653303439806,LISP 1B,002,087185,Munoz Sanchez; Alicia,14,0,14,0
1653303439806,LISP 1B,003,087186,Munoz Sanchez; Alicia,11,0,14,3
1653303439806,LISP 1B,004,087187,Munoz Sanchez; Alicia,12,0,14,2
1653303439806,LISP 1B,005,087188,Munoz Sanchez; Alicia,13,0,14,1
1653303439806,LISP 1B,006,087189,Munoz Sanchez; Alicia,13,0,14,1
1653303439806,LISP 1B,007,087190,Munoz Sanchez; Alicia,14,0,14,0
1653303439806,LISP 1B,008,087191,Munoz Sanchez; Alicia,13,0,14,1
1653303439806,LISP 1B,009,087192,Munoz Sanchez; Alicia,14,0,14,0
1653303439806,LISP 1B,010,087193,Munoz Sanchez; Alicia,13,0,14,1
1653303439806,LISP 1B,011,087194,Munoz Sanchez; Alicia,14,0,14,0
1653303440339,LISP 1BX,A00,087195,Munoz Sanchez; Alicia,28,0,28,0
1653303440339,LISP 1BX,B00,087196,Munoz Sanchez; Alicia,26,0,28,2
1653303440339,LISP 1BX,C00,087197,Munoz Sanchez; Alicia,26,0,28,2
1653303440339,LISP 1BX,D00,087198,Munoz Sanchez; Alicia,26,0,28,2
1653303440339,LISP 1BX,E00,087199,Munoz Sanchez; Alicia,28,0,28,0
1653303440870,LISP 1D,001,087200,Munoz Sanchez; Alicia,13,0,14,1
1653303440870,LISP 1D,002,087201,Munoz Sanchez; Alicia,14,0,14,0
1653303440870,LISP 1D,003,087202,Munoz Sanchez; Alicia,8,0,14,6
1653303440870,LISP 1D,004,087203,Munoz Sanchez; Alicia,5,0,14,9
1653303440870,LISP 1D,005,087204,Munoz Sanchez; Alicia,11,0,14,3
1653303440870,LISP 1D,006,087205,Munoz Sanchez; Alicia,13,0,14,1
1653303440870,LISP 1D,007,087206,Munoz Sanchez; Alicia,13,0,14,1
1653303440870,LISP 1D,008,087207,Munoz Sanchez; Alicia,13,0,14,1
1653303440870,LISP 1D,009,087208,Munoz Sanchez; Alicia,14,0,14,0
1653303440870,LISP 1D,010,087209,Munoz Sanchez; Alicia,12,0,14,2
1653303440870,LISP 1D,011,087210,Munoz Sanchez; Alicia,13,0,14,1
1653303440870,LISP 1D,012,087211,Munoz Sanchez; Alicia,14,0,14,0
1653303440870,LISP 1D,013,087212,Munoz Sanchez; Alicia,14,0,14,0
1653303440870,LISP 1D,014,087213,Munoz Sanchez; Alicia,14,0,14,0
1653303441401,LISP 1DX,A00,087214,Munoz Sanchez; Alicia,27,0,28,1
1653303441401,LISP 1DX,B00,087215,Munoz Sanchez; Alicia,23,0,28,5
1653303441401,LISP 1DX,C00,087216,Munoz Sanchez; Alicia,23,0,28,5
1653303441401,LISP 1DX,D00,087217,Munoz Sanchez; Alicia,25,0,28,3
1653303441401,LISP 1DX,E00,087218,Munoz Sanchez; Alicia,27,0,28,1
1653303441401,LISP 1DX,F00,087219,Munoz Sanchez; Alicia,25,0,28,3
1653303441401,LISP 1DX,G00,087220,Munoz Sanchez; Alicia,28,0,28,0
1653303441925,LISP 15,A00,087221,Munoz Sanchez; Alicia,19,0,20,1
1653303442449,LISP 18,A00,087222,Munoz Sanchez; Alicia,15,0,20,5
1653303442975,LTAM 110,A00,087352,Chacon; Gloria Elizabeth,35,0,40,5
1653303443500,LTCS 87,A00,094011,Nguyen; Hoang Tan,19,0,20,1
1653303444025,LTCS 111,A00,087353,Vitkus; Daniel J.,40,0,40,0
1653303444549,LTCS 119,A00,087354,Nguyen; Hoang Tan,29,0,30,1
1653303445073,LTCS 130,A00,087355,Kim; Joo Ok,37,0,40,3
1653303445600,LTCS 165,A00,087356,Kim; Joo Ok,38,0,40,2
1653303446129,LTEA 120A,A00,087357,Fiss; Geraldine Anna,291,0,300,9
1653303446655,LTEA 140,A00,094009,Lee; Jin-Kyung,28,0,32,4
1653303447178,LTEA 142,A00,087358,Lee; Jin-Kyung,102,0,120,18
1653303447709,LTEN 21,A01,087275,Lampert-Weissig; Lisa,25,0,25,0
1653303447709,LTEN 21,A02,087276,Lampert-Weissig; Lisa,25,0,25,0
1653303447709,LTEN 21,A03,087277,Lampert-Weissig; Lisa,25,0,25,0
1653303447709,LTEN 21,A04,087278,Lampert-Weissig; Lisa,25,0,25,0
1653303448242,LTEN 25,A01,087280,Johnson; Sara E.,25,0,25,0
1653303448242,LTEN 25,A02,087281,Johnson; Sara E.,25,0,25,0
1653303448242,LTEN 25,A03,087282,Johnson; Sara E.,23,0,25,2
1653303448242,LTEN 25,A04,087283,Johnson; Sara E.,25,0,25,0
1653303448769,LTEN 29,A01,087285,Ruiz; Ariana,24,0,25,1
1653303448769,LTEN 29,A02,087286,Ruiz; Ariana,25,0,25,0
1653303448769,LTEN 29,A03,087287,Ruiz; Ariana,24,0,25,1
1653303448769,LTEN 29,A04,087288,Ruiz; Ariana,24,0,25,1
1653303449293,LTEN 107,A00,087359,Lampert-Weissig; Lisa,39,0,40,1
1653303449816,LTEN 117,A00,087360,Vitkus; Daniel J.,40,0,40,0
1653303450340,LTEN 127,A00,087361,Loose; Margaret,38,0,40,2
1653303450861,LTEN 142,A00,094010,Loose; Margaret,38,0,40,2
1653303451386,LTEN 148,A00,087363,Walkiewicz; Kathryn A,40,0,40,0
1653303451911,LTEN 152,A00,087364,Walkiewicz; Kathryn A,37,0,40,3
1653303452438,LTEN 180,A00,087365,Ruiz; Ariana,18,0,20,2
1653303452966,LTFR 2A,A01,087290,Ploye; Catherine,23,0,25,2
1653303453489,LTFR 2B,A01,087292,Ploye; Catherine,25,0,25,0
1653303454013,LTFR 104,A00,087366,Ploye; Catherine,25,0,25,0
1653303454541,LTFR 116,A00,087367,Zhiri; Oumelbanine,13,0,15,2
1653303455064,LTGK 1,A00,087293,Myerston Santana; Jacobo,27,0,30,3
1653303455587,LTGK 103,A00,087368,duBois; Page Ann,14,0,15,1
1653303456111,LTGM 2A,A01,087295,Fischer-Grunski; Eva K,24,0,25,1
1653303456640,LTIT 2A,A01,087297,De Marchi Gherini; Adriana,24,0,25,1
1653303457166,LTKO 1A,A01,087299,Staff,24,0,25,1
1653303457166,LTKO 1A,B01,087301,Staff,25,0,25,0
1653303457166,LTKO 1A,C01,087303,Staff,25,0,25,0
1653303457166,LTKO 1A,D01,087305,Staff,25,0,25,0
1653303457166,LTKO 1A,E01,087307,Staff,24,0,25,1
1653303457166,LTKO 1A,F01,087309,Staff,25,0,25,0
1653303457166,LTKO 1A,G01,087311,Staff,25,0,25,0
1653303457166,LTKO 1A,H01,087313,Staff,24,0,25,1
1653303457166,LTKO 1A,I01,087315,Staff,25,0,25,0
1653303457696,LTKO 2A,A01,087317,Staff,24,0,25,1
1653303457696,LTKO 2A,B01,087319,Staff,22,0,25,3
1653303457696,LTKO 2A,C01,087321,Lee; Jeyseon,24,0,25,1
1653303458230,LTKO 130,A00,087369,Lee; Jeyseon,25,0,25,0
1653303458755,LTLA 1,A00,087322,Murray; Kourtney Kristine,38,0,40,2
1653303459278,LTLA 100,A00,087371,Kelting; Edward William,23,0,25,2
1653303459806,LTRU 1A,A01,087324,Wells; Patricia Rebecca,23,0,25,2
1653303460329,LTRU 2A,A01,087326,Wells; Patricia Rebecca,20,0,20,0
1653303460852,LTRU 104B,A01,087373,Wells; Patricia Rebecca,14,0,15,1
1653303461377,LTSP 2A,A01,087328,Staff,25,0,25,0
1653303461377,LTSP 2A,B01,087330,Staff,22,0,25,3
1653303461377,LTSP 2A,C01,087332,Staff,22,0,25,3
1653303461905,LTSP 2B,A01,087334,Staff,22,0,25,3
1653303461905,LTSP 2B,B01,087336,Staff,19,0,25,6
1653303462429,LTSP 2D,A00,087337,Staff,25,0,25,0
1653303462429,LTSP 2D,B00,087338,Staff,25,0,25,0
1653303462429,LTSP 2D,C00,087339,Staff,25,0,25,0
1653303462953,LTSP 100A,A00,087374,Arcos Herrera; Carol,23,0,25,2
1653303463477,LTSP 116,A00,087375,Blanco; John D,29,0,30,1
1653303464004,LTSP 140,A00,087376,Chacon; Gloria Elizabeth,30,0,30,0
1653303464530,LTSP 175,A00,087377,Arcos Herrera; Carol,30,0,30,0
1653303465054,LTTH 150,A00,087379,Cohen; Alain J. J.,40,0,40,0
1653303465583,LTWL 19A,A00,087340,Myerston Santana; Jacobo,39,0,40,1
1653303466108,LTWL 87,A00,094012,Lampert-Weissig; Lisa,20,0,20,0
1653303466635,LTWL 116,A00,087380,Nguyen; Hoang Tan,60,0,60,0
1653303467162,LTWL 120,A00,087381,Fiss; Geraldine Anna,37,0,40,3
1653303467688,LTWL 172,A00,087382,De Marchi Gherini; Adriana,40,0,40,0
1653303468215,LTWL 180,A00,087383,Kontje; Todd Curtis,39,0,40,1
1653303468740,LTWL 194,A00,087384,Suzuki; Erin M.,31,0,32,1
1653303469264,LTWR 8A,A01,087342,Jemc; Jaclyn,24,0,25,1
1653303469264,LTWR 8A,A02,087343,Jemc; Jaclyn,25,0,25,0
1653303469264,LTWR 8A,A03,087344,Jemc; Jaclyn,24,0,25,1
1653303469264,LTWR 8A,A04,087345,Jemc; Jaclyn,24,0,25,1
1653303469788,LTWR 8C,A01,087348,Forbes; Camille,25,0,25,0
1653303469788,LTWR 8C,A02,087349,Forbes; Camille,25,0,25,0
1653303469788,LTWR 8C,A03,087350,Forbes; Camille,25,0,25,0
1653303469788,LTWR 8C,A04,087351,Forbes; Camille,23,0,25,2
1653303470315,LTWR 100,A00,087385,Staff,12,0,15,3
1653303470841,LTWR 102,A00,087386,Staff,14,0,15,1
1653303471365,LTWR 115,A00,087387,Carroll; Amy Sara,24,0,30,6
1653303471888,LTWR 119,A00,087388,Staff,22,0,30,8
1653303472411,LTWR 140,A00,087389,Carroll; Amy Sara,37,0,40,3
1653303472933,LTWR 194,A00,087390,Som; Brandon D,35,0,40,5
1653303473466,MAE 2,A01,090334,Anderson; Mark Ronald,8,0,8,0
1653303473466,MAE 2,A02,090335,Anderson; Mark Ronald,8,0,8,0
1653303473466,MAE 2,A03,090336,Anderson; Mark Ronald,8,0,8,0
1653303473466,MAE 2,A04,090337,Anderson; Mark Ronald,8,0,8,0
1653303473466,MAE 2,A05,090338,Anderson; Mark Ronald,8,0,8,0
1653303473466,MAE 2,A06,090339,Anderson; Mark Ronald,8,0,8,0
1653303473466,MAE 2,A07,090340,Anderson; Mark Ronald,8,0,8,0
1653303473466,MAE 2,A08,090341,Anderson; Mark Ronald,7,0,8,1
1653303473466,MAE 2,A09,090342,Anderson; Mark Ronald,8,0,8,0
1653303473995,MAE 3,A01,090344,Delson; Nathan Joseph,21,0,22,1
1653303473995,MAE 3,A02,090345,Delson; Nathan Joseph,20,0,22,2
1653303473995,MAE 3,A03,090346,Delson; Nathan Joseph,21,0,22,1
1653303473995,MAE 3,A04,090347,Delson; Nathan Joseph,22,0,22,0
1653303473995,MAE 3,B01,090349,Qi; Huihui,18,0,22,4
1653303473995,MAE 3,B02,090350,Qi; Huihui,17,0,22,5
1653303473995,MAE 3,B03,090351,Qi; Huihui,20,0,22,2
1653303473995,MAE 3,B04,090352,Qi; Huihui,19,0,22,3
1653303474520,MAE 8,A01,090354,Pham; Hieu Tan,182,0,185,3
1653303475046,MAE 11,A00,090355,Nomura; Keiko K.,155,0,165,10
1653303475577,MAE 20,A00,090356,Bandaru; Prabhakar,160,0,160,0
1653303475577,MAE 20,B00,090357,Evdokimenko; Ekaterina,145,0,160,15
1653303476104,MAE 21,A01,090359,Cai; Shengqiang,8,0,9,1
1653303476104,MAE 21,A02,090360,Cai; Shengqiang,9,0,9,0
1653303476104,MAE 21,A03,090361,Cai; Shengqiang,6,0,9,3
1653303476104,MAE 21,A04,090362,Cai; Shengqiang,7,0,9,2
1653303476104,MAE 21,A05,090363,Cai; Shengqiang,0,0,0,0
1653303476104,MAE 21,A06,090364,Cai; Shengqiang,9,0,9,0
1653303476104,MAE 21,A07,090365,Cai; Shengqiang,9,0,9,0
1653303476104,MAE 21,A08,090366,Cai; Shengqiang,8,0,9,1
1653303476104,MAE 21,A09,090367,Cai; Shengqiang,8,0,9,1
1653303476104,MAE 21,A10,090368,Cai; Shengqiang,0,0,0,0
1653303476104,MAE 21,A11,090369,Cai; Shengqiang,9,0,9,0
1653303476104,MAE 21,A12,090370,Cai; Shengqiang,8,0,9,1
1653303476641,MAE 30A,A00,090371,Lal; Ratnesh,72,0,75,3
1653303477164,MAE 40,A00,090372,Bitmead; Robert R.,167,0,175,8
1653303477689,MAE 101A,A00,090373,Bahadori; Mohammad Yousef,105,0,115,10
1653303478215,MAE 101C,A00,090374,Poulikakos; Lisa Voula,41,0,110,69
1653303478215,MAE 101C,B00,090375,Chen; Renkun,96,0,110,14
1653303478740,MAE 104,A00,090376,Sanchez; Antonio Luis,78,0,120,42
1653303479263,MAE 105,A00,090377,Saintillan; David,154,0,170,16
1653303479788,MAE 107,A00,090378,Lindsey; Stephanie,104,0,110,6
1653303479788,MAE 107,B00,090379,Tolley; Michael Thomas,85,0,110,25
1653303480313,MAE 118,A00,090380,Krasheninnikov; Sergei,27,0,45,18
1653303480837,MAE 131A,A00,090381,Ghazinejad; Maziar,70,0,75,5
1653303481361,MAE 133,A00,090382,Frazier; Michael,26,0,33,7
1653303481885,MAE 143A,A00,090383,de Oliveira; Mauricio,74,0,100,26
1653303482414,MAE 144,A00,090384,Bewley; Thomas R,50,0,70,20
1653303482942,MAE 148,A01,091597,Staff,32,0,32,0
1653303483469,MAE 150,A00,090385,Friend; James Robert,69,0,90,21
1653303483469,MAE 150,B00,090386,Ghazinejad; Maziar,4,0,90,86
1653303483990,MAE 152,A00,090387,Tynan; George Robert,0,0,16,16
1653303483990,MAE 152,B00,090388,Tynan; George Robert,0,0,16,16
1653303483990,MAE 152,C00,090389,Tynan; George Robert,0,0,16,16
1653303483990,MAE 152,D00,090390,Tynan; George Robert,0,0,16,16
1653303484520,MAE 156A,A01,090392,Delson; Nathan Joseph,2,0,12,10
1653303484520,MAE 156A,A02,090393,Delson; Nathan Joseph,1,0,12,11
1653303484520,MAE 156A,A03,090394,Delson; Nathan Joseph,4,0,12,8
1653303485050,MAE 170,A01,090396,Lubarda; Marko,14,0,30,16
1653303485050,MAE 170,A02,090397,Lubarda; Marko,19,0,30,11
1653303485050,MAE 170,A03,090398,Lubarda; Marko,28,0,30,2
1653303485050,MAE 170,A04,090399,Lubarda; Marko,20,0,30,10
1653303485050,MAE 170,B01,090401,Diagne; Mamadou Lamine,30,0,30,0
1653303485050,MAE 170,B02,090402,Diagne; Mamadou Lamine,27,0,30,3
1653303485050,MAE 170,B03,090403,Diagne; Mamadou Lamine,28,0,30,2
1653303485050,MAE 170,B04,090404,Diagne; Mamadou Lamine,28,0,30,2
1653303485576,MAE 180A,A00,090405,McEneaney; William Michael,110,0,125,15
1653303486099,MAE 181,A00,090406,Bahadori; Mohammad Yousef,46,0,60,14
1653303486624,MAE 190,A00,090407,Anderson; Mark Ronald,27,0,45,18
1653303487155,MAE 191,A01,090409,Qi; Huihui,25,0,32,7
1653303487778,MATH 2,A01,089123,Hammock; Frances H,0,0,0,0
1653303487778,MATH 2,B01,089126,Hammock; Frances H,0,0,0,0
1653303487778,MATH 2,C01,089129,Hammock; Frances H,0,0,0,0
1653303487778,MATH 2,D01,094201,Harel; Guershon,0,0,0,0
1653303488310,MATH 3C,A01,089132,Bowers; Adam R.,0,0,0,0
1653303488310,MATH 3C,A02,089133,Bowers; Adam R.,0,0,0,0
1653303488310,MATH 3C,A03,089134,Bowers; Adam R.,0,0,0,0
1653303488310,MATH 3C,A04,089135,Bowers; Adam R.,0,0,0,0
1653303488310,MATH 3C,A05,089136,Bowers; Adam R.,0,0,0,0
1653303488310,MATH 3C,A06,089137,Bowers; Adam R.,0,0,0,0
1653303488310,MATH 3C,A07,089138,Bowers; Adam R.,0,0,0,0
1653303488310,MATH 3C,A08,089139,Bowers; Adam R.,0,0,0,0
1653303488310,MATH 3C,A09,089140,Bowers; Adam R.,0,0,0,0
1653303488310,MATH 3C,A10,089141,Bowers; Adam R.,0,0,0,0
1653303488310,MATH 3C,A11,089142,Bowers; Adam R.,0,0,0,0
1653303488310,MATH 3C,A12,089143,Bowers; Adam R.,0,0,0,0
1653303488310,MATH 3C,A13,089144,Bowers; Adam R.,0,0,0,0
1653303488310,MATH 3C,A14,089145,Bowers; Adam R.,0,0,0,0
1653303488310,MATH 3C,A15,089146,Bowers; Adam R.,0,0,0,0
1653303488310,MATH 3C,A16,089147,Bowers; Adam R.,0,0,0,0
1653303488310,MATH 3C,A17,089148,Bowers; Adam R.,0,0,0,0
1653303488310,MATH 3C,A18,089149,Bowers; Adam R.,0,0,0,0
1653303488310,MATH 3C,A19,089150,Bowers; Adam R.,0,0,0,0
1653303488310,MATH 3C,A20,089151,Bowers; Adam R.,0,0,0,0
1653303488310,MATH 3C,A21,089152,Bowers; Adam R.,0,0,0,0
1653303488310,MATH 3C,A22,089153,Bowers; Adam R.,0,0,0,0
1653303488310,MATH 3C,A23,089154,Bowers; Adam R.,0,0,0,0
1653303488310,MATH 3C,A24,089155,Bowers; Adam R.,0,0,0,0
1653303488310,MATH 3C,B01,089158,Staff,0,0,0,0
1653303488310,MATH 3C,B02,089159,Staff,0,0,0,0
1653303488310,MATH 3C,B03,089160,Staff,0,0,0,0
1653303488310,MATH 3C,B04,089161,Staff,0,0,0,0
1653303488310,MATH 3C,C01,094244,Staff,0,0,0,0
1653303488310,MATH 3C,C02,094245,Staff,0,0,0,0
1653303488310,MATH 3C,C03,094246,Staff,0,0,0,0
1653303488310,MATH 3C,C04,094247,Staff,0,0,0,0
1653303488847,MATH 4C,A01,089164,Staff,0,0,0,0
1653303488847,MATH 4C,A02,089165,Staff,0,0,0,0
1653303488847,MATH 4C,A03,089166,Staff,0,0,0,0
1653303488847,MATH 4C,B01,089169,Ganzberger; Geoffrey Michael,0,0,0,0
1653303488847,MATH 4C,B02,089170,Ganzberger; Geoffrey Michael,0,0,0,0
1653303488847,MATH 4C,B03,089171,Ganzberger; Geoffrey Michael,0,0,0,0
1653303488847,MATH 4C,C01,089174,Ganzberger; Geoffrey Michael,0,0,0,0
1653303488847,MATH 4C,C02,089175,Ganzberger; Geoffrey Michael,0,0,0,0
1653303488847,MATH 4C,C03,089176,Ganzberger; Geoffrey Michael,0,0,0,0
1653303488847,MATH 4C,D01,094249,Ganzberger; Geoffrey Michael,0,0,0,0
1653303488847,MATH 4C,D02,094250,Ganzberger; Geoffrey Michael,0,0,0,0
1653303488847,MATH 4C,D03,094251,Ganzberger; Geoffrey Michael,0,0,0,0
1653303489395,MATH 10A,A01,089179,Jin; Muzhi,5,0,5,0
1653303489395,MATH 10A,A02,089180,Jin; Muzhi,5,0,5,0
1653303489395,MATH 10A,A03,089181,Jin; Muzhi,4,0,5,1
1653303489395,MATH 10A,A04,089182,Jin; Muzhi,4,0,5,1
1653303489395,MATH 10A,A05,089183,Jin; Muzhi,5,0,5,0
1653303489395,MATH 10A,A06,089184,Jin; Muzhi,5,0,5,0
1653303489395,MATH 10A,A07,089185,Jin; Muzhi,5,0,5,0
1653303489395,MATH 10A,A08,089186,Jin; Muzhi,5,0,5,0
1653303489395,MATH 10A,B01,089188,Stevens; Laura Jeanne,1,0,5,4
1653303489395,MATH 10A,B02,089189,Stevens; Laura Jeanne,4,0,5,1
1653303489395,MATH 10A,B03,089190,Stevens; Laura Jeanne,4,0,5,1
1653303489395,MATH 10A,B04,089191,Stevens; Laura Jeanne,5,0,5,0
1653303489395,MATH 10A,B05,089192,Stevens; Laura Jeanne,4,0,5,1
1653303489395,MATH 10A,B06,089193,Stevens; Laura Jeanne,5,0,5,0
1653303489395,MATH 10A,B07,089194,Stevens; Laura Jeanne,5,0,5,0
1653303489395,MATH 10A,B08,089195,Stevens; Laura Jeanne,4,0,5,1
1653303489395,MATH 10A,C01,089197,Jin; Muzhi,1,0,5,4
1653303489395,MATH 10A,C02,089198,Jin; Muzhi,5,0,5,0
1653303489395,MATH 10A,C03,089199,Jin; Muzhi,5,0,5,0
1653303489395,MATH 10A,C04,089200,Jin; Muzhi,5,0,5,0
1653303489395,MATH 10A,C05,089201,Jin; Muzhi,5,0,5,0
1653303489395,MATH 10A,C06,089202,Jin; Muzhi,5,0,5,0
1653303489395,MATH 10A,D01,089204,Upton; James Thomas,4,0,5,1
1653303489395,MATH 10A,D02,089205,Upton; James Thomas,5,0,5,0
1653303489395,MATH 10A,D03,089206,Upton; James Thomas,5,0,5,0
1653303489395,MATH 10A,D04,089207,Upton; James Thomas,5,0,5,0
1653303489395,MATH 10A,E01,089211,Greenfeld; Be'Eri,5,0,5,0
1653303489395,MATH 10A,E02,089212,Greenfeld; Be'Eri,3,0,5,2
1653303489395,MATH 10A,E03,089213,Greenfeld; Be'Eri,4,0,5,1
1653303489395,MATH 10A,E04,089214,Greenfeld; Be'Eri,5,0,5,0
1653303489395,MATH 10A,E05,089215,Greenfeld; Be'Eri,5,0,5,0
1653303489395,MATH 10A,E06,089216,Greenfeld; Be'Eri,5,0,5,0
1653303489924,MATH 10B,A01,089218,Stevens; Laura Jeanne,7,0,8,1
1653303489924,MATH 10B,A02,089219,Stevens; Laura Jeanne,7,0,8,1
1653303489924,MATH 10B,A03,089220,Stevens; Laura Jeanne,8,0,8,0
1653303489924,MATH 10B,A04,089221,Stevens; Laura Jeanne,6,0,8,2
1653303489924,MATH 10B,A05,089222,Stevens; Laura Jeanne,2,0,8,6
1653303489924,MATH 10B,A06,089223,Stevens; Laura Jeanne,0,0,8,8
1653303489924,MATH 10B,A07,089224,Stevens; Laura Jeanne,6,0,8,2
1653303489924,MATH 10B,A08,089225,Stevens; Laura Jeanne,4,0,8,4
1653303489924,MATH 10B,B01,089227,Staff,8,0,8,0
1653303489924,MATH 10B,B02,089228,Staff,8,0,8,0
1653303489924,MATH 10B,B03,089229,Staff,7,0,8,1
1653303489924,MATH 10B,B04,089230,Staff,8,0,8,0
1653303489924,MATH 10B,B05,089231,Staff,8,0,8,0
1653303489924,MATH 10B,B06,089232,Staff,8,0,8,0
1653303489924,MATH 10B,B07,089233,Staff,8,0,8,0
1653303489924,MATH 10B,B08,089234,Staff,8,0,8,0
1653303489924,MATH 10B,C01,089236,McKinley; Gweneth Anne,4,0,8,4
1653303489924,MATH 10B,C02,089237,McKinley; Gweneth Anne,8,0,8,0
1653303489924,MATH 10B,C03,089238,McKinley; Gweneth Anne,8,0,8,0
1653303489924,MATH 10B,C04,089239,McKinley; Gweneth Anne,8,0,8,0
1653303489924,MATH 10B,C05,089240,McKinley; Gweneth Anne,8,0,8,0
1653303489924,MATH 10B,C06,089241,McKinley; Gweneth Anne,8,0,8,0
1653303490458,MATH 10C,A01,089243,Staff,13,0,20,7
1653303490458,MATH 10C,A02,089244,Staff,20,0,20,0
1653303490458,MATH 10C,A03,089245,Staff,18,0,20,2
1653303490458,MATH 10C,A04,089246,Staff,20,0,20,0
1653303490458,MATH 10C,A05,089247,Staff,19,0,20,1
1653303490458,MATH 10C,A06,089248,Staff,20,0,20,0
1653303490458,MATH 10C,A07,094505,Staff,20,0,20,0
1653303490458,MATH 10C,A08,094506,Staff,20,0,20,0
1653303490458,MATH 10C,B01,089250,Staff,19,0,20,1
1653303490458,MATH 10C,B02,089251,Staff,19,0,20,1
1653303490458,MATH 10C,B03,089252,Staff,14,0,20,6
1653303490458,MATH 10C,B04,089253,Staff,20,0,20,0
1653303490458,MATH 10C,B05,089254,Staff,20,0,20,0
1653303490458,MATH 10C,B06,089255,Staff,18,0,20,2
1653303490986,MATH 11,A01,089258,Rava; Denise,1,0,15,14
1653303490986,MATH 11,A02,089260,Rava; Denise,9,0,15,6
1653303490986,MATH 11,A03,089263,Rava; Denise,10,0,15,5
1653303490986,MATH 11,A04,089265,Rava; Denise,13,0,15,2
1653303490986,MATH 11,A05,089267,Rava; Denise,10,0,15,5
1653303490986,MATH 11,A06,089269,Rava; Denise,14,0,15,1
1653303490986,MATH 11,A07,089271,Rava; Denise,14,0,15,1
1653303490986,MATH 11,A08,089273,Rava; Denise,13,0,15,2
1653303490986,MATH 11,B01,089279,Staff,4,0,15,11
1653303490986,MATH 11,B02,089281,Staff,14,0,15,1
1653303490986,MATH 11,B03,089283,Staff,14,0,15,1
1653303490986,MATH 11,B04,089284,Staff,15,0,15,0
1653303490986,MATH 11,B05,089286,Staff,14,0,15,1
1653303490986,MATH 11,B06,089288,Staff,15,0,15,0
1653303490986,MATH 11,B07,089289,Staff,14,0,15,1
1653303490986,MATH 11,B08,089290,Staff,14,0,15,1
1653303491517,MATH 18,A01,089303,Anzaldo; Leesa B,5,0,10,5
1653303491517,MATH 18,A02,089304,Anzaldo; Leesa B,6,0,10,4
1653303491517,MATH 18,A03,089305,Anzaldo; Leesa B,10,0,10,0
1653303491517,MATH 18,A04,089306,Anzaldo; Leesa B,8,0,10,2
1653303491517,MATH 18,A05,089307,Anzaldo; Leesa B,10,0,10,0
1653303491517,MATH 18,A06,089308,Anzaldo; Leesa B,9,0,10,1
1653303491517,MATH 18,A07,089309,Anzaldo; Leesa B,10,0,10,0
1653303491517,MATH 18,A08,089310,Anzaldo; Leesa B,10,0,10,0
1653303491517,MATH 18,A09,089311,Anzaldo; Leesa B,10,0,10,0
1653303491517,MATH 18,A10,089312,Anzaldo; Leesa B,10,0,10,0
1653303491517,MATH 18,A11,089313,Anzaldo; Leesa B,9,0,10,1
1653303491517,MATH 18,A12,089314,Anzaldo; Leesa B,10,0,10,0
1653303491517,MATH 18,A13,089315,Anzaldo; Leesa B,9,0,10,1
1653303491517,MATH 18,A14,089316,Anzaldo; Leesa B,10,0,10,0
1653303491517,MATH 18,A15,089317,Anzaldo; Leesa B,9,0,10,1
1653303491517,MATH 18,A16,089318,Anzaldo; Leesa B,10,0,10,0
1653303491517,MATH 18,A17,089319,Anzaldo; Leesa B,9,0,10,1
1653303491517,MATH 18,A18,089320,Anzaldo; Leesa B,10,0,10,0
1653303491517,MATH 18,A19,089321,Anzaldo; Leesa B,0,0,0,0
1653303491517,MATH 18,A20,089322,Anzaldo; Leesa B,0,0,0,0
1653303491517,MATH 18,A21,089323,Anzaldo; Leesa B,9,0,10,1
1653303491517,MATH 18,A22,089324,Anzaldo; Leesa B,7,0,10,3
1653303491517,MATH 18,A23,089325,Anzaldo; Leesa B,10,0,10,0
1653303491517,MATH 18,A24,089326,Anzaldo; Leesa B,9,0,10,1
1653303491517,MATH 18,B01,089329,Staff,13,0,13,0
1653303491517,MATH 18,B02,089330,Staff,12,0,13,1
1653303491517,MATH 18,B03,089331,Staff,12,0,13,1
1653303491517,MATH 18,B04,089332,Staff,13,0,13,0
1653303491517,MATH 18,B05,089333,Staff,12,0,13,1
1653303491517,MATH 18,C01,089336,Staff,13,0,13,0
1653303491517,MATH 18,C02,089337,Staff,11,0,13,2
1653303491517,MATH 18,C03,089338,Staff,0,0,0,0
1653303491517,MATH 18,C04,089339,Staff,0,0,0,0
1653303491517,MATH 18,C05,089340,Staff,0,0,0,1
1653303491517,MATH 18,D01,094194,Staff,0,0,0,0
1653303491517,MATH 18,D02,094195,Staff,0,0,0,0
1653303491517,MATH 18,D03,094196,Staff,0,0,0,0
1653303491517,MATH 18,D04,094197,Staff,0,0,0,0
1653303491517,MATH 18,D05,094198,Staff,0,0,0,0
1653303492055,MATH 20A,A01,089343,Staff,5,0,5,0
1653303492055,MATH 20A,A02,089344,Staff,5,0,5,0
1653303492055,MATH 20A,A03,089345,Staff,5,0,5,0
1653303492055,MATH 20A,B01,089347,Suk; Andrew Hoon,2,0,3,1
1653303492055,MATH 20A,B02,089348,Suk; Andrew Hoon,3,0,3,0
1653303492055,MATH 20A,B03,089349,Suk; Andrew Hoon,3,0,3,0
1653303492055,MATH 20A,B04,089350,Suk; Andrew Hoon,3,0,3,0
1653303492055,MATH 20A,B05,089351,Suk; Andrew Hoon,3,0,3,0
1653303492055,MATH 20A,B06,089352,Suk; Andrew Hoon,2,0,3,1
1653303492055,MATH 20A,B07,089353,Suk; Andrew Hoon,3,0,3,0
1653303492055,MATH 20A,B08,089354,Suk; Andrew Hoon,3,0,3,0
1653303492055,MATH 20A,B09,089355,Suk; Andrew Hoon,3,0,3,0
1653303492055,MATH 20A,B10,089356,Suk; Andrew Hoon,3,0,3,0
1653303492055,MATH 20A,B11,089357,Suk; Andrew Hoon,3,0,3,0
1653303492055,MATH 20A,B12,089358,Suk; Andrew Hoon,3,0,3,0
1653303492055,MATH 20A,B13,089359,Suk; Andrew Hoon,2,0,3,1
1653303492055,MATH 20A,B14,089360,Suk; Andrew Hoon,3,0,3,0
1653303492055,MATH 20A,B15,089361,Suk; Andrew Hoon,3,0,3,0
1653303492055,MATH 20A,B16,089362,Suk; Andrew Hoon,3,0,3,0
1653303492055,MATH 20A,B17,089363,Suk; Andrew Hoon,3,0,3,0
1653303492055,MATH 20A,B18,089364,Suk; Andrew Hoon,0,0,0,0
1653303492055,MATH 20A,B19,089365,Suk; Andrew Hoon,3,0,3,0
1653303492055,MATH 20A,B20,089366,Suk; Andrew Hoon,3,0,3,0
1653303492055,MATH 20A,B21,089367,Suk; Andrew Hoon,3,0,3,0
1653303492055,MATH 20A,B22,089368,Suk; Andrew Hoon,3,0,3,0
1653303492055,MATH 20A,B23,089369,Suk; Andrew Hoon,3,0,3,0
1653303492055,MATH 20A,B24,089370,Suk; Andrew Hoon,3,0,3,0
1653303492584,MATH 20B,A01,089372,Quarfoot; David James,8,0,8,0
1653303492584,MATH 20B,A02,089373,Quarfoot; David James,8,0,8,0
1653303492584,MATH 20B,A03,089374,Quarfoot; David James,7,0,8,1
1653303492584,MATH 20B,A04,089375,Quarfoot; David James,7,0,8,1
1653303492584,MATH 20B,A05,089376,Quarfoot; David James,0,0,0,0
1653303492584,MATH 20B,A06,089377,Quarfoot; David James,0,0,0,0
1653303492584,MATH 20B,A07,089378,Quarfoot; David James,0,0,0,0
1653303492584,MATH 20B,A08,089379,Quarfoot; David James,0,0,0,0
1653303492584,MATH 20B,A09,089380,Quarfoot; David James,0,0,0,0
1653303492584,MATH 20B,A10,089381,Quarfoot; David James,0,0,0,0
1653303492584,MATH 20B,A11,089382,Quarfoot; David James,0,0,0,0
1653303492584,MATH 20B,A12,089383,Quarfoot; David James,0,0,0,0
1653303492584,MATH 20B,A13,089384,Quarfoot; David James,0,0,0,0
1653303492584,MATH 20B,A14,089385,Quarfoot; David James,0,0,0,0
1653303492584,MATH 20B,A15,089386,Quarfoot; David James,0,0,0,0
1653303492584,MATH 20B,A16,089387,Quarfoot; David James,0,0,0,0
1653303492584,MATH 20B,A17,089388,Quarfoot; David James,8,0,8,0
1653303492584,MATH 20B,A18,089389,Quarfoot; David James,8,0,8,0
1653303492584,MATH 20B,A19,089390,Quarfoot; David James,8,0,8,0
1653303492584,MATH 20B,A20,089391,Quarfoot; David James,8,0,8,0
1653303492584,MATH 20B,A21,089392,Quarfoot; David James,8,0,8,0
1653303492584,MATH 20B,A22,089393,Quarfoot; David James,7,0,8,1
1653303492584,MATH 20B,A23,089394,Quarfoot; David James,7,0,8,1
1653303492584,MATH 20B,A24,089395,Quarfoot; David James,8,0,8,0
1653303492584,MATH 20B,B01,089397,Lahiri; Aranya,7,0,10,3
1653303492584,MATH 20B,B02,089398,Lahiri; Aranya,10,0,10,0
1653303492584,MATH 20B,B03,089399,Lahiri; Aranya,10,0,10,0
1653303492584,MATH 20B,B04,089400,Lahiri; Aranya,10,0,10,0
1653303492584,MATH 20B,B05,089401,Lahiri; Aranya,10,0,10,0
1653303492584,MATH 20B,C01,089403,Lahiri; Aranya,0,0,0,0
1653303492584,MATH 20B,C02,089404,Lahiri; Aranya,8,0,10,2
1653303492584,MATH 20B,C03,089405,Lahiri; Aranya,10,0,10,0
1653303492584,MATH 20B,C04,089406,Lahiri; Aranya,9,0,10,1
1653303492584,MATH 20B,C05,089407,Lahiri; Aranya,9,0,10,1
1653303493118,MATH 20C,A01,089409,Um; Ko Woon,10,0,10,0
1653303493118,MATH 20C,A02,089410,Um; Ko Woon,10,0,10,0
1653303493118,MATH 20C,A03,089411,Um; Ko Woon,9,0,10,1
1653303493118,MATH 20C,A04,089412,Um; Ko Woon,9,0,10,1
1653303493118,MATH 20C,A05,089413,Um; Ko Woon,10,0,10,0
1653303493118,MATH 20C,A06,089414,Um; Ko Woon,9,0,10,1
1653303493118,MATH 20C,A07,094270,Um; Ko Woon,10,0,10,0
1653303493118,MATH 20C,A08,094271,Um; Ko Woon,10,0,10,0
1653303493118,MATH 20C,A09,094272,Um; Ko Woon,7,0,10,3
1653303493118,MATH 20C,A10,094273,Um; Ko Woon,10,0,10,0
1653303493118,MATH 20C,A11,094274,Um; Ko Woon,10,0,10,0
1653303493118,MATH 20C,A12,094275,Um; Ko Woon,8,0,10,2
1653303493118,MATH 20C,A13,094276,Um; Ko Woon,10,0,10,0
1653303493118,MATH 20C,A14,094277,Um; Ko Woon,10,0,10,0
1653303493118,MATH 20C,A15,094278,Um; Ko Woon,10,0,10,0
1653303493118,MATH 20C,A16,094279,Um; Ko Woon,10,0,10,0
1653303493118,MATH 20C,B03,089418,Zhang; Ming,7,0,15,8
1653303493118,MATH 20C,B04,089419,Zhang; Ming,13,0,15,2
1653303493118,MATH 20C,B05,089420,Zhang; Ming,13,0,15,2
1653303493118,MATH 20C,C01,089423,Staff,15,0,15,0
1653303493118,MATH 20C,C02,089424,Staff,15,0,15,0
1653303493118,MATH 20C,C03,089425,Staff,15,0,15,0
1653303493118,MATH 20C,C04,089426,Staff,15,0,15,0
1653303493118,MATH 20C,C05,089427,Staff,15,0,15,0
1653303493118,MATH 20C,D04,089433,Zhang; Ming,13,0,15,2
1653303493118,MATH 20C,D05,089434,Zhang; Ming,15,0,15,0
1653303493118,MATH 20C,E01,089439,Staff,15,0,15,0
1653303493118,MATH 20C,E02,089440,Staff,15,0,15,0
1653303493118,MATH 20C,E03,089441,Staff,15,0,15,0
1653303493118,MATH 20C,E04,089442,Staff,15,0,15,0
1653303493118,MATH 20C,E05,089443,Staff,15,0,15,0
1653303493118,MATH 20C,E06,089444,Staff,15,0,15,0
1653303493118,MATH 20C,A17,094280,Um; Ko Woon,0,0,0,0
1653303493118,MATH 20C,A18,094281,Um; Ko Woon,0,0,0,0
1653303493118,MATH 20C,A19,094282,Um; Ko Woon,0,0,0,0
1653303493118,MATH 20C,A20,094283,Um; Ko Woon,0,0,0,0
1653303493118,MATH 20C,A21,094284,Um; Ko Woon,0,0,0,0
1653303493118,MATH 20C,A22,094285,Um; Ko Woon,0,0,0,0
1653303493118,MATH 20C,A23,094286,Um; Ko Woon,0,0,0,0
1653303493118,MATH 20C,A24,094287,Um; Ko Woon,0,0,0,0
1653303493118,MATH 20C,B01,089416,Zhang; Ming,0,0,0,0
1653303493118,MATH 20C,B02,089417,Zhang; Ming,0,0,0,0
1653303493118,MATH 20C,D01,089430,Zhang; Ming,0,0,0,0
1653303493118,MATH 20C,D02,089431,Zhang; Ming,0,0,0,0
1653303493118,MATH 20C,D03,089432,Zhang; Ming,0,0,0,0
1653303493644,MATH 20D,A01,089455,Lee; Kisun,11,0,25,14
1653303493644,MATH 20D,A02,089456,Lee; Kisun,24,0,25,1
1653303493644,MATH 20D,A03,089457,Lee; Kisun,24,0,25,1
1653303493644,MATH 20D,A04,089458,Lee; Kisun,25,0,25,0
1653303493644,MATH 20D,A05,089459,Lee; Kisun,25,0,25,0
1653303493644,MATH 20D,A06,089460,Lee; Kisun,25,0,25,0
1653303493644,MATH 20D,B01,089463,Lee; Kisun,20,0,25,5
1653303493644,MATH 20D,B02,089464,Lee; Kisun,25,0,25,0
1653303493644,MATH 20D,B03,089465,Lee; Kisun,24,0,25,1
1653303493644,MATH 20D,B04,089466,Lee; Kisun,25,0,25,0
1653303493644,MATH 20D,B05,089467,Lee; Kisun,23,0,25,2
1653303493644,MATH 20D,B06,089468,Lee; Kisun,24,0,25,1
1653303493644,MATH 20D,C01,089471,Staff,23,0,25,2
1653303493644,MATH 20D,C02,089472,Staff,25,0,25,0
1653303493644,MATH 20D,C03,089473,Staff,25,0,25,0
1653303493644,MATH 20D,C04,089474,Staff,25,0,25,0
1653303493644,MATH 20D,C05,089475,Staff,25,0,25,0
1653303493644,MATH 20D,C06,089476,Staff,25,0,25,0
1653303494178,MATH 20E,A01,089479,Eggers; John Dietrich,17,0,24,7
1653303494178,MATH 20E,A02,089480,Eggers; John Dietrich,24,0,25,1
1653303494178,MATH 20E,A03,089481,Eggers; John Dietrich,25,0,25,0
1653303494178,MATH 20E,A04,089482,Eggers; John Dietrich,25,0,25,0
1653303494178,MATH 20E,A05,089483,Eggers; John Dietrich,19,0,25,6
1653303494178,MATH 20E,A06,089484,Eggers; John Dietrich,25,0,25,0
1653303494178,MATH 20E,A07,089485,Eggers; John Dietrich,24,0,25,1
1653303494178,MATH 20E,A08,089486,Eggers; John Dietrich,24,0,25,1
1653303494178,MATH 20E,B01,089488,Staff,15,0,25,10
1653303494178,MATH 20E,B02,089489,Staff,21,0,25,4
1653303494178,MATH 20E,B03,089490,Staff,25,0,25,0
1653303494178,MATH 20E,B04,089491,Staff,25,0,25,0
1653303494178,MATH 20E,B05,089492,Staff,24,0,25,1
1653303494178,MATH 20E,B06,089493,Staff,24,0,25,1
1653303494178,MATH 20E,B07,089494,Staff,25,0,25,0
1653303494178,MATH 20E,B08,089495,Staff,25,0,25,0
1653303494178,MATH 20E,C01,089497,Staff,23,0,25,2
1653303494178,MATH 20E,C02,089498,Staff,25,0,25,0
1653303494178,MATH 20E,C03,089499,Staff,25,0,25,0
1653303494178,MATH 20E,C04,089500,Staff,25,0,25,0
1653303494178,MATH 20E,C05,089501,Staff,25,0,25,0
1653303494178,MATH 20E,C06,089502,Staff,25,0,25,0
1653303494178,MATH 20E,C07,089503,Staff,25,0,25,0
1653303494178,MATH 20E,C08,089504,Staff,25,0,25,0
1653303494707,MATH 31AH,A01,089506,Rabin; Jeffrey Mark,35,0,35,0
1653303494707,MATH 31AH,A02,089507,Rabin; Jeffrey Mark,35,0,35,0
1653303495230,MATH 87,A00,094827,Meyer; David A.,20,0,20,0
1653303495754,MATH 96,A00,094836,Kane; Daniel Mertz,11,0,30,19
1653303496286,MATH 100A,A01,089509,Kedlaya; Kiran S.,23,0,30,7
1653303496286,MATH 100A,A02,089510,Kedlaya; Kiran S.,28,0,30,2
1653303496286,MATH 100A,B01,089512,Greenfeld; Be'Eri,24,0,30,6
1653303496286,MATH 100A,B02,089513,Greenfeld; Be'Eri,30,0,30,0
1653303496811,MATH 102,A01,089515,Hodges; Reuven Moses,25,0,30,5
1653303496811,MATH 102,A02,089516,Hodges; Reuven Moses,30,0,30,0
1653303496811,MATH 102,A03,089517,Hodges; Reuven Moses,30,0,30,0
1653303496811,MATH 102,A04,089518,Hodges; Reuven Moses,29,0,30,1
1653303496811,MATH 102,B01,089520,Hodges; Reuven Moses,29,0,30,1
1653303496811,MATH 102,B02,089521,Hodges; Reuven Moses,29,0,30,1
1653303496811,MATH 102,B03,089522,Hodges; Reuven Moses,29,0,30,1
1653303496811,MATH 102,B04,089523,Hodges; Reuven Moses,30,0,30,0
1653303497344,MATH 103A,A01,089525,Staff,27,0,30,3
1653303497344,MATH 103A,A02,089526,Staff,30,0,30,0
1653303497344,MATH 103A,B01,089528,Seward; Brandon M.,9,0,30,21
1653303497344,MATH 103A,B02,089529,Seward; Brandon M.,22,0,30,8
1653303497344,MATH 103A,C01,089531,Staff,27,0,30,3
1653303497344,MATH 103A,C02,089532,Staff,28,0,30,2
1653303497344,MATH 103A,D01,089534,Staff,28,0,30,2
1653303497344,MATH 103A,D02,089535,Staff,28,0,30,2
1653303497873,MATH 109,A01,089537,Chung; Kwun,9,0,10,1
1653303497873,MATH 109,A02,089538,Chung; Kwun,10,0,10,0
1653303497873,MATH 109,B01,089540,Belmont; Eva Kinoshita,9,0,10,1
1653303497873,MATH 109,B02,089541,Belmont; Eva Kinoshita,6,0,10,4
1653303497873,MATH 109,C01,089543,Chow; Bennett,8,0,10,2
1653303497873,MATH 109,C02,089544,Chow; Bennett,10,0,10,0
1653303497873,MATH 109,D01,089546,Chung; Kwun,9,0,10,1
1653303497873,MATH 109,D02,089547,Chung; Kwun,9,0,10,1
1653303497873,MATH 109,E01,089549,Schweinsberg; Jason,6,0,10,4
1653303497873,MATH 109,E02,089550,Schweinsberg; Jason,10,0,10,0
1653303498401,MATH 110,A01,089552,Wenzl; Hans G,27,0,35,8
1653303498401,MATH 110,A02,089553,Wenzl; Hans G,33,0,35,2
1653303498926,MATH 111A,A01,089555,Meyer; David A.,0,0,0,1
1653303499457,MATH 120A,A01,089557,Manners; Frederick,30,0,35,5
1653303499457,MATH 120A,A02,089558,Manners; Frederick,33,0,35,2
1653303499982,MATH 140A,A01,089560,Seward; Brandon M.,25,0,30,5
1653303499982,MATH 140A,A02,089561,Seward; Brandon M.,29,0,30,1
1653303499982,MATH 140A,B01,089563,Chan; Pak Yeung,30,0,30,0
1653303499982,MATH 140A,B02,089564,Chan; Pak Yeung,22,0,30,8
1653303500507,MATH 142A,A01,089566,Staff,29,0,30,1
1653303500507,MATH 142A,A02,089567,Staff,29,0,30,1
1653303500507,MATH 142A,B01,089569,Staff,30,0,30,0
1653303500507,MATH 142A,B02,089570,Staff,29,0,30,1
1653303500507,MATH 142A,C01,089572,Staff,26,0,30,4
1653303500507,MATH 142A,C02,089573,Staff,29,0,30,1
1653303500507,MATH 142A,D01,089575,Eggers; John Dietrich,15,0,30,15
1653303500507,MATH 142A,D02,089576,Eggers; John Dietrich,27,0,30,3
1653303501030,MATH 144,A01,089578,Bejenaru; Ioan,29,0,30,1
1653303501554,MATH 150A,A01,089580,Chow; Bennett,29,0,35,6
1653303501554,MATH 150A,A02,089581,Chow; Bennett,34,0,35,1
1653303502610,MATH 153,A01,094204,Harel; Guershon,33,0,35,2
1653303503141,MATH 154,A01,089590,Verstraete; Jacques Allan,3,0,30,27
1653303503141,MATH 154,A02,089591,Verstraete; Jacques Allan,23,0,30,7
1653303503141,MATH 154,A03,089592,Verstraete; Jacques Allan,28,0,30,2
1653303503141,MATH 154,A04,089593,Verstraete; Jacques Allan,26,0,30,4
1653303503688,MATH 155A,A01,089595,Buss; Samuel R,22,0,35,13
1653303503688,MATH 155A,A02,089596,Buss; Samuel R,32,0,35,3
1653303504211,MATH 160A,A01,089598,Manners; Frederick,28,0,35,7
1653303504211,MATH 160A,A02,094207,Manners; Frederick,34,0,35,1
1653303504738,MATH 170A,A01,089600,Liu; Shuang,24,0,25,1
1653303504738,MATH 170A,A02,089601,Liu; Shuang,24,0,25,1
1653303504738,MATH 170A,A03,089602,Liu; Shuang,24,0,25,1
1653303504738,MATH 170A,A04,089603,Liu; Shuang,23,0,25,2
1653303504738,MATH 170A,B01,089605,Dumitriu; Ioana,8,0,25,17
1653303504738,MATH 170A,B02,089606,Dumitriu; Ioana,20,0,25,5
1653303504738,MATH 170A,B03,089607,Dumitriu; Ioana,21,0,25,4
1653303504738,MATH 170A,B04,089608,Dumitriu; Ioana,25,0,25,0
1653303505266,MATH 173A,A01,089610,Cloninger; Alexander,0,0,35,35
1653303505266,MATH 173A,A02,089611,Cloninger; Alexander,2,0,35,33
1653303505266,MATH 173A,A03,089612,Cloninger; Alexander,20,0,35,15
1653303505790,MATH 174,A01,089614,Cheng; Li-Tien,23,0,25,2
1653303505790,MATH 174,A02,089615,Cheng; Li-Tien,25,0,25,0
1653303506335,MATH 180A,A01,089617,Jekel; David Andrew,0,0,25,25
1653303506335,MATH 180A,A02,089618,Jekel; David Andrew,23,0,25,2
1653303506335,MATH 180A,A03,089619,Jekel; David Andrew,22,0,25,3
1653303506335,MATH 180A,A04,089620,Jekel; David Andrew,22,0,25,3
1653303506335,MATH 180A,A05,089621,Jekel; David Andrew,24,0,25,1
1653303506335,MATH 180A,A06,089622,Jekel; David Andrew,23,0,25,2
1653303506335,MATH 180A,B01,089624,Agarwal; Pooja,23,0,25,2
1653303506335,MATH 180A,B02,089625,Agarwal; Pooja,24,0,25,1
1653303506335,MATH 180A,B03,089626,Agarwal; Pooja,22,0,25,3
1653303506335,MATH 180A,B04,089627,Agarwal; Pooja,25,0,25,0
1653303506335,MATH 180A,B05,089628,Agarwal; Pooja,24,0,25,1
1653303506335,MATH 180A,B06,089629,Agarwal; Pooja,25,0,25,0
1653303506335,MATH 180A,C01,089631,Staff,22,0,25,3
1653303506335,MATH 180A,C02,089632,Staff,25,0,25,0
1653303506335,MATH 180A,C03,089633,Staff,25,0,25,0
1653303506335,MATH 180A,C04,089634,Staff,25,0,25,0
1653303506860,MATH 180C,A01,089636,Fitzsimmons; Patrick J,4,0,25,21
1653303506860,MATH 180C,A02,089637,Fitzsimmons; Patrick J,21,0,25,4
1653303507394,MATH 181B,A01,089639,Rava; Denise,31,0,35,4
1653303507394,MATH 181B,A02,089640,Rava; Denise,34,0,35,1
1653303507394,MATH 181B,A03,089641,Rava; Denise,31,0,35,4
1653303507394,MATH 181B,A04,089642,Rava; Denise,35,0,35,0
1653303507919,MATH 183,A01,089644,Staff,10,0,25,15
1653303507919,MATH 183,A02,089645,Staff,23,0,25,2
1653303507919,MATH 183,A03,089646,Staff,23,0,25,2
1653303507919,MATH 183,A04,089647,Staff,25,0,25,0
1653303507919,MATH 183,A05,089648,Staff,19,0,25,6
1653303507919,MATH 183,A06,089649,Staff,22,0,25,3
1653303507919,MATH 183,A07,089650,Staff,25,0,25,0
1653303507919,MATH 183,A08,089651,Staff,25,0,25,0
1653303508449,MATH 184,A01,089653,Kane; Daniel Mertz,24,0,30,6
1653303508449,MATH 184,A02,089654,Kane; Daniel Mertz,30,0,30,0
1653303508449,MATH 184,A03,089655,Kane; Daniel Mertz,30,0,30,0
1653303508449,MATH 184,A04,089656,Kane; Daniel Mertz,30,0,30,0
1653303508979,MATH 187A,A01,089658,Bucur; Alina Ioana,0,0,25,25
1653303508979,MATH 187A,A02,089659,Bucur; Alina Ioana,12,0,25,13
1653303508979,MATH 187A,A03,089660,Bucur; Alina Ioana,0,0,25,25
1653303508979,MATH 187A,A04,089661,Bucur; Alina Ioana,17,0,25,8
1653303509507,MATH 187B,A01,089663,Bucur; Alina Ioana,28,0,35,7
1653303509507,MATH 187B,A02,089664,Bucur; Alina Ioana,34,0,35,1
1653303510032,MATH 188,A01,094817,Sam; Steven V,33,0,35,2
1653303510555,MATH 190A,A01,089666,Sam; Steven V,21,0,35,14
1653303511079,MATH 196,A00,089667,Spolaor; Luca,33,0,45,12
1653303511614,MCWP 40,004,093486,Wastal; Carrie King,0,0,3,3
1653303511614,MCWP 40,005,093487,Wastal; Carrie King,0,0,3,3
1653303511614,MCWP 40,006,093488,Wastal; Carrie King,3,0,3,0
1653303511614,MCWP 40,007,093489,Wastal; Carrie King,3,0,3,0
1653303511614,MCWP 40,008,093490,Wastal; Carrie King,2,0,3,1
1653303511614,MCWP 40,009,093491,Wastal; Carrie King,2,0,3,1
1653303511614,MCWP 40,013,093495,Wastal; Carrie King,3,0,3,0
1653303511614,MCWP 40,014,093496,Wastal; Carrie King,0,0,3,3
1653303511614,MCWP 40,015,093497,Wastal; Carrie King,3,0,3,0
1653303511614,MCWP 40,016,093498,Wastal; Carrie King,3,0,3,0
1653303511614,MCWP 40,017,093499,Wastal; Carrie King,3,0,3,0
1653303511614,MCWP 40,018,093500,Wastal; Carrie King,1,0,3,2
1653303511614,MCWP 40,020,093502,Wastal; Carrie King,0,0,0,0
1653303511614,MCWP 40,021,093503,Wastal; Carrie King,3,0,3,0
1653303511614,MCWP 40,022,093504,Wastal; Carrie King,2,0,3,1
1653303511614,MCWP 40,023,093505,Wastal; Carrie King,2,0,3,1
1653303511614,MCWP 40,024,093506,Wastal; Carrie King,2,0,3,1
1653303511614,MCWP 40,026,093508,Wastal; Carrie King,3,0,3,0
1653303511614,MCWP 40,027,093509,Wastal; Carrie King,3,0,3,0
1653303511614,MCWP 40,028,093510,Wastal; Carrie King,3,0,3,0
1653303511614,MCWP 40,029,093511,Wastal; Carrie King,3,0,3,0
1653303511614,MCWP 40,030,093512,Wastal; Carrie King,2,0,3,1
1653303511614,MCWP 40,032,093514,Wastal; Carrie King,2,0,3,1
1653303511614,MCWP 40,033,093515,Wastal; Carrie King,3,0,3,0
1653303511614,MCWP 40,034,093516,Wastal; Carrie King,3,0,3,0
1653303511614,MCWP 40,035,093517,Wastal; Carrie King,3,0,3,0
1653303511614,MCWP 40,038,093520,Wastal; Carrie King,2,0,3,1
1653303511614,MCWP 40,039,093521,Wastal; Carrie King,3,0,3,0
1653303511614,MCWP 40,041,093523,Wastal; Carrie King,2,0,3,1
1653303511614,MCWP 40,042,093524,Wastal; Carrie King,3,0,3,0
1653303511614,MCWP 40,043,093525,Wastal; Carrie King,0,0,0,0
1653303511614,MCWP 40,049,093531,Wastal; Carrie King,2,0,3,1
1653303511614,MCWP 40,050,093532,Wastal; Carrie King,3,0,3,0
1653303511614,MCWP 40,051,093533,Wastal; Carrie King,3,0,3,0
1653303512139,MCWP 50,001,093534,Wastal; Carrie King,0,0,0,0
1653303512139,MCWP 50,002,093535,Wastal; Carrie King,0,0,3,3
1653303512139,MCWP 50,003,093536,Wastal; Carrie King,0,0,3,3
1653303512139,MCWP 50,004,093537,Wastal; Carrie King,0,0,3,3
1653303512139,MCWP 50,005,093538,Wastal; Carrie King,0,0,3,3
1653303512139,MCWP 50,006,093539,Wastal; Carrie King,2,0,3,1
1653303512139,MCWP 50,007,093540,Wastal; Carrie King,0,0,3,3
1653303512139,MCWP 50,008,093541,Wastal; Carrie King,0,0,3,3
1653303512139,MCWP 50,009,093542,Wastal; Carrie King,0,0,3,3
1653303512139,MCWP 50,010,093543,Wastal; Carrie King,0,0,3,3
1653303512139,MCWP 50,013,093546,Wastal; Carrie King,1,0,3,2
1653303512139,MCWP 50,014,093547,Wastal; Carrie King,0,0,3,3
1653303512139,MCWP 50,015,093548,Wastal; Carrie King,0,0,3,3
1653303512139,MCWP 50,016,093549,Wastal; Carrie King,0,0,0,0
1653303512665,MCWP 125,A00,093550,Wilson; Marion E.,3,0,3,0
1653303512665,MCWP 125,B00,093551,Guillen; Melinda,3,0,3,0
1653303512665,MCWP 125,C00,093552,Guillen; Melinda,3,0,3,0
1653303512665,MCWP 125,D00,093553,Guillen; Melinda,3,0,3,0
1653303512665,MCWP 125,E00,093554,Miller; Elizabeth Deen,3,0,3,0
1653303512665,MCWP 125,F00,093555,Miller; Elizabeth Deen,3,0,3,0
1653303512665,MCWP 125,G00,093556,Miller; Elizabeth Deen,3,0,3,0
1653303513191,MGT 3,A00,087704,Wagner; Timothy Ryan,90,0,90,0
1653303513733,MGT 4,A01,087706,Levkoff; Steven B.,2,0,3,1
1653303513733,MGT 4,A02,087707,Levkoff; Steven B.,3,0,3,0
1653303513733,MGT 4,A03,092659,Levkoff; Steven B.,1,0,4,3
1653303514268,MGT 5,A00,087708,Houskeeper; Robert,194,0,196,2
1653303514794,MGT 12,A00,087709,Pecore; Joseph P.,91,0,100,9
1653303514794,MGT 12,B00,087710,Lindenberger; Wade Douglas,91,0,100,9
1653303515325,MGT 16,A00,087711,Campbell; Robert Harold,108,0,110,2
1653303515325,MGT 16,B00,087712,Campbell; Robert Harold,110,0,110,0
1653303515325,MGT 16,C00,087713,Lindenberger; Wade Douglas,100,0,110,10
1653303515325,MGT 16,D00,087714,Lindenberger; Wade Douglas,107,0,110,3
1653303515325,MGT 16,E00,094819,Buchanan; Harold G,99,0,100,1
1653303515851,MGT 18,A00,087715,McKay; Michael J,88,0,90,2
1653303515851,MGT 18,B00,087716,McKay; Michael J,90,0,90,0
1653303515851,MGT 18,C00,087717,McKay; Michael J,88,0,90,2
1653303515851,MGT 18,D00,087718,McKay; Mary A,90,0,90,0
1653303515851,MGT 18,E00,087719,McKay; Mary A,87,0,90,3
1653303516379,MGT 45,A00,087720,Pecore; Joseph P.,136,0,150,14
1653303516379,MGT 45,B00,087721,Pecore; Joseph P.,140,0,150,10
1653303516908,MGT 52,A00,087722,Deal; Jennifer Jean,83,0,90,7
1653303517433,MGT 71,A00,087723,August; Terrence,60,0,90,30
1653303518482,MGT 103,A00,087726,Ehrich; Kristine R,86,0,90,4
1653303518482,MGT 103,B00,087727,Ehrich; Kristine R,89,0,90,1
1653303518482,MGT 103,C00,087728,Eberhard; Craig A,89,0,90,1
1653303518482,MGT 103,D00,087729,Eberhard; Craig A,88,0,90,2
1653303518482,MGT 103,E00,087730,Demill; Burritt,75,0,90,15
1653303518482,MGT 103,F00,087731,Bates; Kenneth Walter,81,0,90,9
1653303518482,MGT 103,G00,087732,Bates; Kenneth Walter,88,0,90,2
1653303519006,MGT 105,A00,087733,Campbell; Robert Harold,102,0,120,18
1653303519530,MGT 106,A00,087734,Eberhard; Craig A,81,0,90,9
1653303520054,MGT 108R,A00,087735,Amir; On,84,0,90,6
1653303520581,MGT 109,A00,087736,Staff,77,0,90,13
1653303521109,MGT 112,A00,087737,Somasundaram; Tyagarajan,89,0,90,1
1653303521109,MGT 112,B00,087738,Somasundaram; Tyagarajan,86,0,90,4
1653303521109,MGT 112,C00,087739,Ehrich; Kristine R,86,0,90,4
1653303521109,MGT 112,D00,087740,Zimmermann; Carsten,65,0,90,25
1653303521631,MGT 121A,A00,087741,Wang; Helen Shan,65,0,70,5
1653303521631,MGT 121A,B00,087742,Wang; Helen Shan,64,0,70,6
1653303522155,MGT 131A,A00,087743,Houskeeper; Robert,146,0,150,4
1653303522685,MGT 132,A00,087744,Blakley; Bruce,88,0,90,2
1653303523221,MGT 134,A00,087745,Houskeeper; Robert,84,0,90,6
1653303523746,MGT 135,A00,087746,Anderson; John Charles,83,0,90,7
1653303524270,MGT 139,A00,087747,Perols; Johan Lars,88,0,90,2
1653303524794,MGT 153,A00,087748,Perols; Johan Lars,82,0,90,8
1653303524794,MGT 153,B00,087749,Phiroz; Zal Navroze,75,0,90,15
1653303524794,MGT 153,C00,087750,Phiroz; Zal Navroze,87,0,90,3
1653303525320,MGT 162R,A00,087751,Gneezy; Uri,64,0,90,26
1653303525855,MGT 164,A00,087752,McKay; Mary A,90,0,90,0
1653303525855,MGT 164,B00,087753,Meyer; Alison Bloomfield,0,0,0,0
1653303525855,MGT 164,C00,087754,Smith; Pamela Karen,82,0,90,8
1653303526384,MGT 166,A00,087755,Moran; Cathleen L.,89,0,90,1
1653303526384,MGT 166,B00,087756,Moran; Cathleen L.,90,0,90,0
1653303526384,MGT 166,C00,087757,Moran; Cathleen L.,90,0,90,0
1653303526384,MGT 166,D00,087758,Demill; Burritt,56,0,90,34
1653303526911,MGT 167,A00,087759,Klaas; Jeffrey David,88,0,90,2
1653303526911,MGT 167,B00,087760,Jacob; Jo Dee C,83,0,90,7
1653303527446,MGT 171,A00,087761,Phiroz; Zal Navroze,85,0,90,5
1653303527969,MGT 172,A00,087762,Hedges; Kathleen & Royal; Rebecca,96,0,100,4
1653303527969,MGT 172,B00,087763,Hedges; Kathleen,79,0,90,11
1653303527969,MGT 172,C00,087764,Zimmermann; Carsten,90,0,90,0
1653303528498,MGT 172R,A00,094888,Erat; Sanjiv,90,0,90,0
1653303529037,MGT 173,A00,087765,Hayes; Sherry Lorine,80,0,100,20
1653303529564,MGT 175,A00,087766,Gopal; Christopher S.,84,0,90,6
1653303530093,MGT 181,A00,087767,Buchanan; Harold G,114,0,120,6
1653303530093,MGT 181,B00,087768,Buchanan; Harold G,110,0,120,10
1653303530093,MGT 181,C00,087769,Bliss; Barbara Ann,109,0,120,11
1653303531141,MGT 185,A00,087771,Dunn; Louis Jean,83,0,90,7
1653303531666,MGT 187,A00,087772,Dunn; Louis Jean,138,0,146,8
1653303532198,MMW 11,A01,086931,duBois; Page Ann,4,0,4,0
1653303532198,MMW 11,A02,086932,duBois; Page Ann,4,0,4,0
1653303532198,MMW 11,A03,086933,duBois; Page Ann,3,0,4,1
1653303532198,MMW 11,A04,086934,duBois; Page Ann,3,0,4,1
1653303532198,MMW 11,A05,086935,duBois; Page Ann,4,0,4,0
1653303532198,MMW 11,A06,086936,duBois; Page Ann,3,0,4,1
1653303532198,MMW 11,A07,086937,duBois; Page Ann,4,0,4,0
1653303532198,MMW 11,A08,086938,duBois; Page Ann,4,0,4,0
1653303532198,MMW 11,A09,086939,duBois; Page Ann,4,0,4,0
1653303532198,MMW 11,A10,086940,duBois; Page Ann,4,0,4,0
1653303532198,MMW 11,A11,086941,duBois; Page Ann,4,0,4,0
1653303532198,MMW 11,A12,093877,duBois; Page Ann,3,0,4,1
1653303532732,MMW 11R,A01,093852,Herbst; Matthew,4,0,4,0
1653303532732,MMW 11R,A02,093853,Herbst; Matthew,4,0,4,0
1653303532732,MMW 11R,A03,093854,Herbst; Matthew,4,0,4,0
1653303532732,MMW 11R,A04,093855,Herbst; Matthew,4,0,4,0
1653303532732,MMW 11R,A05,093856,Herbst; Matthew,4,0,4,0
1653303532732,MMW 11R,A06,093857,Herbst; Matthew,4,0,4,0
1653303532732,MMW 11R,A07,093858,Herbst; Matthew,4,0,4,0
1653303532732,MMW 11R,A08,093859,Herbst; Matthew,4,0,4,0
1653303532732,MMW 11R,A09,093860,Herbst; Matthew,4,0,4,0
1653303532732,MMW 11R,A10,093861,Herbst; Matthew,4,0,4,0
1653303532732,MMW 11R,A11,093862,Herbst; Matthew,4,0,4,0
1653303532732,MMW 11R,A12,093863,Herbst; Matthew,4,0,4,0
1653303532732,MMW 11R,B01,093865,Herbst; Matthew,4,0,4,0
1653303532732,MMW 11R,B02,093866,Herbst; Matthew,4,0,4,0
1653303532732,MMW 11R,B03,093867,Herbst; Matthew,4,0,4,0
1653303532732,MMW 11R,B04,093868,Herbst; Matthew,4,0,4,0
1653303532732,MMW 11R,B05,093869,Herbst; Matthew,4,0,4,0
1653303532732,MMW 11R,B06,093870,Herbst; Matthew,4,0,4,0
1653303532732,MMW 11R,B07,093871,Herbst; Matthew,4,0,4,0
1653303532732,MMW 11R,B08,093872,Herbst; Matthew,4,0,4,0
1653303532732,MMW 11R,B09,093873,Herbst; Matthew,4,0,4,0
1653303532732,MMW 11R,B10,093874,Herbst; Matthew,4,0,4,0
1653303532732,MMW 11R,B11,093875,Herbst; Matthew,4,0,4,0
1653303532732,MMW 11R,B12,093876,Herbst; Matthew,4,0,4,0
1653303533265,MMW 14,A01,086968,Chang; Edmond Yi-Teh,28,0,28,0
1653303533265,MMW 14,A02,086969,Chang; Edmond Yi-Teh,27,0,28,1
1653303533265,MMW 14,A03,086970,Chang; Edmond Yi-Teh,21,0,28,7
1653303533265,MMW 14,A04,086971,Chang; Edmond Yi-Teh,27,0,28,1
1653303533265,MMW 14,A05,086972,Chang; Edmond Yi-Teh,26,0,28,2
1653303533265,MMW 14,A06,086973,Chang; Edmond Yi-Teh,28,0,28,0
1653303533265,MMW 14,A07,086974,Chang; Edmond Yi-Teh,27,0,28,1
1653303533265,MMW 14,A08,086975,Chang; Edmond Yi-Teh,25,0,28,3
1653303533265,MMW 14,A09,086976,Chang; Edmond Yi-Teh,0,0,0,0
1653303533265,MMW 14,A10,086977,Chang; Edmond Yi-Teh,27,0,28,1
1653303533265,MMW 14,A11,086978,Chang; Edmond Yi-Teh,26,0,28,2
1653303533265,MMW 14,A12,086979,Chang; Edmond Yi-Teh,27,0,28,1
1653303533265,MMW 14,A13,086980,Chang; Edmond Yi-Teh,28,0,28,0
1653303533791,MMW 121,A01,086982,Chang; Edmond Yi-Teh,0,0,0,0
1653303533791,MMW 121,A02,086983,Chang; Edmond Yi-Teh,0,0,0,0
1653303533791,MMW 121,A03,086984,Chang; Edmond Yi-Teh,2,0,4,2
1653303533791,MMW 121,A04,086985,Chang; Edmond Yi-Teh,4,0,4,0
1653303533791,MMW 121,A05,086986,Chang; Edmond Yi-Teh,4,0,4,0
1653303533791,MMW 121,A06,086987,Chang; Edmond Yi-Teh,4,0,4,0
1653303533791,MMW 121,A07,086988,Chang; Edmond Yi-Teh,4,0,4,0
1653303533791,MMW 121,A08,086989,Chang; Edmond Yi-Teh,4,0,4,0
1653303533791,MMW 121,B01,086991,Patterson; Patrick H.,4,0,4,0
1653303533791,MMW 121,B02,086992,Patterson; Patrick H.,4,0,4,0
1653303533791,MMW 121,B03,086993,Patterson; Patrick H.,4,0,4,0
1653303533791,MMW 121,B04,086994,Patterson; Patrick H.,3,0,4,1
1653303533791,MMW 121,B05,086995,Patterson; Patrick H.,4,0,4,0
1653303533791,MMW 121,B06,086996,Patterson; Patrick H.,4,0,4,0
1653303533791,MMW 121,B07,086997,Patterson; Patrick H.,4,0,4,0
1653303533791,MMW 121,B08,086998,Patterson; Patrick H.,4,0,4,0
1653303533791,MMW 121,B09,086999,Patterson; Patrick H.,4,0,4,0
1653303533791,MMW 121,B10,087000,Patterson; Patrick H.,4,0,4,0
1653303533791,MMW 121,B11,087001,Patterson; Patrick H.,0,0,0,0
1653303533791,MMW 121,B12,087002,Patterson; Patrick H.,0,0,0,0
1653303534316,MUS 1A,A01,090497,Staff,19,0,20,1
1653303534316,MUS 1A,A02,090498,Staff,13,0,20,7
1653303534316,MUS 1A,A03,090499,Staff,18,0,20,2
1653303534316,MUS 1A,A04,090500,Staff,19,0,20,1
1653303534316,MUS 1A,A05,090501,Staff,20,0,20,0
1653303534316,MUS 1A,A06,090502,Staff,20,0,20,0
1653303534316,MUS 1A,B01,090504,Staff,18,0,20,2
1653303534316,MUS 1A,B02,090505,Staff,20,0,20,0
1653303534316,MUS 1A,B03,090506,Staff,18,0,20,2
1653303534316,MUS 1A,B04,090507,Staff,18,0,20,2
1653303534316,MUS 1A,B05,090508,Staff,16,0,20,4
1653303534316,MUS 1A,B06,090509,Staff,20,0,20,0
1653303534846,MUS 2A,A01,090511,Carlson; Erik Norman,19,0,20,1
1653303535381,MUS 2AK,A00,090512,Ohnishi; Takae,24,0,25,1
1653303535381,MUS 2AK,B00,090513,Ohnishi; Takae,15,0,15,0
1653303535906,MUS 4,A01,090515,Staff,24,0,25,1
1653303535906,MUS 4,A02,090516,Staff,24,0,25,1
1653303535906,MUS 4,A03,090517,Staff,22,0,25,3
1653303535906,MUS 4,A04,090518,Staff,24,0,25,1
1653303535906,MUS 4,A05,090519,Staff,25,0,25,0
1653303535906,MUS 4,A06,090520,Staff,25,0,25,0
1653303535906,MUS 4,A07,090521,Staff,24,0,25,1
1653303535906,MUS 4,A08,090522,Staff,24,0,25,1
1653303536431,MUS 5,A01,090524,Staff,20,0,20,0
1653303536431,MUS 5,A02,090525,Staff,18,0,20,2
1653303536431,MUS 5,A03,090526,Staff,20,0,20,0
1653303536431,MUS 5,A04,090527,Staff,20,0,20,0
1653303536431,MUS 5,A05,090528,Staff,19,0,20,1
1653303536958,MUS 6,A01,090530,Staff,22,0,25,3
1653303536958,MUS 6,A02,090531,Staff,25,0,25,0
1653303536958,MUS 6,A03,090532,Staff,25,0,25,0
1653303536958,MUS 6,A04,090533,Staff,23,0,25,2
1653303537487,MUS 8,A01,090535,Kenyatta; Kamau,17,0,25,8
1653303537487,MUS 8,A02,090536,Kenyatta; Kamau,19,0,25,6
1653303537487,MUS 8,A03,090537,Kenyatta; Kamau,17,0,25,8
1653303537487,MUS 8,A04,090538,Kenyatta; Kamau,21,0,25,4
1653303538017,MUS 12,A01,090540,Narucki; Susan M,20,0,20,0
1653303538017,MUS 12,A02,090541,Narucki; Susan M,20,0,20,0
1653303538017,MUS 12,A03,090542,Narucki; Susan M,17,0,20,3
1653303538546,MUS 15,A01,090544,Staff,21,0,25,4
1653303538546,MUS 15,A02,090545,Staff,23,0,25,2
1653303538546,MUS 15,A03,090546,Staff,24,0,25,1
1653303538546,MUS 15,A04,090547,Staff,22,0,25,3
1653303538546,MUS 15,A05,090548,Staff,25,0,25,0
1653303538546,MUS 15,A06,090549,Staff,24,0,25,1
1653303539074,MUS 19R,A01,090551,Britt; King James,17,0,20,3
1653303539074,MUS 19R,A02,090552,Britt; King James,19,0,20,1
1653303539074,MUS 19R,A03,090553,Britt; King James,20,0,20,0
1653303539074,MUS 19R,A04,090554,Britt; King James,19,0,20,1
1653303539074,MUS 19R,A05,090555,Britt; King James,20,0,20,0
1653303539074,MUS 19R,A06,090556,Britt; King James,18,0,20,2
1653303539074,MUS 19R,A07,090557,Britt; King James,19,0,20,1
1653303539074,MUS 19R,A08,090558,Britt; King James,19,0,20,1
1653303539074,MUS 19R,A09,090559,Britt; King James,20,0,20,0
1653303539074,MUS 19R,A10,090560,Britt; King James,20,0,20,0
1653303539074,MUS 19R,B01,090562,Britt; King James,10,0,10,0
1653303539074,MUS 19R,B02,090563,Britt; King James,10,0,10,0
1653303539074,MUS 19R,B03,090564,Britt; King James,10,0,10,0
1653303539074,MUS 19R,B04,090565,Britt; King James,10,0,10,0
1653303539074,MUS 19R,B05,090566,Britt; King James,10,0,10,0
1653303539074,MUS 19R,B06,090567,Britt; King James,10,0,10,0
1653303539074,MUS 19R,B07,090568,Britt; King James,10,0,10,0
1653303539074,MUS 19R,B08,090569,Britt; King James,10,0,10,0
1653303539074,MUS 19R,B09,090570,Britt; King James,10,0,10,0
1653303539074,MUS 19R,B10,090571,Britt; King James,10,0,10,0
1653303539603,MUS 20,A01,090573,Borgo; David Garcia,12,0,15,3
1653303539603,MUS 20,A02,090574,Borgo; David Garcia,14,0,15,1
1653303539603,MUS 20,A03,090575,Borgo; David Garcia,13,0,15,2
1653303540141,MUS 32,001,094074,Staff,10,0,10,0
1653303540141,MUS 32,002,094075,Kenyatta; Kamau,10,0,10,0
1653303540141,MUS 32,003,094076,Curtis; Charles Rector,10,0,10,0
1653303540141,MUS 32,005,094078,Terrazas Perez; Wilfrido D,10,0,10,0
1653303540141,MUS 32,006,094079,Ohnishi; Takae,10,0,10,0
1653303540141,MUS 32,007,094080,Burr; Anthony I,10,0,10,0
1653303540141,MUS 32,008,094081,Carlson; Erik Norman,10,0,10,0
1653303540141,MUS 32,009,094082,Dresser; Mark Stuart,10,0,10,0
1653303540141,MUS 32,011,094084,Richards; Stephanie F,10,0,10,0
1653303540141,MUS 32,012,094085,Borgo; David Garcia,10,0,10,0
1653303540141,MUS 32,013,094086,Paganos Koukakis; Dimitrios,10,0,10,0
1653303540141,MUS 32,014,094087,Jones; Michael David,10,0,10,0
1653303540670,MUS 32V,A00,094355,Zazueta Cervera; Miguel Angel,10,0,10,0
1653303540670,MUS 32V,B00,094089,Flores; Mariana,10,0,10,0
1653303541271,MUS 32VM,A00,094090,Zazueta Cervera; Miguel Angel,15,0,15,0
1653303541794,MUS 33A,A00,090576,Liang; Lei,24,0,25,1
1653303542318,MUS 43,A00,090577,Burr; Anthony I,92,0,100,8
1653303542842,MUS 95C,B00,094829,Staff,28,0,30,2
1653303543365,MUS 95D,A00,090579,Staff,30,0,30,0
1653303543888,MUS 95E,A00,090580,Staff,30,0,30,0
1653303544412,MUS 95G,A00,090581,Anderson; Kenneth,384,0,395,11
1653303544412,MUS 95G,B00,090582,Anderson; Kenneth,393,0,395,2
1653303544935,MUS 95JC,A00,090583,Kenyatta; Kamau,35,0,35,0
1653303545459,MUS 95L,A00,090584,Staff,30,0,30,0
1653303545983,MUS 95W,A00,090585,Seshadri; Kartik,60,0,60,0
1653303545983,MUS 95W,B00,090586,Seshadri; Kartik,30,0,30,0
1653303546504,MUS 101A,A01,090588,Staff,29,0,30,1
1653303547032,MUS 103A,A00,090589,Ung; Chinary,15,0,15,0
1653303547555,MUS 107,A00,090590,Terrazas Perez; Wilfrido D,30,0,30,0
1653303548080,MUS 111,A00,090591,Yadegari; Shahrokh D,124,0,130,6
1653303548603,MUS 114,A00,090592,Curtis; Charles Rector,117,0,125,8
1653303549127,MUS 120A,A01,090594,Cimini; Amy Marie,29,0,30,1
1653303549652,MUS 126R,A00,090595,Borgo; David Garcia,106,0,115,9
1653303550175,MUS 130,A00,090596,Ohnishi; Takae,30,0,30,0
1653303550707,MUS 132,001,094091,Nourai; Keyarash,10,0,10,0
1653303550707,MUS 132,002,094093,Kenyatta; Kamau,10,0,10,0
1653303550707,MUS 132,003,094094,Curtis; Charles Rector,10,0,10,0
1653303550707,MUS 132,005,094096,Terrazas Perez; Wilfrido D,10,0,10,0
1653303550707,MUS 132,006,094097,Ohnishi; Takae,10,0,10,0
1653303550707,MUS 132,007,094098,Burr; Anthony I,10,0,10,0
1653303550707,MUS 132,008,094099,Carlson; Erik Norman,10,0,10,0
1653303550707,MUS 132,009,094100,Dresser; Mark Stuart,10,0,10,0
1653303550707,MUS 132,011,094102,Richards; Stephanie F,10,0,10,0
1653303550707,MUS 132,012,094103,Borgo; David Garcia,10,0,10,0
1653303550707,MUS 132,013,094104,Jones; Michael David,10,0,10,0
1653303550707,MUS 132,014,094105,Staff,10,0,10,0
1653303551231,MUS 132V,A00,094106,Narucki; Susan M,15,0,15,0
1653303551760,MUS 134,A00,090597,Staff,30,0,30,0
1653303552283,MUS 137A,A00,090598,Kenyatta; Kamau,30,0,30,0
1653303552805,MUS 143,A00,090599,Staff,26,0,30,4
1653303553870,MUS 173,A00,090600,Britt; King James,19,0,30,11
1653303554392,MUS 174A,A00,090601,Staff,8,0,15,7
1653303555445,NANO 4,A01,088199,Vazquez Mena; Oscar,20,0,20,0
1653303555445,NANO 4,B01,088201,Vazquez Mena; Oscar,20,0,20,0
1653303555445,NANO 4,C01,088203,Vazquez Mena; Oscar,20,0,20,0
1653303555969,NANO 15,A01,088205,Lubarda; Vlado,50,0,50,0
1653303555969,NANO 15,B01,088207,Lubarda; Vlado,50,0,50,0
1653303556492,NANO 20L,A00,088208,Sirbuly; Donald,27,0,30,3
1653303556492,NANO 20L,B00,088209,Sirbuly; Donald,29,0,30,1
1653303557021,NANO 100L,A00,088210,Vecchio; Kenneth S,24,0,30,6
1653303557545,NANO 102,A00,088211,Tao; Andrea Rae,94,0,100,6
1653303558069,NANO 110,A00,088212,Pascal; Tod A,99,0,100,1
1653303558595,NANO 111,A00,088213,Fenning; David,45,0,50,5
1653303559124,NANO 117,A00,088214,Cubukcu; Ertugrul,71,0,75,4
1653303559654,NANO 119,A00,088215,Vazquez Mena; Oscar,50,0,50,0
1653303560184,NANO 159,A00,088216,Wang; Joseph,33,0,40,7
1653303560710,NANO 181,A01,088218,Ong; Shyue Ping,22,0,25,3
1653303561241,PHIL 1,A00,090815,Sher; Gila,57,0,60,3
1653303561768,PHIL 10,A01,090817,Grush; Rick Scott,37,0,40,3
1653303561768,PHIL 10,A02,090818,Grush; Rick Scott,37,0,40,3
1653303561768,PHIL 10,A03,090819,Grush; Rick Scott,38,0,40,2
1653303561768,PHIL 10,A04,090820,Grush; Rick Scott,40,0,40,0
1653303561768,PHIL 10,A05,090821,Grush; Rick Scott,38,0,40,2
1653303561768,PHIL 10,A06,090822,Grush; Rick Scott,39,0,40,1
1653303562290,PHIL 12,A01,090824,Bechtel; William,20,0,25,5
1653303562290,PHIL 12,A02,090825,Bechtel; William,24,0,25,1
1653303562290,PHIL 12,A03,090826,Bechtel; William,25,0,25,0
1653303562290,PHIL 12,A04,090827,Bechtel; William,25,0,25,0
1653303562820,PHIL 13,A01,090829,Wonderly; Monique L.,25,0,25,0
1653303562820,PHIL 13,A02,090830,Wonderly; Monique L.,24,0,25,1
1653303562820,PHIL 13,A03,090831,Wonderly; Monique L.,24,0,25,1
1653303562820,PHIL 13,A04,090832,Wonderly; Monique L.,25,0,25,0
1653303563365,PHIL 27,A01,090834,Harrell; Maralee Mae,23,0,35,12
1653303563365,PHIL 27,A02,090835,Harrell; Maralee Mae,35,0,35,0
1653303563365,PHIL 27,A03,090836,Harrell; Maralee Mae,33,0,35,2
1653303563365,PHIL 27,A04,090837,Harrell; Maralee Mae,33,0,35,2
1653303563365,PHIL 27,A05,090838,Harrell; Maralee Mae,35,0,35,0
1653303563365,PHIL 27,A06,090839,Harrell; Maralee Mae,35,0,35,0
1653303563890,PHIL 28,A01,090841,Bazargan-Forward; Saba,31,0,35,4
1653303563890,PHIL 28,A02,090842,Bazargan-Forward; Saba,31,0,35,4
1653303563890,PHIL 28,A03,090843,Bazargan-Forward; Saba,35,0,35,0
1653303563890,PHIL 28,A04,090844,Bazargan-Forward; Saba,30,0,35,5
1653303563890,PHIL 28,A05,090845,Bazargan-Forward; Saba,33,0,35,2
1653303563890,PHIL 28,A06,090846,Bazargan-Forward; Saba,34,0,35,1
1653303563890,PHIL 28,A07,090847,Bazargan-Forward; Saba,32,0,35,3
1653303563890,PHIL 28,A08,090848,Bazargan-Forward; Saba,33,0,35,2
1653303564416,PHIL 31,A00,090849,Johnson; Monte,59,0,60,1
1653303564945,PHIL 100,A00,090852,Nelkin; Dana Kay,28,0,35,7
1653303565470,PHIL 110,A00,090853,Johnson; Monte,29,0,30,1
1653303565994,PHIL 120,A00,090854,Rickless; Samuel Charles,23,0,35,12
1653303566520,PHIL 123,A00,090855,Sher; Gila,38,0,40,2
1653303567047,PHIL 131,A00,090856,Cohen; Jonathan David,34,0,35,1
1653303567575,PHIL 132,A00,090857,Carr; Jennifer Rose,33,0,35,2
1653303568103,PHIL 138,A00,090858,Brink; David O.,34,0,40,6
1653303568627,PHIL 147,A00,090860,Fulkerson; Matthew Todd,33,0,35,2
1653303569155,PHIL 150,A00,090861,Bechtel; William,36,0,40,4
1653303569682,PHIL 155,A00,090862,Vargas; Manuel Rogelio,38,0,40,2
1653303570207,PHIL 165,A00,090863,Rickless; Samuel Charles,59,0,70,11
1653303570734,PHIL 172,A00,090864,Bazargan-Forward; Saba,37,0,40,3
1653303571261,PHIL 173,A00,090865,Wonderly; Monique L.,33,0,40,7
1653303571795,PHYS 1A,A00,088555,Koslover; Elena F,354,0,362,8
1653303571795,PHYS 1A,B00,088556,Koslover; Elena F,343,0,362,19
1653303571795,PHYS 1A,C00,088557,Shpyrko; Oleg,326,0,362,36
1653303572324,PHYS 1AL,001,088558,Tsai; Philbert S,30,0,30,0
1653303572324,PHYS 1AL,002,088559,Tsai; Philbert S,30,0,30,0
1653303572324,PHYS 1AL,003,088560,Tsai; Philbert S,23,0,30,7
1653303572324,PHYS 1AL,004,088561,Tsai; Philbert S,26,0,30,4
1653303572324,PHYS 1AL,005,088562,Tsai; Philbert S,24,0,30,6
1653303572324,PHYS 1AL,006,088563,Tsai; Philbert S,30,0,30,0
1653303572324,PHYS 1AL,007,088564,Tsai; Philbert S,26,0,30,4
1653303572324,PHYS 1AL,008,088565,Tsai; Philbert S,29,0,30,1
1653303572324,PHYS 1AL,009,088566,Tsai; Philbert S,28,0,30,2
1653303572324,PHYS 1AL,010,088567,Tsai; Philbert S,30,0,30,0
1653303572324,PHYS 1AL,011,088568,Tsai; Philbert S,29,0,30,1
1653303572324,PHYS 1AL,012,088569,Tsai; Philbert S,29,0,30,1
1653303572324,PHYS 1AL,013,088570,Tsai; Philbert S,30,0,30,0
1653303572324,PHYS 1AL,014,088571,Tsai; Philbert S,29,0,30,1
1653303572324,PHYS 1AL,015,088572,Tsai; Philbert S,23,0,30,7
1653303572324,PHYS 1AL,016,088573,Tsai; Philbert S,28,0,30,2
1653303572324,PHYS 1AL,017,088574,Tsai; Philbert S,29,0,30,1
1653303572324,PHYS 1AL,018,088575,Tsai; Philbert S,28,0,30,2
1653303572324,PHYS 1AL,019,088576,Tsai; Philbert S,26,0,30,4
1653303572324,PHYS 1AL,020,088577,Tsai; Philbert S,29,0,30,1
1653303572324,PHYS 1AL,021,088578,Tsai; Philbert S,30,0,30,0
1653303572324,PHYS 1AL,022,088579,Tsai; Philbert S,30,0,30,0
1653303572324,PHYS 1AL,023,088580,Tsai; Philbert S,30,0,30,0
1653303572324,PHYS 1AL,024,088581,Tsai; Philbert S,30,0,30,0
1653303572324,PHYS 1AL,025,088582,Tsai; Philbert S,26,0,30,4
1653303572324,PHYS 1AL,026,088583,Tsai; Philbert S,29,0,30,1
1653303572324,PHYS 1AL,027,088584,Tsai; Philbert S,28,0,30,2
1653303572324,PHYS 1AL,028,088585,Tsai; Philbert S,30,0,30,0
1653303572324,PHYS 1AL,029,088586,Tsai; Philbert S,27,0,30,3
1653303572324,PHYS 1AL,030,088587,Tsai; Philbert S,29,0,30,1
1653303572324,PHYS 1AL,031,088588,Tsai; Philbert S,30,0,30,0
1653303572324,PHYS 1AL,032,088589,Tsai; Philbert S,30,0,30,0
1653303572324,PHYS 1AL,033,088590,Tsai; Philbert S,30,0,30,0
1653303572324,PHYS 1AL,034,088591,Tsai; Philbert S,30,0,30,0
1653303572324,PHYS 1AL,035,088592,Tsai; Philbert S,29,0,30,1
1653303572324,PHYS 1AL,036,088593,Tsai; Philbert S,30,0,30,0
1653303572848,PHYS 1B,A00,088594,Groisman; Alexander,351,0,360,9
1653303573371,PHYS 1BL,001,088595,Tsai; Philbert S,30,0,30,0
1653303573371,PHYS 1BL,002,088596,Tsai; Philbert S,25,0,30,5
1653303573371,PHYS 1BL,003,088597,Tsai; Philbert S,27,0,30,3
1653303573371,PHYS 1BL,004,088598,Tsai; Philbert S,30,0,30,0
1653303573371,PHYS 1BL,005,088599,Tsai; Philbert S,29,0,30,1
1653303573371,PHYS 1BL,006,088600,Tsai; Philbert S,25,0,30,5
1653303573371,PHYS 1BL,007,088601,Tsai; Philbert S,30,0,30,0
1653303573371,PHYS 1BL,008,088602,Tsai; Philbert S,29,0,30,1
1653303573371,PHYS 1BL,009,088603,Tsai; Philbert S,30,0,30,0
1653303573371,PHYS 1BL,010,088604,Tsai; Philbert S,30,0,30,0
1653303573371,PHYS 1BL,011,088605,Tsai; Philbert S,28,0,30,2
1653303573371,PHYS 1BL,012,088606,Tsai; Philbert S,26,0,30,4
1653303573896,PHYS 1C,A00,088607,Tsai; Philbert S,334,0,360,26
1653303574421,PHYS 1CL,001,088608,Tsai; Philbert S,30,0,30,0
1653303574421,PHYS 1CL,002,088609,Tsai; Philbert S,24,0,30,6
1653303574421,PHYS 1CL,003,088610,Tsai; Philbert S,24,0,30,6
1653303574421,PHYS 1CL,004,088611,Tsai; Philbert S,29,0,30,1
1653303574421,PHYS 1CL,005,088612,Tsai; Philbert S,17,0,30,13
1653303574421,PHYS 1CL,006,088613,Tsai; Philbert S,19,0,30,11
1653303574421,PHYS 1CL,007,088614,Tsai; Philbert S,30,0,30,0
1653303574421,PHYS 1CL,008,088615,Tsai; Philbert S,26,0,30,4
1653303574421,PHYS 1CL,009,088616,Tsai; Philbert S,27,0,30,3
1653303574421,PHYS 1CL,010,088617,Tsai; Philbert S,29,0,30,1
1653303574421,PHYS 1CL,011,088618,Tsai; Philbert S,27,0,30,3
1653303574421,PHYS 1CL,012,088619,Tsai; Philbert S,24,0,30,6
1653303574960,PHYS 2A,A01,092602,Meyertholen; Andrew D.,26,0,30,4
1653303574960,PHYS 2A,A02,092603,Meyertholen; Andrew D.,28,0,30,2
1653303574960,PHYS 2A,A03,092604,Meyertholen; Andrew D.,29,0,30,1
1653303574960,PHYS 2A,A04,092605,Meyertholen; Andrew D.,30,0,30,0
1653303574960,PHYS 2A,A05,092606,Meyertholen; Andrew D.,29,0,30,1
1653303574960,PHYS 2A,A06,092607,Meyertholen; Andrew D.,29,0,30,1
1653303574960,PHYS 2A,A07,092608,Meyertholen; Andrew D.,30,0,30,0
1653303574960,PHYS 2A,A08,092609,Meyertholen; Andrew D.,30,0,30,0
1653303574960,PHYS 2A,A09,092610,Meyertholen; Andrew D.,27,0,30,3
1653303574960,PHYS 2A,A10,092611,Meyertholen; Andrew D.,30,0,30,0
1653303574960,PHYS 2A,A11,092612,Meyertholen; Andrew D.,30,0,30,0
1653303574960,PHYS 2A,A12,094499,Meyertholen; Andrew D.,27,0,30,3
1653303575486,PHYS 2B,A01,092613,Branson; James G,28,0,30,2
1653303575486,PHYS 2B,A02,092614,Branson; James G,29,0,30,1
1653303575486,PHYS 2B,A03,092615,Branson; James G,30,0,30,0
1653303575486,PHYS 2B,A04,092616,Branson; James G,30,0,30,0
1653303575486,PHYS 2B,A05,092617,Branson; James G,29,0,30,1
1653303575486,PHYS 2B,A06,092618,Branson; James G,29,0,30,1
1653303575486,PHYS 2B,A07,092619,Branson; James G,29,0,30,1
1653303575486,PHYS 2B,A08,092620,Branson; James G,0,0,0,0
1653303575486,PHYS 2B,A09,092621,Branson; James G,0,0,0,0
1653303575486,PHYS 2B,A10,092622,Branson; James G,0,0,0,0
1653303575486,PHYS 2B,A11,092623,Branson; James G,0,0,0,0
1653303575486,PHYS 2B,A12,092624,Branson; James G,30,0,30,0
1653303576013,PHYS 2C,A01,092625,Barreiro Guerrero; Julio,26,0,30,4
1653303576013,PHYS 2C,A02,092626,Barreiro Guerrero; Julio,28,0,30,2
1653303576013,PHYS 2C,A03,092627,Barreiro Guerrero; Julio,29,0,30,1
1653303576013,PHYS 2C,A04,092628,Barreiro Guerrero; Julio,29,0,30,1
1653303576013,PHYS 2C,A05,092629,Barreiro Guerrero; Julio,30,0,30,0
1653303576013,PHYS 2C,A06,092630,Barreiro Guerrero; Julio,30,0,30,0
1653303576013,PHYS 2C,A07,092631,Barreiro Guerrero; Julio,30,0,30,0
1653303576013,PHYS 2C,A08,092632,Barreiro Guerrero; Julio,30,0,30,0
1653303576013,PHYS 2C,A09,092633,Barreiro Guerrero; Julio,29,0,30,1
1653303576013,PHYS 2C,A10,092634,Barreiro Guerrero; Julio,29,0,30,1
1653303576013,PHYS 2C,A11,092635,Barreiro Guerrero; Julio,27,0,30,3
1653303576013,PHYS 2C,A12,092636,Barreiro Guerrero; Julio,29,0,30,1
1653303576013,PHYS 2C,B01,092637,Barreiro Guerrero; Julio,29,0,30,1
1653303576013,PHYS 2C,B02,092638,Barreiro Guerrero; Julio,30,0,30,0
1653303576013,PHYS 2C,B03,092639,Barreiro Guerrero; Julio,28,0,30,2
1653303576013,PHYS 2C,B04,092640,Barreiro Guerrero; Julio,29,0,30,1
1653303576013,PHYS 2C,B05,092641,Barreiro Guerrero; Julio,26,0,30,4
1653303576013,PHYS 2C,B06,092642,Barreiro Guerrero; Julio,28,0,30,2
1653303576013,PHYS 2C,B07,092643,Barreiro Guerrero; Julio,29,0,30,1
1653303576013,PHYS 2C,B08,092644,Barreiro Guerrero; Julio,30,0,30,0
1653303576013,PHYS 2C,B09,092645,Barreiro Guerrero; Julio,29,0,30,1
1653303576013,PHYS 2C,B10,092646,Barreiro Guerrero; Julio,29,0,30,1
1653303576013,PHYS 2C,B11,092647,Barreiro Guerrero; Julio,30,0,30,0
1653303576013,PHYS 2C,B12,092648,Barreiro Guerrero; Julio,30,0,30,0
1653303576545,PHYS 2CL,A01,088625,Du; Chunhui,26,0,30,4
1653303576545,PHYS 2CL,A02,088626,Du; Chunhui,29,0,30,1
1653303576545,PHYS 2CL,A03,088627,Du; Chunhui,21,0,30,9
1653303576545,PHYS 2CL,A04,088628,Du; Chunhui,30,0,30,0
1653303576545,PHYS 2CL,A05,088629,Du; Chunhui,29,0,30,1
1653303576545,PHYS 2CL,A06,088630,Du; Chunhui,24,0,30,6
1653303576545,PHYS 2CL,A07,088631,Du; Chunhui,28,0,30,2
1653303576545,PHYS 2CL,A08,088632,Du; Chunhui,28,0,30,2
1653303576545,PHYS 2CL,A09,088633,Du; Chunhui,24,0,30,6
1653303576545,PHYS 2CL,A10,088634,Du; Chunhui,29,0,30,1
1653303576545,PHYS 2CL,A11,088635,Du; Chunhui,27,0,30,3
1653303576545,PHYS 2CL,A12,088636,Du; Chunhui,30,0,30,0
1653303577069,PHYS 2D,A01,092649,Hirsch; Jorge Eduardo,30,0,30,0
1653303577069,PHYS 2D,A02,092650,Hirsch; Jorge Eduardo,28,0,30,2
1653303577069,PHYS 2D,A03,092651,Hirsch; Jorge Eduardo,30,0,30,0
1653303577069,PHYS 2D,A04,092652,Hirsch; Jorge Eduardo,30,0,30,0
1653303577069,PHYS 2D,A05,092653,Hirsch; Jorge Eduardo,30,0,30,0
1653303577069,PHYS 2D,A06,092654,Hirsch; Jorge Eduardo,30,0,30,0
1653303577594,PHYS 2DL,A01,088639,Butov; Leonid,7,0,16,9
1653303577594,PHYS 2DL,A02,088640,Butov; Leonid,13,0,16,3
1653303577594,PHYS 2DL,A03,094501,Butov; Leonid,13,0,16,3
1653303577594,PHYS 2DL,A04,094502,Butov; Leonid,16,0,16,0
1653303578118,PHYS 4C,A01,092655,Averitt; Richard Douglas,28,0,30,2
1653303578118,PHYS 4C,A02,092656,Averitt; Richard Douglas,30,0,30,0
1653303578118,PHYS 4C,A03,092657,Averitt; Richard Douglas,30,0,30,0
1653303578118,PHYS 4C,A04,092658,Staff,30,0,30,0
1653303578648,PHYS 5,A01,092662,Konopacky; Quinn Morgan,197,0,200,3
1653303579172,PHYS 10,A01,092663,Tytler; David Robert,191,0,192,1
1653303579704,PHYS 100A,A01,092660,Shpyrko; Oleg,114,0,120,6
1653303580232,PHYS 110A,A01,092664,Arovas; Daniel P,116,0,120,4
1653303580756,PHYS 122,A01,088647,Yang; Liang,30,0,40,10
1653303581279,PHYS 130B,A01,092661,Grover; Tarun,106,0,120,14
1653303581804,PHYS 139,A00,088649,Kuti; Julius,19,0,20,1
1653303582328,PHYS 140A,A01,092665,Shotwell; Brian,105,0,120,15
1653303582852,PHYS 161,A01,092666,Fuller; George Michael,46,0,65,19
1653303583381,PHYS 163,A01,092667,Keres; Dusan,48,0,50,2
1653303583910,PHYS 175,A00,088653,Dudko; Olga,18,0,20,2
1653303584433,PHYS 191,A00,088654,Shpyrko; Oleg,26,0,30,4
1653303584968,POLI 11D,A01,090896,Ferree; Karen E,29,0,30,1
1653303584968,POLI 11D,A02,090897,Ferree; Karen E,28,0,30,2
1653303584968,POLI 11D,A03,090899,Ferree; Karen E,28,0,30,2
1653303584968,POLI 11D,A04,090900,Ferree; Karen E,29,0,30,1
1653303585492,POLI 12D,A01,090902,Roeder; Philip G,26,0,30,4
1653303585492,POLI 12D,A02,090903,Roeder; Philip G,27,0,30,3
1653303585492,POLI 12D,A05,090906,Roeder; Philip G,28,0,30,2
1653303585492,POLI 12D,A06,090907,Roeder; Philip G,30,0,30,0
1653303586020,POLI 13DR,A01,090909,Forman; Fonna,26,0,30,4
1653303586020,POLI 13DR,A02,090910,Forman; Fonna,30,0,30,0
1653303586020,POLI 13DR,A03,090911,Forman; Fonna,28,0,30,2
1653303586020,POLI 13DR,A04,090912,Forman; Fonna,30,0,30,0
1653303586020,POLI 13DR,A05,090913,Forman; Fonna,28,0,30,2
1653303586020,POLI 13DR,A06,090914,Forman; Fonna,34,0,34,0
1653303586545,POLI 27,A01,090916,Elgin; Samuel Zincke,23,0,30,7
1653303586545,POLI 27,A02,090917,Elgin; Samuel Zincke,26,0,30,4
1653303586545,POLI 27,A03,090918,Elgin; Samuel Zincke,30,0,30,0
1653303586545,POLI 27,A04,090919,Elgin; Samuel Zincke,28,0,30,2
1653303586545,POLI 27,A05,090920,Elgin; Samuel Zincke,24,0,30,6
1653303586545,POLI 27,A06,090921,Elgin; Samuel Zincke,29,0,30,1
1653303587069,POLI 28,A01,090923,Elgin; Samuel Zincke,23,0,30,7
1653303587069,POLI 28,A02,090924,Elgin; Samuel Zincke,26,0,30,4
1653303587069,POLI 28,A05,090927,Elgin; Samuel Zincke,23,0,30,7
1653303587069,POLI 28,A06,090928,Elgin; Samuel Zincke,23,0,30,7
1653303587594,POLI 30D,A01,090930,Desposato; Scott,22,0,24,2
1653303587594,POLI 30D,A02,090931,Desposato; Scott,22,0,24,2
1653303587594,POLI 30D,A03,090932,Desposato; Scott,23,0,24,1
1653303587594,POLI 30D,A04,090933,Desposato; Scott,24,0,24,0
1653303587594,POLI 30D,A05,090934,Desposato; Scott,23,0,24,1
1653303587594,POLI 30D,A06,090935,Desposato; Scott,24,0,24,0
1653303588122,POLI 100G,A00,090936,Fletcher; Nathan,199,0,208,9
1653303588646,POLI 100V,A00,090937,Gause; LaGina,111,0,115,4
1653303589173,POLI 100W,A00,090938,Paglayan; Agustina,161,0,165,4
1653303589704,POLI 104A,A00,090940,Smith; Glenn Chatmas,186,0,195,9
1653303590241,POLI 104F,A00,090941,Smith; Glenn Chatmas,11,0,19,8
1653303590768,POLI 104M,A00,090942,Stephens; Mattheus E,156,0,165,9
1653303591291,POLI 110A,A00,090943,Wiens; David,39,0,44,5
1653303591814,POLI 110F,A00,090944,Elgin; Samuel Zincke,50,0,50,0
1653303592339,POLI 113A,A00,090945,Magagna; Victor Valentine,469,0,475,6
1653303592339,POLI 113A,B00,090946,Magagna; Victor Valentine,467,0,475,8
1653303592863,POLI 117R,A00,090947,Forman; Fonna,16,0,40,24
1653303593386,POLI 120E,A00,090948,Strom; Kaare,47,0,50,3
1653303593913,POLI 120G,A00,090949,Fisk; David Lee,110,0,115,5
1653303594508,POLI 120H,A00,090950,Fisk; David Lee,111,0,115,4
1653303595035,POLI 133A,A00,090951,Naoi; Megumi,156,0,165,9
1653303595562,POLI 135,A00,090952,Fisk; David Lee,111,0,115,4
1653303596092,POLI 142J,A00,090953,Slantchev; Branislav,45,0,50,5
1653303596620,POLI 143,A00,090954,Gartzke; Erik,111,0,115,4
1653303597145,POLI 149,A00,090955,Joseph; Michael F,152,0,165,13
1653303597672,POLI 151,A00,090956,Schneider; Christina,92,0,100,8
1653303598200,POLI 165,A00,090957,Warren; Scott,45,0,50,5
1653303598724,POLI 178,A00,090958,Joseph; Michael F,34,0,50,16
1653303599252,POLI 191A,A00,090959,Forman; Fonna & Hoston; Germaine,25,0,25,0
1653303599776,POLI 194,A00,090960,Hill; Seth J,9999,0,9999,0
1653303600299,POLI 194SD,A00,090961,Nichter; Maysa,9999,0,9999,0
1653303600825,POLI 197SD,001,090962,Nichter; Maysa,9999,0,9999,0
1653303601356,PSYC 1,A00,088391,Ferreira; Victor,194,0,200,6
1653303601883,PSYC 2,A00,093916,Moranton; Nirelia Melbina-,192,0,195,3
1653303602408,PSYC 3,A00,088392,Pilegard; Celeste Cristine,221,0,225,4
1653303602931,PSYC 6,A00,088393,McCullough; Michael E,198,0,200,2
1653303603458,PSYC 7,A00,088394,Powell; Lindsey Jane,196,0,200,4
1653303603992,PSYC 60,A01,088397,Lowe; Angela Beth,12,0,25,13
1653303603992,PSYC 60,A02,088398,Lowe; Angela Beth,25,0,25,0
1653303603992,PSYC 60,A03,088399,Lowe; Angela Beth,24,0,25,1
1653303603992,PSYC 60,A04,088400,Lowe; Angela Beth,23,0,25,2
1653303603992,PSYC 60,A05,088401,Lowe; Angela Beth,24,0,25,1
1653303603992,PSYC 60,A06,088402,Lowe; Angela Beth,25,0,25,0
1653303603992,PSYC 60,A07,088403,Lowe; Angela Beth,24,0,25,1
1653303603992,PSYC 60,B01,088405,Rickard; Timothy C.,25,0,25,0
1653303603992,PSYC 60,B02,088406,Rickard; Timothy C.,25,0,25,0
1653303603992,PSYC 60,B03,088407,Rickard; Timothy C.,25,0,25,0
1653303603992,PSYC 60,B04,088408,Rickard; Timothy C.,23,0,25,2
1653303603992,PSYC 60,B05,088410,Rickard; Timothy C.,24,0,25,1
1653303603992,PSYC 60,B06,088411,Rickard; Timothy C.,24,0,25,1
1653303603992,PSYC 60,B07,088412,Rickard; Timothy C.,24,0,25,1
1653303604514,PSYC 70,A01,088414,Pilegard; Celeste Cristine,17,0,25,8
1653303604514,PSYC 70,A02,088415,Pilegard; Celeste Cristine,24,0,25,1
1653303604514,PSYC 70,A03,088416,Pilegard; Celeste Cristine,25,0,25,0
1653303604514,PSYC 70,A04,088417,Pilegard; Celeste Cristine,25,0,25,0
1653303604514,PSYC 70,A05,088418,Pilegard; Celeste Cristine,22,0,25,3
1653303604514,PSYC 70,A06,088419,Pilegard; Celeste Cristine,19,0,25,6
1653303605043,PSYC 71,A01,088421,Lowe; Angela Beth,15,0,25,10
1653303605043,PSYC 71,A02,088422,Lowe; Angela Beth,21,0,25,4
1653303605043,PSYC 71,B01,088424,Steiner; Eric Tomas,20,0,25,5
1653303605043,PSYC 71,B02,088425,Steiner; Eric Tomas,23,0,25,2
1653303605567,PSYC 87,A00,093915,Gorman; Michael R.,20,0,20,0
1653303606090,PSYC 88,A00,088426,Dobkins; Karen R.,61,0,65,4
1653303606618,PSYC 100,A00,088428,Chapman; Eddie Nathaniel,125,0,170,45
1653303607142,PSYC 101,A00,088429,Heyman; Gail D.,148,0,170,22
1653303607664,PSYC 102,A00,093917,Moranton; Nirelia Melbina-,162,0,170,8
1653303608191,PSYC 104,A00,088430,Fine; Rachel,163,0,175,12
1653303608715,PSYC 116A,A01,088433,Lang; Ariel,25,0,25,0
1653303609240,PSYC 122,A00,088434,Miller; Cory T.,103,0,115,12
1653303609765,PSYC 125,A00,088436,Rose; Fred E.,90,0,120,30
1653303610291,PSYC 134,A00,088437,Kaye; Walter H.,235,0,250,15
1653303610817,PSYC 137,A00,088438,Fine; Rachel,210,0,216,6
1653303611340,PSYC 145,A00,093918,Staff,73,0,90,17
1653303611864,PSYC 147,A00,088441,Wong; Lauren Hitomi,120,0,146,26
1653303612388,PSYC 154,A00,093919,Lacefield; Katharine I,270,0,295,25
1653303612917,PSYC 158,A00,088443,Willis; Jarryd Thomas,250,0,295,45
1653303613441,PSYC 162,A00,088444,Wixted; John T,210,0,225,15
1653303613968,PSYC 167,A00,088445,Walker; Caren Michelle,0,0,30,30
1653303614495,PSYC 168,A00,088446,Chapman; Eddie Nathaniel,222,0,250,28
1653303615019,PSYC 171,A00,088447,Mukku; Dhananjaya,66,0,75,9
1653303615547,PSYC 178,A00,088448,Glaser; Dale,105,0,120,15
1653303616071,PSYC 179,A00,088449,Lacefield; Katharine I,193,0,250,57
1653303616601,PSYC 181,A00,088450,Anagnostaras; Stephan,284,0,300,16
1653303617124,PSYC 189,A00,088451,Gentner; Tim,19,0,31,12
1653303617648,PSYC 193,A00,088452,Gremel; Christina M,19,0,20,1
1653303617648,PSYC 193,B00,088453,Staff,19,0,20,1
1653303618172,PSYC 193L,A01,088455,Staff,33,0,35,2
1653303618701,PSYC 194A,A01,088461,Heyman; Gail D.,35,0,35,0
1653303619232,RELI 1,A01,086478,Kalleres; Dayna,20,0,20,0
1653303619232,RELI 1,A02,086479,Kalleres; Dayna,19,0,20,1
1653303619758,RELI 147,A00,088409,Caciola; Nancy A,0,0,0,0
1653303620285,REV 1,A01,092308,Leigh; Brian,24,0,24,0
1653303620285,REV 1,A02,092310,Leigh; Brian,24,0,24,0
1653303620285,REV 1,A03,092312,Leigh; Brian,24,0,24,0
1653303620285,REV 1,A04,092314,Leigh; Brian,24,0,24,0
1653303620285,REV 1,A05,092316,Leigh; Brian,24,0,24,0
1653303620809,REV 2,A01,092318,Staff,28,0,28,0
1653303620809,REV 2,A02,092319,Staff,28,0,28,0
1653303621332,REV 20,A00,092320,Staff,40,0,40,0
1653303621858,REV 87,A00,092321,Lyon; Antony J.,20,0,20,0
1653303622382,SE 1,A01,088674,Van Den Einde; Yael Dahlia,48,0,48,0
1653303622382,SE 1,A02,088675,Van Den Einde; Yael Dahlia,47,0,48,1
1653303622382,SE 1,A03,088676,Van Den Einde; Yael Dahlia,46,0,48,2
1653303622905,SE 101A,A00,088677,Morrison; Machel Leigh,191,0,200,9
1653303623429,SE 101C,A00,088678,Zhu; Qiang,137,0,145,8
1653303623955,SE 125,A00,088679,Conte; Joel P,143,0,145,2
1653303624479,SE 130A,A00,088680,Loh; Kenneth J. H.,110,0,115,5
1653303625002,SE 131B,A00,088681,Krysl; Petr,84,0,115,31
1653303625524,SE 142,A01,088683,Staff,11,0,18,7
1653303625524,SE 142,A02,088684,Staff,13,0,18,5
1653303626052,SE 164,A01,088686,Loh; Kenneth J. H.,14,0,16,2
1653303626576,SE 180,A00,088687,Elgamal; Ahmed,66,0,75,9
1653303627103,SE 181,A01,088689,McCartney; John Scott,25,0,30,5
1653303627103,SE 181,A02,088690,McCartney; John Scott,14,0,30,16
1653303627103,SE 181,A03,088691,McCartney; John Scott,25,0,25,0
1653303627103,SE 181,A04,088692,McCartney; John Scott,25,0,25,0
1653303627627,SIO 12,A00,088342,Staff,141,0,146,5
1653303628158,SIO 15,A00,088343,Laske; Gabi,333,0,340,7
1653303628687,SIO 30,A01,092382,Castillo; Paterno R.,28,0,35,7
1653303628687,SIO 30,A02,092383,Castillo; Paterno R.,32,0,35,3
1653303628687,SIO 30,A03,092384,Castillo; Paterno R.,35,0,35,0
1653303628687,SIO 30,A04,092385,Castillo; Paterno R.,35,0,35,0
1653303629213,SIO 40,A00,088345,Barbeau; Katherine,144,0,146,2
1653303629744,SIO 50,A01,088347,Cook; Geoffrey W,11,0,14,3
1653303629744,SIO 50,A02,088348,Cook; Geoffrey W,11,0,14,3
1653303630268,SIO 87,A00,088350,Cook; Geoffrey W,20,0,20,0
1653303630268,SIO 87,B00,088351,Cook; Geoffrey W,20,0,20,0
1653303630268,SIO 87,C00,094017,Gilbert; Jack Anthony,20,0,20,0
1653303630268,SIO 87,D00,094018,Gerwick; William Henry,20,0,20,0
1653303630790,SIO 90,A00,088352,Staff,56,0,60,4
1653303631315,SIO 100,A00,088354,Norris; Richard D. & Gee; Jeffrey S,10,0,20,10
1653303631850,SIO 101,A01,088356,Aluwihare; Lihini & Decima; Moira R.,1,0,30,29
1653303631850,SIO 101,A02,088357,Aluwihare; Lihini & Decima; Moira R.,15,0,30,15
1653303632387,SIO 103,A01,088359,Parnell-Turner; Ross Ernes,21,0,25,4
1653303632911,SIO 105,A00,088360,Driscoll; Neal W.,18,0,20,2
1653303633436,SIO 108,A01,088363,Teranes; Jane,15,0,20,5
1653303633959,SIO 109R,A00,088364,Forman; Fonna,27,0,40,13
1653303634486,SIO 110,A01,088366,Staff,8,0,29,21
1653303635012,SIO 117,A01,088368,Keeling; Ralph F.,31,0,36,5
1653303635537,SIO 123,A00,088369,Allen; Andrew Ellis,61,0,70,9
1653303636063,SIO 132,A01,092386,Hechinger; Ryan F. & Kacev; David,17,0,28,11
1653303636063,SIO 132,A02,092387,Hechinger; Ryan F. & Kacev; David,26,0,28,2
1653303636063,SIO 132,A03,092388,Hechinger; Ryan F. & Kacev; David,28,0,28,0
1653303636063,SIO 132,A04,092389,Hechinger; Ryan F. & Kacev; David,23,0,28,5
1653303636063,SIO 132,A05,092390,Hechinger; Ryan F. & Kacev; David,27,0,28,1
1653303636063,SIO 132,A06,092391,Hechinger; Ryan F. & Kacev; David,27,0,28,1
1653303636597,SIO 136,A01,088373,Kacev; David & Bowman; Jeff Shovlowsky,0,0,5,7
1653303636597,SIO 136,B01,088376,Kacev; David & Bowman; Jeff Shovlowsky,0,0,5,5
1653303637120,SIO 155,A01,088379,Day; James M.D.,1,0,5,4
1653303637645,SIO 170,A00,088380,Cook; Geoffrey W,29,0,30,1
1653303638170,SIO 171,A01,088382,Rudnick; Daniel Lars,37,0,40,3
1653303638694,SIO 175,A01,088384,Merrifield; Mark A,22,0,25,3
1653303639227,SIO 177,A00,088385,Becker; Janet Maria,15,0,20,5
1653303639757,SIO 179,A01,088387,Martz; Todd R.,7,0,15,8
1653303640804,SIO 189,A00,088390,Hamdoun; Amr,35,0,60,25
1653303641331,SIO 194,A00,091602,Hill; Seth J,9999,0,9999,0
1653303641855,SOCE 194,A00,091601,Hill; Seth J,9999,0,9999,0
1653303642398,SOCI 1,A01,093704,Skrentny; John David,19,0,20,1
1653303642398,SOCI 1,A02,093705,Skrentny; John David,20,0,20,0
1653303642398,SOCI 1,A03,093706,Skrentny; John David,18,0,20,2
1653303642398,SOCI 1,A04,093707,Skrentny; John David,19,0,20,1
1653303642398,SOCI 1,A05,093708,Skrentny; John David,17,0,20,3
1653303642398,SOCI 1,A06,093709,Skrentny; John David,20,0,20,0
1653303642398,SOCI 1,A07,093710,Skrentny; John David,20,0,20,0
1653303642398,SOCI 1,A08,093711,Skrentny; John David,20,0,20,0
1653303642398,SOCI 1,A09,093712,Skrentny; John David,20,0,20,0
1653303642398,SOCI 1,A10,093713,Skrentny; John David,20,0,20,0
1653303642398,SOCI 1,A11,093714,Skrentny; John David,20,0,20,0
1653303642923,SOCI 30,A01,093716,Staff,30,0,30,0
1653303642923,SOCI 30,A02,093717,Staff,30,0,30,0
1653303643453,SOCI 60,A01,093719,Staff,17,0,20,3
1653303643453,SOCI 60,A02,093720,Staff,18,0,20,2
1653303643453,SOCI 60,A03,093721,Staff,20,0,20,0
1653303643453,SOCI 60,A04,093722,Staff,20,0,20,0
1653303643975,SOCI 87,A00,093819,Blair-Loy; Mary,20,0,20,0
1653303644504,SOCI 100,A01,093724,Estefan; Michel,15,0,20,5
1653303644504,SOCI 100,A02,093725,Estefan; Michel,5,0,20,15
1653303645027,SOCI 104,A00,093728,Gong; Neil M,22,0,25,3
1653303645553,SOCI 104Q,A00,093729,Staff,23,0,25,2
1653303646077,SOCI 106,A00,093730,Staff,25,0,25,0
1653303646601,SOCI 109,A00,093731,Staff,21,0,25,4
1653303647129,SOCI 110,A00,093732,Binder; Amy,24,0,25,1
1653303648792,SOCI 117,A01,091568,Chung; Luz Marina,29,0,35,6
1653303648792,SOCI 117,A02,091569,Chung; Luz Marina,35,0,35,0
1653303649317,SOCI 118,A00,093735,Staff,0,0,0,0
1653303649842,SOCI 120T,A00,093736,Lampland; Martha,50,0,50,0
1653303649842,SOCI 120T,B00,094832,Staff,69,0,70,1
1653303650365,SOCI 122,A00,093737,Lewis; Kevin Michael,62,0,70,8
1653303650887,SOCI 123,A00,094831,Staff,57,0,65,8
1653303651414,SOCI 125,A00,093738,Staff,115,0,120,5
1653303651939,SOCI 127,A00,094894,Staff,54,0,56,2
1653303652470,SOCI 132,A00,093739,Blair-Loy; Mary,51,0,60,9
1653303653518,SOCI 136F,A00,094830,Staff,45,0,56,11
1653303654046,SOCI 138,A00,093741,Navon; Daniel,117,0,120,3
1653303654572,SOCI 140A,A00,093743,Gong; Neil M,53,0,60,7
1653303655102,SOCI 141,A00,093744,Summers; Valerie R.,111,0,120,9
1653303656148,SOCI 144,A00,093746,Staff,0,0,0,0
1653303658245,SOCI 159,A00,094902,Staff,49,0,50,1
1653303658769,SOCI 160,A00,093750,Staff,0,0,0,0
1653303659301,SOCI 165,A00,093751,Rona-Tas; Akos,43,0,48,5
1653303659825,SOCI 165A,A00,094206,Hallin; Daniel C,3,0,4,1
1653303660350,SOCI 166,A00,093752,Lampland; Martha,52,0,56,4
1653303660882,SOCI 176,A00,093753,Turner; Christena L.,44,0,48,4
1653303661407,SOCI 180,A00,094901,Staff,56,0,56,0
1653303661929,SOCI 185,A00,094903,Staff,55,0,56,1
1653303662452,SOCI 196A,A00,093754,Shafir; Gershon,20,0,20,0
1653303662978,SXTH 1,A01,092351,Bronstein; Phoebe Malan,18,0,18,0
1653303662978,SXTH 1,A02,092352,Bronstein; Phoebe Malan,18,0,18,0
1653303662978,SXTH 1,A03,092353,Bronstein; Phoebe Malan,18,0,18,0
1653303663511,SXTH 20A,A00,092355,Chilukuri; Lakshmi N,56,0,56,0
1653303664078,SYN 2,001,091487,Gladstein; Jill M,13,0,15,2
1653303664078,SYN 2,002,091488,Gladstein; Jill M,14,0,15,1
1653303664078,SYN 2,003,091490,Gladstein; Jill M,12,0,15,3
1653303664078,SYN 2,004,091491,Gladstein; Jill M,15,0,15,0
1653303664078,SYN 2,005,091493,Gladstein; Jill M,15,0,15,0
1653303664078,SYN 2,006,091495,Gladstein; Jill M,15,0,15,0
1653303664078,SYN 2,007,091496,Gladstein; Jill M,15,0,15,0
1653303664078,SYN 2,008,091497,Gladstein; Jill M,14,0,15,1
1653303664078,SYN 2,009,091499,Gladstein; Jill M,13,0,15,2
1653303664078,SYN 2,010,091501,Gladstein; Jill M,13,0,15,2
1653303664078,SYN 2,011,091502,Gladstein; Jill M,13,0,15,2
1653303664078,SYN 2,012,091503,Gladstein; Jill M,15,0,15,0
1653303664078,SYN 2,013,091505,Gladstein; Jill M,13,0,15,2
1653303664078,SYN 2,014,091506,Gladstein; Jill M,12,0,15,3
1653303664078,SYN 2,015,091508,Gladstein; Jill M,14,0,15,1
1653303664078,SYN 2,016,091509,Gladstein; Jill M,12,0,15,3
1653303664078,SYN 2,017,091510,Gladstein; Jill M,14,0,15,1
1653303664078,SYN 2,018,091512,Gladstein; Jill M,15,0,15,0
1653303664078,SYN 2,019,091513,Gladstein; Jill M,15,0,15,0
1653303664078,SYN 2,020,091514,Gladstein; Jill M,15,0,15,0
1653303664078,SYN 2,021,091516,Gladstein; Jill M,12,0,15,3
1653303664078,SYN 2,022,091517,Gladstein; Jill M,13,0,15,2
1653303664078,SYN 2,023,091518,Gladstein; Jill M,15,0,15,0
1653303664078,SYN 2,024,091519,Gladstein; Jill M,15,0,15,0
1653303664078,SYN 2,025,091520,Gladstein; Jill M,11,0,15,4
1653303664078,SYN 2,026,091521,Gladstein; Jill M,15,0,15,0
1653303664078,SYN 2,027,091522,Gladstein; Jill M,0,0,0,0
1653303664078,SYN 2,028,091523,Gladstein; Jill M,0,0,0,0
1653303664078,SYN 2,029,091524,Gladstein; Jill M,0,0,0,0
1653303664078,SYN 2,030,091525,Gladstein; Jill M,0,0,0,0
1653303664078,SYN 2,031,091526,Gladstein; Jill M,14,0,15,1
1653303664078,SYN 2,032,091527,Gladstein; Jill M,15,0,15,0
1653303664078,SYN 2,033,091528,Gladstein; Jill M,0,0,0,0
1653303664078,SYN 2,034,091529,Gladstein; Jill M,15,0,15,0
1653303664078,SYN 2,035,091530,Gladstein; Jill M,15,0,15,0
1653303664078,SYN 2,036,091531,Gladstein; Jill M,15,0,15,0
1653303664078,SYN 2,037,091532,Gladstein; Jill M,15,0,15,0
1653303664078,SYN 2,038,091533,Gladstein; Jill M,15,0,15,0
1653303664078,SYN 2,039,091534,Gladstein; Jill M,15,0,15,0
1653303664078,SYN 2,040,091535,Gladstein; Jill M,15,0,15,0
1653303664602,SYN 100,A01,091537,Gladstein; Jill M,26,0,30,4
1653303664602,SYN 100,B01,091539,Gladstein; Jill M,26,0,30,4
1653303664602,SYN 100,C01,091541,Gladstein; Jill M,26,0,30,4
1653303664602,SYN 100,D01,091543,Gladstein; Jill M,25,0,30,5
1653303664602,SYN 100,E01,091545,Gladstein; Jill M,28,0,30,2
1653303665128,TDAC 1,A00,088922,Walsh; Kim C.,10,0,10,0
1653303665128,TDAC 1,B00,088923,Walsh; Kim C.,8,0,10,2
1653303665128,TDAC 1,C00,088924,Walsh; Kim C.,0,0,10,10
1653303665128,TDAC 1,D00,088925,Walsh; Kim C.,7,0,10,3
1653303665128,TDAC 1,E00,088926,Walsh; Kim C.,2,0,10,8
1653303665128,TDAC 1,F00,088927,Walsh; Kim C.,9,0,10,1
1653303665654,TDAC 101,A00,088972,Harting; Carla Kelso,9,0,10,1
1653303665654,TDAC 101,B00,088973,Salovey; Todd,8,0,10,2
1653303665654,TDAC 101,C00,088974,Walsh; Kim C.,6,0,10,4
1653303666183,TDAC 102,A00,088975,Basso; Beatrice,9,0,10,1
1653303666183,TDAC 102,B00,088976,Basso; Beatrice,7,0,10,3
1653303666715,TDAC 103A,A00,094044,Castro; Robert Jess,32,0,35,3
1653303667245,TDAC 108,A00,088977,Staff,20,0,20,0
1653303667770,TDAC 109,A00,088978,Blair; Kyle Adam,20,0,20,0
1653303668294,TDAC 115,A00,088979,Newcomb; James,20,0,20,0
1653303668817,TDAC 122,A00,088981,Staff,30,0,30,0
1653303669341,TDAC 123,A00,088982,Staff,30,0,30,0
1653303669865,TDDE 1,A01,088929,Benzoni; Elisa,9,0,11,2
1653303669865,TDDE 1,A02,088930,Benzoni; Elisa,11,0,11,0
1653303669865,TDDE 1,A03,088931,Benzoni; Elisa,11,0,11,0
1653303669865,TDDE 1,A04,088932,Benzoni; Elisa,10,0,11,1
1653303669865,TDDE 1,A05,088933,Benzoni; Elisa,11,0,11,0
1653303670393,TDDE 130,A00,088983,Staff,20,0,20,0
1653303670921,TDDE 132,A00,094263,Staff,20,0,20,0
1653303671446,TDDE 169A,A00,094046,Petrovich; Victoria A.,18,0,20,2
1653303671974,TDDM 1,A00,088934,Snaith; Yolande,6,0,10,4
1653303672498,TDDM 5,A00,088935,Smith; Alison D,30,0,30,0
1653303673023,TDDR 101,A00,088986,Powell; Lora,34,0,35,1
1653303673547,TDDR 111,A00,088987,Stalling; Vanessa,24,0,30,6
1653303673547,TDDR 111,B00,094045,Castro; Robert Jess,14,0,16,2
1653303674070,TDDR 190,A00,088988,Stalling; Vanessa,10,0,10,0
1653303674599,TDGE 1,A01,088937,Salovey; Todd,12,0,12,0
1653303674599,TDGE 1,A02,088938,Salovey; Todd,10,0,12,2
1653303674599,TDGE 1,A03,088939,Salovey; Todd,8,0,12,4
1653303674599,TDGE 1,A04,088940,Salovey; Todd,12,0,12,0
1653303674599,TDGE 1,A05,088941,Salovey; Todd,11,0,12,1
1653303674599,TDGE 1,A06,088942,Salovey; Todd,12,0,12,0
1653303675123,TDGE 10,A00,088943,Havis; Allan,191,0,200,9
1653303675646,TDGE 11,A00,088944,Staff,200,0,200,0
1653303676178,TDGE 25,A00,088945,Harting; Carla Kelso,19,0,20,1
1653303676178,TDGE 25,B00,088946,Harting; Carla Kelso,19,0,20,1
1653303676178,TDGE 25,C00,088947,Harting; Carla Kelso,20,0,20,0
1653303676178,TDGE 25,D00,088948,Harting; Carla Kelso,19,0,20,1
1653303676178,TDGE 25,E00,088949,Harting; Carla Kelso,20,0,20,0
1653303676178,TDGE 25,F00,088950,Harting; Carla Kelso,19,0,20,1
1653303676178,TDGE 25,G00,088951,Harting; Carla Kelso,19,0,20,1
1653303676706,TDGE 127,A00,088990,Havis; Allan,188,0,200,12
1653303677235,TDHD 21,A00,088952,Jun; Grace Shin Hae,20,0,20,0
1653303677764,TDHT 10,A00,088953,Power; Jade Yukana,14,0,14,0
1653303677764,TDHT 10,B00,088954,Power; Jade Yukana,13,0,14,1
1653303678290,TDHT 21,A01,088956,Power; Jade Yukana,17,0,18,1
1653303678290,TDHT 21,A02,088957,Power; Jade Yukana,7,0,11,4
1653303678290,TDHT 21,A03,088958,Power; Jade Yukana,11,0,11,0
1653303678819,TDHT 101,A00,088994,Burelle; Julie Sara Veronique,21,0,25,4
1653303679354,TDHT 114,A00,094208,Williams; Madison Mae,47,0,50,3
1653303679876,TDHT 119,A00,094299,Burelle; Julie Sara Veronique,25,0,25,0
1653303680410,TDMV 1,A00,088959,Weinberg; Sadie,23,0,30,7
1653303680944,TDMV 2,A00,088960,Sammartano; Tonnie,27,0,30,3
1653303680944,TDMV 2,B00,094043,Duran; Marcos Antonio,29,0,30,1
1653303681469,TDMV 3,A00,088961,Arcidiacono; Kristin,27,0,30,3
1653303681994,TDMV 110,A00,088995,Wilson; Terry A.,0,0,0,0
1653303682518,TDMV 120,A00,088996,Smith; Alison D,17,0,20,3
1653303683040,TDMV 122,A00,088997,Chaleff; Rebecca,28,0,30,2
1653303683568,TDMV 130,A00,094042,Rincon; Alicia,30,0,30,0
1653303684091,TDMV 138,A00,088998,Jun; Grace Shin Hae,12,0,40,28
1653303684621,TDMV 142,A00,088999,Caligagan; Tony,28,0,40,12
1653303685151,TDMV 143,A00,094041,Foster-King; Sandra,37,0,40,3
1653303685679,TDMV 146,A00,089000,Caligagan; Tony,39,0,40,1
1653303686205,TDPF 160,A00,094264,Snaith; Yolande,30,0,30,0
1653303686205,TDPF 160,B00,094265,Smith; Alison D,30,0,30,0
1653303686205,TDPF 160,C00,094266,Weinberg; Sadie,30,0,30,0
1653303686728,TDPR 6,A01,088963,Benzoni; Elisa,25,0,25,0
1653303686728,TDPR 6,A02,088964,Benzoni; Elisa,25,0,25,0
1653303687251,TDPR 102,A00,089003,Staff,15,0,15,0
1653303687775,TDPR 104,A00,089004,Powell; Lora,15,0,15,0
1653303688299,TDPW 1,A00,088965,Staff,10,0,10,0
1653303688299,TDPW 1,B00,088966,Staff,10,0,10,0
1653303688299,TDPW 1,C00,088967,Staff,9,0,10,1
1653303688299,TDPW 1,D00,088968,Staff,9,0,10,1
1653303688299,TDPW 1,E00,088969,Staff,10,0,10,0
1653303688299,TDPW 1,F00,088970,Staff,9,0,10,1
1653303688828,TDTR 10,A00,088971,Wilson; Terry A.,22,0,25,3
1653303689353,TMC 2,A01,092358,Carver; Leslie J.,20,0,20,0
1653303689353,TMC 2,A02,092359,Carver; Leslie J.,20,0,20,0
1653303689353,TMC 2,A03,092360,Carver; Leslie J.,20,0,20,0
1653303689353,TMC 2,A04,092361,Carver; Leslie J.,20,0,20,0
1653303689353,TMC 2,A05,092362,Carver; Leslie J.,20,0,20,0
1653303689353,TMC 2,A06,092363,Carver; Leslie J.,20,0,20,0
1653303689876,TMC 15,A00,092364,Atkinson; Arthur Laird,20,0,20,0
1653303690401,TMC 20,A00,092365,Carver; Leslie J.,20,0,20,0
1653303690925,TMC 90,A00,092366,Mell; Loren K.,20,0,20,0
1653303691448,TMC 120,A01,092368,Staff,20,0,20,0
1653303691974,USP 1,A01,087520,Kwak; Nancy,19,0,20,1
1653303691974,USP 1,A02,087521,Kwak; Nancy,17,0,20,3
1653303691974,USP 1,A03,087522,Kwak; Nancy,16,0,20,4
1653303691974,USP 1,A04,087523,Kwak; Nancy,19,0,20,1
1653303692503,USP 2,A01,087525,Lerner; Amy M,29,0,30,1
1653303692503,USP 2,A02,087526,Lerner; Amy M,29,0,30,1
1653303693033,USP 4,A00,094267,Polat; Soydan Alihan,16,0,20,4
1653303693033,USP 4,B00,094268,Staff,20,0,20,0
1653303693561,USP 5,A01,087532,Staff,26,0,30,4
1653303693561,USP 5,A02,087533,Staff,27,0,30,3
1653303694095,USP 6,A01,094322,Shvartzberg Carrio; Manuel,20,0,20,0
1653303694095,USP 6,A02,094323,Shvartzberg Carrio; Manuel,20,0,20,0
1653303694620,USP 15,A01,087535,Anderson; William Raymond,20,0,25,5
1653303694620,USP 15,A02,087536,Anderson; William Raymond,23,0,25,2
1653303695143,USP 25,A00,087537,Staff,0,0,7,7
1653303695673,USP 50,A00,087538,Martin; Isaac,38,0,40,2
1653303696201,USP 124,A00,087539,Bussell; Mirle Rabinowitz,26,0,35,9
1653303696730,USP 125,A00,087540,Staff,17,0,23,6
1653303697258,USP 136,A00,087541,Staff,23,0,25,2
1653303697782,USP 144,A00,087542,Staff,136,0,146,10
1653303698306,USP 151,A00,087543,Boomhower; Matthew Charles,18,0,20,2
1653303698830,USP 152,A01,087545,Moeder; Nathan L,17,0,20,3
1653303698830,USP 152,A02,087546,Moeder; Nathan L,20,0,20,0
1653303699353,USP 153,A00,087547,Moden; Kelly Kjestine,27,0,30,3
1653303699881,USP 161,A00,094854,Wartell; Julie Dara,25,0,25,0
1653303700412,USP 169,A00,087548,Bajaj; Ravi Siddharth,30,0,35,5
1653303701006,USP 170,A00,087549,Hinds; Juli Beth,30,0,35,5
1653303701535,USP 171,A00,087550,Lerner; Amy M,38,0,50,12
1653303702064,USP 176,A00,094853,Staff,24,0,25,1
1653303702587,USP 177A,A00,087551,Peerson; Susan,20,0,22,2
1653303703111,USP 184,A00,094324,Shvartzberg Carrio; Manuel,24,0,25,1
1653303703634,USP 185A,A01,087553,Norr; Alex Vaughn,28,0,30,2
1653303703634,USP 185A,B01,087555,Boomhower; Matthew Charles,26,0,30,4
1653303704160,USP 186,A01,087557,Pezzoli; Keith,22,0,25,3
1653303704160,USP 186,A02,087558,Pezzoli; Keith,20,0,25,5
1653303705224,USP 191A,A00,087561,Rothberg; Scott Jacob,18,0,20,2
1653303705751,USP 194,A00,091599,Hill; Seth J,9999,0,9999,0
1653303706276,VIS 1,A01,088809,Tonies; Joshua Vanjaymes,10,0,10,0
1653303706276,VIS 1,A02,088810,Tonies; Joshua Vanjaymes,10,0,10,0
1653303706276,VIS 1,A03,088811,Tonies; Joshua Vanjaymes,3,0,10,7
1653303706276,VIS 1,A04,088812,Tonies; Joshua Vanjaymes,8,0,10,2
1653303706276,VIS 1,A05,088813,Tonies; Joshua Vanjaymes,4,0,10,6
1653303706276,VIS 1,A06,088814,Tonies; Joshua Vanjaymes,6,0,10,4
1653303706276,VIS 1,A07,088815,Tonies; Joshua Vanjaymes,6,0,10,4
1653303706276,VIS 1,A08,088816,Tonies; Joshua Vanjaymes,9,0,10,1
1653303706276,VIS 1,A09,088817,Tonies; Joshua Vanjaymes,8,0,10,2
1653303706276,VIS 1,A10,088818,Tonies; Joshua Vanjaymes,8,0,10,2
1653303706276,VIS 1,A11,088819,Tonies; Joshua Vanjaymes,3,0,10,7
1653303706276,VIS 1,A12,088820,Tonies; Joshua Vanjaymes,6,0,10,4
1653303706276,VIS 1,A13,088821,Tonies; Joshua Vanjaymes,6,0,10,4
1653303706276,VIS 1,A14,088822,Tonies; Joshua Vanjaymes,7,0,10,3
1653303706276,VIS 1,A15,088823,Tonies; Joshua Vanjaymes,7,0,10,3
1653303706276,VIS 1,A16,088824,Tonies; Joshua Vanjaymes,8,0,10,2
1653303706809,VIS 20,A01,088826,Woods; Ann,19,0,20,1
1653303706809,VIS 20,A02,088827,Woods; Ann,20,0,20,0
1653303706809,VIS 20,A03,088828,Woods; Ann,18,0,20,2
1653303706809,VIS 20,A04,088829,Woods; Ann,17,0,20,3
1653303706809,VIS 20,A05,088830,Woods; Ann,20,0,20,0
1653303706809,VIS 20,A06,088831,Woods; Ann,20,0,20,0
1653303706809,VIS 20,A07,088832,Woods; Ann,20,0,20,0
1653303706809,VIS 20,A08,088833,Woods; Ann,20,0,20,0
1653303706809,VIS 20,A09,088834,Woods; Ann,18,0,20,2
1653303706809,VIS 20,A10,088835,Woods; Ann,19,0,20,1
1653303706809,VIS 20,A11,088836,Woods; Ann,20,0,20,0
1653303706809,VIS 20,A12,088837,Woods; Ann,20,0,20,0
1653303707332,VIS 23,A00,088838,Rose; Jordan M,3,0,3,0
1653303707856,VIS 30,A01,088840,Stone; Patricia,11,0,11,0
1653303707856,VIS 30,A02,088841,Stone; Patricia,7,0,11,4
1653303707856,VIS 30,A03,094821,Stone; Patricia,8,0,11,3
1653303707856,VIS 30,A04,094822,Stone; Patricia,11,0,11,0
1653303708385,VIS 41,A01,088844,D'Elena-Tweed; Jessica Erin,9,0,10,1
1653303708385,VIS 41,A02,088845,D'Elena-Tweed; Jessica Erin,9,0,10,1
1653303708385,VIS 41,A03,088846,D'Elena-Tweed; Jessica Erin,9,0,10,1
1653303708385,VIS 41,A04,088847,D'Elena-Tweed; Jessica Erin,9,0,10,1
1653303708385,VIS 41,A05,088848,D'Elena-Tweed; Jessica Erin,10,0,10,0
1653303708385,VIS 41,A06,088849,D'Elena-Tweed; Jessica Erin,10,0,10,0
1653303708385,VIS 41,A07,088850,D'Elena-Tweed; Jessica Erin,10,0,10,0
1653303708385,VIS 41,A08,088851,D'Elena-Tweed; Jessica Erin,10,0,10,0
1653303708909,VIS 60,A01,088853,Sepuya; Paul Mpagi,9,0,10,1
1653303708909,VIS 60,A02,088854,Sepuya; Paul Mpagi,10,0,10,0
1653303708909,VIS 60,A03,088855,Sepuya; Paul Mpagi,10,0,10,0
1653303708909,VIS 60,A04,088856,Sepuya; Paul Mpagi,10,0,10,0
1653303708909,VIS 60,A05,088857,Sepuya; Paul Mpagi,10,0,10,0
1653303708909,VIS 60,A06,088858,Sepuya; Paul Mpagi,10,0,10,0
1653303708909,VIS 60,A07,088859,Sepuya; Paul Mpagi,9,0,10,1
1653303708909,VIS 60,A08,093932,Sepuya; Paul Mpagi,10,0,10,0
1653303709434,VIS 70N,A01,088861,Segade; Alexandro Abraham,8,0,8,0
1653303709434,VIS 70N,A02,088862,Segade; Alexandro Abraham,8,0,8,0
1653303709434,VIS 70N,A03,088863,Segade; Alexandro Abraham,8,0,8,0
1653303709434,VIS 70N,A04,088864,Segade; Alexandro Abraham,8,0,8,0
1653303709434,VIS 70N,A05,088865,Segade; Alexandro Abraham,7,0,8,1
1653303709434,VIS 70N,A06,088866,Segade; Alexandro Abraham,8,0,8,0
1653303709965,VIS 80,A01,088868,Adler; Amy,9,0,10,1
1653303709965,VIS 80,A02,088869,Adler; Amy,8,0,10,2
1653303709965,VIS 80,A03,088870,Adler; Amy,9,0,10,1
1653303709965,VIS 80,A04,088871,Adler; Amy,8,0,10,2
1653303709965,VIS 80,A05,088872,Adler; Amy,10,0,10,0
1653303709965,VIS 80,A06,088873,Adler; Amy,7,0,10,3
1653303710493,VIS 100,A00,088874,Cruz; Edwin Teddy,65,0,75,10
1653303711020,VIS 105A,A00,088875,Tonies; Joshua Vanjaymes,26,0,30,4
1653303711543,VIS 105B,A00,088876,Staff,25,0,30,5
1653303712068,VIS 106A,A00,088877,Tobe; Geoffroy,21,0,25,4
1653303712591,VIS 106B,A00,088878,Staff,21,0,25,4
1653303713118,VIS 106C,A00,088879,Staff,9,0,15,6
1653303713640,VIS 107B,A00,088880,Gallaccio; Anya,24,0,25,1
1653303714162,VIS 108,A00,093894,Gallaccio; Anya,5,0,15,10
1653303714685,VIS 110A,A00,093895,Dean; Danielle Adobi,15,0,15,0
1653303715210,VIS 110B,A00,088881,Adler; Amy,14,0,15,1
1653303715735,VIS 125E,A00,093896,Welchman; John C.,75,0,75,0
1653303716259,VIS 126HN,A00,088882,Newsome; Elizabeth Ann,74,0,75,1
1653303716783,VIS 126P,A00,088883,Wardwell; Mariana Razo,72,0,75,3
1653303717309,VIS 128E,A00,088884,Staff,68,0,75,7
1653303717831,VIS 132,A00,088885,Miller; Nicole L,15,0,15,0
1653303718362,VIS 133,A01,094348,D'Elena-Tweed; Jessica Erin,34,0,34,0
1653303718362,VIS 133,A02,094492,D'Elena-Tweed; Jessica Erin,33,0,34,1
1653303718892,VIS 142,A01,088887,Stalbaum; Brett,14,0,15,1
1653303718892,VIS 142,A02,088888,Stalbaum; Brett,10,0,15,5
1653303718892,VIS 142,A03,088889,Stalbaum; Brett,15,0,15,0
1653303718892,VIS 142,A04,088890,Stalbaum; Brett,8,0,15,7
1653303718892,VIS 142,A05,088891,Stalbaum; Brett,14,0,15,1
1653303718892,VIS 142,A06,094828,Stalbaum; Brett,15,0,15,0
1653303719418,VIS 143,A00,088892,Akten; Mehmet,11,0,22,11
1653303719943,VIS 147A,A01,088894,Stalbaum; Brett,20,0,22,2
1653303719943,VIS 147A,A02,088895,Stalbaum; Brett,17,0,22,5
1653303720466,VIS 149,A00,088896,Akten; Mehmet,11,0,15,4
1653303720994,VIS 150,A00,093893,Tufenkian; Armand Yervant,24,0,30,6
1653303721518,VIS 151A,A00,088897,Williams; Alena J,13,0,15,2
1653303722043,VIS 163,A00,088901,Bratton; Benjamin H.,75,0,75,0
1653303722565,VIS 164,A00,088902,Nakayama; Yue,22,0,22,0
1653303723089,VIS 165A,A00,093892,Cross; Brian R,19,0,22,3
1653303723611,VIS 167,A00,088903,Ortiz-Torres; Ruben,19,0,22,3
1653303724133,VIS 174,A00,088905,Staff,21,0,22,1
1653303724133,VIS 174,B00,088906,Kauffmann; Casey,22,0,22,0
1653303724660,VIS 175,A00,093891,Staff,18,0,22,4
1653303725184,VIS 177,A00,088907,Segade; Alexandro Abraham,20,0,22,2
1653303725710,VIS 178,A00,093890,Staff,17,0,22,5
1653303726234,VIS 179,A00,093889,Kauffmann; Casey,21,0,22,1
1653303726762,VIS 180A,A00,093888,Nakayama; Yue,16,0,22,6
1653303727288,VIS 180B,A00,088908,Miller; Nicole L,21,0,22,1
1653303727811,VIS 183A,A00,088909,Sepuya; Paul Mpagi,20,0,22,2
1653303728358,WCWP 10A,001,086588,Gagnon; Jeffrey C,15,0,15,0
1653303728358,WCWP 10A,002,086589,Gagnon; Jeffrey C,14,0,15,1
1653303728358,WCWP 10A,003,086590,Gagnon; Jeffrey C,15,0,15,0
1653303728358,WCWP 10A,004,086591,Gagnon; Jeffrey C,15,0,15,0
1653303728358,WCWP 10A,005,086592,Gagnon; Jeffrey C,15,0,15,0
1653303728358,WCWP 10A,006,086593,Gagnon; Jeffrey C,15,0,15,0
1653303728358,WCWP 10A,007,086594,Gagnon; Jeffrey C,15,0,15,0
1653303728358,WCWP 10A,008,086595,Gagnon; Jeffrey C,15,0,15,0
1653303728358,WCWP 10A,009,086596,Gagnon; Jeffrey C,15,0,15,0
1653303728358,WCWP 10A,010,086597,Gagnon; Jeffrey C,15,0,15,0
1653303728358,WCWP 10A,011,086598,Gagnon; Jeffrey C,20,0,20,0
1653303728358,WCWP 10A,012,086599,Gagnon; Jeffrey C,20,0,20,0
1653303728358,WCWP 10A,013,086600,Gagnon; Jeffrey C,20,0,20,0
1653303728358,WCWP 10A,014,086601,Gagnon; Jeffrey C,20,0,20,0
1653303728358,WCWP 10A,015,086602,Gagnon; Jeffrey C,20,0,20,0
1653303728358,WCWP 10A,016,086603,Gagnon; Jeffrey C,20,0,20,0
1653303728358,WCWP 10A,017,086604,Gagnon; Jeffrey C,20,0,20,0
1653303728358,WCWP 10A,018,086605,Gagnon; Jeffrey C,19,0,20,1
1653303728358,WCWP 10A,019,086606,Gagnon; Jeffrey C,19,0,20,1
1653303728358,WCWP 10A,020,086607,Gagnon; Jeffrey C,20,0,20,0
1653303728358,WCWP 10A,021,086608,Gagnon; Jeffrey C,20,0,20,0
1653303728358,WCWP 10A,022,086609,Gagnon; Jeffrey C,20,0,20,0
1653303728358,WCWP 10A,023,086610,Gagnon; Jeffrey C,19,0,20,1
1653303728358,WCWP 10A,024,086611,Gagnon; Jeffrey C,20,0,20,0
1653303728358,WCWP 10A,025,086612,Gagnon; Jeffrey C,0,0,0,0
1653303728358,WCWP 10A,026,086613,Gagnon; Jeffrey C,0,0,0,0
1653303728358,WCWP 10A,027,086614,Gagnon; Jeffrey C,0,0,0,0
1653303728358,WCWP 10A,028,086615,Gagnon; Jeffrey C,0,0,0,0
1653303728358,WCWP 10A,029,086616,Gagnon; Jeffrey C,0,0,0,0
1653303728358,WCWP 10A,030,086617,Gagnon; Jeffrey C,15,0,15,0
1653303728358,WCWP 10A,031,086618,Gagnon; Jeffrey C,15,0,15,0
1653303728358,WCWP 10A,032,093687,Gagnon; Jeffrey C,15,0,15,0
1653303728358,WCWP 10A,033,093688,Gagnon; Jeffrey C,15,0,15,0
1653303728358,WCWP 10A,034,093689,Gagnon; Jeffrey C,0,0,0,0
1653303728358,WCWP 10A,035,093690,Gagnon; Jeffrey C,0,0,0,0
1653303728882,WCWP 10B,003,086621,Gagnon; Jeffrey C,0,0,0,0
1653303728882,WCWP 10B,004,086622,Gagnon; Jeffrey C,16,0,20,4
1653303728882,WCWP 10B,005,086623,Gagnon; Jeffrey C,18,0,20,2
1653303728882,WCWP 10B,006,086624,Gagnon; Jeffrey C,20,0,20,0
1653303728882,WCWP 10B,007,086625,Gagnon; Jeffrey C,0,0,0,0
1653303729416,WCWP 100,A00,086626,McCleary; Keith Long,20,0,20,0
1653303729416,WCWP 100,B00,086627,McCleary; Keith Long,20,0,20,0
1653303729416,WCWP 100,C00,086628,McCleary; Keith Long,18,0,20,2
1653303729416,WCWP 100,D00,086629,Twohig; Niall Ivan,17,0,20,3
1653303729416,WCWP 100,E00,086630,Twohig; Niall Ivan,17,0,20,3
1653303729416,WCWP 100,F00,086631,Twohig; Niall Ivan,18,0,20,2
1653303729416,WCWP 100,G00,086632,Young; Mark T,20,0,20,0
1653303729416,WCWP 100,H00,086633,Young; Mark T,20,0,20,0
1653303787430,AAS 10,A01,085689,Butler; Elizabeth Annette,28,0,34,6
1653303787430,AAS 10,A02,085690,Butler; Elizabeth Annette,34,0,34,0
1653303787953,AAS 170,A00,085691,Butler; Elizabeth Annette,30,0,32,2
1653303788481,AIP 197,001,085683,Staff,100,0,100,0
1653303788481,AIP 197,002,085684,Rao; Ramesh R,50,0,50,0
1653303789008,AIP 197DC,001,085696,Anderson; Patrick W.,27,0,27,0
1653303789531,AIP 197T,A00,085685,Anderson; Patrick W.,15,0,15,0
1653303790061,ANAR 100,A00,094326,Fortier; Jana,22,0,25,3
1653303790587,ANAR 104,A01,085846,Staff,13,0,15,2
1653303791117,ANAR 120,A00,085847,Staff,15,0,15,0
1653303791641,ANAR 143,A00,094288,Staff,31,0,32,1
1653303792165,ANBI 100,A00,085849,Marchetto; Maria Carolina,31,0,34,3
1653303792691,ANBI 112,A00,085850,Marchetto; Maria Carolina,21,0,28,7
1653303793220,ANBI 118,A00,085851,Fox; Patrick Keolu Ozer,32,0,32,0
1653303793744,ANBI 136,A00,085852,Semendeferi; Ekaterini,20,0,22,2
1653303794267,ANBI 141,A00,085854,Gagneux; Pascal,186,0,192,6
1653303794790,ANBI 145,A00,085855,Staff,30,0,32,2
1653303795315,ANBI 175,A00,085857,Staff,30,0,32,2
1653303795844,ANSC 104,A00,094290,Yeh; Rihan Wen Xin,40,0,46,6
1653303796368,ANSC 105,A00,085859,Olivas Hernandez; Olga Lid,36,0,37,1
1653303796892,ANSC 120,A00,085860,Jassal; Aftab,51,0,56,5
1653303797420,ANSC 121,A00,085861,Staff,29,0,32,3
1653303798466,ANSC 148,A00,085866,Staff,71,0,73,2
1653303798991,ANSC 169,A00,085869,Fortier; Jana,23,0,25,2
1653303799525,ANSC 175,A00,085871,Pedersen; David,28,0,32,4
1653303800052,ANTH 1,A00,085803,Varma; Saiba,146,0,146,0
1653303800580,ANTH 2,A01,085805,Staff,43,0,44,1
1653303800580,ANTH 2,A02,085806,Staff,42,0,44,2
1653303800580,ANTH 2,A03,085807,Staff,44,0,44,0
1653303800580,ANTH 2,A04,085808,Staff,44,0,44,0
1653303800580,ANTH 2,A05,085809,Staff,40,0,40,0
1653303801104,ANTH 4,A01,085811,Yeh; Rihan Wen Xin,32,0,32,0
1653303801104,ANTH 4,A02,095113,Yeh; Rihan Wen Xin,32,0,32,0
1653303801104,ANTH 4,A03,095114,Yeh; Rihan Wen Xin,32,0,32,0
1653303801104,ANTH 4,A04,095115,Yeh; Rihan Wen Xin,34,0,34,0
1653303801629,ANTH 10,A00,085814,Stewart; Alexander B,215,0,216,1
1653303802162,ANTH 21,A01,085816,Kang; Byung Chu,35,0,35,0
1653303802162,ANTH 21,A02,085817,Kang; Byung Chu,35,0,35,0
1653303802162,ANTH 21,A03,085818,Kang; Byung Chu,35,0,35,0
1653303802162,ANTH 21,A04,085819,Kang; Byung Chu,35,0,35,0
1653303802162,ANTH 21,A05,085820,Kang; Byung Chu,33,0,35,2
1653303802162,ANTH 21,A06,085821,Kang; Byung Chu,33,0,35,2
1653303802162,ANTH 21,A07,085822,Kang; Byung Chu,35,0,35,0
1653303802162,ANTH 21,A08,085823,Kang; Byung Chu,35,0,35,0
1653303802162,ANTH 21,A09,085824,Kang; Byung Chu,0,0,0,0
1653303802162,ANTH 21,A10,085825,Kang; Byung Chu,0,0,0,0
1653303802162,ANTH 21,A11,095111,Kang; Byung Chu,30,0,30,0
1653303802162,ANTH 21,A12,095112,Kang; Byung Chu,30,0,30,0
1653303802162,ANTH 21,B01,085827,Staff,36,0,36,0
1653303802162,ANTH 21,B02,085828,Staff,36,0,36,0
1653303802162,ANTH 21,B03,085829,Staff,36,0,36,0
1653303802162,ANTH 21,B04,085830,Staff,38,0,38,0
1653303802693,ANTH 23,A01,085832,Stewart; Alexander B,31,0,31,0
1653303802693,ANTH 23,A02,085833,Stewart; Alexander B,31,0,31,0
1653303802693,ANTH 23,A03,085834,Stewart; Alexander B,31,0,31,0
1653303802693,ANTH 23,A04,085835,Stewart; Alexander B,31,0,31,0
1653303802693,ANTH 23,A05,085836,Stewart; Alexander B,31,0,31,0
1653303802693,ANTH 23,A06,085837,Stewart; Alexander B,0,0,0,0
1653303802693,ANTH 23,A07,085838,Stewart; Alexander B,0,0,0,0
1653303803216,ANTH 87,A00,085842,Staff,20,0,20,0
1653303803216,ANTH 87,B00,085843,Staff,20,0,20,0
1653303803746,ANTH 101,A01,085873,Goldstein; Paul S,33,0,36,3
1653303803746,ANTH 101,A02,085874,Goldstein; Paul S,33,0,36,3
1653303803746,ANTH 101,A03,085875,Goldstein; Paul S,36,0,36,0
1653303803746,ANTH 101,A04,085876,Goldstein; Paul S,36,0,38,2
1653303804271,ANTH 105,A00,085877,Staff,39,0,40,1
1653303804798,ANTH 108,A00,085878,Staff,31,0,32,1
1653303805321,ANTH 192,A00,094234,Kaiser; Bronwyn Nicole & Non; Amy L,20,0,20,0
1653303805845,ANTH 196A,A00,085879,Varma; Saiba,20,0,20,0
1653303806380,AWP 3,001,085697,Staff,13,0,13,0
1653303806380,AWP 3,002,085698,Staff,13,0,13,0
1653303806380,AWP 3,003,085699,Staff,13,0,13,0
1653303806380,AWP 3,004,085700,Staff,0,0,0,0
1653303806380,AWP 3,005,085701,Staff,0,0,0,0
1653303806380,AWP 3,006,085703,Staff,0,0,0,0
1653303806380,AWP 3,007,085704,Staff,13,0,13,0
1653303806380,AWP 3,008,085707,Staff,0,0,0,0
1653303806380,AWP 3,009,085709,Staff,13,0,13,0
1653303806380,AWP 3,010,085710,Staff,13,0,13,0
1653303806380,AWP 3,011,085711,Staff,0,0,0,0
1653303806380,AWP 3,012,085712,Staff,0,0,0,0
1653303806380,AWP 3,013,085713,Staff,13,0,13,0
1653303806380,AWP 3,014,085715,Staff,13,0,13,0
1653303806380,AWP 3,015,085717,Staff,13,0,13,0
1653303806380,AWP 3,016,085719,Staff,13,0,13,0
1653303806380,AWP 3,017,085720,Staff,13,0,13,0
1653303806380,AWP 3,018,085721,Staff,13,0,13,0
1653303806380,AWP 3,019,085722,Staff,13,0,13,0
1653303806380,AWP 3,020,085723,Staff,13,0,13,0
1653303806380,AWP 3,021,085724,Staff,13,0,13,0
1653303806380,AWP 3,022,085725,Staff,13,0,13,0
1653303806380,AWP 3,023,085726,Staff,13,0,13,0
1653303806380,AWP 3,024,085727,Staff,13,0,13,0
1653303806380,AWP 3,025,085728,Staff,13,0,13,0
1653303806380,AWP 3,026,085729,Staff,13,0,13,0
1653303806380,AWP 3,027,085730,Staff,13,0,13,0
1653303806380,AWP 3,028,085731,Staff,13,0,13,0
1653303806380,AWP 3,029,085732,Staff,13,0,13,0
1653303806380,AWP 3,030,085733,Staff,13,0,13,0
1653303806380,AWP 3,031,085734,Staff,13,0,13,0
1653303806380,AWP 3,032,085735,Staff,13,0,13,0
1653303806380,AWP 3,033,085736,Staff,13,0,13,0
1653303806380,AWP 3,034,085737,Staff,13,0,13,0
1653303806380,AWP 3,035,085738,Staff,13,0,13,0
1653303806380,AWP 3,036,085739,Staff,13,0,13,0
1653303806380,AWP 3,037,085740,Staff,13,0,13,0
1653303806380,AWP 3,038,085741,Staff,13,0,13,0
1653303806380,AWP 3,039,085742,Staff,13,0,13,0
1653303806380,AWP 3,040,085743,Staff,13,0,13,0
1653303806380,AWP 3,041,085744,Staff,13,0,13,0
1653303806380,AWP 3,042,085745,Staff,13,0,13,0
1653303806380,AWP 3,043,085746,Staff,13,0,13,0
1653303806380,AWP 3,044,085747,Staff,13,0,13,0
1653303806380,AWP 3,045,085748,Staff,13,0,13,0
1653303806380,AWP 3,046,085749,Staff,13,0,13,0
1653303806380,AWP 3,047,085750,Staff,13,0,13,0
1653303806380,AWP 3,048,085751,Staff,13,0,13,0
1653303806380,AWP 3,049,085752,Staff,13,0,13,0
1653303806380,AWP 3,050,085753,Staff,13,0,13,0
1653303806380,AWP 3,051,085754,Staff,13,0,13,0
1653303806380,AWP 3,052,085755,Staff,0,0,0,0
1653303806380,AWP 3,053,085756,Staff,13,0,13,0
1653303806380,AWP 3,054,085757,Staff,0,0,0,0
1653303806380,AWP 3,055,085758,Staff,13,0,13,0
1653303806380,AWP 3,056,085759,Staff,13,0,13,0
1653303806380,AWP 3,057,085760,Staff,13,0,13,0
1653303806380,AWP 3,058,085761,Staff,13,0,13,0
1653303806380,AWP 3,059,085762,Staff,13,0,13,0
1653303806380,AWP 3,060,085763,Staff,13,0,13,0
1653303806380,AWP 3,061,085764,Staff,13,0,13,0
1653303806380,AWP 3,062,085765,Staff,13,0,13,0
1653303806380,AWP 3,063,085766,Staff,13,0,13,0
1653303806380,AWP 3,064,085767,Staff,13,0,13,0
1653303806380,AWP 3,065,085768,Staff,13,0,13,0
1653303806380,AWP 3,066,085769,Staff,0,0,0,0
1653303806909,AWP 4A,001,085770,Staff,0,0,0,0
1653303806909,AWP 4A,002,085771,Staff,13,0,13,0
1653303806909,AWP 4A,003,085772,Staff,13,0,13,0
1653303806909,AWP 4A,004,085773,Staff,13,0,13,0
1653303806909,AWP 4A,005,085774,Staff,0,0,0,0
1653303806909,AWP 4A,006,085775,Staff,13,0,13,0
1653303806909,AWP 4A,007,085776,Staff,0,0,0,0
1653303806909,AWP 4A,008,085777,Staff,0,0,0,0
1653303806909,AWP 4A,009,085778,Staff,0,0,0,0
1653303806909,AWP 4A,010,085779,Staff,13,0,13,0
1653303806909,AWP 4A,011,085780,Staff,13,0,13,0
1653303806909,AWP 4A,012,085781,Staff,0,0,0,0
1653303806909,AWP 4A,013,085782,Staff,13,0,13,0
1653303806909,AWP 4A,014,085783,Staff,13,0,13,0
1653303806909,AWP 4A,015,085784,Staff,13,0,13,0
1653303806909,AWP 4A,016,085785,Staff,13,0,13,0
1653303806909,AWP 4A,017,085786,Staff,13,0,13,0
1653303806909,AWP 4A,018,085787,Staff,0,0,0,0
1653303806909,AWP 4A,019,085788,Staff,13,0,13,0
1653303806909,AWP 4A,020,085789,Staff,13,0,13,0
1653303806909,AWP 4A,021,085790,Staff,0,0,0,0
1653303806909,AWP 4A,022,085791,Staff,13,0,13,0
1653303806909,AWP 4A,023,085792,Staff,0,0,0,0
1653303806909,AWP 4A,024,085793,Staff,0,0,0,0
1653303806909,AWP 4A,025,085794,Staff,13,0,13,0
1653303806909,AWP 4A,026,085795,Staff,13,0,13,0
1653303806909,AWP 4A,027,085796,Staff,13,0,13,0
1653303806909,AWP 4A,028,085797,Staff,13,0,13,0
1653303806909,AWP 4A,029,085798,Staff,0,0,0,0
1653303806909,AWP 4A,030,085799,Staff,0,0,0,0
1653303806909,AWP 4A,031,093835,Staff,0,0,0,0
1653303807434,AWP 4B,001,085800,Staff,0,0,0,0
1653303807434,AWP 4B,002,085801,Staff,0,0,0,0
1653303807958,BENG 2,A00,085936,Wheeler; Bruce Christopher,28,0,30,2
1653303808557,BENG 110,A01,085939,Mc Culloch; Andrew Douglas,20,0,30,10
1653303808557,BENG 110,A02,085940,Mc Culloch; Andrew Douglas,18,0,30,12
1653303808557,BENG 110,A03,085941,Mc Culloch; Andrew Douglas,27,0,30,3
1653303809088,BENG 119A,A01,085943,Wheeler; Bruce Christopher,29,0,30,1
1653303809614,BENG 122A,A01,085945,Cauwenberghs; Gert,18,0,25,7
1653303809614,BENG 122A,A02,085946,Cauwenberghs; Gert,22,0,25,3
1653303809614,BENG 122A,A03,085947,Cauwenberghs; Gert,22,0,25,3
1653303810137,BENG 126A,A01,085949,Wheeler; Bruce Christopher,30,0,30,0
1653303810660,BENG 127A,A01,085951,Wheeler; Bruce Christopher,28,0,30,2
1653303811186,BENG 128A,A01,085953,Wheeler; Bruce Christopher,29,0,30,1
1653303811714,BENG 134,A01,085955,Smarr; Benjamin,0,0,0,0
1653303812240,BENG 135,A00,085956,Wheeler; Bruce Christopher,23,0,30,7
1653303812764,BENG 141,A00,085958,Lal; Ratnesh,20,0,30,10
1653303813287,BENG 147A,A01,085963,Wheeler; Bruce Christopher,30,0,30,0
1653303813811,BENG 148A,A01,085967,Wheeler; Bruce Christopher,30,0,30,0
1653303814338,BENG 149A,A01,085969,Wheeler; Bruce Christopher,30,0,30,0
1653303814860,BENG 161A,A01,085971,Fraley; Stephanie I.,20,0,25,5
1653303814860,BENG 161A,A02,085972,Fraley; Stephanie I.,13,0,25,12
1653303814860,BENG 161A,A03,085973,Fraley; Stephanie I.,9,0,25,16
1653303815384,BENG 162,A01,085975,Mali; Prashant Gulab Ram,0,0,35,35
1653303815384,BENG 162,A02,085976,Mali; Prashant Gulab Ram,26,0,35,9
1653303815916,BENG 166A,A00,085977,Sah; Robert Lie-Yuan,0,0,0,0
1653303816439,BENG 169A,A01,085982,Wheeler; Bruce Christopher,28,0,30,2
1653303816962,BENG 179A,A01,085984,Wheeler; Bruce Christopher,30,0,30,0
1653303817486,BENG 183,A01,085986,Zhong; Sheng,13,0,30,17
1653303817486,BENG 183,A02,085987,Zhong; Sheng,15,0,30,15
1653303817486,BENG 183,A03,085988,Zhong; Sheng,20,0,30,10
1653303818009,BENG 187B,A00,085989,Wheeler; Bruce Christopher,105,0,170,65
1653303818532,BENG 196,001,094047,Engler; Adam J.,9999,0,9999,0
1653303819066,BIBC 100,A01,092918,Huffaker; Alisa,0,0,19,19
1653303819066,BIBC 100,A02,092919,Huffaker; Alisa,19,0,19,0
1653303819066,BIBC 100,A03,092920,Huffaker; Alisa,18,0,19,1
1653303819066,BIBC 100,A04,092921,Huffaker; Alisa,18,0,19,1
1653303819066,BIBC 100,A05,092922,Huffaker; Alisa,19,0,19,0
1653303819066,BIBC 100,A06,092923,Huffaker; Alisa,18,0,19,1
1653303819066,BIBC 100,A07,092924,Huffaker; Alisa,10,0,19,9
1653303819066,BIBC 100,A08,092925,Huffaker; Alisa,17,0,19,2
1653303819066,BIBC 100,A09,092926,Huffaker; Alisa,19,0,19,0
1653303819066,BIBC 100,A10,092927,Huffaker; Alisa,11,0,19,8
1653303819598,BIBC 102,A01,092997,Schmelz; Eric Alexander,16,0,19,3
1653303819598,BIBC 102,A02,092998,Schmelz; Eric Alexander,5,0,19,14
1653303819598,BIBC 102,A03,092999,Schmelz; Eric Alexander,1,0,19,18
1653303819598,BIBC 102,A04,093000,Schmelz; Eric Alexander,17,0,19,2
1653303819598,BIBC 102,A05,093001,Schmelz; Eric Alexander,9,0,19,10
1653303819598,BIBC 102,A06,093002,Schmelz; Eric Alexander,16,0,19,3
1653303819598,BIBC 102,A07,093003,Schmelz; Eric Alexander,19,0,19,0
1653303819598,BIBC 102,A08,093004,Schmelz; Eric Alexander,19,0,19,0
1653303819598,BIBC 102,A09,093005,Schmelz; Eric Alexander,14,0,19,5
1653303819598,BIBC 102,B01,093064,Coleman; Aaron B.,19,0,19,0
1653303819598,BIBC 102,B02,093065,Coleman; Aaron B.,17,0,19,2
1653303819598,BIBC 102,B03,093066,Coleman; Aaron B.,16,0,19,3
1653303819598,BIBC 102,B04,093067,Coleman; Aaron B.,11,0,19,8
1653303819598,BIBC 102,B05,093068,Coleman; Aaron B.,18,0,19,1
1653303819598,BIBC 102,B06,093069,Coleman; Aaron B.,16,0,19,3
1653303819598,BIBC 102,B07,093070,Coleman; Aaron B.,19,0,19,0
1653303819598,BIBC 102,B08,093071,Coleman; Aaron B.,15,0,19,4
1653303819598,BIBC 102,B09,093072,Coleman; Aaron B.,17,0,19,2
1653303820128,BIBC 103,A01,089887,Bozinovic; Goran,19,0,24,5
1653303820128,BIBC 103,A02,089888,Bozinovic; Goran,23,0,24,1
1653303820128,BIBC 103,B01,089890,Burg; Michael,1,0,24,23
1653303820128,BIBC 103,B02,089891,Burg; Michael,20,0,24,4
1653303820128,BIBC 103,C01,089893,Beyhan; Sinem,14,0,24,10
1653303820128,BIBC 103,C02,089894,Beyhan; Sinem,22,0,24,2
1653303820128,BIBC 103,D01,089896,Coleman; Aaron B.,10,0,24,14
1653303820128,BIBC 103,D02,089897,Coleman; Aaron B.,22,0,24,2
1653303820652,BIBC 194,A00,089898,Hui; Enfu,16,0,27,11
1653303821184,BICD 100,A01,092396,Smith; Laurie,21,0,22,1
1653303821184,BICD 100,A02,092397,Smith; Laurie,22,0,22,0
1653303821184,BICD 100,A03,092398,Smith; Laurie,21,0,22,1
1653303821184,BICD 100,A04,092399,Smith; Laurie,22,0,22,0
1653303821184,BICD 100,A05,092400,Smith; Laurie,21,0,22,1
1653303821184,BICD 100,A06,092401,Smith; Laurie,22,0,22,0
1653303821184,BICD 100,A07,092402,Smith; Laurie,22,0,22,0
1653303821184,BICD 100,A08,092403,Smith; Laurie,22,0,22,0
1653303821184,BICD 100,B01,093073,Mueller; Liam O'Connor,21,0,22,1
1653303821184,BICD 100,B02,093074,Mueller; Liam O'Connor,22,0,22,0
1653303821184,BICD 100,B03,093075,Mueller; Liam O'Connor,22,0,22,0
1653303821184,BICD 100,B04,093076,Mueller; Liam O'Connor,22,0,22,0
1653303821184,BICD 100,B05,093077,Mueller; Liam O'Connor,22,0,22,0
1653303821184,BICD 100,B06,093078,Mueller; Liam O'Connor,22,0,22,0
1653303821184,BICD 100,B07,093079,Mueller; Liam O'Connor,21,0,22,1
1653303821184,BICD 100,B08,093080,Mueller; Liam O'Connor,22,0,22,0
1653303821184,BICD 100,C01,093021,McDonnell; Lisa Marie,21,0,22,1
1653303821184,BICD 100,C02,093022,McDonnell; Lisa Marie,20,0,22,2
1653303821184,BICD 100,C03,093023,McDonnell; Lisa Marie,22,0,22,0
1653303821184,BICD 100,C04,093024,McDonnell; Lisa Marie,22,0,22,0
1653303821184,BICD 100,C05,093025,McDonnell; Lisa Marie,22,0,22,0
1653303821184,BICD 100,C06,093026,McDonnell; Lisa Marie,22,0,22,0
1653303821184,BICD 100,C07,093027,McDonnell; Lisa Marie,20,0,22,2
1653303821184,BICD 100,C08,093028,McDonnell; Lisa Marie,22,0,22,0
1653303821184,BICD 100,D01,093081,Day; Christopher D,22,0,22,0
1653303821184,BICD 100,D02,093082,Day; Christopher D,17,0,22,5
1653303821184,BICD 100,D03,093083,Day; Christopher D,21,0,22,1
1653303821184,BICD 100,D04,093084,Day; Christopher D,19,0,22,3
1653303821184,BICD 100,D05,093085,Day; Christopher D,22,0,22,0
1653303821184,BICD 100,D06,093086,Day; Christopher D,20,0,22,2
1653303821184,BICD 100,D07,093087,Day; Christopher D,19,0,22,3
1653303821184,BICD 100,D08,093088,Day; Christopher D,20,0,22,2
1653303821711,BICD 110,A01,093089,Kiger; Amy,29,0,32,3
1653303821711,BICD 110,A02,093091,Kiger; Amy,32,0,32,0
1653303821711,BICD 110,A03,093092,Kiger; Amy,31,0,32,1
1653303821711,BICD 110,A04,093093,Kiger; Amy,31,0,32,1
1653303821711,BICD 110,A05,093094,Kiger; Amy,26,0,32,6
1653303821711,BICD 110,A06,093095,Kiger; Amy,31,0,32,1
1653303821711,BICD 110,A07,093096,Kiger; Amy,31,0,32,1
1653303821711,BICD 110,B01,093029,Grossman; Emily N,21,0,32,11
1653303821711,BICD 110,B02,093030,Grossman; Emily N,28,0,32,4
1653303821711,BICD 110,B03,093031,Grossman; Emily N,32,0,32,0
1653303821711,BICD 110,B04,093032,Grossman; Emily N,28,0,32,4
1653303821711,BICD 110,B05,093033,Grossman; Emily N,26,0,32,6
1653303821711,BICD 110,B06,093034,Grossman; Emily N,19,0,32,13
1653303821711,BICD 110,B07,093035,Grossman; Emily N,20,0,32,12
1653303822233,BICD 140,A01,093097,Zuniga; Elina I,19,0,32,13
1653303822233,BICD 140,A02,093098,Zuniga; Elina I,17,0,32,15
1653303822233,BICD 140,A03,093099,Zuniga; Elina I,30,0,32,2
1653303822233,BICD 140,A04,093100,Zuniga; Elina I,32,0,32,0
1653303822233,BICD 140,A05,093101,Zuniga; Elina I,29,0,32,3
1653303822233,BICD 140,A06,093102,Zuniga; Elina I,27,0,32,5
1653303822758,BIEB 102,A01,092528,Butler; Shannon Rhey,22,0,27,5
1653303822758,BIEB 102,A02,092529,Butler; Shannon Rhey,17,0,27,10
1653303822758,BIEB 102,A03,092530,Butler; Shannon Rhey,24,0,27,3
1653303822758,BIEB 102,A04,092531,Butler; Shannon Rhey,26,0,27,1
1653303822758,BIEB 102,A05,092532,Butler; Shannon Rhey,25,0,27,2
1653303822758,BIEB 102,A06,092533,Butler; Shannon Rhey,24,0,27,3
1653303822758,BIEB 102,A07,092534,Butler; Shannon Rhey,23,0,27,4
1653303823281,BIEB 121,A00,089907,Holway; David A.,0,0,32,32
1653303823809,BIEB 126,A01,092974,Kohn; Joshua R,24,0,27,3
1653303823809,BIEB 126,A02,092975,Kohn; Joshua R,26,0,27,1
1653303823809,BIEB 126,A03,092976,Kohn; Joshua R,23,0,27,4
1653303823809,BIEB 126,A04,092977,Kohn; Joshua R,25,0,27,2
1653303823809,BIEB 126,A05,092978,Kohn; Joshua R,27,0,27,0
1653303824334,BIEB 146,A01,093054,Petrie; Katherine Lynn,1,0,27,26
1653303824334,BIEB 146,A02,093055,Petrie; Katherine Lynn,4,0,27,23
1653303824334,BIEB 146,A03,093056,Petrie; Katherine Lynn,0,0,27,27
1653303824334,BIEB 146,A04,093057,Petrie; Katherine Lynn,0,0,27,27
1653303824334,BIEB 146,A05,093058,Petrie; Katherine Lynn,20,0,27,7
1653303824334,BIEB 146,A06,093059,Petrie; Katherine Lynn,26,0,27,1
1653303824334,BIEB 146,A07,093060,Petrie; Katherine Lynn,16,0,27,11
1653303824334,BIEB 146,A08,093061,Petrie; Katherine Lynn,25,0,27,2
1653303824334,BIEB 146,A09,093062,Petrie; Katherine Lynn,17,0,27,10
1653303824863,BIEB 150,A01,093103,Rennison; Diana,16,0,27,11
1653303824863,BIEB 150,A02,093104,Rennison; Diana,21,0,27,6
1653303824863,BIEB 150,A03,093105,Rennison; Diana,26,0,27,1
1653303824863,BIEB 150,A04,093106,Rennison; Diana,24,0,27,3
1653303824863,BIEB 150,A05,093107,Rennison; Diana,25,0,27,2
1653303824863,BIEB 150,A06,093108,Rennison; Diana,27,0,27,0
1653303825389,BIEB 158,A01,094057,Reese; Aspen Taylor & Jackrel; Sara,31,0,32,1
1653303825389,BIEB 158,A02,094058,Reese; Aspen Taylor & Jackrel; Sara,28,0,32,4
1653303825389,BIEB 158,A03,094059,Reese; Aspen Taylor & Jackrel; Sara,31,0,32,1
1653303825389,BIEB 158,A04,094060,Reese; Aspen Taylor & Jackrel; Sara,32,0,32,0
1653303825915,BIEB 174,A01,092465,Cleland; Elsa Eleanor & Barton; Andrew David,27,0,27,0
1653303825915,BIEB 174,A02,092466,Cleland; Elsa Eleanor & Barton; Andrew David,27,0,27,0
1653303825915,BIEB 174,A03,092467,Cleland; Elsa Eleanor & Barton; Andrew David,23,0,27,4
1653303825915,BIEB 174,A04,092468,Cleland; Elsa Eleanor & Barton; Andrew David,20,0,27,7
1653303825915,BIEB 174,A05,092469,Cleland; Elsa Eleanor & Barton; Andrew David,25,0,27,2
1653303825915,BIEB 174,A06,092470,Cleland; Elsa Eleanor & Barton; Andrew David,27,0,27,0
1653303825915,BIEB 174,A07,092471,Cleland; Elsa Eleanor & Barton; Andrew David,25,0,27,2
1653303826450,BILD 1,A01,092884,Pickett; Brooke Elizabeth,16,0,19,3
1653303826450,BILD 1,A02,092885,Pickett; Brooke Elizabeth,19,0,19,0
1653303826450,BILD 1,A03,092886,Pickett; Brooke Elizabeth,19,0,19,0
1653303826450,BILD 1,A04,092887,Pickett; Brooke Elizabeth,18,0,19,1
1653303826450,BILD 1,A05,092888,Pickett; Brooke Elizabeth,19,0,19,0
1653303826450,BILD 1,A06,092889,Pickett; Brooke Elizabeth,19,0,19,0
1653303826450,BILD 1,A07,092890,Pickett; Brooke Elizabeth,17,0,19,2
1653303826450,BILD 1,B01,092891,Pekkurnaz Banghart; Gulcin,19,0,19,0
1653303826450,BILD 1,B02,092892,Pekkurnaz Banghart; Gulcin,16,0,19,3
1653303826450,BILD 1,B03,092893,Pekkurnaz Banghart; Gulcin,19,0,19,0
1653303826450,BILD 1,B04,092894,Pekkurnaz Banghart; Gulcin,19,0,19,0
1653303826450,BILD 1,B05,092895,Pekkurnaz Banghart; Gulcin,17,0,19,2
1653303826450,BILD 1,B06,092896,Pekkurnaz Banghart; Gulcin,19,0,19,0
1653303826450,BILD 1,B07,092897,Pekkurnaz Banghart; Gulcin,19,0,19,0
1653303826450,BILD 1,C01,092421,Meaders; Clara Leigh,18,0,19,1
1653303826450,BILD 1,C02,092422,Meaders; Clara Leigh,18,0,19,1
1653303826450,BILD 1,C03,092423,Meaders; Clara Leigh,17,0,19,2
1653303826450,BILD 1,C04,092424,Meaders; Clara Leigh,16,0,19,3
1653303826450,BILD 1,C05,092425,Meaders; Clara Leigh,19,0,19,0
1653303826450,BILD 1,C06,092426,Meaders; Clara Leigh,19,0,19,0
1653303826450,BILD 1,C07,092427,Meaders; Clara Leigh,19,0,19,0
1653303826450,BILD 1,D01,092428,Meaders; Clara Leigh,14,0,19,5
1653303826450,BILD 1,D02,092429,Meaders; Clara Leigh,19,0,19,0
1653303826450,BILD 1,D03,092430,Meaders; Clara Leigh,19,0,19,0
1653303826450,BILD 1,D04,092431,Meaders; Clara Leigh,19,0,19,0
1653303826450,BILD 1,D05,092432,Meaders; Clara Leigh,19,0,19,0
1653303826450,BILD 1,D06,092433,Meaders; Clara Leigh,19,0,19,0
1653303826450,BILD 1,D07,092434,Meaders; Clara Leigh,19,0,19,0
1653303826450,BILD 1,E01,092445,Cooper; Andrew Michael,19,0,19,0
1653303826450,BILD 1,E02,092446,Cooper; Andrew Michael,19,0,19,0
1653303826450,BILD 1,E03,092447,Cooper; Andrew Michael,19,0,19,0
1653303826450,BILD 1,E04,092448,Cooper; Andrew Michael,19,0,19,0
1653303826450,BILD 1,E05,092449,Cooper; Andrew Michael,17,0,19,2
1653303826450,BILD 1,E06,092450,Cooper; Andrew Michael,19,0,19,0
1653303826450,BILD 1,E07,092451,Cooper; Andrew Michael,19,0,19,0
1653303826991,BILD 2,A01,092822,Glasgow; Stacey Marie,25,0,25,0
1653303826991,BILD 2,A02,092823,Glasgow; Stacey Marie,24,0,25,1
1653303826991,BILD 2,A03,092824,Glasgow; Stacey Marie,24,0,25,1
1653303826991,BILD 2,A04,092825,Glasgow; Stacey Marie,25,0,25,0
1653303826991,BILD 2,A05,092826,Glasgow; Stacey Marie,25,0,25,0
1653303826991,BILD 2,A06,092827,Glasgow; Stacey Marie,25,0,25,0
1653303826991,BILD 2,A07,092828,Glasgow; Stacey Marie,25,0,25,0
1653303826991,BILD 2,B01,092830,Owens; Melinda Tsao-Ying,25,0,25,0
1653303826991,BILD 2,B02,092831,Owens; Melinda Tsao-Ying,21,0,25,4
1653303826991,BILD 2,B03,092832,Owens; Melinda Tsao-Ying,23,0,25,2
1653303826991,BILD 2,B04,092833,Owens; Melinda Tsao-Ying,25,0,25,0
1653303826991,BILD 2,B05,092834,Owens; Melinda Tsao-Ying,24,0,25,1
1653303826991,BILD 2,B06,092835,Owens; Melinda Tsao-Ying,21,0,25,4
1653303826991,BILD 2,B07,092836,Owens; Melinda Tsao-Ying,25,0,25,0
1653303826991,BILD 2,C01,092668,Owens; Melinda Tsao-Ying,24,0,25,1
1653303826991,BILD 2,C02,092669,Owens; Melinda Tsao-Ying,23,0,25,2
1653303826991,BILD 2,C03,092670,Owens; Melinda Tsao-Ying,22,0,25,3
1653303826991,BILD 2,C04,092671,Owens; Melinda Tsao-Ying,25,0,25,0
1653303826991,BILD 2,C05,092672,Owens; Melinda Tsao-Ying,25,0,25,0
1653303826991,BILD 2,C06,092673,Owens; Melinda Tsao-Ying,24,0,25,1
1653303826991,BILD 2,C07,092674,Owens; Melinda Tsao-Ying,25,0,25,0
1653303827523,BILD 3,A01,092454,Stockwell; Sarah R,17,0,19,2
1653303827523,BILD 3,A02,092455,Stockwell; Sarah R,17,0,19,2
1653303827523,BILD 3,A03,092456,Stockwell; Sarah R,18,0,19,1
1653303827523,BILD 3,A04,092457,Stockwell; Sarah R,19,0,19,0
1653303827523,BILD 3,A05,092458,Stockwell; Sarah R,19,0,19,0
1653303827523,BILD 3,A06,092459,Stockwell; Sarah R,18,0,19,1
1653303827523,BILD 3,A07,092460,Stockwell; Sarah R,18,0,19,1
1653303827523,BILD 3,A08,092461,Stockwell; Sarah R,19,0,19,0
1653303827523,BILD 3,A09,092462,Stockwell; Sarah R,19,0,19,0
1653303827523,BILD 3,B01,092479,Stockwell; Sarah R,19,0,19,0
1653303827523,BILD 3,B02,092480,Stockwell; Sarah R,18,0,19,1
1653303827523,BILD 3,B03,092481,Stockwell; Sarah R,18,0,19,1
1653303827523,BILD 3,B04,092482,Stockwell; Sarah R,19,0,19,0
1653303827523,BILD 3,B05,092483,Stockwell; Sarah R,19,0,19,0
1653303827523,BILD 3,B06,092484,Stockwell; Sarah R,19,0,19,0
1653303827523,BILD 3,B07,092485,Stockwell; Sarah R,19,0,19,0
1653303827523,BILD 3,B08,092486,Stockwell; Sarah R,18,0,19,1
1653303827523,BILD 3,B09,092487,Stockwell; Sarah R,18,0,19,1
1653303827523,BILD 3,C01,092412,Butler; Shannon Rhey,18,0,19,1
1653303827523,BILD 3,C02,092413,Butler; Shannon Rhey,15,0,19,4
1653303827523,BILD 3,C03,092414,Butler; Shannon Rhey,19,0,19,0
1653303827523,BILD 3,C04,092415,Butler; Shannon Rhey,19,0,19,0
1653303827523,BILD 3,C05,092416,Butler; Shannon Rhey,19,0,19,0
1653303827523,BILD 3,C06,092417,Butler; Shannon Rhey,19,0,19,0
1653303827523,BILD 3,C07,092418,Butler; Shannon Rhey,19,0,19,0
1653303827523,BILD 3,C08,092419,Butler; Shannon Rhey,19,0,19,0
1653303827523,BILD 3,C09,092420,Butler; Shannon Rhey,19,0,19,0
1653303827523,BILD 3,D01,092898,Reuther; Keefe,18,0,19,1
1653303827523,BILD 3,D02,092899,Reuther; Keefe,19,0,19,0
1653303827523,BILD 3,D03,092900,Reuther; Keefe,19,0,19,0
1653303827523,BILD 3,D04,092901,Reuther; Keefe,19,0,19,0
1653303827523,BILD 3,D05,092902,Reuther; Keefe,19,0,19,0
1653303827523,BILD 3,D06,092903,Reuther; Keefe,19,0,19,0
1653303827523,BILD 3,D07,092904,Reuther; Keefe,18,0,19,1
1653303827523,BILD 3,D08,092905,Reuther; Keefe,19,0,19,0
1653303827523,BILD 3,D09,092906,Reuther; Keefe,19,0,19,0
1653303828051,BILD 4,A01,089840,Mel; Stephanie,0,0,0,0
1653303828051,BILD 4,A02,089841,Mel; Stephanie,0,0,0,0
1653303828051,BILD 4,A03,089842,Mel; Stephanie,0,0,0,0
1653303828051,BILD 4,A04,089843,Mel; Stephanie,0,0,0,0
1653303828051,BILD 4,A05,089844,Mel; Stephanie,0,0,0,0
1653303828051,BILD 4,A06,089845,Mel; Stephanie,0,0,0,0
1653303828051,BILD 4,A07,089846,Mel; Stephanie,0,0,0,0
1653303828051,BILD 4,A08,089847,Mel; Stephanie,0,0,0,0
1653303828051,BILD 4,A09,089848,Mel; Stephanie,0,0,0,0
1653303828051,BILD 4,A10,089849,Mel; Stephanie,0,0,0,0
1653303828051,BILD 4,A11,089850,Mel; Stephanie,0,0,0,0
1653303828051,BILD 4,A12,089851,Mel; Stephanie,0,0,0,0
1653303828051,BILD 4,A13,089852,Mel; Stephanie,0,0,0,0
1653303828051,BILD 4,A14,089853,Mel; Stephanie,0,0,0,0
1653303828051,BILD 4,A15,089854,Mel; Stephanie,0,0,0,0
1653303828051,BILD 4,A16,089855,Mel; Stephanie,0,0,0,0
1653303828051,BILD 4,B01,089857,Lo; Stanley M.,0,0,0,0
1653303828051,BILD 4,B02,089858,Lo; Stanley M.,0,0,0,0
1653303828051,BILD 4,B03,089859,Lo; Stanley M.,0,0,0,0
1653303828051,BILD 4,B04,089860,Lo; Stanley M.,0,0,0,0
1653303828051,BILD 4,B05,089861,Lo; Stanley M.,0,0,0,0
1653303828051,BILD 4,B06,089862,Lo; Stanley M.,0,0,0,0
1653303828051,BILD 4,B07,089863,Lo; Stanley M.,0,0,0,0
1653303828051,BILD 4,B08,089864,Lo; Stanley M.,0,0,0,0
1653303828051,BILD 4,B09,089865,Lo; Stanley M.,0,0,0,0
1653303828051,BILD 4,B10,089866,Lo; Stanley M.,0,0,0,0
1653303828051,BILD 4,B11,089867,Lo; Stanley M.,0,0,0,0
1653303828051,BILD 4,B12,089868,Lo; Stanley M.,0,0,0,0
1653303828051,BILD 4,B13,089869,Lo; Stanley M.,0,0,0,0
1653303828051,BILD 4,B14,089870,Lo; Stanley M.,0,0,0,0
1653303828051,BILD 4,B15,089871,Lo; Stanley M.,0,0,0,0
1653303828051,BILD 4,B16,089872,Lo; Stanley M.,0,0,0,0
1653303828578,BILD 5,A01,092907,Reuther; Keefe,31,0,32,1
1653303828578,BILD 5,A02,092908,Reuther; Keefe,30,0,32,2
1653303829105,BILD 10,A01,092909,Gustafson-Brown; Cindy,27,0,27,0
1653303829105,BILD 10,A02,092910,Gustafson-Brown; Cindy,27,0,27,0
1653303829105,BILD 10,A03,092911,Gustafson-Brown; Cindy,27,0,27,0
1653303829105,BILD 10,A04,092912,Gustafson-Brown; Cindy,27,0,27,0
1653303829105,BILD 10,A05,092913,Gustafson-Brown; Cindy,25,0,27,2
1653303829105,BILD 10,A06,092914,Gustafson-Brown; Cindy,26,0,27,1
1653303829105,BILD 10,A07,092915,Gustafson-Brown; Cindy,27,0,27,0
1653303829105,BILD 10,A08,092916,Gustafson-Brown; Cindy,27,0,27,0
1653303829105,BILD 10,A09,092917,Gustafson-Brown; Cindy,27,0,27,0
1653303829628,BILD 20,A01,092956,Rana; Brinda Kanti,24,0,27,3
1653303829628,BILD 20,A02,092957,Rana; Brinda Kanti,24,0,27,3
1653303829628,BILD 20,A03,092958,Rana; Brinda Kanti,27,0,27,0
1653303829628,BILD 20,A04,092959,Rana; Brinda Kanti,27,0,27,0
1653303830152,BILD 32,A01,092990,Burg; Michael,27,0,27,0
1653303830152,BILD 32,A02,092991,Burg; Michael,26,0,27,1
1653303830152,BILD 32,A03,092992,Burg; Michael,27,0,27,0
1653303830152,BILD 32,A04,092993,Burg; Michael,26,0,27,1
1653303830152,BILD 32,A05,092994,Burg; Michael,27,0,27,0
1653303830152,BILD 32,A06,092995,Burg; Michael,27,0,27,0
1653303830152,BILD 32,A07,092996,Burg; Michael,27,0,27,0
1653303830683,BILD 60,A01,092392,Hammond; LaTisha Marie,24,0,24,0
1653303830683,BILD 60,A02,092393,Hammond; LaTisha Marie,24,0,24,0
1653303830683,BILD 60,B01,092394,Macagno; Eduardo R.,23,0,24,1
1653303830683,BILD 60,B02,092395,Macagno; Eduardo R.,24,0,24,0
1653303831206,BILD 62,A01,092949,Aljadeff; Johnatan,31,0,32,1
1653303831206,BILD 62,A02,092950,Aljadeff; Johnatan,32,0,32,0
1653303831206,BILD 62,A03,092951,Aljadeff; Johnatan,32,0,32,0
1653303831736,BILD 80,A00,089880,Pogliano; Joseph,27,0,30,3
1653303832272,BIMM 100,A01,092435,Pasquinelli; Amy,32,0,32,0
1653303832272,BIMM 100,A02,092436,Pasquinelli; Amy,30,0,32,2
1653303832272,BIMM 100,A03,092437,Pasquinelli; Amy,32,0,32,0
1653303832272,BIMM 100,A04,092438,Pasquinelli; Amy,31,0,32,1
1653303832272,BIMM 100,A05,092439,Pasquinelli; Amy,32,0,32,0
1653303832272,BIMM 100,A06,092440,Pasquinelli; Amy,32,0,32,0
1653303832272,BIMM 100,A07,092441,Pasquinelli; Amy,32,0,32,0
1653303832272,BIMM 100,A08,092442,Pasquinelli; Amy,32,0,32,0
1653303832272,BIMM 100,A09,092443,Pasquinelli; Amy,32,0,32,0
1653303832272,BIMM 100,A10,092444,Pasquinelli; Amy,32,0,32,0
1653303832272,BIMM 100,B01,092518,Pruneda-Paz; Jose L.,26,0,32,6
1653303832272,BIMM 100,B02,092519,Pruneda-Paz; Jose L.,19,0,32,13
1653303832272,BIMM 100,B03,092520,Pruneda-Paz; Jose L.,20,0,32,12
1653303832272,BIMM 100,B04,092521,Pruneda-Paz; Jose L.,24,0,32,8
1653303832272,BIMM 100,B05,092522,Pruneda-Paz; Jose L.,23,0,32,9
1653303832272,BIMM 100,B06,092523,Pruneda-Paz; Jose L.,24,0,32,8
1653303832272,BIMM 100,B07,092524,Pruneda-Paz; Jose L.,28,0,32,4
1653303832272,BIMM 100,B08,092525,Pruneda-Paz; Jose L.,25,0,32,7
1653303832272,BIMM 100,B09,092526,Pruneda-Paz; Jose L.,26,0,32,6
1653303832272,BIMM 100,B10,092527,Pruneda-Paz; Jose L.,24,0,32,8
1653303832806,BIMM 101,A01,089915,Rusert; Jessica Marie,22,0,24,2
1653303832806,BIMM 101,A02,089916,Rusert; Jessica Marie,21,0,24,3
1653303832806,BIMM 101,A03,089917,Rusert; Jessica Marie,21,0,24,3
1653303832806,BIMM 101,A04,089918,Rusert; Jessica Marie,20,0,24,4
1653303832806,BIMM 101,B01,089920,Grossman; Emily N,0,0,24,24
1653303832806,BIMM 101,B02,089921,Grossman; Emily N,1,0,24,23
1653303832806,BIMM 101,C01,089923,Day; Christopher D,0,0,24,24
1653303832806,BIMM 101,C02,089924,Day; Christopher D,0,0,24,24
1653303832806,BIMM 101,D01,089926,Cooper; Andrew Michael,18,0,24,6
1653303832806,BIMM 101,D02,089927,Cooper; Andrew Michael,24,0,24,0
1653303832806,BIMM 101,E01,089929,McDonnell; Lisa Marie,1,0,24,23
1653303832806,BIMM 101,E02,089930,McDonnell; Lisa Marie,12,0,24,12
1653303833332,BIMM 110,A01,092472,Tour; Ella,26,0,32,6
1653303833332,BIMM 110,A02,092473,Tour; Ella,23,0,32,9
1653303833332,BIMM 110,A03,092474,Tour; Ella,29,0,32,3
1653303833332,BIMM 110,A04,092475,Tour; Ella,27,0,32,5
1653303833332,BIMM 110,A05,092476,Tour; Ella,32,0,32,0
1653303833332,BIMM 110,A06,092477,Tour; Ella,30,0,32,2
1653303833332,BIMM 110,A07,092478,Tour; Ella,29,0,32,3
1653303833855,BIMM 120,A01,092979,Allen; Eric,28,0,32,4
1653303833855,BIMM 120,A02,092980,Allen; Eric,1,0,32,31
1653303833855,BIMM 120,A03,092981,Allen; Eric,14,0,32,18
1653303833855,BIMM 120,A04,092982,Allen; Eric,27,0,32,5
1653303833855,BIMM 120,A05,092983,Allen; Eric,30,0,32,2
1653303833855,BIMM 120,A06,092984,Allen; Eric,29,0,32,3
1653303833855,BIMM 120,A07,092985,Allen; Eric,20,0,32,12
1653303833855,BIMM 120,A08,092986,Allen; Eric,30,0,32,2
1653303833855,BIMM 120,A09,092987,Allen; Eric,30,0,32,2
1653303833855,BIMM 120,A10,092988,Allen; Eric,30,0,32,2
1653303833855,BIMM 120,A11,092989,Allen; Eric,32,0,32,0
1653303834379,BIMM 121,A01,089934,Petrie; Katherine Lynn,0,0,24,24
1653303834379,BIMM 121,A02,089935,Petrie; Katherine Lynn,0,0,24,24
1653303834379,BIMM 121,B01,089937,Pickett; Brooke Elizabeth,0,0,24,24
1653303834379,BIMM 121,B02,089938,Pickett; Brooke Elizabeth,0,0,24,24
1653303834379,BIMM 121,C01,089940,Pirino; Giorgia,0,0,24,24
1653303834379,BIMM 121,C02,089941,Pirino; Giorgia,0,0,24,24
1653303834379,BIMM 121,C03,089942,Pirino; Giorgia,0,0,24,24
1653303834379,BIMM 121,C04,089943,Pirino; Giorgia,0,0,24,24
1653303834904,BIMM 122,A01,093006,Russell; Alistair B,18,0,32,14
1653303834904,BIMM 122,A02,093007,Russell; Alistair B,16,0,32,16
1653303834904,BIMM 122,A03,093008,Russell; Alistair B,26,0,32,6
1653303834904,BIMM 122,A04,093009,Russell; Alistair B,32,0,32,0
1653303834904,BIMM 122,A05,093010,Russell; Alistair B,30,0,32,2
1653303835433,BIMM 124,A01,092404,Gustafson-Brown; Cindy,26,0,32,6
1653303835433,BIMM 124,A02,092405,Gustafson-Brown; Cindy,29,0,32,3
1653303835433,BIMM 124,A03,092406,Gustafson-Brown; Cindy,30,0,32,2
1653303835433,BIMM 124,A04,092407,Gustafson-Brown; Cindy,32,0,32,0
1653303835433,BIMM 124,A05,092408,Gustafson-Brown; Cindy,28,0,32,4
1653303835433,BIMM 124,A06,092409,Gustafson-Brown; Cindy,31,0,32,1
1653303835433,BIMM 124,A07,092410,Gustafson-Brown; Cindy,32,0,32,0
1653303835964,BIMM 140,A01,089947,Suel; Gurol Mehmet & Hao; Nan,16,0,27,11
1653303835964,BIMM 140,A02,089948,Suel; Gurol Mehmet & Hao; Nan,24,0,27,3
1653303835964,BIMM 140,A03,089949,Suel; Gurol Mehmet & Hao; Nan,21,0,27,6
1653303835964,BIMM 140,A04,089950,Suel; Gurol Mehmet & Hao; Nan,25,0,27,2
1653303835964,BIMM 140,A05,089951,Suel; Gurol Mehmet & Hao; Nan,24,0,27,3
1653303836489,BIMM 143,A01,089953,Grant; Barry J,0,0,40,40
1653303836489,BIMM 143,B01,089955,Fan; Chun Chieh,39,0,40,1
1653303836489,BIMM 143,C01,089957,Bozinovic; Goran,29,0,40,11
1653303837022,BIMM 194,A00,089958,Hasty; Jeff M,15,0,27,12
1653303837022,BIMM 194,B00,089959,Golden; James W,19,0,27,8
1653303837022,BIMM 194,C00,089960,Lykke-Andersen; Jens,2,0,27,25
1653303837022,BIMM 194,D00,094317,Golden; Susan S.,25,0,27,2
1653303837549,BIPN 100,A01,093011,Cooke; James Edward,7,0,19,12
1653303837549,BIPN 100,A02,093012,Cooke; James Edward,10,0,19,9
1653303837549,BIPN 100,A03,093013,Cooke; James Edward,8,0,19,11
1653303837549,BIPN 100,A04,093014,Cooke; James Edward,12,0,19,7
1653303837549,BIPN 100,A05,093015,Cooke; James Edward,17,0,19,2
1653303837549,BIPN 100,A06,093016,Cooke; James Edward,12,0,19,7
1653303837549,BIPN 100,A07,093017,Cooke; James Edward,12,0,19,7
1653303837549,BIPN 100,A08,093018,Cooke; James Edward,18,0,19,1
1653303837549,BIPN 100,A09,093019,Cooke; James Edward,17,0,19,2
1653303837549,BIPN 100,A10,093020,Cooke; James Edward,18,0,19,1
1653303837549,BIPN 100,B01,093036,Reyes Gonzalez; Catalina,17,0,19,2
1653303837549,BIPN 100,B02,093037,Reyes Gonzalez; Catalina,14,0,19,5
1653303837549,BIPN 100,B03,093038,Reyes Gonzalez; Catalina,16,0,19,3
1653303837549,BIPN 100,B04,093039,Reyes Gonzalez; Catalina,19,0,19,0
1653303837549,BIPN 100,B05,093040,Reyes Gonzalez; Catalina,19,0,19,0
1653303837549,BIPN 100,B06,093041,Reyes Gonzalez; Catalina,19,0,19,0
1653303837549,BIPN 100,B07,093042,Reyes Gonzalez; Catalina,14,0,19,5
1653303837549,BIPN 100,B08,093043,Reyes Gonzalez; Catalina,16,0,19,3
1653303837549,BIPN 100,B09,093044,Reyes Gonzalez; Catalina,19,0,19,0
1653303837549,BIPN 100,B10,093045,Reyes Gonzalez; Catalina,19,0,19,0
1653303838079,BIPN 102,A01,093046,Reyes Gonzalez; Catalina,28,0,32,4
1653303838079,BIPN 102,A02,093047,Reyes Gonzalez; Catalina,17,0,32,15
1653303838079,BIPN 102,A05,093050,Reyes Gonzalez; Catalina,29,0,32,3
1653303838079,BIPN 102,A06,093051,Reyes Gonzalez; Catalina,15,0,32,17
1653303838079,BIPN 102,A07,093052,Reyes Gonzalez; Catalina,29,0,32,3
1653303838079,BIPN 102,A08,093053,Reyes Gonzalez; Catalina,31,0,32,1
1653303838603,BIPN 105,A01,089966,Armour; Jon Christopher,0,0,21,21
1653303838603,BIPN 105,A02,089967,Armour; Jon Christopher,0,0,21,21
1653303838603,BIPN 105,A03,089968,Armour; Jon Christopher,3,0,21,18
1653303838603,BIPN 105,A04,089969,Armour; Jon Christopher,10,0,21,11
1653303839131,BIPN 140,A01,092514,Spitzer; Nicholas & Su; Chih-Ying,9,0,19,10
1653303839131,BIPN 140,A02,092515,Spitzer; Nicholas & Su; Chih-Ying,12,0,19,7
1653303839131,BIPN 140,A03,092516,Spitzer; Nicholas & Su; Chih-Ying,11,0,19,8
1653303839131,BIPN 140,A04,092517,Spitzer; Nicholas & Su; Chih-Ying,15,0,19,4
1653303839131,BIPN 140,B01,092952,Banghart; Matthew Ryan,12,0,19,7
1653303839131,BIPN 140,B02,092953,Banghart; Matthew Ryan,19,0,19,0
1653303839131,BIPN 140,B03,092954,Banghart; Matthew Ryan,19,0,19,0
1653303839131,BIPN 140,B04,092955,Banghart; Matthew Ryan,19,0,19,0
1653303839655,BIPN 145,A01,089973,Marino; Marc J,35,0,42,7
1653303839655,BIPN 145,A02,089974,Marino; Marc J,36,0,42,6
1653303839655,BIPN 145,B01,089976,Juavinett; Ashley Lauren,0,0,42,42
1653303840190,BIPN 148,A01,092960,Leutgeb; Jill K.,31,0,32,1
1653303840190,BIPN 148,A02,092961,Leutgeb; Jill K.,25,0,32,7
1653303840190,BIPN 148,A03,092962,Leutgeb; Jill K.,29,0,31,2
1653303840190,BIPN 148,A04,092963,Leutgeb; Jill K.,31,0,31,0
1653303840190,BIPN 148,A05,092964,Leutgeb; Jill K.,31,0,31,0
1653303840190,BIPN 148,A06,094351,Leutgeb; Jill K.,26,0,31,5
1653303840190,BIPN 148,A07,092966,Leutgeb; Jill K.,26,0,31,5
1653303840190,BIPN 148,A08,092967,Leutgeb; Jill K.,26,0,31,5
1653303840727,BIPN 189,A00,090665,Gentner; Tim,0,0,25,25
1653303841252,BIPN 194,A00,089978,Pekkurnaz Banghart; Gulcin,17,0,27,10
1653303841252,BIPN 194,B00,089979,Leutgeb; Stefan,24,0,27,3
1653303841779,BISP 194,A00,089980,Wertheim; Joel Okrent,8,0,27,19
1653303842353,CAT 1,A01,086671,Bronstein; Phoebe Malan,17,0,17,0
1653303842353,CAT 1,A02,086672,Bronstein; Phoebe Malan,13,0,17,4
1653303842353,CAT 1,A03,086673,Bronstein; Phoebe Malan,17,0,17,0
1653303842353,CAT 1,A04,086674,Bronstein; Phoebe Malan,15,0,17,2
1653303842353,CAT 1,A05,086675,Bronstein; Phoebe Malan,17,0,17,0
1653303842353,CAT 1,A06,086676,Bronstein; Phoebe Malan,17,0,17,0
1653303842353,CAT 1,A07,086677,Bronstein; Phoebe Malan,16,0,17,1
1653303842353,CAT 1,A08,086678,Bronstein; Phoebe Malan,17,0,17,0
1653303842353,CAT 1,A09,086679,Bronstein; Phoebe Malan,16,0,17,1
1653303842353,CAT 1,A10,086680,Bronstein; Phoebe Malan,17,0,17,0
1653303842353,CAT 1,A11,086681,Bronstein; Phoebe Malan,16,0,17,1
1653303842353,CAT 1,A12,086682,Bronstein; Phoebe Malan,17,0,17,0
1653303842353,CAT 1,A13,086683,Bronstein; Phoebe Malan,17,0,17,0
1653303842353,CAT 1,A14,086684,Bronstein; Phoebe Malan,17,0,17,0
1653303842353,CAT 1,A15,086685,Bronstein; Phoebe Malan,17,0,17,0
1653303842353,CAT 1,A16,086686,Bronstein; Phoebe Malan,17,0,17,0
1653303842353,CAT 1,B01,086688,Bigham; David Joseph,17,0,17,0
1653303842353,CAT 1,B02,086689,Bigham; David Joseph,16,0,17,1
1653303842353,CAT 1,B03,086690,Bigham; David Joseph,17,0,17,0
1653303842353,CAT 1,B04,086691,Bigham; David Joseph,17,0,17,0
1653303842353,CAT 1,B05,086692,Bigham; David Joseph,16,0,17,1
1653303842353,CAT 1,B06,086693,Bigham; David Joseph,17,0,17,0
1653303842353,CAT 1,B07,086694,Bigham; David Joseph,17,0,17,0
1653303842353,CAT 1,B08,086695,Bigham; David Joseph,17,0,17,0
1653303842353,CAT 1,B09,086696,Bigham; David Joseph,17,0,17,0
1653303842353,CAT 1,B10,086697,Bigham; David Joseph,17,0,17,0
1653303842353,CAT 1,B11,086698,Bigham; David Joseph,17,0,17,0
1653303842353,CAT 1,B12,086699,Bigham; David Joseph,17,0,17,0
1653303842353,CAT 1,B13,086700,Bigham; David Joseph,15,0,17,2
1653303842353,CAT 1,B14,086701,Bigham; David Joseph,17,0,17,0
1653303842353,CAT 1,C01,086703,Algaze; Guillermo,17,0,17,0
1653303842353,CAT 1,C02,086704,Algaze; Guillermo,17,0,17,0
1653303842353,CAT 1,C03,086705,Algaze; Guillermo,17,0,17,0
1653303842353,CAT 1,C04,086706,Algaze; Guillermo,17,0,17,0
1653303842353,CAT 1,C05,086707,Algaze; Guillermo,17,0,17,0
1653303842353,CAT 1,C06,086708,Algaze; Guillermo,17,0,17,0
1653303842353,CAT 1,C07,086709,Algaze; Guillermo,17,0,17,0
1653303842353,CAT 1,C08,086710,Algaze; Guillermo,17,0,17,0
1653303842353,CAT 1,C09,086711,Algaze; Guillermo,17,0,17,0
1653303842353,CAT 1,C10,086712,Algaze; Guillermo,17,0,17,0
1653303842353,CAT 1,C11,086713,Algaze; Guillermo,17,0,17,0
1653303842353,CAT 1,C12,086714,Algaze; Guillermo,17,0,17,0
1653303842353,CAT 1,C13,086715,Algaze; Guillermo,17,0,17,0
1653303842353,CAT 1,C14,086716,Algaze; Guillermo,16,0,17,1
1653303842353,CAT 1,C15,086717,Algaze; Guillermo,17,0,17,0
1653303842353,CAT 1,C16,086718,Algaze; Guillermo,16,0,17,1
1653303842353,CAT 1,D01,086720,Staff,17,0,17,0
1653303842353,CAT 1,D02,086721,Staff,17,0,17,0
1653303842353,CAT 1,D03,086722,Staff,17,0,17,0
1653303842353,CAT 1,D04,086723,Staff,17,0,17,0
1653303842353,CAT 1,D05,086724,Staff,16,0,17,1
1653303842353,CAT 1,D06,086725,Staff,16,0,17,1
1653303842353,CAT 1,D07,086726,Staff,17,0,17,0
1653303842353,CAT 1,D08,086727,Staff,17,0,17,0
1653303842353,CAT 1,D09,086728,Staff,16,0,17,1
1653303842353,CAT 1,D10,086729,Staff,17,0,17,0
1653303842353,CAT 1,D11,086730,Staff,17,0,17,0
1653303842353,CAT 1,D12,086731,Staff,17,0,17,0
1653303842353,CAT 1,D13,086732,Staff,17,0,17,0
1653303842353,CAT 1,D14,086733,Staff,17,0,17,0
1653303842883,CAT 3,A01,086735,Gumm; Elizabeth Ashley,14,0,15,1
1653303842883,CAT 3,A02,086736,Gumm; Elizabeth Ashley,14,0,15,1
1653303842883,CAT 3,A03,086737,Gumm; Elizabeth Ashley,15,0,15,0
1653303842883,CAT 3,A04,086738,Gumm; Elizabeth Ashley,15,0,15,0
1653303842883,CAT 3,A05,086739,Gumm; Elizabeth Ashley,15,0,15,0
1653303842883,CAT 3,A06,086740,Gumm; Elizabeth Ashley,15,0,15,0
1653303843416,CAT 124,A01,086742,Staff,15,0,15,0
1653303843947,CAT 125R,A01,094882,Staff,14,0,16,2
1653303843947,CAT 125R,A02,086745,Staff,16,0,16,0
1653303843947,CAT 125R,A03,086746,Staff,14,0,16,2
1653303843947,CAT 125R,A04,086747,Staff,13,0,16,3
1653303843947,CAT 125R,A05,086748,Staff,15,0,16,1
1653303843947,CAT 125R,A06,086749,Staff,12,0,16,4
1653303843947,CAT 125R,A07,086750,Staff,14,0,16,2
1653303843947,CAT 125R,A08,094883,Staff,14,0,16,2
1653303843947,CAT 125R,A09,094884,Staff,16,0,16,0
1653303843947,CAT 125R,A10,094885,Staff,15,0,16,1
1653303843947,CAT 125R,A14,086761,Staff,15,0,16,1
1653303843947,CAT 125R,A15,086762,Staff,16,0,16,0
1653303843947,CAT 125R,A16,086763,Staff,13,0,16,3
1653303843947,CAT 125R,A17,086764,Staff,14,0,16,2
1653303843947,CAT 125R,A18,086765,Staff,14,0,16,2
1653303843947,CAT 125R,A19,086766,Staff,14,0,16,2
1653303844481,CCS 101,A00,088353,Staff,29,0,35,6
1653303845007,CENG 4,A01,086204,Bae; Jinhye,30,0,30,0
1653303845007,CENG 4,A02,086205,Bae; Jinhye,30,0,30,0
1653303845007,CENG 4,B01,086207,Drews; Aaron,30,0,30,0
1653303845007,CENG 4,B02,086208,Drews; Aaron,30,0,30,0
1653303845530,CENG 15,A01,086210,Lubarda; Vlado,63,0,65,2
1653303845530,CENG 15,B01,086212,Lubarda; Vlado,65,0,65,0
1653303846054,CENG 100,A00,086213,Chen; Zheng,147,0,150,3
1653303846583,CENG 101A,A00,086214,Bae; Jinhye,142,0,150,8
1653303847106,CENG 120,A00,086215,Opatkiewicz; Justin Paul,125,0,150,25
1653303847630,CENG 122,A00,086216,Opatkiewicz; Justin Paul,137,0,150,13
1653303848155,CGS 2A,A01,086271,Shelby; Karen Lee,12,0,15,3
1653303848155,CGS 2A,A02,086272,Shelby; Karen Lee,13,0,15,2
1653303848155,CGS 2A,A03,086273,Shelby; Karen Lee,14,0,15,1
1653303848155,CGS 2A,A04,086274,Shelby; Karen Lee,15,0,15,0
1653303848682,CGS 100A,A00,086275,Perez; Roy,26,0,32,6
1653303849203,CGS 101,A00,086276,Shelby; Karen Lee,30,0,30,0
1653303849727,CGS 106,A00,086277,Shelby; Karen Lee,24,0,30,6
1653303850253,CGS 119,A00,086279,Nguyen; Hoang Tan,27,0,30,3
1653303850776,CGS 121,A00,086280,Martin Sandino; Amanda Maria Yoland,19,0,20,1
1653303851301,CGS 122,A00,086281,Whitley; Leila Marie,20,0,20,0
1653303851824,CGS 123,A00,086282,Staff,0,0,0,0
1653303852347,CGS 127,A00,086283,Whitley; Leila Marie,15,0,15,0
1653303852880,CGS 130,A00,086284,Martin Sandino; Amanda Maria Yoland,15,0,15,0
1653303853406,CGS 187,A00,086285,Perez; Roy,15,0,16,1
1653303853934,CGS 190,A00,086286,Staff,5,0,5,0
1653303854474,CHEM 4,A01,089669,Bussey; Thomas J,40,0,40,0
1653303854474,CHEM 4,A02,089670,Bussey; Thomas J,42,0,42,0
1653303854474,CHEM 4,A03,089671,Bussey; Thomas J,40,0,42,2
1653303854474,CHEM 4,A04,089672,Bussey; Thomas J,42,0,42,0
1653303854474,CHEM 4,A05,089673,Bussey; Thomas J,40,0,42,2
1653303854474,CHEM 4,A06,089674,Bussey; Thomas J,40,0,42,2
1653303854474,CHEM 4,A07,089675,Bussey; Thomas J,42,0,42,0
1653303854474,CHEM 4,A08,089676,Bussey; Thomas J,42,0,42,0
1653303854474,CHEM 4,A09,089677,Bussey; Thomas J,41,0,41,0
1653303854474,CHEM 4,A10,089678,Bussey; Thomas J,40,0,40,0
1653303855033,CHEM 6A,A01,092734,Pomeroy; Robert S.,4,0,4,0
1653303855033,CHEM 6A,A02,092735,Pomeroy; Robert S.,4,0,4,0
1653303855033,CHEM 6A,A03,092736,Pomeroy; Robert S.,4,0,4,0
1653303855033,CHEM 6A,A04,092737,Pomeroy; Robert S.,4,0,4,0
1653303855033,CHEM 6A,A05,092738,Pomeroy; Robert S.,4,0,4,0
1653303855033,CHEM 6A,A06,092739,Pomeroy; Robert S.,4,0,4,0
1653303855033,CHEM 6A,A07,092740,Pomeroy; Robert S.,4,0,4,0
1653303855033,CHEM 6A,A08,092741,Pomeroy; Robert S.,4,0,4,0
1653303855033,CHEM 6A,A09,092742,Pomeroy; Robert S.,0,0,0,0
1653303855033,CHEM 6A,B01,092744,Schurmeier; Kimberly,4,0,4,0
1653303855033,CHEM 6A,B02,092746,Schurmeier; Kimberly,4,0,4,0
1653303855033,CHEM 6A,B03,092749,Schurmeier; Kimberly,4,0,4,0
1653303855033,CHEM 6A,B04,092751,Schurmeier; Kimberly,4,0,4,0
1653303855033,CHEM 6A,B05,092753,Schurmeier; Kimberly,4,0,4,0
1653303855033,CHEM 6A,B06,092755,Schurmeier; Kimberly,3,0,4,1
1653303855033,CHEM 6A,B07,092756,Schurmeier; Kimberly,4,0,4,0
1653303855033,CHEM 6A,B08,092757,Schurmeier; Kimberly,4,0,4,0
1653303855033,CHEM 6A,B09,092758,Schurmeier; Kimberly,0,0,0,0
1653303855033,CHEM 6A,C01,092805,Schurmeier; Kimberly,4,0,4,0
1653303855033,CHEM 6A,C02,092806,Schurmeier; Kimberly,4,0,4,0
1653303855033,CHEM 6A,C03,092807,Schurmeier; Kimberly,4,0,4,0
1653303855033,CHEM 6A,C04,092808,Schurmeier; Kimberly,4,0,4,0
1653303855033,CHEM 6A,C05,092809,Schurmeier; Kimberly,4,0,4,0
1653303855033,CHEM 6A,C06,092810,Schurmeier; Kimberly,4,0,4,0
1653303855033,CHEM 6A,C07,092811,Schurmeier; Kimberly,4,0,4,0
1653303855033,CHEM 6A,C08,092812,Schurmeier; Kimberly,4,0,4,0
1653303855033,CHEM 6A,C09,092813,Schurmeier; Kimberly,0,0,0,0
1653303855033,CHEM 6A,D01,092837,Stallings; Dontarie M,4,0,4,0
1653303855033,CHEM 6A,D02,092838,Stallings; Dontarie M,4,0,4,0
1653303855033,CHEM 6A,D03,092839,Stallings; Dontarie M,4,0,4,0
1653303855033,CHEM 6A,D04,092840,Stallings; Dontarie M,4,0,4,0
1653303855033,CHEM 6A,D05,092841,Stallings; Dontarie M,4,0,4,0
1653303855033,CHEM 6A,D06,092842,Stallings; Dontarie M,4,0,4,0
1653303855033,CHEM 6A,D07,092843,Stallings; Dontarie M,4,0,4,0
1653303855033,CHEM 6A,D08,092844,Stallings; Dontarie M,4,0,4,0
1653303855033,CHEM 6A,D09,092845,Stallings; Dontarie M,0,0,0,0
1653303855033,CHEM 6A,E01,092796,Brydges; Stacey,4,0,4,0
1653303855033,CHEM 6A,E02,092797,Brydges; Stacey,3,0,4,1
1653303855033,CHEM 6A,E03,092798,Brydges; Stacey,4,0,4,0
1653303855033,CHEM 6A,E04,092799,Brydges; Stacey,3,0,4,1
1653303855033,CHEM 6A,E05,092800,Brydges; Stacey,4,0,4,0
1653303855033,CHEM 6A,E06,092801,Brydges; Stacey,4,0,4,0
1653303855033,CHEM 6A,E07,092802,Brydges; Stacey,4,0,4,0
1653303855033,CHEM 6A,E08,092803,Brydges; Stacey,4,0,4,0
1653303855033,CHEM 6A,E09,092804,Brydges; Stacey,0,0,0,0
1653303855033,CHEM 6A,F01,092759,Brydges; Stacey,4,0,4,0
1653303855033,CHEM 6A,F02,092760,Brydges; Stacey,4,0,4,0
1653303855033,CHEM 6A,F03,092761,Brydges; Stacey,3,0,4,1
1653303855033,CHEM 6A,F04,092762,Brydges; Stacey,4,0,4,0
1653303855033,CHEM 6A,F05,092763,Brydges; Stacey,4,0,4,0
1653303855033,CHEM 6A,F06,092764,Brydges; Stacey,4,0,4,0
1653303855033,CHEM 6A,F07,092765,Brydges; Stacey,4,0,4,0
1653303855033,CHEM 6A,F08,092766,Brydges; Stacey,4,0,4,0
1653303855033,CHEM 6A,F09,092767,Brydges; Stacey,0,0,0,0
1653303855033,CHEM 6A,G01,092774,Zid; Brian M,0,0,4,4
1653303855033,CHEM 6A,G02,092775,Zid; Brian M,2,0,4,2
1653303855033,CHEM 6A,G03,092776,Zid; Brian M,2,0,4,2
1653303855033,CHEM 6A,G04,092777,Zid; Brian M,2,0,4,2
1653303855033,CHEM 6A,G05,092778,Zid; Brian M,4,0,4,0
1653303855033,CHEM 6A,G06,092779,Zid; Brian M,4,0,4,0
1653303855033,CHEM 6A,G07,092780,Zid; Brian M,3,0,4,1
1653303855033,CHEM 6A,G08,092781,Zid; Brian M,3,0,4,1
1653303855033,CHEM 6A,G09,092782,Zid; Brian M,0,0,0,0
1653303855033,CHEM 6A,H01,092846,Stallings; Dontarie M,4,0,4,0
1653303855033,CHEM 6A,H02,092847,Stallings; Dontarie M,3,0,4,1
1653303855033,CHEM 6A,H03,092848,Stallings; Dontarie M,4,0,4,0
1653303855033,CHEM 6A,H04,092849,Stallings; Dontarie M,4,0,4,0
1653303855033,CHEM 6A,H05,092850,Stallings; Dontarie M,4,0,4,0
1653303855033,CHEM 6A,H06,092851,Stallings; Dontarie M,3,0,4,1
1653303855033,CHEM 6A,H07,092852,Stallings; Dontarie M,4,0,4,0
1653303855033,CHEM 6A,H08,092853,Stallings; Dontarie M,3,0,4,1
1653303855033,CHEM 6A,H09,092854,Stallings; Dontarie M,0,0,0,0
1653303855033,CHEM 6A,I01,092814,Staff,0,0,0,0
1653303855033,CHEM 6A,I02,092815,Staff,0,0,0,0
1653303855033,CHEM 6A,I04,092816,Staff,0,0,0,0
1653303855033,CHEM 6A,I05,092817,Staff,0,0,0,0
1653303855033,CHEM 6A,I06,092818,Staff,0,0,0,0
1653303855033,CHEM 6A,I07,092819,Staff,0,0,0,0
1653303855033,CHEM 6A,I08,092820,Staff,0,0,0,0
1653303855033,CHEM 6A,I09,092821,Staff,0,0,0,0
1653303855560,CHEM 6AH,A01,092793,Paesani; Francesco,15,0,16,1
1653303855560,CHEM 6AH,A02,092794,Paesani; Francesco,16,0,16,0
1653303855560,CHEM 6AH,A03,092795,Paesani; Francesco,16,0,16,0
1653303856090,CHEM 6B,A01,092691,Hopkins; Patrycja Anna,21,0,25,4
1653303856090,CHEM 6B,A02,092692,Hopkins; Patrycja Anna,23,0,25,2
1653303856090,CHEM 6B,A03,092693,Hopkins; Patrycja Anna,25,0,25,0
1653303856090,CHEM 6B,A04,092694,Hopkins; Patrycja Anna,0,0,0,0
1653303856090,CHEM 6B,A05,092695,Hopkins; Patrycja Anna,24,0,25,1
1653303856090,CHEM 6B,A06,092696,Hopkins; Patrycja Anna,22,0,25,3
1653303856090,CHEM 6B,A07,092697,Hopkins; Patrycja Anna,24,0,25,1
1653303856614,CHEM 6C,A01,092708,Albizati; Kim F.,31,0,38,7
1653303856614,CHEM 6C,A02,092709,Albizati; Kim F.,32,0,38,6
1653303856614,CHEM 6C,A03,092710,Albizati; Kim F.,37,0,38,1
1653303856614,CHEM 6C,A04,092711,Albizati; Kim F.,36,0,38,2
1653303856614,CHEM 6C,A05,092712,Albizati; Kim F.,0,0,0,0
1653303856614,CHEM 6C,A06,092714,Albizati; Kim F.,33,0,38,5
1653303856614,CHEM 6C,A07,092715,Albizati; Kim F.,32,0,38,6
1653303856614,CHEM 6C,A08,092716,Albizati; Kim F.,37,0,38,1
1653303856614,CHEM 6C,A09,092717,Albizati; Kim F.,38,0,38,0
1653303857142,CHEM 7L,A01,089692,Leigh; Brian,11,0,19,8
1653303857142,CHEM 7L,A02,089693,Leigh; Brian,23,0,24,1
1653303857142,CHEM 7L,A03,089694,Leigh; Brian,24,0,24,0
1653303857142,CHEM 7L,A04,089695,Leigh; Brian,24,0,24,0
1653303857142,CHEM 7L,A05,089696,Leigh; Brian,23,0,24,1
1653303857142,CHEM 7L,A06,089697,Leigh; Brian,22,0,24,2
1653303857142,CHEM 7L,A07,089698,Leigh; Brian,21,0,21,0
1653303857142,CHEM 7L,A08,089699,Leigh; Brian,17,0,24,7
1653303857142,CHEM 7L,A09,089700,Leigh; Brian,23,0,24,1
1653303857142,CHEM 7L,A10,089701,Leigh; Brian,0,0,0,0
1653303857142,CHEM 7L,B01,089703,Leigh; Brian,18,0,24,6
1653303857142,CHEM 7L,B02,089704,Leigh; Brian,18,0,24,6
1653303857142,CHEM 7L,B03,089705,Leigh; Brian,23,0,24,1
1653303857142,CHEM 7L,B04,089706,Leigh; Brian,20,0,21,1
1653303857142,CHEM 7L,B05,089707,Leigh; Brian,17,0,24,7
1653303857142,CHEM 7L,B06,089708,Leigh; Brian,17,0,24,7
1653303857142,CHEM 7L,B07,089709,Leigh; Brian,17,0,24,7
1653303857142,CHEM 7L,B08,089710,Leigh; Brian,21,0,24,3
1653303857142,CHEM 7L,B09,089711,Leigh; Brian,21,0,24,3
1653303857142,CHEM 7L,B10,089712,Leigh; Brian,0,0,0,0
1653303857142,CHEM 7L,C01,089714,Staff,23,0,24,1
1653303857142,CHEM 7L,C02,089715,Staff,22,0,24,2
1653303857142,CHEM 7L,C03,089716,Staff,23,0,24,1
1653303857142,CHEM 7L,C04,089717,Staff,24,0,24,0
1653303857142,CHEM 7L,C05,089718,Staff,21,0,24,3
1653303857142,CHEM 7L,C06,089719,Staff,22,0,24,2
1653303857142,CHEM 7L,C07,089720,Staff,23,0,24,1
1653303857142,CHEM 7L,C08,089721,Staff,24,0,24,0
1653303857142,CHEM 7L,C09,089722,Staff,24,0,24,0
1653303857142,CHEM 7L,C10,089723,Staff,0,0,0,0
1653303857681,CHEM 40A,A01,092871,Schmidt; Valerie A,31,0,31,0
1653303857681,CHEM 40A,A02,092872,Schmidt; Valerie A,31,0,31,0
1653303857681,CHEM 40A,A03,092873,Schmidt; Valerie A,31,0,31,0
1653303857681,CHEM 40A,A04,092874,Schmidt; Valerie A,0,0,0,0
1653303857681,CHEM 40A,A05,092875,Schmidt; Valerie A,31,0,31,0
1653303857681,CHEM 40A,A06,092876,Schmidt; Valerie A,29,0,31,2
1653303857681,CHEM 40A,A07,092877,Schmidt; Valerie A,31,0,31,0
1653303857681,CHEM 40A,A08,092878,Schmidt; Valerie A,28,0,28,0
1653303857681,CHEM 40A,B01,089726,Lam; Tin Yiu,31,0,31,0
1653303857681,CHEM 40A,B02,089727,Lam; Tin Yiu,31,0,31,0
1653303857681,CHEM 40A,B03,089728,Lam; Tin Yiu,31,0,31,0
1653303857681,CHEM 40A,B04,089729,Lam; Tin Yiu,30,0,31,1
1653303857681,CHEM 40A,B05,089730,Lam; Tin Yiu,31,0,31,0
1653303857681,CHEM 40A,B06,089731,Lam; Tin Yiu,30,0,31,1
1653303857681,CHEM 40A,B07,089732,Lam; Tin Yiu,29,0,31,2
1653303857681,CHEM 40A,B08,089733,Lam; Tin Yiu,0,0,0,0
1653303857681,CHEM 40A,C01,092718,Albizati; Kim F.,17,0,31,14
1653303857681,CHEM 40A,C02,092719,Albizati; Kim F.,24,0,31,7
1653303857681,CHEM 40A,C03,092720,Albizati; Kim F.,12,0,31,19
1653303857681,CHEM 40A,C04,092721,Albizati; Kim F.,24,0,31,7
1653303857681,CHEM 40A,C05,092722,Albizati; Kim F.,21,0,31,10
1653303857681,CHEM 40A,C06,092723,Albizati; Kim F.,24,0,31,7
1653303857681,CHEM 40A,C07,092724,Albizati; Kim F.,30,0,31,1
1653303857681,CHEM 40A,C08,092725,Albizati; Kim F.,0,0,0,0
1653303857681,CHEM 40A,D01,092863,Yang; Jerry,28,0,31,3
1653303857681,CHEM 40A,D02,092864,Yang; Jerry,28,0,31,3
1653303857681,CHEM 40A,D03,092865,Yang; Jerry,31,0,31,0
1653303857681,CHEM 40A,D04,092866,Yang; Jerry,31,0,31,0
1653303857681,CHEM 40A,D05,092867,Yang; Jerry,0,0,0,0
1653303857681,CHEM 40A,D06,092868,Yang; Jerry,31,0,31,0
1653303857681,CHEM 40A,D07,092869,Yang; Jerry,31,0,31,0
1653303857681,CHEM 40A,D08,092870,Yang; Jerry,31,0,31,0
1653303858205,CHEM 40B,A01,092698,Oconnor; Joseph M.,24,0,34,10
1653303858205,CHEM 40B,A02,092699,Oconnor; Joseph M.,34,0,34,0
1653303858205,CHEM 40B,A03,092700,Oconnor; Joseph M.,0,0,0,0
1653303858205,CHEM 40B,A04,092701,Oconnor; Joseph M.,30,0,34,4
1653303858205,CHEM 40B,A05,092702,Oconnor; Joseph M.,33,0,34,1
1653303858205,CHEM 40B,A06,092703,Oconnor; Joseph M.,34,0,34,0
1653303858205,CHEM 40B,A07,092704,Oconnor; Joseph M.,32,0,34,2
1653303858205,CHEM 40B,A08,092705,Oconnor; Joseph M.,33,0,34,1
1653303858205,CHEM 40B,A09,092706,Oconnor; Joseph M.,34,0,34,0
1653303858728,CHEM 40C,A01,089739,Lam; Tin Yiu,0,0,0,0
1653303858728,CHEM 40C,A02,089740,Lam; Tin Yiu,0,0,0,0
1653303858728,CHEM 40C,A03,089741,Lam; Tin Yiu,0,0,0,0
1653303858728,CHEM 40C,A04,089742,Lam; Tin Yiu,13,0,34,21
1653303858728,CHEM 40C,A05,089743,Lam; Tin Yiu,32,0,34,2
1653303858728,CHEM 40C,A06,089744,Lam; Tin Yiu,31,0,34,3
1653303859263,CHEM 41A,A01,093840,Ternansky; Robert J.,29,0,33,4
1653303859263,CHEM 41A,A02,093841,Ternansky; Robert J.,32,0,33,1
1653303859263,CHEM 41A,A03,093842,Ternansky; Robert J.,33,0,33,0
1653303859263,CHEM 41A,A04,093843,Ternansky; Robert J.,30,0,33,3
1653303859263,CHEM 41A,A05,093844,Ternansky; Robert J.,31,0,33,2
1653303859263,CHEM 41A,A06,093845,Ternansky; Robert J.,27,0,27,0
1653303859263,CHEM 41A,A07,093846,Ternansky; Robert J.,32,0,33,1
1653303859263,CHEM 41A,A08,093847,Ternansky; Robert J.,33,0,33,0
1653303859798,CHEM 43A,A01,089746,Klosterman; Jeremy K,11,0,24,13
1653303859798,CHEM 43A,A02,089747,Klosterman; Jeremy K,16,0,24,8
1653303859798,CHEM 43A,A03,089748,Klosterman; Jeremy K,21,0,24,3
1653303859798,CHEM 43A,A04,089749,Klosterman; Jeremy K,22,0,24,2
1653303859798,CHEM 43A,A05,089750,Klosterman; Jeremy K,23,0,24,1
1653303859798,CHEM 43A,A06,089751,Klosterman; Jeremy K,8,0,24,16
1653303859798,CHEM 43A,A07,089752,Klosterman; Jeremy K,17,0,24,7
1653303859798,CHEM 43A,A08,089753,Klosterman; Jeremy K,16,0,24,8
1653303859798,CHEM 43A,A09,089754,Klosterman; Jeremy K,21,0,24,3
1653303859798,CHEM 43A,A10,089755,Klosterman; Jeremy K,21,0,24,3
1653303859798,CHEM 43A,A11,089756,Klosterman; Jeremy K,0,0,0,0
1653303859798,CHEM 43A,A12,089757,Klosterman; Jeremy K,0,0,0,0
1653303859798,CHEM 43A,A13,089758,Klosterman; Jeremy K,0,0,0,0
1653303859798,CHEM 43A,B01,089760,Klosterman; Jeremy K,0,0,0,0
1653303859798,CHEM 43A,B02,089761,Klosterman; Jeremy K,0,0,0,0
1653303859798,CHEM 43A,B03,089762,Klosterman; Jeremy K,16,0,24,8
1653303859798,CHEM 43A,B04,089763,Klosterman; Jeremy K,22,0,24,2
1653303859798,CHEM 43A,B05,089764,Klosterman; Jeremy K,23,0,24,1
1653303859798,CHEM 43A,B06,089765,Klosterman; Jeremy K,23,0,24,1
1653303859798,CHEM 43A,B07,089766,Klosterman; Jeremy K,17,0,24,7
1653303859798,CHEM 43A,B08,089767,Klosterman; Jeremy K,23,0,24,1
1653303859798,CHEM 43A,B09,089768,Klosterman; Jeremy K,24,0,24,0
1653303859798,CHEM 43A,B10,089769,Klosterman; Jeremy K,23,0,24,1
1653303859798,CHEM 43A,B11,089770,Klosterman; Jeremy K,22,0,24,2
1653303859798,CHEM 43A,B12,089771,Klosterman; Jeremy K,21,0,24,3
1653303860320,CHEM 87,A00,089772,Bussey; Thomas J,20,0,20,0
1653303860844,CHEM 96,A00,089773,Bussey; Thomas J,20,0,25,5
1653303861375,CHEM 100A,A01,089775,Pomeroy; Robert S.,22,0,24,2
1653303861375,CHEM 100A,A02,089776,Pomeroy; Robert S.,19,0,24,5
1653303861375,CHEM 100A,A03,089777,Pomeroy; Robert S.,13,0,24,11
1653303861375,CHEM 100A,A04,089778,Pomeroy; Robert S.,18,0,24,6
1653303861375,CHEM 100A,A05,089779,Pomeroy; Robert S.,19,0,24,5
1653303861375,CHEM 100A,A06,089780,Pomeroy; Robert S.,24,0,24,0
1653303861375,CHEM 100A,A07,089781,Pomeroy; Robert S.,0,0,0,0
1653303861979,CHEM 105A,A01,089783,Young; Mark,0,0,39,39
1653303861979,CHEM 105A,B01,089785,Young; Mark,26,0,39,13
1653303862506,CHEM 108,A01,089787,Ghosh; Gourisankar,1,0,22,21
1653303862506,CHEM 108,A02,089788,Ghosh; Gourisankar,6,0,22,16
1653303862506,CHEM 108,B01,089790,Ghosh; Gourisankar,13,0,22,9
1653303862506,CHEM 108,B02,089791,Ghosh; Gourisankar,20,0,22,2
1653303863031,CHEM 109,A01,089793,Hamaoka; Brent Y,4,0,22,18
1653303863031,CHEM 109,A02,089794,Hamaoka; Brent Y,10,0,22,12
1653303863031,CHEM 109,B01,089796,Hamaoka; Brent Y,6,0,22,16
1653303863031,CHEM 109,B02,089797,Hamaoka; Brent Y,18,0,22,4
1653303863561,CHEM 114A,A01,092855,Toor; Navtej,21,0,25,4
1653303863561,CHEM 114A,A02,092856,Toor; Navtej,25,0,25,0
1653303863561,CHEM 114A,A03,092857,Toor; Navtej,19,0,25,6
1653303863561,CHEM 114A,A04,092858,Toor; Navtej,24,0,25,1
1653303863561,CHEM 114A,A05,092859,Toor; Navtej,0,0,0,0
1653303863561,CHEM 114A,A06,092860,Toor; Navtej,14,0,25,11
1653303863561,CHEM 114A,A07,092861,Toor; Navtej,24,0,25,1
1653303863561,CHEM 114A,A08,092862,Toor; Navtej,24,0,25,1
1653303864085,CHEM 116,A01,092707,Ferguson; Fleur,6,0,35,29
1653303864085,CHEM 116,A02,094887,Ferguson; Fleur,31,0,35,4
1653303864615,CHEM 120A,A01,092785,Schimpf; Alina M,16,0,28,12
1653303864615,CHEM 120A,A02,092786,Schimpf; Alina M,26,0,28,2
1653303864615,CHEM 120A,A03,092787,Schimpf; Alina M,20,0,28,8
1653303864615,CHEM 120A,A04,092788,Schimpf; Alina M,27,0,28,1
1653303864615,CHEM 120A,A05,092789,Schimpf; Alina M,27,0,28,1
1653303864615,CHEM 120A,A06,092790,Schimpf; Alina M,0,0,0,0
1653303864615,CHEM 120A,A07,092791,Schimpf; Alina M,15,0,28,13
1653303864615,CHEM 120A,A08,092792,Schimpf; Alina M,0,0,0,0
1653303865139,CHEM 126A,A01,092768,Schoeneberg; Johannes,16,0,35,19
1653303865139,CHEM 126A,A02,092769,Schoeneberg; Johannes,35,0,35,0
1653303865139,CHEM 126A,A03,092770,Schoeneberg; Johannes,29,0,35,6
1653303865139,CHEM 126A,A04,092771,Schoeneberg; Johannes,0,0,0,0
1653303865139,CHEM 126A,A05,092772,Schoeneberg; Johannes,30,0,35,5
1653303865139,CHEM 126A,A06,092773,Schoeneberg; Johannes,33,0,35,2
1653303865665,CHEM 130,A01,092685,Sinha; Amitabha,28,0,38,10
1653303865665,CHEM 130,A02,092686,Sinha; Amitabha,31,0,38,7
1653303865665,CHEM 130,A03,092687,Sinha; Amitabha,34,0,38,4
1653303866193,CHEM 142,A00,089803,Esko; Jeffrey D. & Godula; Kamil,9,0,46,37
1653303866715,CHEM 143C,A01,089805,Ternansky; Robert J.,17,0,22,5
1653303866715,CHEM 143C,A02,089806,Ternansky; Robert J.,18,0,22,4
1653303866715,CHEM 143C,A03,089807,Ternansky; Robert J.,19,0,22,3
1653303866715,CHEM 143C,A04,089808,Ternansky; Robert J.,20,0,22,2
1653303867238,CHEM 152,A00,089809,Romero; Nathan A & Schmidt; Valerie A,35,0,40,5
1653303867767,CHEM 171,A01,092688,Slade; Jonathan,35,0,45,10
1653303867767,CHEM 171,A02,092689,Slade; Jonathan,44,0,45,1
1653303867767,CHEM 171,A03,092690,Slade; Jonathan,45,0,45,0
1653303868294,CHEM 186,A00,089811,Paesani; Francesco,9,0,15,6
1653303868825,CHIN 10AD,A01,086223,Staff,13,0,13,0
1653303868825,CHIN 10AD,A02,086224,Staff,12,0,13,1
1653303868825,CHIN 10AD,B01,086227,Staff,14,0,15,1
1653303869350,CHIN 10AM,A01,086230,Chen; Pei-Chia,16,0,16,0
1653303869350,CHIN 10AM,A02,086231,Chen; Pei-Chia,16,0,16,0
1653303869883,CHIN 10AN,A01,086234,Xu; Li,14,0,14,0
1653303869883,CHIN 10AN,A02,086235,Xu; Li,14,0,14,0
1653303869883,CHIN 10AN,B01,086240,Xu; Li,14,0,14,0
1653303869883,CHIN 10AN,B02,086242,Xu; Li,0,0,0,0
1653303869883,CHIN 10AN,C01,086245,Xu; Li,14,0,14,0
1653303869883,CHIN 10AN,C02,086246,Xu; Li,14,0,14,0
1653303870407,CHIN 20AD,A01,086248,Wang; Xiao,14,0,14,0
1653303870407,CHIN 20AD,A02,086249,Wang; Xiao,14,0,14,0
1653303870407,CHIN 20AD,B01,086251,Wang; Xiao,13,0,14,1
1653303870407,CHIN 20AD,B02,086252,Wang; Xiao,14,0,14,0
1653303870932,CHIN 20AM,A01,086254,Wang; Xiao,11,0,14,3
1653303870932,CHIN 20AM,A02,086255,Wang; Xiao,13,0,14,1
1653303870932,CHIN 20AM,B01,086257,Staff,15,0,15,0
1653303871457,CHIN 20AN,A01,086259,Anderson; Qin-Hong,11,0,12,1
1653303871457,CHIN 20AN,A02,086260,Anderson; Qin-Hong,12,0,12,0
1653303871457,CHIN 20AN,A03,086261,Anderson; Qin-Hong,0,0,0,0
1653303871457,CHIN 20AN,B01,086263,Anderson; Qin-Hong,12,0,13,1
1653303871457,CHIN 20AN,B02,086264,Anderson; Qin-Hong,13,0,13,0
1653303871984,CHIN 100AM,A00,086265,Anderson; Qin-Hong,20,0,20,0
1653303872512,CHIN 100AN,A00,086266,Chen; Pei-Chia,17,0,20,3
1653303873041,CHIN 185A,A00,086268,Staff,20,0,20,0
1653303873566,COGS 1,A01,087834,Barrera; Steven James,57,0,60,3
1653303873566,COGS 1,A02,087835,Barrera; Steven James,52,0,60,8
1653303873566,COGS 1,A03,087836,Barrera; Steven James,57,0,60,3
1653303873566,COGS 1,A04,087837,Barrera; Steven James,59,0,60,1
1653303873566,COGS 1,A05,087838,Barrera; Steven James,60,0,60,0
1653303873566,COGS 1,A06,087839,Barrera; Steven James,59,0,60,1
1653303873566,COGS 1,A07,087840,Barrera; Steven James,54,0,57,3
1653303874092,COGS 2,A01,087842,Boyle; Mary E. T.,64,0,64,0
1653303874092,COGS 2,A02,087843,Boyle; Mary E. T.,61,0,64,3
1653303874092,COGS 2,A03,087844,Boyle; Mary E. T.,64,0,64,0
1653303874619,COGS 3,A01,094312,Boyle; Mary E. T.,30,0,35,5
1653303874619,COGS 3,A02,094313,Boyle; Mary E. T.,33,0,35,2
1653303874619,COGS 3,A03,094314,Boyle; Mary E. T.,35,0,35,0
1653303874619,COGS 3,A04,094315,Boyle; Mary E. T.,35,0,35,0
1653303874619,COGS 3,A05,094316,Boyle; Mary E. T.,35,0,35,0
1653303875143,COGS 8,A01,087846,Staff,35,0,35,0
1653303875675,COGS 10,A01,094357,Hollan; James D.,53,0,60,7
1653303875675,COGS 10,A02,094358,Hollan; James D.,58,0,60,2
1653303875675,COGS 10,A03,094359,Hollan; James D.,59,0,60,1
1653303875675,COGS 10,A04,094360,Hollan; James D.,60,0,60,0
1653303875675,COGS 10,A05,094361,Hollan; James D.,60,0,60,0
1653303876203,COGS 11,A01,087848,Boyle; Mary E. T.,46,0,47,1
1653303876203,COGS 11,A02,087849,Boyle; Mary E. T.,44,0,47,3
1653303876203,COGS 11,A03,087850,Boyle; Mary E. T.,46,0,46,0
1653303876725,COGS 13,A01,087852,Davis; Joshua Daniel,56,0,60,4
1653303876725,COGS 13,A02,087853,Davis; Joshua Daniel,55,0,60,5
1653303876725,COGS 13,A03,087854,Davis; Joshua Daniel,57,0,60,3
1653303876725,COGS 13,A04,087855,Davis; Joshua Daniel,58,0,60,2
1653303877252,COGS 14A,A01,087857,Creel; Sarah,58,0,65,7
1653303877252,COGS 14A,A02,087858,Creel; Sarah,62,0,65,3
1653303877252,COGS 14A,A03,087859,Creel; Sarah,63,0,65,2
1653303877252,COGS 14A,A04,087860,Creel; Sarah,63,0,65,2
1653303877779,COGS 14B,A01,087862,Hoffman; Drew Ellen,56,0,60,4
1653303877779,COGS 14B,A02,087863,Hoffman; Drew Ellen,53,0,60,7
1653303877779,COGS 14B,A03,087864,Hoffman; Drew Ellen,60,0,60,0
1653303878303,COGS 15,A01,087866,Bergen; Benjamin,60,0,60,0
1653303878303,COGS 15,A02,087867,Bergen; Benjamin,59,0,60,1
1653303878832,COGS 17,A01,087869,Johnson; Christine M.,55,0,60,5
1653303878832,COGS 17,A02,087870,Johnson; Christine M.,58,0,60,2
1653303878832,COGS 17,A03,087871,Johnson; Christine M.,55,0,60,5
1653303878832,COGS 17,A04,087872,Johnson; Christine M.,60,0,60,0
1653303878832,COGS 17,A05,087873,Johnson; Christine M.,59,0,60,1
1653303878832,COGS 17,A06,087874,Johnson; Christine M.,60,0,60,0
1653303879362,COGS 18,A01,087876,Fleischer; Jason G,22,0,35,13
1653303879362,COGS 18,A02,087877,Fleischer; Jason G,31,0,35,4
1653303879362,COGS 18,A03,087878,Fleischer; Jason G,33,0,35,2
1653303879362,COGS 18,A04,087879,Fleischer; Jason G,33,0,35,2
1653303879362,COGS 18,A05,087880,Fleischer; Jason G,28,0,35,7
1653303879362,COGS 18,A06,087881,Fleischer; Jason G,34,0,35,1
1653303879362,COGS 18,A07,087882,Fleischer; Jason G,33,0,35,2
1653303879362,COGS 18,A08,087883,Fleischer; Jason G,31,0,35,4
1653303879362,COGS 18,A09,087884,Fleischer; Jason G,33,0,35,2
1653303879887,COGS 20,A01,090761,Borgo; David Garcia,5,0,5,0
1653303879887,COGS 20,A02,090762,Borgo; David Garcia,5,0,5,0
1653303879887,COGS 20,A03,090763,Borgo; David Garcia,5,0,5,0
1653303880412,COGS 87,A00,087885,Deak; Gedeon O.,20,0,20,0
1653303880412,COGS 87,B00,087886,Fleischer; Jason G,20,0,20,0
1653303880936,COGS 100,A01,087892,Kirsh; David Joel,56,0,60,4
1653303880936,COGS 100,A02,087893,Kirsh; David Joel,54,0,60,6
1653303880936,COGS 100,A03,087894,Kirsh; David Joel,54,0,60,6
1653303880936,COGS 100,A04,087895,Kirsh; David Joel,51,0,60,9
1653303880936,COGS 100,A05,087896,Kirsh; David Joel,48,0,60,12
1653303881462,COGS 101A,A01,087898,Hoffman; Drew Ellen,48,0,60,12
1653303881462,COGS 101A,A02,087899,Hoffman; Drew Ellen,58,0,60,2
1653303881462,COGS 101A,A03,087900,Hoffman; Drew Ellen,55,0,60,5
1653303881462,COGS 101A,A04,087901,Hoffman; Drew Ellen,58,0,60,2
1653303881462,COGS 101A,A05,087902,Hoffman; Drew Ellen,59,0,60,1
1653303881462,COGS 101A,A06,087903,Hoffman; Drew Ellen,56,0,60,4
1653303881986,COGS 101B,A01,087905,Barrera; Steven James,30,0,60,30
1653303881986,COGS 101B,A02,087906,Barrera; Steven James,52,0,60,8
1653303881986,COGS 101B,A03,087907,Barrera; Steven James,54,0,60,6
1653303882515,COGS 101C,A01,094240,Cooperrider; Kensy A,70,0,75,5
1653303882515,COGS 101C,A02,094241,Cooperrider; Kensy A,73,0,75,2
1653303883040,COGS 102A,A01,087909,Scott; Taylor Jackson,58,0,60,2
1653303883040,COGS 102A,A02,087910,Scott; Taylor Jackson,51,0,60,9
1653303883564,COGS 107A,A01,087912,Rangel; Lara M,51,0,60,9
1653303883564,COGS 107A,A02,087913,Rangel; Lara M,54,0,60,6
1653303883564,COGS 107A,A03,087914,Rangel; Lara M,47,0,60,13
1653303883564,COGS 107A,A04,087915,Rangel; Lara M,53,0,60,7
1653303883564,COGS 107A,A05,087916,Rangel; Lara M,55,0,60,5
1653303883564,COGS 107A,A06,087917,Rangel; Lara M,50,0,60,10
1653303884089,COGS 108,A01,087919,Fleischer; Jason G,14,0,60,46
1653303884089,COGS 108,A02,087920,Fleischer; Jason G,25,0,60,35
1653303884089,COGS 108,A03,087921,Fleischer; Jason G,40,0,60,20
1653303884089,COGS 108,A04,087922,Fleischer; Jason G,40,0,60,20
1653303884089,COGS 108,A05,087923,Fleischer; Jason G,48,0,60,12
1653303884089,COGS 108,A06,087924,Fleischer; Jason G,55,0,60,5
1653303884089,COGS 108,A07,087925,Fleischer; Jason G,42,0,57,15
1653303884617,COGS 110,A01,087927,Deak; Gedeon O.,30,0,35,5
1653303884617,COGS 110,A02,087928,Deak; Gedeon O.,33,0,35,2
1653303885142,COGS 116,A01,094228,Greene; Deanna Jacquelyn,51,0,52,1
1653303885142,COGS 116,A02,094229,Greene; Deanna Jacquelyn,52,0,52,0
1653303885142,COGS 116,A03,094230,Greene; Deanna Jacquelyn,50,0,52,2
1653303886059,COGS 118B,A01,087930,De Sa; Virginia,24,0,35,11
1653303886059,COGS 118B,A02,087931,De Sa; Virginia,28,0,35,7
1653303886059,COGS 118B,A03,087932,De Sa; Virginia,18,0,35,17
1653303886059,COGS 118B,A04,087933,De Sa; Virginia,29,0,35,6
1653303886059,COGS 118B,A05,087934,De Sa; Virginia,27,0,35,8
1653303886059,COGS 118B,A06,087935,De Sa; Virginia,27,0,35,8
1653303886591,COGS 120,A01,087937,Xia; Haijun,38,0,50,12
1653303886591,COGS 120,A02,087938,Xia; Haijun,32,0,50,18
1653303886591,COGS 120,A03,087939,Xia; Haijun,26,0,50,24
1653303886591,COGS 120,A04,087940,Xia; Haijun,1,0,50,49
1653303887115,COGS 128,A01,087944,Scott; Taylor Jackson,11,0,56,45
1653303887640,COGS 143,A01,087947,Johnson; Christine M.,23,0,40,17
1653303888167,COGS 153,A00,087949,Davis; Joshua Daniel,46,0,75,29
1653303888698,COGS 160,A00,087950,Deak; Gedeon O.,20,0,20,0
1653303888698,COGS 160,B00,094232,Saygin; Ayse P,40,0,40,0
1653303889222,COGS 175,A01,094238,Staff,27,0,40,13
1653303889753,COGS 187A,A01,087958,Kirsh; David Joel,22,0,50,28
1653303889753,COGS 187A,A02,087959,Kirsh; David Joel,30,0,50,20
1653303889753,COGS 187A,A03,087960,Kirsh; David Joel,34,0,45,11
1653303890280,COGS 190A,A00,087961,Staff,9999,0,9999,0
1653303890804,COGS 194,A00,087962,Hill; Seth J,9999,0,9999,0
1653303891337,COMM 10,A02,090628,Schmidt; Thomas Rainer,1,0,5,4
1653303891337,COMM 10,A03,090629,Schmidt; Thomas Rainer,3,0,5,2
1653303891337,COMM 10,A04,090630,Schmidt; Thomas Rainer,4,0,5,1
1653303891337,COMM 10,A05,090631,Schmidt; Thomas Rainer,4,0,5,1
1653303891337,COMM 10,A06,090632,Schmidt; Thomas Rainer,5,0,5,0
1653303891337,COMM 10,A07,090633,Schmidt; Thomas Rainer,5,0,5,0
1653303891337,COMM 10,A08,090634,Schmidt; Thomas Rainer,5,0,5,0
1653303891337,COMM 10,A09,090635,Schmidt; Thomas Rainer,5,0,5,0
1653303891337,COMM 10,A10,090636,Schmidt; Thomas Rainer,2,0,5,3
1653303891337,COMM 10,A11,090637,Schmidt; Thomas Rainer,4,0,5,1
1653303891337,COMM 10,A12,094013,Schmidt; Thomas Rainer,2,0,5,3
1653303891337,COMM 10,A13,094014,Schmidt; Thomas Rainer,5,0,5,0
1653303891337,COMM 10,A14,094015,Schmidt; Thomas Rainer,4,0,5,1
1653303891337,COMM 10,A15,094016,Schmidt; Thomas Rainer,5,0,5,0
1653303891865,COMM 100A,A01,090639,Irani; Lilly C,5,0,5,0
1653303891865,COMM 100A,A02,090640,Irani; Lilly C,4,0,5,1
1653303891865,COMM 100A,A03,090641,Irani; Lilly C,5,0,5,0
1653303891865,COMM 100A,A04,090642,Irani; Lilly C,3,0,5,2
1653303891865,COMM 100A,A05,090643,Irani; Lilly C,3,0,5,2
1653303891865,COMM 100A,A06,090644,Irani; Lilly C,4,0,5,1
1653303891865,COMM 100A,A07,090645,Irani; Lilly C,5,0,5,0
1653303891865,COMM 100A,A08,090646,Irani; Lilly C,5,0,5,0
1653303891865,COMM 100A,A09,090647,Irani; Lilly C,5,0,5,0
1653303891865,COMM 100A,A10,090648,Irani; Lilly C,5,0,5,0
1653303891865,COMM 100A,A11,090649,Irani; Lilly C,3,0,5,2
1653303891865,COMM 100A,A12,090650,Irani; Lilly C,5,0,5,0
1653303892398,COMM 101,A01,090652,Halm; Gavin Patrick,14,0,15,1
1653303892398,COMM 101,A02,090653,Halm; Gavin Patrick,14,0,15,1
1653303892398,COMM 101,A03,090654,Halm; Gavin Patrick,12,0,15,3
1653303892398,COMM 101,A04,090655,Halm; Gavin Patrick,13,0,15,2
1653303892925,COMM 101D,A00,090656,Halm; Gavin Patrick,14,0,15,1
1653303893456,COMM 101K,A00,090657,Ahn; Patricia Jeehyun,16,0,20,4
1653303893982,COMM 101T,A00,093701,Staff,20,0,20,0
1653303894508,COMM 102C,A01,090660,Staff,4,0,6,2
1653303894508,COMM 102C,A02,090661,Staff,6,0,6,0
1653303894508,COMM 102C,A03,090662,Staff,4,0,6,2
1653303895033,COMM 103D,A00,090663,Davis; Zeinabu I.,38,0,40,2
1653303895558,COMM 106E,A00,090667,Geiger; Richard Stuart,26,0,30,4
1653303896082,COMM 106G,A00,090668,Cordoba Azcarate; Matilde,25,0,30,5
1653303896612,COMM 108G,A00,090670,Walkover; Lillian B,30,0,30,0
1653303897142,COMM 109I,A00,090671,Tanaka; Stefan A.,30,0,30,0
1653303897666,COMM 109N,A00,094205,Hallin; Daniel C,25,0,30,5
1653303898194,COMM 110G,A00,090672,Whitworth-Smith; Andrew C,45,0,50,5
1653303898718,COMM 111P,A00,090673,Conner; Thomas Hartnell,27,0,30,3
1653303899263,COMM 111T,A00,090674,Iatarola; Briana Marie,27,0,30,3
1653303899789,COMM 124A,A00,090677,Sims; Christopher O,79,0,80,1
1653303900316,COMM 131,A00,090678,Fields; Gary,22,0,25,3
1653303900844,COMM 134,A00,090679,Kidman; Shawna F,16,0,25,9
1653303901367,COMM 146,A00,090680,Staff,22,0,25,3
1653303901891,COMM 166,A00,094493,Staff,24,0,25,1
1653303902414,COMM 172,A00,094066,Staff,23,0,25,2
1653303902946,COMM 182,A00,094063,Staff,25,0,25,0
1653303903479,COMM 190,A00,090686,Kidman; Shawna F,17,0,23,6
1653303903479,COMM 190,B00,090687,Irani; Lilly C,0,0,0,0
1653303903479,COMM 190,C00,090688,Keith; Kerry,21,0,23,2
1653303903479,COMM 190,D00,090689,Zilberg; Elana,23,0,23,0
1653303904001,COMM 194,A00,091600,Hill; Seth J,9999,0,9999,0
1653303904573,COMM 196A,A00,090690,Schmidt; Thomas Rainer,0,0,0,0
1653303905119,COMM 198,001,091397,Ahn; Patricia Jeehyun,9999,0,9999,0
1653303905119,COMM 198,002,091398,Alac; Morana,9999,0,9999,0
1653303905119,COMM 198,003,091399,Anderson; Patrick W.,9999,0,9999,0
1653303905119,COMM 198,004,091400,Boateng; Boatema,9999,0,9999,0
1653303905119,COMM 198,005,091401,Booker; Angela N,9999,0,9999,0
1653303905119,COMM 198,008,091402,Cordoba Azcarate; Matilde,9999,0,9999,0
1653303905119,COMM 198,009,091403,Davis; Zeinabu I.,9999,0,9999,0
1653303905119,COMM 198,010,091404,Dewaard; Andrew Michael,9999,0,9999,0
1653303905119,COMM 198,011,091405,Dominguez Rubio; Fernando,9999,0,9999,0
1653303905119,COMM 198,012,091406,Fattal; Alexander Leor,9999,0,9999,0
1653303905119,COMM 198,013,091407,Fields; Gary,9999,0,9999,0
1653303905119,COMM 198,014,091408,Gates; Kelly,9999,0,9999,0
1653303905119,COMM 198,015,091409,Goldfarb; Brian,9999,0,9999,0
1653303905119,COMM 198,018,091410,Hill; Erin Truesdell,9999,0,9999,0
1653303905119,COMM 198,019,091411,Horwitz; Robert B,9999,0,9999,0
1653303905119,COMM 198,021,091412,Irani; Lilly C,9999,0,9999,0
1653303905119,COMM 198,022,091413,Jack; Caroline Sarah,9999,0,9999,0
1653303905119,COMM 198,023,091414,Kidman; Shawna F,9999,0,9999,0
1653303905119,COMM 198,024,091415,Martinico; Daniel J,9999,0,9999,0
1653303905119,COMM 198,026,091416,Schmidt; Thomas Rainer,9999,0,9999,0
1653303905119,COMM 198,027,091417,Serlin; David,9999,0,9999,0
1653303905119,COMM 198,028,091418,Sims; Christopher O,9999,0,9999,0
1653303905119,COMM 198,029,091419,Tanaka; Stefan A.,9999,0,9999,0
1653303905119,COMM 198,030,091420,Zilberg; Elana,9999,0,9999,0
1653303905119,COMM 198,031,091421,Walkover; Lillian B,9999,0,9999,0
1653303905119,COMM 198,032,091422,Geiger; Richard Stuart,9999,0,9999,0
1653303905657,CSE 8A,A50,089985,Soosai Raj; Adalbert Geral,7,0,10,3
1653303905657,CSE 8A,A51,089986,Soosai Raj; Adalbert Geral,1,0,10,9
1653303905657,CSE 8A,A52,089987,Soosai Raj; Adalbert Geral,5,0,10,5
1653303905657,CSE 8A,A53,089988,Soosai Raj; Adalbert Geral,9,0,10,1
1653303905657,CSE 8A,B50,089990,Soosai Raj; Adalbert Geral,0,0,10,10
1653303905657,CSE 8A,B51,089991,Soosai Raj; Adalbert Geral,5,0,10,5
1653303905657,CSE 8A,B52,089992,Soosai Raj; Adalbert Geral,5,0,10,5
1653303905657,CSE 8A,B53,089993,Soosai Raj; Adalbert Geral,9,0,10,1
1653303905657,CSE 8A,C50,089995,Lerner; Sorin,0,0,10,10
1653303905657,CSE 8A,C51,089996,Lerner; Sorin,6,0,10,4
1653303905657,CSE 8A,C52,089997,Lerner; Sorin,9,0,10,1
1653303905657,CSE 8A,C53,089998,Lerner; Sorin,8,0,10,2
1653303906192,CSE 8B,A01,090000,Ochoa; Benjamin Lawrence,94,0,100,6
1653303906723,CSE 11,A01,090002,Cao; Yingjun,39,0,49,10
1653303906723,CSE 11,B01,090004,Cao; Yingjun,45,0,49,4
1653303906723,CSE 11,C01,090006,Cao; Yingjun,35,0,49,14
1653303907250,CSE 12,A01,090008,Staff,73,0,73,0
1653303907250,CSE 12,B01,090010,Staff,67,0,73,6
1653303907250,CSE 12,C01,090012,Staff,60,0,73,13
1653303907786,CSE 15L,A01,090014,Politz; Joseph Gibbs,4,0,10,6
1653303907786,CSE 15L,A02,090015,Politz; Joseph Gibbs,7,0,10,3
1653303907786,CSE 15L,A03,090016,Politz; Joseph Gibbs,9,0,10,1
1653303907786,CSE 15L,A04,090017,Politz; Joseph Gibbs,9,0,10,1
1653303907786,CSE 15L,A05,090018,Politz; Joseph Gibbs,9,0,10,1
1653303907786,CSE 15L,B01,090020,Politz; Joseph Gibbs,8,0,10,2
1653303907786,CSE 15L,B02,090021,Politz; Joseph Gibbs,6,0,10,4
1653303907786,CSE 15L,B03,090022,Politz; Joseph Gibbs,7,0,10,3
1653303907786,CSE 15L,B04,090023,Politz; Joseph Gibbs,7,0,10,3
1653303907786,CSE 15L,B05,090024,Politz; Joseph Gibbs,7,0,10,3
1653303908318,CSE 20,A01,090026,Staff,204,0,210,6
1653303908843,CSE 21,A01,090028,Impagliazzo; Russell,0,0,0,0
1653303908843,CSE 21,A02,094488,Impagliazzo; Russell,0,0,0,0
1653303908843,CSE 21,A03,094489,Impagliazzo; Russell,0,0,0,0
1653303909368,CSE 30,A01,092463,Muller; P Keith,73,0,100,27
1653303909368,CSE 30,A02,092464,Staff,97,0,100,3
1653303909896,CSE 87,A00,094193,Moshiri; Alexander Niema,20,0,20,0
1653303910424,CSE 95,A00,090030,Minnes Kemp; Mor Mia,35,0,35,0
1653303910424,CSE 95,B00,093883,Minnes Kemp; Mor Mia,35,0,35,0
1653303910424,CSE 95,C00,093885,Minnes Kemp; Mor Mia,35,0,35,0
1653303910949,CSE 100,A01,090033,Moshiri; Alexander Niema,68,0,114,46
1653303911479,CSE 100R,A01,093837,Moshiri; Alexander Niema,334,0,350,16
1653303912003,CSE 101,A01,090035,Saha; Barna,152,0,237,85
1653303912532,CSE 103,A01,090037,Freund; Yoav,60,0,75,15
1653303913058,CSE 105,A01,090039,Lovett; Shachar,201,0,225,24
1653303913583,CSE 106,A50,090042,Paturi; Ramamohan,11,0,30,19
1653303914110,CSE 107,A01,090044,Bellare; Mihir,94,0,120,26
1653303914636,CSE 110,A50,090047,Powell; Thomas Allan,39,0,50,11
1653303914636,CSE 110,A51,090048,Powell; Thomas Allan,39,0,50,11
1653303914636,CSE 110,A52,090049,Powell; Thomas Allan,48,0,50,2
1653303914636,CSE 110,A53,090050,Powell; Thomas Allan,49,0,50,1
1653303914636,CSE 110,A54,090051,Powell; Thomas Allan,45,0,50,5
1653303914636,CSE 110,A55,090052,Powell; Thomas Allan,50,0,50,0
1653303914636,CSE 110,A56,090053,Powell; Thomas Allan,49,0,50,1
1653303914636,CSE 110,A57,090054,Powell; Thomas Allan,41,0,45,4
1653303915165,CSE 118,A00,094897,Weibel; Nadir,0,0,0,0
1653303915689,CSE 120,A01,090056,Voelker; Geoffrey M.,226,0,300,74
1653303916217,CSE 124,A01,090058,Porter; George M,123,0,189,66
1653303916746,CSE 127,A01,090060,Savage; Stefan,46,0,189,143
1653303917269,CSE 130,A01,090062,Polikarpova; Nadezhda,171,0,189,18
1653303917797,CSE 132A,A01,090064,Deutsch; Alin Bernard,46,0,189,143
1653303918324,CSE 140,A01,090068,Eldon; John,169,0,196,27
1653303918324,CSE 140,B01,090070,Orailoglu; Alex,48,0,49,1
1653303918849,CSE 140L,A01,090072,Eldon; John,161,0,192,31
1653303918849,CSE 140L,B01,090075,Orailoglu; Alex,44,0,49,5
1653303919372,CSE 142,A01,090078,Porter; Leonard Emerson,86,0,146,60
1653303919372,CSE 142,B01,090080,Porter; Leonard Emerson,107,0,146,39
1653303919898,CSE 142L,A01,090082,Swanson; Steven James,48,0,146,98
1653303919898,CSE 142L,B01,090084,Swanson; Steven James,120,0,146,26
1653303920433,CSE 151B,A01,090088,Cottrell; Garrison W,258,0,328,70
1653303920963,CSE 152A,A01,090090,Chandraker; Manmohan Krishna,153,0,189,36
1653303921488,CSE 158,A01,090092,McAuley; Julian John,84,0,197,113
1653303922016,CSE 158R,A01,090094,McAuley; Julian John,306,0,353,47
1653303922541,CSE 167,A01,090096,Chern; Albert Ren-Haur,165,0,189,24
1653303923067,CSE 170,A01,090098,Vaccaro; Kristen Marie,20,0,20,0
1653303923067,CSE 170,A02,090099,Vaccaro; Kristen Marie,14,0,20,6
1653303923067,CSE 170,A03,090100,Vaccaro; Kristen Marie,14,0,20,6
1653303923067,CSE 170,A04,090101,Vaccaro; Kristen Marie,14,0,20,6
1653303923067,CSE 170,A05,090102,Vaccaro; Kristen Marie,18,0,20,2
1653303923593,CSE 190,A00,090103,Shalev; Aaron D,40,0,40,0
1653303923593,CSE 190,B00,090104,Vaccaro; Kristen Marie,100,0,100,0
1653303923593,CSE 190,C00,090105,Pannuto; Patrick William,25,0,25,0
1653303924119,CSE 191,A00,093848,Minnes Kemp; Mor Mia,9999,0,9999,0
1653303924648,CSE 193,A01,090107,Elsherif; May Elhussein,49,0,49,0
1653303925176,CSE 194,A01,090109,Munyaka; Imani N. S.,20,0,49,29
1653303925701,CSS 1,A01,086486,Staff,22,0,24,2
1653303925701,CSS 1,A02,086487,Staff,21,0,24,3
1653303925701,CSS 1,A03,086488,Staff,20,0,24,4
1653303925701,CSS 1,A04,086489,Staff,23,0,24,1
1653303926236,DOC 1,A01,086773,Solomon; Amanda Lee Albaniel,0,0,0,0
1653303926236,DOC 1,A02,086774,Solomon; Amanda Lee Albaniel,0,0,0,0
1653303926236,DOC 1,A03,086775,Solomon; Amanda Lee Albaniel,5,0,6,1
1653303926236,DOC 1,A04,086776,Solomon; Amanda Lee Albaniel,6,0,6,0
1653303926236,DOC 1,A05,086777,Solomon; Amanda Lee Albaniel,6,0,6,0
1653303926236,DOC 1,A06,086778,Solomon; Amanda Lee Albaniel,6,0,6,0
1653303926236,DOC 1,A07,086779,Solomon; Amanda Lee Albaniel,5,0,6,1
1653303926236,DOC 1,A08,086849,Solomon; Amanda Lee Albaniel,6,0,6,0
1653303926236,DOC 1,A09,086780,Solomon; Amanda Lee Albaniel,6,0,6,0
1653303926236,DOC 1,A10,086781,Solomon; Amanda Lee Albaniel,6,0,6,0
1653303926236,DOC 1,A11,086782,Solomon; Amanda Lee Albaniel,5,0,6,1
1653303926236,DOC 1,A12,086783,Solomon; Amanda Lee Albaniel,6,0,6,0
1653303926236,DOC 1,A13,086784,Solomon; Amanda Lee Albaniel,6,0,6,0
1653303926236,DOC 1,A14,086785,Solomon; Amanda Lee Albaniel,6,0,6,0
1653303926236,DOC 1,A15,086786,Solomon; Amanda Lee Albaniel,6,0,6,0
1653303926236,DOC 1,A16,086787,Solomon; Amanda Lee Albaniel,6,0,6,0
1653303926236,DOC 1,A17,086788,Solomon; Amanda Lee Albaniel,0,0,0,0
1653303926236,DOC 1,A18,086789,Solomon; Amanda Lee Albaniel,0,0,0,0
1653303926236,DOC 1,B01,086791,Solomon; Amanda Lee Albaniel,6,0,6,0
1653303926236,DOC 1,B02,086792,Solomon; Amanda Lee Albaniel,6,0,6,0
1653303926236,DOC 1,B03,086793,Solomon; Amanda Lee Albaniel,6,0,6,0
1653303926236,DOC 1,B04,086794,Solomon; Amanda Lee Albaniel,6,0,6,0
1653303926236,DOC 1,B05,086795,Solomon; Amanda Lee Albaniel,3,0,6,3
1653303926236,DOC 1,B06,086796,Solomon; Amanda Lee Albaniel,6,0,6,0
1653303926236,DOC 1,B07,086797,Solomon; Amanda Lee Albaniel,6,0,6,0
1653303926236,DOC 1,B08,086798,Solomon; Amanda Lee Albaniel,6,0,6,0
1653303926236,DOC 1,B09,086799,Solomon; Amanda Lee Albaniel,6,0,6,0
1653303926236,DOC 1,B10,086800,Solomon; Amanda Lee Albaniel,6,0,6,0
1653303926236,DOC 1,B11,086801,Solomon; Amanda Lee Albaniel,5,0,6,1
1653303926236,DOC 1,B12,086802,Solomon; Amanda Lee Albaniel,6,0,6,0
1653303926236,DOC 1,B13,086803,Solomon; Amanda Lee Albaniel,6,0,6,0
1653303926236,DOC 1,B14,086804,Solomon; Amanda Lee Albaniel,6,0,6,0
1653303926236,DOC 1,B15,086805,Solomon; Amanda Lee Albaniel,5,0,6,1
1653303926236,DOC 1,B16,086806,Solomon; Amanda Lee Albaniel,6,0,6,0
1653303926236,DOC 1,B17,086807,Solomon; Amanda Lee Albaniel,0,0,0,0
1653303926236,DOC 1,B18,086808,Solomon; Amanda Lee Albaniel,0,0,0,0
1653303926236,DOC 1,C01,086810,Strom; Megan C.,6,0,6,0
1653303926236,DOC 1,C02,086811,Strom; Megan C.,5,0,6,1
1653303926236,DOC 1,C03,086812,Strom; Megan C.,6,0,6,0
1653303926236,DOC 1,C04,086813,Strom; Megan C.,5,0,6,1
1653303926236,DOC 1,C05,086814,Strom; Megan C.,5,0,6,1
1653303926236,DOC 1,C06,086815,Strom; Megan C.,6,0,6,0
1653303926236,DOC 1,C07,086816,Strom; Megan C.,6,0,6,0
1653303926236,DOC 1,C08,086817,Strom; Megan C.,6,0,6,0
1653303926236,DOC 1,C09,086818,Strom; Megan C.,6,0,6,0
1653303926236,DOC 1,C10,086819,Strom; Megan C.,6,0,6,0
1653303926236,DOC 1,C11,086820,Strom; Megan C.,6,0,6,0
1653303926236,DOC 1,C12,086821,Strom; Megan C.,6,0,6,0
1653303926236,DOC 1,C13,086822,Strom; Megan C.,6,0,6,0
1653303926236,DOC 1,C14,086823,Strom; Megan C.,6,0,6,0
1653303926236,DOC 1,C15,086824,Strom; Megan C.,6,0,6,0
1653303926236,DOC 1,C16,086825,Strom; Megan C.,6,0,6,0
1653303926236,DOC 1,C17,086826,Strom; Megan C.,0,0,0,0
1653303926236,DOC 1,C18,086827,Strom; Megan C.,0,0,0,0
1653303926236,DOC 1,D01,086829,Strom; Megan C.,6,0,6,0
1653303926236,DOC 1,D02,086830,Strom; Megan C.,6,0,6,0
1653303926236,DOC 1,D03,086831,Strom; Megan C.,5,0,6,1
1653303926236,DOC 1,D04,086832,Strom; Megan C.,6,0,6,0
1653303926236,DOC 1,D05,086833,Strom; Megan C.,6,0,6,0
1653303926236,DOC 1,D06,086834,Strom; Megan C.,6,0,6,0
1653303926236,DOC 1,D07,086835,Strom; Megan C.,6,0,6,0
1653303926236,DOC 1,D08,086836,Strom; Megan C.,6,0,6,0
1653303926236,DOC 1,D09,086837,Strom; Megan C.,0,0,0,0
1653303926236,DOC 1,D10,086838,Strom; Megan C.,0,0,0,0
1653303926236,DOC 1,D11,086839,Strom; Megan C.,6,0,6,0
1653303926236,DOC 1,D12,086840,Strom; Megan C.,6,0,6,0
1653303926236,DOC 1,D13,086841,Strom; Megan C.,6,0,6,0
1653303926236,DOC 1,D14,086842,Strom; Megan C.,5,0,6,1
1653303926236,DOC 1,D15,086843,Strom; Megan C.,6,0,6,0
1653303926236,DOC 1,D16,086844,Strom; Megan C.,5,0,6,1
1653303926761,DOC 100D,A00,086845,Pass; Natalye Joann,0,0,0,0
1653303926761,DOC 100D,B00,086846,Pass; Natalye Joann,21,0,25,4
1653303926761,DOC 100D,C00,086847,Pass; Natalye Joann,23,0,25,2
1653303927297,DSC 10,A01,088092,Tiefenbruck; Janine LoBue,13,0,15,2
1653303927297,DSC 10,B01,088095,Tiefenbruck; Janine LoBue,9,0,15,6
1653303927297,DSC 10,C01,088098,Rampure; Suraj,0,0,15,15
1653303927826,DSC 20,A01,088101,Langlois; Marina,148,0,150,2
1653303928349,DSC 30,A01,088105,Langlois; Marina,74,0,75,1
1653303928879,DSC 40A,A01,088107,Rampure; Suraj,97,0,100,3
1653303928879,DSC 40A,B01,088109,Rampure; Suraj,99,0,100,1
1653303929411,DSC 40B,A01,088111,Eldridge; Justin Matthew,73,0,75,2
1653303929411,DSC 40B,B01,088113,Wang; Yusu,75,0,75,0
1653303929938,DSC 80,A01,088115,Eldridge; Justin Matthew,95,0,100,5
1653303930464,DSC 95,A01,088117,Langlois; Marina,20,0,20,0
1653303930988,DSC 96,A00,088118,Liao; Soohyun Nam,50,0,50,0
1653303931516,DSC 100,A01,088120,Salimi; Babak,164,0,175,11
1653303932043,DSC 102,A01,094320,Kumar; Arun Kumar,77,0,125,48
1653303932578,DSC 180A,A01,088124,Fraenkel; Aaron Mcmillan,0,0,0,0
1653303932578,DSC 180A,A02,088125,Fraenkel; Aaron Mcmillan,0,0,0,0
1653303932578,DSC 180A,A03,088126,Fraenkel; Aaron Mcmillan,0,0,0,0
1653303932578,DSC 180A,A04,088127,Fraenkel; Aaron Mcmillan,0,0,0,0
1653303932578,DSC 180A,A05,088128,Fraenkel; Aaron Mcmillan,0,0,0,0
1653303932578,DSC 180A,A06,088129,Fraenkel; Aaron Mcmillan,0,0,0,0
1653303932578,DSC 180A,A07,088130,Fraenkel; Aaron Mcmillan,0,0,0,0
1653303932578,DSC 180A,A08,088131,Fraenkel; Aaron Mcmillan,0,0,0,0
1653303932578,DSC 180A,A09,088132,Fraenkel; Aaron Mcmillan,0,0,0,0
1653303932578,DSC 180A,A10,088133,Fraenkel; Aaron Mcmillan,0,0,0,0
1653303932578,DSC 180A,A11,088134,Fraenkel; Aaron Mcmillan,0,0,0,0
1653303932578,DSC 180A,A12,088135,Fraenkel; Aaron Mcmillan,0,0,0,0
1653303932578,DSC 180A,A13,088136,Fraenkel; Aaron Mcmillan,0,0,0,0
1653303932578,DSC 180A,A14,088137,Fraenkel; Aaron Mcmillan,0,0,0,0
1653303932578,DSC 180A,A15,088138,Fraenkel; Aaron Mcmillan,0,0,0,0
1653303932578,DSC 180A,B01,088141,Fraenkel; Aaron Mcmillan,0,0,0,0
1653303932578,DSC 180A,B02,088142,Fraenkel; Aaron Mcmillan,0,0,0,0
1653303932578,DSC 180A,B03,088143,Fraenkel; Aaron Mcmillan,0,0,0,0
1653303932578,DSC 180A,B04,088144,Fraenkel; Aaron Mcmillan,0,0,0,0
1653303932578,DSC 180A,B05,088145,Fraenkel; Aaron Mcmillan,0,0,0,0
1653303932578,DSC 180A,B06,088146,Fraenkel; Aaron Mcmillan,0,0,0,0
1653303932578,DSC 180A,B07,088147,Fraenkel; Aaron Mcmillan,0,0,0,0
1653303932578,DSC 180A,B08,088148,Fraenkel; Aaron Mcmillan,0,0,0,0
1653303932578,DSC 180A,B09,088149,Fraenkel; Aaron Mcmillan,0,0,0,0
1653303932578,DSC 180A,B10,088150,Fraenkel; Aaron Mcmillan,0,0,0,0
1653303932578,DSC 180A,B11,088151,Fraenkel; Aaron Mcmillan,0,0,0,0
1653303932578,DSC 180A,B12,088152,Fraenkel; Aaron Mcmillan,0,0,0,0
1653303932578,DSC 180A,B13,088153,Fraenkel; Aaron Mcmillan,0,0,0,0
1653303932578,DSC 180A,B14,088154,Fraenkel; Aaron Mcmillan,0,0,0,0
1653303932578,DSC 180A,B15,088155,Fraenkel; Aaron Mcmillan,0,0,0,0
1653303933105,DSC 190,A01,088158,Mishne; Gal,48,0,50,2
1653303933105,DSC 190,B01,088160,Silberman; Jack,16,0,21,5
1653303933628,DSC 197,001,088161,Eldridge; Justin Matthew,9999,0,9999,0
1653303934157,DSGN 1,A01,087888,Meyer; Michael Wayne,49,0,53,4
1653303934157,DSGN 1,A02,087889,Meyer; Michael Wayne,47,0,53,6
1653303934157,DSGN 1,A03,087890,Meyer; Michael Wayne,43,0,53,10
1653303934681,DSGN 100,A01,087983,Dow; Steven P,39,0,40,1
1653303934681,DSGN 100,A02,087984,Dow; Steven P,40,0,40,0
1653303934681,DSGN 100,A03,087985,Dow; Steven P,34,0,40,6
1653303935213,DSGN 118,A01,087987,Xia; Haijun,55,0,60,5
1653303935213,DSGN 118,A02,087988,Xia; Haijun,56,0,60,4
1653303935740,DSGN 119,A00,087989,Staff,51,0,70,19
1653303936264,ECE 5,A01,090699,Morris; Karcher William,0,0,0,0
1653303936264,ECE 5,A02,090700,Morris; Karcher William,0,0,0,0
1653303936264,ECE 5,A03,090701,Morris; Karcher William,0,0,0,0
1653303936264,ECE 5,A04,090702,Morris; Karcher William,0,0,0,0
1653303936264,ECE 5,A05,090703,Morris; Karcher William,0,0,0,0
1653303936264,ECE 5,A06,090704,Morris; Karcher William,0,0,0,0
1653303936795,ECE 15,A01,090706,Schurgers; Curt,0,0,0,0
1653303936795,ECE 15,A02,090707,Schurgers; Curt,0,0,0,0
1653303937322,ECE 16,A01,090709,Khoshabeh; Ramsin,24,0,30,6
1653303937853,ECE 17,A01,090711,Gilja; Vikash,55,0,60,5
1653303938378,ECE 25,A50,090714,Liu; Zhaowei,0,0,0,0
1653303938378,ECE 25,A51,090715,Liu; Zhaowei,0,0,0,0
1653303938378,ECE 25,A52,090716,Liu; Zhaowei,0,0,0,0
1653303938904,ECE 30,A50,094300,Mir Arabbaygi; Siavash,25,0,30,5
1653303938904,ECE 30,A51,094301,Mir Arabbaygi; Siavash,29,0,30,1
1653303938904,ECE 30,A52,094302,Mir Arabbaygi; Siavash,27,0,30,3
1653303938904,ECE 30,A53,094303,Mir Arabbaygi; Siavash,29,0,30,1
1653303938904,ECE 30,A54,094304,Mir Arabbaygi; Siavash,25,0,25,0
1653303939542,ECE 35,A50,090720,Schurgers; Curt,0,0,0,0
1653303939542,ECE 35,A51,090721,Schurgers; Curt,0,0,0,0
1653303939542,ECE 35,A52,090722,Schurgers; Curt,0,0,0,0
1653303939542,ECE 35,A53,090723,Schurgers; Curt,0,0,0,0
1653303939542,ECE 35,A54,090724,Schurgers; Curt,0,0,0,0
1653303939542,ECE 35,A55,090725,Schurgers; Curt,0,0,0,0
1653303939542,ECE 35,B50,090729,Schurgers; Curt,0,0,0,0
1653303939542,ECE 35,B51,090730,Schurgers; Curt,0,0,0,0
1653303939542,ECE 35,B52,090731,Schurgers; Curt,0,0,0,0
1653303939542,ECE 35,B53,090732,Schurgers; Curt,0,0,0,0
1653303939542,ECE 35,B54,090733,Schurgers; Curt,0,0,0,0
1653303939542,ECE 35,B55,090734,Schurgers; Curt,0,0,0,0
1653303940072,ECE 45,A01,090736,Franceschetti; Massimo,56,0,57,1
1653303940072,ECE 45,A02,090737,Franceschetti; Massimo,50,0,58,8
1653303940607,ECE 65,A50,090741,Baghdadchi; Saharnaz,13,0,15,2
1653303940607,ECE 65,A51,090742,Baghdadchi; Saharnaz,5,0,10,5
1653303940607,ECE 65,A52,090743,Baghdadchi; Saharnaz,14,0,15,1
1653303940607,ECE 65,A53,090744,Baghdadchi; Saharnaz,8,0,10,2
1653303940607,ECE 65,A54,094865,Baghdadchi; Saharnaz,14,0,15,1
1653303940607,ECE 65,A55,094866,Baghdadchi; Saharnaz,9,0,10,1
1653303940607,ECE 65,A56,094867,Baghdadchi; Saharnaz,14,0,15,1
1653303940607,ECE 65,A57,094868,Baghdadchi; Saharnaz,15,0,15,0
1653303940607,ECE 65,A58,094869,Baghdadchi; Saharnaz,10,0,10,0
1653303941144,ECE 100,A01,090746,Baghdadchi; Saharnaz,16,0,20,4
1653303941144,ECE 100,A02,090747,Baghdadchi; Saharnaz,20,0,20,0
1653303941144,ECE 100,A03,090748,Baghdadchi; Saharnaz,18,0,20,2
1653303941144,ECE 100,A04,090749,Baghdadchi; Saharnaz,20,0,20,0
1653303941144,ECE 100,A05,090750,Baghdadchi; Saharnaz,18,0,20,2
1653303941144,ECE 100,A06,090751,Baghdadchi; Saharnaz,18,0,20,2
1653303941144,ECE 100,A07,090752,Baghdadchi; Saharnaz,20,0,20,0
1653303941680,ECE 101,A01,090754,Siegel; Paul H.,62,0,75,13
1653303941680,ECE 101,A02,090755,Siegel; Paul H.,71,0,75,4
1653303942204,ECE 102,A00,090756,Hsueh; Tzu-Chien,57,0,75,18
1653303942732,ECE 103,A01,090767,Lo; Yu-Hwa,45,0,50,5
1653303943260,ECE 107,A01,090769,Lomakin; Vitaliy,72,0,75,3
1653303943789,ECE 109,A01,090771,Zeger; Kenneth A.,176,0,180,4
1653303944316,ECE 111,A01,090774,Koushanfar; Farinaz,100,0,120,20
1653303944840,ECE 121A,A50,090777,Esmaili; Gholamreza,17,0,24,7
1653303944840,ECE 121A,A51,090778,Esmaili; Gholamreza,9,0,24,15
1653303944840,ECE 121A,A52,090779,Esmaili; Gholamreza,22,0,24,2
1653303945366,ECE 128A,A00,090780,Staff,40,0,70,30
1653303945892,ECE 135A,A00,090781,Kuzum; Duygu,30,0,30,0
1653303946416,ECE 143,A00,090782,Unpingco; Jose H.,0,0,0,2
1653303946941,ECE 148,A01,090784,Staff,32,0,32,0
1653303947465,ECE 155,A01,090786,Milstein; Laurence B.,16,0,20,4
1653303947987,ECE 158A,A01,090788,Franceschetti; Massimo,56,0,65,9
1653303948516,ECE 161A,A01,090790,Rao; Bhaskar D.,103,0,115,12
1653303949044,ECE 164,A00,090791,Hall; Drew A.,87,0,115,28
1653303949570,ECE 166,A50,090796,Rebeiz; Gabriel,6,0,12,6
1653303949570,ECE 166,A51,090797,Rebeiz; Gabriel,9,0,12,3
1653303949570,ECE 166,A52,090799,Rebeiz; Gabriel,1,0,12,11
1653303949570,ECE 166,A53,090800,Rebeiz; Gabriel,6,0,12,6
1653303949570,ECE 166,A54,094335,Rebeiz; Gabriel,11,0,12,1
1653303949570,ECE 166,A55,094336,Rebeiz; Gabriel,12,0,12,0
1653303949570,ECE 166,A56,094349,Rebeiz; Gabriel,13,0,15,2
1653303949570,ECE 166,A57,094350,Rebeiz; Gabriel,14,0,15,1
1653303950094,ECE 171A,A01,090802,Atanasov; Nikolay A.,45,0,60,15
1653303950625,ECE 171B,A01,090804,Shi; Yuanyuan,44,0,50,6
1653303951151,ECE 174,A01,090806,Pal; Piya,125,0,146,21
1653303951675,ECE 182,A01,090808,Lomakin; Vitaliy,23,0,23,0
1653303952198,ECE 187,A00,090809,Liu; Zhaowei,19,0,20,1
1653303952730,ECE 196,A00,090812,Morris; Karcher William,19,0,24,5
1653303952730,ECE 196,B00,094833,Morris; Karcher William,24,0,24,0
1653303953255,ECE 197,001,090813,Sievenpiper; Daniel F.,9999,0,9999,0
1653303953798,ECON 1,A01,092535,Staff,0,0,0,0
1653303953798,ECON 1,A02,092536,Staff,0,0,0,0
1653303953798,ECON 1,A03,092537,Staff,0,0,0,0
1653303953798,ECON 1,A04,092538,Staff,0,0,0,0
1653303953798,ECON 1,A05,092539,Staff,0,0,0,0
1653303953798,ECON 1,B01,092540,Ma; Alyson Chan,42,0,45,3
1653303953798,ECON 1,B02,092541,Ma; Alyson Chan,45,0,45,0
1653303953798,ECON 1,B03,092542,Ma; Alyson Chan,45,0,45,0
1653303953798,ECON 1,B04,092543,Ma; Alyson Chan,40,0,40,0
1653303953798,ECON 1,B05,092544,Ma; Alyson Chan,40,0,40,0
1653303953798,ECON 1,C01,092545,Tocoian; Oana,0,0,0,0
1653303953798,ECON 1,C02,092546,Tocoian; Oana,0,0,0,0
1653303953798,ECON 1,C03,092547,Tocoian; Oana,0,0,0,0
1653303953798,ECON 1,C04,092548,Tocoian; Oana,0,0,0,0
1653303953798,ECON 1,D01,094253,Levkoff; Steven B.,41,0,45,4
1653303953798,ECON 1,D02,094254,Levkoff; Steven B.,44,0,45,1
1653303953798,ECON 1,D03,094255,Levkoff; Steven B.,45,0,45,0
1653303953798,ECON 1,D04,094256,Levkoff; Steven B.,36,0,40,4
1653303953798,ECON 1,D05,094257,Levkoff; Steven B.,40,0,40,0
1653303954328,ECON 2,A01,092549,Staff,0,0,0,0
1653303954328,ECON 2,A02,092550,Staff,0,0,0,0
1653303954328,ECON 2,A03,092551,Staff,0,0,0,0
1653303954855,ECON 4,A01,092554,Levkoff; Steven B.,29,0,30,1
1653303954855,ECON 4,A02,092555,Levkoff; Steven B.,27,0,30,3
1653303954855,ECON 4,A03,092556,Levkoff; Steven B.,30,0,30,0
1653303955380,ECON 100A,A01,092557,Newhouse; Herbert S,23,0,30,7
1653303955380,ECON 100A,A02,092558,Newhouse; Herbert S,28,0,30,2
1653303955380,ECON 100A,A03,092559,Newhouse; Herbert S,29,0,30,1
1653303955380,ECON 100A,A04,092560,Newhouse; Herbert S,35,0,35,0
1653303955380,ECON 100A,B01,092561,Newhouse; Herbert S,20,0,30,10
1653303955380,ECON 100A,B02,092562,Newhouse; Herbert S,28,0,30,2
1653303955380,ECON 100A,B03,092563,Newhouse; Herbert S,15,0,30,15
1653303955380,ECON 100A,B04,092564,Newhouse; Herbert S,35,0,35,0
1653303955908,ECON 100B,A01,092565,Galperti; Simone,27,0,30,3
1653303955908,ECON 100B,A02,092566,Galperti; Simone,18,0,20,2
1653303955908,ECON 100B,A03,094496,Staff,27,0,30,3
1653303955908,ECON 100B,A04,094497,Staff,16,0,20,4
1653303955908,ECON 100B,B01,092567,Galperti; Simone,16,0,25,9
1653303956443,ECON 100C,A01,092569,Du; Songzi,62,0,75,13
1653303956443,ECON 100C,B01,092570,Du; Songzi,70,0,75,5
1653303956443,ECON 100C,B02,094258,Du; Songzi,75,0,75,0
1653303956967,ECON 100CH,A00,088284,Andreoni; James,20,0,20,0
1653303957491,ECON 109,A01,092572,Watson; Joel Christopher,68,0,75,7
1653303957491,ECON 109,B01,092573,Watson; Joel Christopher,68,0,75,7
1653303958016,ECON 110A,A01,092574,Alon; Titan Michael,12,0,25,13
1653303958016,ECON 110A,A02,092575,Alon; Titan Michael,24,0,25,1
1653303958016,ECON 110A,B01,092576,Alon; Titan Michael,24,0,25,1
1653303958016,ECON 110A,B02,092577,Alon; Titan Michael,25,0,25,0
1653303958545,ECON 110B,A01,092578,Trottner; Fabian Gunter We,16,0,25,9
1653303958545,ECON 110B,A02,094054,Trottner; Fabian Gunter We,23,0,25,2
1653303958545,ECON 110B,B01,092579,Trottner; Fabian Gunter We,7,0,25,18
1653303958545,ECON 110B,B02,094055,Trottner; Fabian Gunter We,24,0,25,1
1653303959068,ECON 116,A00,088291,Lowes; Sara Rachel,58,0,70,12
1653303959595,ECON 120A,A01,092580,Elliott; Graham,18,0,25,7
1653303959595,ECON 120A,A02,092581,Elliott; Graham,22,0,25,3
1653303959595,ECON 120A,B01,092582,Elliott; Graham,18,0,25,7
1653303959595,ECON 120A,B02,092583,Elliott; Graham,20,0,25,5
1653303959595,ECON 120A,C01,092584,Tocoian; Oana,27,0,30,3
1653303959595,ECON 120A,C02,092585,Tocoian; Oana,28,0,30,2
1653303959595,ECON 120A,C03,092586,Tocoian; Oana,40,0,40,0
1653303960118,ECON 120B,A01,092587,Candido; Maria Teresa,58,0,70,12
1653303960118,ECON 120B,A02,092588,Candido; Maria Teresa,51,0,60,9
1653303960118,ECON 120B,A03,092589,Candido; Maria Teresa,56,0,60,4
1653303960647,ECON 120C,A01,092590,Candido; Maria Teresa,48,0,60,12
1653303960647,ECON 120C,A02,092591,Candido; Maria Teresa,59,0,60,1
1653303960647,ECON 120C,A03,094310,Candido; Maria Teresa,73,0,75,2
1653303961172,ECON 121,A00,088298,Vogl; Tom Saul,36,0,50,14
1653303961698,ECON 130,A00,088299,Staff,59,0,75,16
1653303962222,ECON 131,A00,088300,Jacobsen; Mark,129,0,150,21
1653303962222,ECON 131,B00,088301,Jacobsen; Mark,15,0,30,15
1653303962747,ECON 152,A00,088302,Fadlon; Yizhak,34,0,50,16
1653303962747,ECON 152,B00,088303,Fadlon; Yizhak,49,0,50,1
1653303963276,ECON 168,A00,088304,Staff,54,0,60,6
1653303963802,ECON 191B,A00,088312,Galperti; Simone,20,0,20,0
1653303964337,EDS 25,A01,087581,Staff,9,0,10,1
1653303964337,EDS 25,A02,087582,Staff,10,0,10,0
1653303964337,EDS 25,A03,087583,Staff,7,0,10,3
1653303964337,EDS 25,A04,087584,Staff,10,0,10,0
1653303964864,EDS 31,A00,087585,Bussey; Thomas J,9,0,10,1
1653303965387,EDS 110R,A01,087597,Cohen; Shana R,43,0,50,7
1653303965387,EDS 110R,B01,093579,Cohen; Shana R,10,0,10,0
1653303965915,EDS 113,A00,087598,Staff,45,0,50,5
1653303966438,EDS 114,A01,088091,Eguchi; Emi,17,0,20,3
1653303966438,EDS 114,A02,087600,Eguchi; Emi,19,0,20,1
1653303966962,EDS 117,A01,087603,Chung; Luz Marina,25,0,35,10
1653303966962,EDS 117,A02,087604,Chung; Luz Marina,34,0,35,1
1653303967497,EDS 124AR,A01,087606,Simon; Elizabeth A,0,0,19,19
1653303967497,EDS 124AR,A02,087607,Simon; Elizabeth A,13,0,19,6
1653303967497,EDS 124AR,A03,087608,Simon; Elizabeth A,15,0,19,4
1653303967497,EDS 124AR,A04,087609,Simon; Elizabeth A,4,0,19,15
1653303967497,EDS 124AR,B01,087611,Simon; Elizabeth A,14,0,19,5
1653303967497,EDS 124AR,B02,087612,Simon; Elizabeth A,18,0,19,1
1653303967497,EDS 124AR,B03,087613,Simon; Elizabeth A,18,0,19,1
1653303967497,EDS 124AR,B04,087614,Simon; Elizabeth A,19,0,19,0
1653303967497,EDS 124AR,C01,094210,Simon; Elizabeth A,6,0,6,0
1653303967497,EDS 124AR,C02,094211,Simon; Elizabeth A,6,0,6,0
1653303967497,EDS 124AR,C03,094212,Simon; Elizabeth A,6,0,6,0
1653303967497,EDS 124AR,C04,094213,Simon; Elizabeth A,6,0,6,0
1653303967497,EDS 124AR,D01,094215,Simon; Elizabeth A,6,0,6,0
1653303967497,EDS 124AR,D02,094216,Simon; Elizabeth A,6,0,6,0
1653303967497,EDS 124AR,D03,094217,Simon; Elizabeth A,6,0,6,0
1653303967497,EDS 124AR,D04,094218,Simon; Elizabeth A,6,0,6,0
1653303968025,EDS 124BR,A00,087615,Eguchi; Emi,65,0,75,10
1653303968025,EDS 124BR,B00,093580,Eguchi; Emi,25,0,25,0
1653303968548,EDS 125,A00,087616,Jones; Gabrielle Anastasia,51,0,60,9
1653303969071,EDS 129A,A01,087618,Heinzman; Erica M.,43,0,50,7
1653303969599,EDS 130,A01,087620,Holtzman; Caren Lynn,17,0,20,3
1653303969599,EDS 130,A02,087621,Holtzman; Caren Lynn,20,0,20,0
1653303969599,EDS 130,A03,087622,Holtzman; Caren Lynn,20,0,20,0
1653303970122,EDS 131,A01,087624,Wishard Guerra; Alison G.,37,0,40,3
1653303970652,EDS 133,A01,087627,Bintliff; Amy S.V.,17,0,20,3
1653303970652,EDS 133,A02,087628,Bintliff; Amy S.V.,19,0,20,1
1653303971178,EDS 139,A00,087629,Holtzman; Caren Lynn,55,0,60,5
1653303971178,EDS 139,B00,087630,Heinzman; Erica M.,51,0,60,9
1653303971178,EDS 139,C00,087631,Bintliff; Amy S.V.,57,0,60,3
1653303971178,EDS 139,D00,087632,Wishard Guerra; Alison G.,58,0,60,2
1653303971178,EDS 139,E00,087633,Holtzman; Caren Lynn,30,0,30,0
1653303971178,EDS 139,F00,094886,Staff,25,0,25,0
1653303971703,EDS 146,A01,094220,Staff,25,0,25,0
1653303972225,EDS 164R,A01,087644,Wishard Guerra; Alison G.,37,0,40,3
1653303972225,EDS 164R,B01,093582,Wishard Guerra; Alison G.,20,0,20,0
1653303972750,EDS 190,A00,087645,Bresser; Bernard George,20,0,20,0
1653303972750,EDS 190,B00,087646,Pappas; Elizabeth,20,0,20,0
1653303972750,EDS 190,C00,087647,Scharton; Susan Michelle,20,0,20,0
1653303972750,EDS 190,E00,087648,Staff,20,0,20,0
1653303973273,ENG 10,A00,086288,Staff,30,0,30,0
1653303973273,ENG 10,B00,086289,Staff,30,0,30,0
1653303973796,ENG 15,A01,086291,Staff,35,0,35,0
1653303974320,ENG 20,A00,086292,Evdokimenko; Ekaterina,33,0,35,2
1653303974843,ENG 100D,A00,086293,Ngo; Anh-Thu T.,45,0,50,5
1653303974843,ENG 100D,B00,094309,Staff,46,0,50,4
1653303975379,ENG 100L,A00,086295,Kleissl; Jan,6,0,6,0
1653303975379,ENG 100L,B00,086296,Bratton; Maryann,8,0,8,0
1653303975379,ENG 100L,C00,086297,Nguyen; Truong Quang,10,0,10,0
1653303975379,ENG 100L,E00,086299,de Oliveira; Mauricio,8,0,8,0
1653303975379,ENG 100L,F00,086300,Goldberg; Charles G.,6,0,6,0
1653303975379,ENG 100L,G00,086301,Bratton; Maryann,6,0,6,0
1653303975379,ENG 100L,H00,086302,Staff,6,0,6,0
1653303975903,ENVR 30,A01,093565,Staff,29,0,30,1
1653303975903,ENVR 30,A02,093567,Staff,28,0,30,2
1653303975903,ENVR 30,A03,093568,Staff,25,0,30,5
1653303975903,ENVR 30,A04,093569,Staff,30,0,30,0
1653303975903,ENVR 30,A05,093570,Staff,29,0,30,1
1653303975903,ENVR 30,A06,093566,Staff,29,0,30,1
1653303976431,ENVR 102,A00,093571,Daly; Heather Marie,25,0,30,5
1653303977492,ERC 1,A01,092328,Herbst; Matthew,20,0,20,0
1653303977492,ERC 1,A02,092330,Herbst; Matthew,20,0,20,0
1653303977492,ERC 1,A03,092331,Herbst; Matthew,20,0,20,0
1653303977492,ERC 1,A04,092332,Herbst; Matthew,20,0,20,0
1653303977492,ERC 1,A05,092333,Herbst; Matthew,20,0,20,0
1653303977492,ERC 1,A06,092334,Herbst; Matthew,20,0,20,0
1653303978021,ERC 2,A01,092336,Rahimi; Babak,20,0,20,0
1653303978021,ERC 2,A02,092337,Rahimi; Babak,20,0,20,0
1653303978021,ERC 2,A03,092338,Rahimi; Babak,20,0,20,0
1653303978021,ERC 2,A04,092339,Rahimi; Babak,20,0,20,0
1653303978546,ERC 20,A00,092340,Evans; Ivan T,30,0,30,0
1653303978546,ERC 20,B00,092341,Evans; Ivan T,30,0,30,0
1653303979075,ERC 87,A00,093850,Herbst; Matthew,20,0,20,0
1653303979599,ERC 92,A00,092342,Staff,1,0,1,0
1653303979599,ERC 92,B00,092343,Staff,1,0,1,0
1653303979599,ERC 92,C00,092344,Staff,1,0,1,0
1653303979599,ERC 92,D00,092345,Staff,1,0,1,0
1653303979599,ERC 92,E00,092346,Staff,1,0,1,0
1653303979599,ERC 92,F00,092347,Staff,1,0,1,0
1653303980122,ESYS 90,A00,086303,Teranes; Jane,12,0,12,0
1653303980648,ESYS 101,A01,086305,Taylor; Jennifer Rebecca & Diaz; Julia Michelle,25,0,27,2
1653303980648,ESYS 101,A02,086306,Taylor; Jennifer Rebecca & Diaz; Julia Michelle,15,0,27,12
1653303980648,ESYS 101,A03,086307,Taylor; Jennifer Rebecca & Diaz; Julia Michelle,21,0,27,6
1653303980648,ESYS 101,A04,086308,Taylor; Jennifer Rebecca & Diaz; Julia Michelle,27,0,27,0
1653303981171,ESYS 187A,A01,086310,Teranes; Jane,38,0,40,2
1653303981171,ESYS 187A,B01,086312,Teranes; Jane,30,0,40,10
1653303981706,ETHN 1,A01,086314,Frank; Ross H.,15,0,15,0
1653303981706,ETHN 1,A02,086315,Frank; Ross H.,15,0,15,0
1653303981706,ETHN 1,A03,086316,Frank; Ross H.,14,0,15,1
1653303981706,ETHN 1,A04,086317,Frank; Ross H.,15,0,15,0
1653303981706,ETHN 1,A05,086318,Frank; Ross H.,15,0,15,0
1653303981706,ETHN 1,A06,086319,Frank; Ross H.,13,0,15,2
1653303981706,ETHN 1,A07,086320,Frank; Ross H.,15,0,15,0
1653303981706,ETHN 1,A08,086321,Frank; Ross H.,14,0,15,1
1653303981706,ETHN 1,A09,086322,Frank; Ross H.,15,0,15,0
1653303981706,ETHN 1,A10,086323,Frank; Ross H.,15,0,15,0
1653303981706,ETHN 1,A11,086324,Frank; Ross H.,15,0,15,0
1653303981706,ETHN 1,A12,086325,Frank; Ross H.,15,0,15,0
1653303981706,ETHN 1,A13,086326,Frank; Ross H.,15,0,15,0
1653303981706,ETHN 1,A14,086327,Frank; Ross H.,15,0,15,0
1653303981706,ETHN 1,A15,086328,Frank; Ross H.,15,0,15,0
1653303981706,ETHN 1,A16,086329,Frank; Ross H.,15,0,15,0
1653303982232,ETHN 100A,A00,086330,Patel; Shaista,41,0,48,7
1653303982757,ETHN 103,A00,086331,Perreira; Christopher Michael,63,0,70,7
1653303983283,ETHN 104,A00,086332,Staff,0,0,0,0
1653303983813,ETHN 106,A00,086333,Staff,0,0,0,0
1653303984337,ETHN 121,A00,086341,Sasaki; Christen T,20,0,28,8
1653303984865,ETHN 139,A00,086342,Ruiz; Ariana,16,0,20,4
1653303985401,ETHN 144M,A00,086343,Jolivette; Andrew J,66,0,70,4
1653303985924,ETHN 159,A00,088427,Graham; Jessica Lynn,0,0,0,0
1653303986452,ETHN 163E,A00,086344,Patel; Shaista,37,0,40,3
1653303986980,ETHN 178R,A00,090798,Borgo; David Garcia,15,0,20,5
1653303987504,ETHN 187,A00,086345,Perez; Roy,14,0,16,2
1653303988028,EXPR 100,A00,085686,Staff,9999,0,9999,0
1653303988551,FMPH 40,A00,086370,Emory; Kristen,70,0,75,5
1653303988551,FMPH 40,B00,086371,Romero; Sally Ann Dominick,71,0,75,4
1653303989074,FMPH 101,A00,086372,Brouwer; Kimberly,43,0,55,12
1653303989600,FMPH 102,A50,094498,Rana; Brinda Kanti,42,0,55,13
1653303990124,FMPH 110,A00,086374,Zoumas-Morse; Christine E.,61,0,65,4
1653303990648,FMPH 120,A00,086375,Nguyen-Grozavu; France T.,45,0,65,20
1653303990648,FMPH 120,B00,086376,Nguyen-Grozavu; France T.,60,0,65,5
1653303991174,FMPH 130,A00,086377,Staff,48,0,65,17
1653303992227,FMPH 161,A00,086379,Zoumas-Morse; Christine E.,58,0,65,7
1653303992824,FMPH 191,A00,086380,Harrell; Maralee Mae,58,0,60,2
1653303993361,FMPH 196A,A00,086381,Binkin; Nancy Jeanne,0,0,0,0
1653303993885,GLBH 20,A00,086407,Walkover; Lillian B,85,0,90,5
1653303994415,GLBH 100,A00,086408,Staff,55,0,56,1
1653303994415,GLBH 100,B00,086409,Wu; Hua,52,0,56,4
1653303994415,GLBH 100,D00,086411,Staff,38,0,40,2
1653303994940,GLBH 103,A00,086412,Hannah; Seth Donal,48,0,50,2
1653303995464,GLBH 105,A00,086413,Olivas Hernandez; Olga Lid,36,0,38,2
1653303995991,GLBH 106,A00,086414,Kayser; Georgia Lyn,40,0,40,0
1653303996522,GLBH 111,A01,094330,Burgos; Jose L.,0,0,0,0
1653303996522,GLBH 111,B01,094332,Burgos; Jose L.,0,0,0,0
1653303997046,GLBH 148,A00,086415,Staff,69,0,73,4
1653303997573,GLBH 181,A00,086417,Burgos; Jose L.,144,0,146,2
1653303998096,GSS 20,A00,094269,Staff,73,0,75,2
1653303998626,HDS 1,A01,086423,Staff,24,0,25,1
1653303998626,HDS 1,A02,086424,Staff,24,0,25,1
1653303998626,HDS 1,A03,086425,Staff,23,0,25,2
1653303998626,HDS 1,A04,086426,Staff,25,0,25,0
1653303998626,HDS 1,A05,086427,Staff,24,0,25,1
1653303998626,HDS 1,A06,086428,Staff,25,0,25,0
1653303998626,HDS 1,A07,086429,Staff,30,0,30,0
1653303999150,HDS 60,A01,086431,Staff,23,0,25,2
1653303999674,HDS 111,A00,086432,Staff,73,0,80,7
1653304000197,HDS 121,A01,086434,Deak; Gedeon O.,11,0,15,4
1653304000197,HDS 121,A02,086435,Deak; Gedeon O.,13,0,15,2
1653304000732,HDS 150,A00,086436,Staff,25,0,25,0
1653304000732,HDS 150,B00,086437,Staff,25,0,25,0
1653304001255,HDS 173,A00,086439,Staff,27,0,30,3
1653304001778,HDS 181,A01,086441,Staff,30,0,30,0
1653304002302,HDS 191,A01,086443,Staff,25,0,25,0
1653304002827,HIEA 129,A00,088057,Schneewind; Sarah,0,0,0,0
1653304003360,HIEA 137,A00,088058,Lu; Weijing,53,0,55,2
1653304003883,HIEA 144,A00,088059,Henry; Todd A.,43,0,45,2
1653304004408,HIEA 171,A00,088060,Lu; Weijing,15,0,15,0
1653304004932,HIEU 102,A00,088061,Watts; Edward J.,0,0,0,0
1653304005464,HIEU 107,A00,088062,Caciola; Nancy A,0,0,0,0
1653304005989,HIEU 108,A00,088063,Balberg; Mira,53,0,60,7
1653304006517,HIEU 128,A00,088064,Neuheiser; Joerg,0,0,0,0
1653304007040,HIEU 144,A00,094327,Staff,48,0,50,2
1653304007566,HIEU 149,A00,088065,Devereux; Andrew W,38,0,45,7
1653304008093,HIEU 154,A00,088066,Biess; Frank Peter,58,0,65,7
1653304008622,HIGL 114,A00,088067,Edington; Claire Ellen,53,0,55,2
1653304009145,HILA 119,A00,088068,Vitz; Matthew,49,0,51,2
1653304009673,HILA 122,A00,088069,Widener; Daniel,61,0,65,4
1653304010206,HILD 2A,A01,088024,Hanna; Mark G.,28,0,28,0
1653304010206,HILD 2A,A02,088025,Hanna; Mark G.,25,0,25,0
1653304010206,HILD 2A,A03,088026,Hanna; Mark G.,27,0,28,1
1653304010206,HILD 2A,A04,088027,Hanna; Mark G.,28,0,28,0
1653304010206,HILD 2A,A05,088028,Hanna; Mark G.,28,0,28,0
1653304010206,HILD 2A,A06,088029,Hanna; Mark G.,28,0,28,0
1653304010732,HILD 7A,A01,088031,Graham; Jessica Lynn,28,0,28,0
1653304010732,HILD 7A,A02,088032,Graham; Jessica Lynn,27,0,28,1
1653304010732,HILD 7A,A03,088033,Graham; Jessica Lynn,27,0,28,1
1653304010732,HILD 7A,A04,088034,Graham; Jessica Lynn,26,0,28,2
1653304010732,HILD 7A,A05,088035,Graham; Jessica Lynn,26,0,28,2
1653304010732,HILD 7A,A06,088037,Graham; Jessica Lynn,22,0,28,6
1653304010732,HILD 7A,A07,088038,Graham; Jessica Lynn,28,0,28,0
1653304010732,HILD 7A,A08,088039,Graham; Jessica Lynn,28,0,28,0
1653304010732,HILD 7A,A09,088040,Graham; Jessica Lynn,27,0,28,1
1653304010732,HILD 7A,A10,088041,Graham; Jessica Lynn,28,0,28,0
1653304010732,HILD 7A,A11,088042,Graham; Jessica Lynn,28,0,28,0
1653304010732,HILD 7A,A12,088043,Graham; Jessica Lynn,28,0,28,0
1653304011258,HILD 10,A01,088045,Muscolino; Micah S,27,0,28,1
1653304011258,HILD 10,A02,088046,Muscolino; Micah S,27,0,28,1
1653304011258,HILD 10,A03,088047,Muscolino; Micah S,28,0,28,0
1653304011258,HILD 10,A04,088048,Muscolino; Micah S,27,0,28,1
1653304011258,HILD 10,A05,088049,Muscolino; Micah S,28,0,28,0
1653304011258,HILD 10,A06,088050,Muscolino; Micah S,27,0,28,1
1653304011785,HILD 30,A01,088052,Edington; Claire Ellen,24,0,28,4
1653304011785,HILD 30,A02,088053,Edington; Claire Ellen,28,0,28,0
1653304012308,HILD 41,A01,088055,Devereux; Andrew W,28,0,28,0
1653304012308,HILD 41,A02,088056,Devereux; Andrew W,28,0,28,0
1653304012833,HINE 116,A00,088070,Kayali; Hasan,47,0,50,3
1653304013357,HINE 144,A00,088071,Provence; Michael,40,0,45,5
